PokerStars Hand #238159637138:  Hold'em No Limit ($0.01/$0.02 USD) - 2022/08/22 21:37:23 ET
Table 'Achilles IV' 6-max Seat #3 is the button
Seat 1: Ramirres ($2 in chips)
Seat 2: MojaMamka ($0.80 in chips)
Seat 3: Leonardo Puel ($1.62 in chips)
Seat 4: 123 ($1.62 in chips)
Seat 6: pbanks08 ($0.78 in chips)
pbanks08: posts small blind $0.01
Ramirres: posts big blind $0.02
SurfinGhost: sits out
*** HOLE CARDS ***
MojaMamka: folds
Leonardo Puel: calls $0.02
pbanks08: calls $0.01
SurfinGhost leaves the table
Ramirres: checks
*** FLOP *** [5h 2d 8d]
pbanks08: checks
Ramirres: checks
Leonardo Puel: bets $0.06
pbanks08: calls $0.06
Ramirres: folds
*** TURN *** [5h 2d 8d] [4s]
pbanks08: checks
Leonardo Puel: checks
*** RIVER *** [5h 2d 8d 4s] [5c]
pbanks08: bets $0.10
tantanmen19 joins the table at seat #3
Leonardo Puel: folds
Uncalled bet ($0.10) returned to pbanks08
pbanks08 collected $0.17 from pot
pbanks08: doesn't show hand
*** SUMMARY ***
Total pot $0.18 | Rake $0.01
Board [5h 2d 8d 4s 5c]
Seat 1: Ramirres (big blind) folded on the Flop
Seat 2: MojaMamka folded before Flop (didn't bet)
Seat 4: Leonardo Puel (button) folded on the River
Seat 6: pbanks08 (small blind) collected ($0.17)


PokerStars Hand #238159655139:  Hold'em No Limit ($0.01/$0.02 USD) - 2022/08/22 21:38:49 ET
Table 'Achilles IV' 6-max Seat #6 is the button
Seat 1: Ramirres ($2 in chips)
Seat 2: MojaMamka ($0.80 in chips)
Seat 4: Leonardo Puel ($1.54 in chips)
Seat 6: pbanks08 ($0.87 in chips)
Ramirres: posts small blind $0.01
MojaMamka: posts big blind $0.02
tantanmen19: sits out
bichito72: sits out
*** HOLE CARDS ***
Leonardo Puel: calls $0.02
pbanks08: raises $0.02 to $0.04
Ramirres: folds
MojaMamka: calls $0.02
Leonardo Puel: calls $0.02
*** FLOP *** [9h Ts 6d]
MojaMamka: bets $0.06
Leonardo Puel: calls $0.06
pbanks08: raises $0.06 to $0.12
MojaMamka: calls $0.06
Leonardo Puel: calls $0.06
*** TURN *** [9h Ts 6d] [8c]
MojaMamka: checks
Leonardo Puel: checks
pbanks08: bets $0.20
MojaMamka: folds
Leonardo Puel: calls $0.20
*** RIVER *** [9h Ts 6d 8c] [5d]
Leonardo Puel: checks
pbanks08: bets $0.51 and is all-in
Leonardo Puel: folds
Uncalled bet ($0.51) returned to pbanks08
pbanks08 collected $0.86 from pot
pbanks08: doesn't show hand
*** SUMMARY ***
Total pot $0.89 | Rake $0.03
Board [9h Ts 6d 8c 5d]
Seat 1: Ramirres (small blind) folded before Flop
Seat 2: MojaMamka (big blind) folded on the Turn
Seat 4: Leonardo Puel folded on the River
Seat 6: pbanks08 (button) collected ($0.86)


PokerStars Hand #238159666177:  Hold'em No Limit ($0.01/$0.02 USD) - 2022/08/22 21:39:43 ET
Table 'Achilles IV' 6-max Seat #1 is the button
Seat 1: Ramirres ($2 in chips)
Seat 2: MojaMamka ($0.64 in chips)
Seat 3: tantanmen19 ($1.60 in chips)
Seat 4: Leonardo Puel ($1.18 in chips)
Seat 6: pbanks08 ($1.37 in chips)
MojaMamka: posts small blind $0.01
tantanmen19: posts big blind $0.02
bichito72: sits out
*** HOLE CARDS ***
Leonardo Puel: raises $0.02 to $0.04
pbanks08: calls $0.04
Ramirres: raises $0.20 to $0.24
MojaMamka: folds
tantanmen19: calls $0.22
Leonardo Puel: folds
pbanks08: calls $0.20
*** FLOP *** [Ah 5h Jd]
tantanmen19: checks
pbanks08: checks
Ramirres: bets $0.24
tantanmen19: folds
pbanks08: folds
Uncalled bet ($0.24) returned to Ramirres
Ramirres collected $0.74 from pot
*** SUMMARY ***
Total pot $0.77 | Rake $0.03
Board [Ah 5h Jd]
Seat 1: Ramirres (button) collected ($0.74)
Seat 2: MojaMamka (small blind) folded before Flop
Seat 3: tantanmen19 (big blind) folded on the Flop
Seat 4: Leonardo Puel folded before Flop
Seat 6: pbanks08 folded on the Flop


PokerStars Hand #238159679044:  Hold'em No Limit ($0.01/$0.02 USD) - 2022/08/22 21:40:45 ET
Table 'Achilles IV' 6-max Seat #2 is the button
Seat 1: Ramirres ($2.50 in chips)
Seat 2: MojaMamka ($0.63 in chips)
Seat 3: tantanmen19 ($1.36 in chips)
Seat 4: Leonardo Puel ($1.14 in chips)
Seat 6: pbanks08 ($1.13 in chips)
tantanmen19: posts small blind $0.01
Leonardo Puel: posts big blind $0.02
bichito72: sits out
*** HOLE CARDS ***
pbanks08: calls $0.02
Ramirres: folds
MojaMamka: folds
tantanmen19: folds
Leonardo Puel: checks
*** FLOP *** [8d 2s Jc]
tantanmen19 leaves the table
Leonardo Puel: checks
pbanks08: checks
*** TURN *** [8d 2s Jc] [Js]
Leonardo Puel: checks
pbanks08: bets $0.02
Leonardo Puel: calls $0.02
*** RIVER *** [8d 2s Jc Js] [Jd]
Leonardo Puel: checks
pbanks08: bets $0.10
Leonardo Puel: raises $0.15 to $0.25
pbanks08: raises $0.15 to $0.40
Leonardo Puel: raises $0.70 to $1.10 and is all-in
pbanks08: folds
Uncalled bet ($0.70) returned to Leonardo Puel
Leonardo Puel collected $0.86 from pot
*** SUMMARY ***
Total pot $0.89 | Rake $0.03
Board [8d 2s Jc Js Jd]
Seat 1: Ramirres folded before Flop (didn't bet)
Seat 2: MojaMamka (button) folded before Flop (didn't bet)
Seat 3: tantanmen19 (small blind) folded before Flop
Seat 4: Leonardo Puel (big blind) collected ($0.86)
Seat 6: pbanks08 folded on the River


PokerStars Hand #238159690908:  Hold'em No Limit ($0.01/$0.02 USD) - 2022/08/22 21:41:42 ET
Table 'Achilles IV' 6-max Seat #4 is the button
Seat 1: Ramirres ($2.50 in chips)
Seat 2: MojaMamka ($0.63 in chips)
Seat 4: Leonardo Puel ($1.56 in chips)
Seat 6: pbanks08 ($0.69 in chips)
pbanks08: posts small blind $0.01
Ramirres: posts big blind $0.02
*** HOLE CARDS ***
MojaMamka: folds
Leonardo Puel: calls $0.02
pbanks08: raises $0.02 to $0.04
Ramirres: folds
Leonardo Puel: calls $0.02
*** FLOP *** [6h 4s 3d]
pbanks08: checks
Leonardo Puel: checks
*** TURN *** [6h 4s 3d] [9c]
pbanks08: checks
Leonardo Puel: checks
*** RIVER *** [6h 4s 3d 9c] [5h]
pbanks08: checks
Leonardo Puel: checks
*** SHOW DOWN ***
pbanks08: shows [Ac 8c] (high card Ace)
Leonardo Puel: shows [As 8h] (high card Ace)
pbanks08 collected $0.05 from pot
Leonardo Puel collected $0.05 from pot
*** SUMMARY ***
Total pot $0.10 | Rake $0
Board [6h 4s 3d 9c 5h]
Seat 1: Ramirres (big blind) folded before Flop
Seat 2: MojaMamka folded before Flop (didn't bet)
Seat 4: Leonardo Puel (button) showed [As 8h] and won ($0.05) with high card Ace
Seat 6: pbanks08 (small blind) showed [Ac 8c] and won ($0.05) with high card Ace


PokerStars Hand #238159698862:  Hold'em No Limit ($0.01/$0.02 USD) - 2022/08/22 21:42:20 ET
Table 'Achilles IV' 6-max Seat #6 is the button
Seat 1: Ramirres ($2.48 in chips)
Seat 2: MojaMamka ($0.63 in chips)
Seat 4: Leonardo Puel ($1.57 in chips)
Seat 6: pbanks08 ($0.70 in chips)
Ramirres: posts small blind $0.01
MojaMamka: posts big blind $0.02
bichito72: sits out
*** HOLE CARDS ***
Leonardo Puel: folds
pbanks08: folds
Ramirres: folds
Uncalled bet ($0.01) returned to MojaMamka
MojaMamka collected $0.02 from pot
MojaMamka: doesn't show hand
*** SUMMARY ***
Total pot $0.02 | Rake $0
Seat 1: Ramirres (small blind) folded before Flop
Seat 2: MojaMamka (big blind) collected ($0.02)
Seat 4: Leonardo Puel folded before Flop (didn't bet)
Seat 6: pbanks08 (button) folded before Flop (didn't bet)


PokerStars Hand #238159701377:  Hold'em No Limit ($0.01/$0.02 USD) - 2022/08/22 21:42:33 ET
Table 'Achilles IV' 6-max Seat #1 is the button
Seat 1: Ramirres ($2.47 in chips)
Seat 2: MojaMamka ($0.64 in chips)
Seat 4: Leonardo Puel ($1.57 in chips)
Seat 6: pbanks08 ($0.70 in chips)
MojaMamka: posts small blind $0.01
Leonardo Puel: posts big blind $0.02
bichito72: sits out
*** HOLE CARDS ***
pbanks08: calls $0.02
Ramirres: folds
MojaMamka: calls $0.01
Leonardo Puel: checks
*** FLOP *** [Js Ts Qc]
MojaMamka: checks
Leonardo Puel: bets $0.06
pbanks08: folds
MojaMamka: folds
Uncalled bet ($0.06) returned to Leonardo Puel
Leonardo Puel collected $0.06 from pot
*** SUMMARY ***
Total pot $0.06 | Rake $0
Board [Js Ts Qc]
Seat 1: Ramirres (button) folded before Flop (didn't bet)
Seat 2: MojaMamka (small blind) folded on the Flop
Seat 4: Leonardo Puel (big blind) collected ($0.06)
Seat 6: pbanks08 folded on the Flop


PokerStars Hand #238159706610:  Hold'em No Limit ($0.01/$0.02 USD) - 2022/08/22 21:42:58 ET
Table 'Achilles IV' 6-max Seat #2 is the button
Seat 1: Ramirres ($2.47 in chips)
Seat 2: MojaMamka ($0.62 in chips)
Seat 4: Leonardo Puel ($1.61 in chips)
Seat 5: bichito72 ($2 in chips)
Seat 6: pbanks08 ($0.68 in chips)
Leonardo Puel: posts small blind $0.01
bichito72: posts big blind $0.02
*** HOLE CARDS ***
pbanks08: calls $0.02
Ramirres: folds
MojaMamka: raises $0.04 to $0.06
Leonardo Puel: calls $0.05
bichito72: folds
pbanks08: calls $0.04
*** FLOP *** [5s 2d 9d]
Leonardo Puel: checks
pbanks08: checks
MojaMamka: bets $0.09
Leonardo Puel: folds
pbanks08: folds
Uncalled bet ($0.09) returned to MojaMamka
MojaMamka collected $0.19 from pot
MojaMamka: doesn't show hand
*** SUMMARY ***
Total pot $0.20 | Rake $0.01
Board [5s 2d 9d]
Seat 1: Ramirres folded before Flop (didn't bet)
Seat 2: MojaMamka (button) collected ($0.19)
Seat 4: Leonardo Puel (small blind) folded on the Flop
Seat 5: bichito72 (big blind) folded before Flop
Seat 6: pbanks08 folded on the Flop


PokerStars Hand #238159712379:  Hold'em No Limit ($0.01/$0.02 USD) - 2022/08/22 21:43:26 ET
Table 'Achilles IV' 6-max Seat #4 is the button
Seat 1: Ramirres ($2.47 in chips)
Seat 2: MojaMamka ($0.75 in chips)
Seat 4: Leonardo Puel ($1.55 in chips)
Seat 5: bichito72 ($1.98 in chips)
Seat 6: pbanks08 ($0.62 in chips)
bichito72: posts small blind $0.01
pbanks08: posts big blind $0.02
*** HOLE CARDS ***
Ramirres: folds
MojaMamka: folds
Leonardo Puel: calls $0.02
bichito72: folds
pbanks08: checks
*** FLOP *** [Ad Td 8s]
pbanks08: checks
Leonardo Puel: bets $0.05
pbanks08: folds
Uncalled bet ($0.05) returned to Leonardo Puel
Leonardo Puel collected $0.05 from pot
*** SUMMARY ***
Total pot $0.05 | Rake $0
Board [Ad Td 8s]
Seat 1: Ramirres folded before Flop (didn't bet)
Seat 2: MojaMamka folded before Flop (didn't bet)
Seat 4: Leonardo Puel (button) collected ($0.05)
Seat 5: bichito72 (small blind) folded before Flop
Seat 6: pbanks08 (big blind) folded on the Flop


PokerStars Hand #238159718332:  Hold'em No Limit ($0.01/$0.02 USD) - 2022/08/22 21:43:55 ET
Table 'Achilles IV' 6-max Seat #5 is the button
Seat 1: Ramirres ($2.47 in chips)
Seat 2: MojaMamka ($0.75 in chips)
Seat 4: Leonardo Puel ($1.58 in chips)
Seat 5: bichito72 ($1.97 in chips)
Seat 6: pbanks08 ($0.60 in chips)
pbanks08: posts small blind $0.01
Ramirres: posts big blind $0.02
*** HOLE CARDS ***
MojaMamka: folds
Leonardo Puel: calls $0.02
bichito72: raises $0.06 to $0.08
pbanks08: calls $0.07
Ramirres: folds
Leonardo Puel: calls $0.06
*** FLOP *** [6h Ts 5s]
MOE.DINO joins the table at seat #3
pbanks08: checks
Leonardo Puel: checks
bichito72: bets $0.17
pbanks08: folds
Leonardo Puel: folds
Uncalled bet ($0.17) returned to bichito72
bichito72 collected $0.25 from pot
bichito72: doesn't show hand
*** SUMMARY ***
Total pot $0.26 | Rake $0.01
Board [6h Ts 5s]
Seat 1: Ramirres (big blind) folded before Flop
Seat 2: MojaMamka folded before Flop (didn't bet)
Seat 4: Leonardo Puel folded on the Flop
Seat 5: bichito72 (button) collected ($0.25)
Seat 6: pbanks08 (small blind) folded on the Flop


PokerStars Hand #238159725743:  Hold'em No Limit ($0.01/$0.02 USD) - 2022/08/22 21:44:31 ET
Table 'Achilles IV' 6-max Seat #6 is the button
Seat 1: Ramirres ($2.45 in chips)
Seat 2: MojaMamka ($0.75 in chips)
Seat 4: Leonardo Puel ($1.50 in chips)
Seat 5: bichito72 ($2.14 in chips)
Seat 6: pbanks08 ($0.52 in chips)
Ramirres: posts small blind $0.01
MojaMamka: posts big blind $0.02
MOE.DINO: sits out
*** HOLE CARDS ***
Leonardo Puel: calls $0.02
bichito72: folds
pbanks08: calls $0.02
Ramirres: raises $0.04 to $0.06
MojaMamka: calls $0.04
Leonardo Puel: calls $0.04
pbanks08: calls $0.04
*** FLOP *** [Qh Ts 4d]
Ramirres: checks
MojaMamka: checks
Leonardo Puel: bets $0.11
pbanks08: folds
Ramirres: folds
MojaMamka: folds
Uncalled bet ($0.11) returned to Leonardo Puel
Leonardo Puel collected $0.23 from pot
*** SUMMARY ***
Total pot $0.24 | Rake $0.01
Board [Qh Ts 4d]
Seat 1: Ramirres (small blind) folded on the Flop
Seat 2: MojaMamka (big blind) folded on the Flop
Seat 4: Leonardo Puel collected ($0.23)
Seat 5: bichito72 folded before Flop (didn't bet)
Seat 6: pbanks08 (button) folded on the Flop


PokerStars Hand #238159732645:  Hold'em No Limit ($0.01/$0.02 USD) - 2022/08/22 21:45:05 ET
Table 'Achilles IV' 6-max Seat #1 is the button
Seat 1: Ramirres ($2.39 in chips)
Seat 2: MojaMamka ($0.69 in chips)
Seat 3: MOE.DINO ($1.75 in chips)
Seat 4: Leonardo Puel ($1.67 in chips)
Seat 5: bichito72 ($2.14 in chips)
Seat 6: pbanks08 ($0.46 in chips)
MojaMamka: posts small blind $0.01
MOE.DINO: posts big blind $0.02
*** HOLE CARDS ***
Leonardo Puel: calls $0.02
bichito72: folds
pbanks08: calls $0.02
Ramirres: raises $0.07 to $0.09
MojaMamka: folds
MOE.DINO: calls $0.07
Leonardo Puel: calls $0.07
pbanks08: calls $0.07
*** FLOP *** [Kd 6c 2h]
MOE.DINO: checks
Leonardo Puel: checks
pbanks08: checks
Ramirres: bets $0.26
MOE.DINO: folds
Leonardo Puel: folds
pbanks08: folds
Uncalled bet ($0.26) returned to Ramirres
Ramirres collected $0.36 from pot
*** SUMMARY ***
Total pot $0.37 | Rake $0.01
Board [Kd 6c 2h]
Seat 1: Ramirres (button) collected ($0.36)
Seat 2: MojaMamka (small blind) folded before Flop
Seat 3: MOE.DINO (big blind) folded on the Flop
Seat 4: Leonardo Puel folded on the Flop
Seat 5: bichito72 folded before Flop (didn't bet)
Seat 6: pbanks08 folded on the Flop


PokerStars Hand #238159741555:  Hold'em No Limit ($0.01/$0.02 USD) - 2022/08/22 21:45:49 ET
Table 'Achilles IV' 6-max Seat #2 is the button
Seat 1: Ramirres ($2.66 in chips)
Seat 2: MojaMamka ($0.68 in chips)
Seat 3: MOE.DINO ($1.66 in chips)
Seat 4: Leonardo Puel ($1.58 in chips)
Seat 5: bichito72 ($2.14 in chips)
Seat 6: pbanks08 ($0.37 in chips)
MOE.DINO: posts small blind $0.01
Leonardo Puel: posts big blind $0.02
*** HOLE CARDS ***
bichito72: raises $0.04 to $0.06
pbanks08: folds
Ramirres: folds
MojaMamka: calls $0.06
MOE.DINO: calls $0.05
Leonardo Puel: calls $0.04
*** FLOP *** [6s 9c 2s]
MOE.DINO: checks
Leonardo Puel: bets $0.11
bichito72: folds
MojaMamka: calls $0.11
MOE.DINO: calls $0.11
*** TURN *** [6s 9c 2s] [4c]
MOE.DINO: checks
Leonardo Puel: bets $0.55
MojaMamka: calls $0.51 and is all-in
MOE.DINO: calls $0.55
*** RIVER *** [6s 9c 2s 4c] [3s]
MOE.DINO: checks
Leonardo Puel: bets $0.86 and is all-in
MOE.DINO: folds
Uncalled bet ($0.86) returned to Leonardo Puel
*** SHOW DOWN ***
Leonardo Puel: shows [9h 7h] (a pair of Nines)
Leonardo Puel collected $0.07 from side pot
MojaMamka: shows [4s Ks] (a flush, King high)
MojaMamka collected $2.03 from main pot
*** SUMMARY ***
Total pot $2.18 Main pot $2.03. Side pot $0.07. | Rake $0.08
Board [6s 9c 2s 4c 3s]
Seat 1: Ramirres folded before Flop (didn't bet)
Seat 2: MojaMamka (button) showed [4s Ks] and won ($2.03) with a flush, King high
Seat 3: MOE.DINO (small blind) folded on the River
Seat 4: Leonardo Puel (big blind) showed [9h 7h] and won ($0.07) with a pair of Nines
Seat 5: bichito72 folded on the Flop
Seat 6: pbanks08 folded before Flop (didn't bet)


PokerStars Hand #238159759669:  Hold'em No Limit ($0.01/$0.02 USD) - 2022/08/22 21:47:19 ET
Table 'Achilles IV' 6-max Seat #3 is the button
Seat 1: Ramirres ($2.66 in chips)
Seat 2: MojaMamka ($2.03 in chips)
Seat 3: MOE.DINO ($0.94 in chips)
Seat 4: Leonardo Puel ($0.93 in chips)
Seat 5: bichito72 ($2.08 in chips)
Seat 6: pbanks08 ($0.37 in chips)
Leonardo Puel: posts small blind $0.01
bichito72: posts big blind $0.02
*** HOLE CARDS ***
pbanks08: calls $0.02
Ramirres: raises $0.03 to $0.05
MojaMamka: folds
MOE.DINO: calls $0.05
Leonardo Puel: folds
bichito72: folds
pbanks08: folds
*** FLOP *** [Ac 8d 4h]
Ramirres: checks
MOE.DINO: checks
*** TURN *** [Ac 8d 4h] [5h]
Ramirres: checks
MOE.DINO: bets $0.14
Ramirres: folds
Uncalled bet ($0.14) returned to MOE.DINO
MOE.DINO collected $0.14 from pot
*** SUMMARY ***
Total pot $0.15 | Rake $0.01
Board [Ac 8d 4h 5h]
Seat 1: Ramirres folded on the Turn
Seat 2: MojaMamka folded before Flop (didn't bet)
Seat 3: MOE.DINO (button) collected ($0.14)
Seat 4: Leonardo Puel (small blind) folded before Flop
Seat 5: bichito72 (big blind) folded before Flop
Seat 6: pbanks08 folded before Flop


PokerStars Hand #238159772058:  Hold'em No Limit ($0.01/$0.02 USD) - 2022/08/22 21:48:10 ET
Table 'Achilles IV' 6-max Seat #4 is the button
Seat 1: Ramirres ($2.61 in chips)
Seat 2: MojaMamka ($2.03 in chips)
Seat 3: MOE.DINO ($1.03 in chips)
Seat 4: Leonardo Puel ($0.92 in chips)
Seat 5: bichito72 ($2.06 in chips)
Seat 6: pbanks08 ($0.35 in chips)
bichito72: posts small blind $0.01
pbanks08: posts big blind $0.02
*** HOLE CARDS ***
Ramirres: folds
MojaMamka: folds
MOE.DINO: calls $0.02
Leonardo Puel: calls $0.02
bichito72: calls $0.01
pbanks08: checks
*** FLOP *** [Jc Ah 7h]
bichito72: checks
pbanks08: checks
MOE.DINO: bets $0.04
Leonardo Puel: folds
bichito72: folds
pbanks08: folds
Uncalled bet ($0.04) returned to MOE.DINO
MOE.DINO collected $0.08 from pot
*** SUMMARY ***
Total pot $0.08 | Rake $0
Board [Jc Ah 7h]
Seat 1: Ramirres folded before Flop (didn't bet)
Seat 2: MojaMamka folded before Flop (didn't bet)
Seat 3: MOE.DINO collected ($0.08)
Seat 4: Leonardo Puel (button) folded on the Flop
Seat 5: bichito72 (small blind) folded on the Flop
Seat 6: pbanks08 (big blind) folded on the Flop


PokerStars Hand #238159780286:  Hold'em No Limit ($0.01/$0.02 USD) - 2022/08/22 21:48:51 ET
Table 'Achilles IV' 6-max Seat #5 is the button
Seat 1: Ramirres ($2.61 in chips)
Seat 2: MojaMamka ($2.03 in chips)
Seat 3: MOE.DINO ($1.09 in chips)
Seat 4: Leonardo Puel ($0.90 in chips)
Seat 5: bichito72 ($2.04 in chips)
Seat 6: pbanks08 ($0.33 in chips)
pbanks08: posts small blind $0.01
Ramirres: posts big blind $0.02
*** HOLE CARDS ***
MojaMamka: folds
MOE.DINO: folds
Leonardo Puel: calls $0.02
bichito72: raises $0.04 to $0.06
pbanks08: folds
Ramirres: folds
Leonardo Puel: calls $0.04
*** FLOP *** [9c 5s Qs]
Leonardo Puel: checks
bichito72: bets $0.07
Leonardo Puel: calls $0.07
*** TURN *** [9c 5s Qs] [6s]
Leonardo Puel: checks
bichito72: checks
*** RIVER *** [9c 5s Qs 6s] [Kd]
Leonardo Puel: bets $0.28
bichito72: folds
Uncalled bet ($0.28) returned to Leonardo Puel
Leonardo Puel collected $0.28 from pot
*** SUMMARY ***
Total pot $0.29 | Rake $0.01
Board [9c 5s Qs 6s Kd]
Seat 1: Ramirres (big blind) folded before Flop
Seat 2: MojaMamka folded before Flop (didn't bet)
Seat 3: MOE.DINO folded before Flop (didn't bet)
Seat 4: Leonardo Puel collected ($0.28)
Seat 5: bichito72 (button) folded on the River
Seat 6: pbanks08 (small blind) folded before Flop


PokerStars Hand #238159798745:  Hold'em No Limit ($0.01/$0.02 USD) - 2022/08/22 21:50:22 ET
Table 'Achilles IV' 6-max Seat #6 is the button
Seat 1: Ramirres ($2.59 in chips)
Seat 2: MojaMamka ($2.03 in chips)
Seat 3: MOE.DINO ($1.09 in chips)
Seat 4: Leonardo Puel ($1.05 in chips)
Seat 5: bichito72 ($1.91 in chips)
Seat 6: pbanks08 ($0.32 in chips)
Ramirres: posts small blind $0.01
MojaMamka: posts big blind $0.02
*** HOLE CARDS ***
MOE.DINO: folds
Leonardo Puel: calls $0.02
bichito72: folds
pbanks08: folds
Ramirres: raises $0.08 to $0.10
MojaMamka: calls $0.08
Leonardo Puel: calls $0.08
*** FLOP *** [6c 6s 9c]
Ramirres: checks
MojaMamka: checks
Leonardo Puel: checks
*** TURN *** [6c 6s 9c] [3d]
Ramirres: checks
MojaMamka: checks
Leonardo Puel: checks
*** RIVER *** [6c 6s 9c 3d] [Ah]
Ramirres: bets $0.24
MojaMamka: folds
Leonardo Puel: folds
Uncalled bet ($0.24) returned to Ramirres
Ramirres collected $0.29 from pot
*** SUMMARY ***
Total pot $0.30 | Rake $0.01
Board [6c 6s 9c 3d Ah]
Seat 1: Ramirres (small blind) collected ($0.29)
Seat 2: MojaMamka (big blind) folded on the River
Seat 3: MOE.DINO folded before Flop (didn't bet)
Seat 4: Leonardo Puel folded on the River
Seat 5: bichito72 folded before Flop (didn't bet)
Seat 6: pbanks08 (button) folded before Flop (didn't bet)


PokerStars Hand #238159806147:  Hold'em No Limit ($0.01/$0.02 USD) - 2022/08/22 21:50:59 ET
Table 'Achilles IV' 6-max Seat #1 is the button
Seat 1: Ramirres ($2.78 in chips)
Seat 2: MojaMamka ($1.93 in chips)
Seat 3: MOE.DINO ($1.09 in chips)
Seat 4: Leonardo Puel ($0.95 in chips)
Seat 5: bichito72 ($1.91 in chips)
Seat 6: pbanks08 ($0.32 in chips)
MojaMamka: posts small blind $0.01
MOE.DINO: posts big blind $0.02
*** HOLE CARDS ***
Leonardo Puel: calls $0.02
bichito72: folds
pbanks08: calls $0.02
Ramirres: folds
MojaMamka: calls $0.01
MOE.DINO: raises $0.04 to $0.06
Leonardo Puel: calls $0.04
pbanks08: folds
MojaMamka: calls $0.04
*** FLOP *** [4s Qs 8h]
MojaMamka: checks
MOE.DINO: checks
Leonardo Puel: bets $0.09
MojaMamka: calls $0.09
MOE.DINO: calls $0.09
*** TURN *** [4s Qs 8h] [9c]
MojaMamka: checks
MOE.DINO: checks
Leonardo Puel: bets $0.45
MojaMamka: folds
MOE.DINO: calls $0.45
*** RIVER *** [4s Qs 8h 9c] [Ks]
MOE.DINO: bets $0.49 and is all-in
Leonardo Puel: calls $0.35 and is all-in
Uncalled bet ($0.14) returned to MOE.DINO
*** SHOW DOWN ***
MOE.DINO: shows [6c 6d] (a pair of Sixes)
Leonardo Puel: shows [Jh Qd] (a pair of Queens)
Leonardo Puel collected $2 from pot
*** SUMMARY ***
Total pot $2.07 | Rake $0.07
Board [4s Qs 8h 9c Ks]
Seat 1: Ramirres (button) folded before Flop (didn't bet)
Seat 2: MojaMamka (small blind) folded on the Turn
Seat 3: MOE.DINO (big blind) showed [6c 6d] and lost with a pair of Sixes
Seat 4: Leonardo Puel showed [Jh Qd] and won ($2) with a pair of Queens
Seat 5: bichito72 folded before Flop (didn't bet)
Seat 6: pbanks08 folded before Flop


PokerStars Hand #238159833545:  Hold'em No Limit ($0.01/$0.02 USD) - 2022/08/22 21:52:07 ET
Table 'Achilles IV' 6-max Seat #2 is the button
Seat 1: Ramirres ($2.78 in chips)
Seat 2: MojaMamka ($1.78 in chips)
Seat 3: MOE.DINO ($0.14 in chips)
Seat 4: Leonardo Puel ($2 in chips)
Seat 5: bichito72 ($1.91 in chips)
Seat 6: pbanks08 ($0.30 in chips)
MOE.DINO: posts small blind $0.01
Leonardo Puel: posts big blind $0.02
*** HOLE CARDS ***
bichito72: folds
pbanks08: calls $0.02
Ramirres: raises $0.04 to $0.06
MojaMamka: calls $0.06
MOE.DINO: raises $0.08 to $0.14 and is all-in
Leonardo Puel: calls $0.12
pbanks08: calls $0.12
Ramirres: calls $0.08
MojaMamka: calls $0.08
*** FLOP *** [2h 8s Td]
Leonardo Puel: checks
pbanks08: bets $0.16 and is all-in
Ramirres: calls $0.16
MojaMamka: folds
Leonardo Puel: folds
*** TURN *** [2h 8s Td] [8d]
*** RIVER *** [2h 8s Td 8d] [Ad]
*** SHOW DOWN ***
pbanks08: shows [5h 5c] (two pair, Eights and Fives)
Ramirres: shows [7d 6d] (a flush, Ace high)
Ramirres collected $0.30 from side pot
MOE.DINO: shows [7c Ks] (a pair of Eights)
Ramirres collected $0.68 from main pot
*** SUMMARY ***
Total pot $1.02 Main pot $0.68. Side pot $0.30. | Rake $0.04
Board [2h 8s Td 8d Ad]
Seat 1: Ramirres showed [7d 6d] and won ($0.98) with a flush, Ace high
Seat 2: MojaMamka (button) folded on the Flop
Seat 3: MOE.DINO (small blind) showed [7c Ks] and lost with a pair of Eights
Seat 4: Leonardo Puel (big blind) folded on the Flop
Seat 5: bichito72 folded before Flop (didn't bet)
Seat 6: pbanks08 showed [5h 5c] and lost with two pair, Eights and Fives


PokerStars Hand #238159845702:  Hold'em No Limit ($0.01/$0.02 USD) - 2022/08/22 21:53:08 ET
Table 'Achilles IV' 6-max Seat #4 is the button
Seat 1: Ramirres ($3.46 in chips)
Seat 2: MojaMamka ($1.64 in chips)
Seat 4: Leonardo Puel ($1.86 in chips)
Seat 5: bichito72 ($1.91 in chips)
bichito72: posts small blind $0.01
Ramirres: posts big blind $0.02
*** HOLE CARDS ***
pbanks08 leaves the table
MojaMamka: folds
Koresh153 joins the table at seat #6
Leonardo Puel: folds
bichito72: raises $0.03 to $0.05
Ramirres: folds
Uncalled bet ($0.03) returned to bichito72
bichito72 collected $0.04 from pot
bichito72: doesn't show hand
*** SUMMARY ***
Total pot $0.04 | Rake $0
Seat 1: Ramirres (big blind) folded before Flop
Seat 2: MojaMamka folded before Flop (didn't bet)
Seat 4: Leonardo Puel (button) folded before Flop (didn't bet)
Seat 5: bichito72 (small blind) collected ($0.04)


PokerStars Hand #238159849339:  Hold'em No Limit ($0.01/$0.02 USD) - 2022/08/22 21:53:26 ET
Table 'Achilles IV' 6-max Seat #5 is the button
Seat 1: Ramirres ($3.44 in chips)
Seat 2: MojaMamka ($1.64 in chips)
Seat 3: MOE.DINO ($2 in chips)
Seat 4: Leonardo Puel ($1.86 in chips)
Seat 5: bichito72 ($1.93 in chips)
Ramirres: posts small blind $0.01
MojaMamka: posts big blind $0.02
*** HOLE CARDS ***
MOE.DINO: calls $0.02
Leonardo Puel: calls $0.02
bichito72: calls $0.02
Ramirres: folds
MojaMamka: checks
*** FLOP *** [Qh 4s 5d]
MojaMamka: checks
MOE.DINO: bets $0.06
Leonardo Puel: raises $0.06 to $0.12
bichito72: folds
MojaMamka: folds
MOE.DINO: calls $0.06
*** TURN *** [Qh 4s 5d] [4c]
MOE.DINO: bets $0.08
Leonardo Puel: calls $0.08
*** RIVER *** [Qh 4s 5d 4c] [6c]
MOE.DINO: bets $0.08
Leonardo Puel: raises $0.63 to $0.71
MOE.DINO: calls $0.63
*** SHOW DOWN ***
Leonardo Puel: shows [Qc 6s] (two pair, Queens and Sixes)
MOE.DINO: mucks hand
Leonardo Puel collected $1.84 from pot
*** SUMMARY ***
Total pot $1.91 | Rake $0.07
Board [Qh 4s 5d 4c 6c]
Seat 1: Ramirres (small blind) folded before Flop
Seat 2: MojaMamka (big blind) folded on the Flop
Seat 3: MOE.DINO mucked
Seat 4: Leonardo Puel showed [Qc 6s] and won ($1.84) with two pair, Queens and Sixes
Seat 5: bichito72 (button) folded on the Flop


PokerStars Hand #238159863859:  Hold'em No Limit ($0.01/$0.02 USD) - 2022/08/22 21:54:39 ET
Table 'Achilles IV' 6-max Seat #1 is the button
Seat 1: Ramirres ($3.43 in chips)
Seat 2: MojaMamka ($1.62 in chips)
Seat 3: MOE.DINO ($1.07 in chips)
Seat 4: Leonardo Puel ($2.77 in chips)
Seat 5: bichito72 ($1.91 in chips)
MojaMamka: posts small blind $0.01
MOE.DINO: posts big blind $0.02
Koresh153: sits out
*** HOLE CARDS ***
Leonardo Puel: calls $0.02
bichito72: folds
Ramirres: raises $0.04 to $0.06
MojaMamka: calls $0.05
MOE.DINO: calls $0.04
Leonardo Puel: calls $0.04
*** FLOP *** [4d 4h 7d]
MojaMamka: bets $0.11
MOE.DINO: calls $0.11
Leonardo Puel: folds
Ramirres: folds
*** TURN *** [4d 4h 7d] [Js]
MojaMamka: bets $0.22
MOE.DINO: calls $0.22
*** RIVER *** [4d 4h 7d Js] [Td]
MojaMamka: bets $0.43
MOE.DINO: folds
Uncalled bet ($0.43) returned to MojaMamka
MojaMamka collected $0.87 from pot
MojaMamka: doesn't show hand
*** SUMMARY ***
Total pot $0.90 | Rake $0.03
Board [4d 4h 7d Js Td]
Seat 1: Ramirres (button) folded on the Flop
Seat 2: MojaMamka (small blind) collected ($0.87)
Seat 3: MOE.DINO (big blind) folded on the River
Seat 4: Leonardo Puel folded on the Flop
Seat 5: bichito72 folded before Flop (didn't bet)


PokerStars Hand #238159872840:  Hold'em No Limit ($0.01/$0.02 USD) - 2022/08/22 21:55:27 ET
Table 'Achilles IV' 6-max Seat #2 is the button
Seat 1: Ramirres ($3.37 in chips)
Seat 2: MojaMamka ($2.10 in chips)
Seat 3: MOE.DINO ($0.68 in chips)
Seat 4: Leonardo Puel ($2.71 in chips)
Seat 5: bichito72 ($1.91 in chips)
MOE.DINO: posts small blind $0.01
Leonardo Puel: posts big blind $0.02
Koresh153: sits out
*** HOLE CARDS ***
bichito72: folds
Ramirres: folds
MojaMamka: folds
MOE.DINO: calls $0.01
Leonardo Puel: checks
*** FLOP *** [5h 7h 4h]
MOE.DINO: checks
Leonardo Puel: checks
*** TURN *** [5h 7h 4h] [6c]
MOE.DINO: bets $0.04
Leonardo Puel: folds
Uncalled bet ($0.04) returned to MOE.DINO
MOE.DINO collected $0.04 from pot
*** SUMMARY ***
Total pot $0.04 | Rake $0
Board [5h 7h 4h 6c]
Seat 1: Ramirres folded before Flop (didn't bet)
Seat 2: MojaMamka (button) folded before Flop (didn't bet)
Seat 3: MOE.DINO (small blind) collected ($0.04)
Seat 4: Leonardo Puel (big blind) folded on the Turn
Seat 5: bichito72 folded before Flop (didn't bet)


PokerStars Hand #238159875794:  Hold'em No Limit ($0.01/$0.02 USD) - 2022/08/22 21:55:46 ET
Table 'Achilles IV' 6-max Seat #3 is the button
Seat 1: Ramirres ($3.37 in chips)
Seat 2: MojaMamka ($2.10 in chips)
Seat 3: MOE.DINO ($0.70 in chips)
Seat 4: Leonardo Puel ($2.69 in chips)
Seat 5: bichito72 ($1.91 in chips)
Leonardo Puel: posts small blind $0.01
bichito72: posts big blind $0.02
Koresh153: sits out
*** HOLE CARDS ***
Ramirres: folds
MojaMamka: folds
MOE.DINO: calls $0.02
Leonardo Puel: calls $0.01
bichito72: checks
*** FLOP *** [2h 3s Kd]
Leonardo Puel: checks
bichito72: bets $0.04
MOE.DINO: calls $0.04
Leonardo Puel: calls $0.04
*** TURN *** [2h 3s Kd] [Td]
Leonardo Puel: bets $0.10
bichito72: calls $0.10
MOE.DINO: calls $0.10
*** RIVER *** [2h 3s Kd Td] [3d]
Leonardo Puel: checks
bichito72: checks
MOE.DINO: checks
*** SHOW DOWN ***
Leonardo Puel: shows [Jd Kh] (two pair, Kings and Threes)
bichito72: mucks hand
MOE.DINO: mucks hand
Leonardo Puel collected $0.46 from pot
*** SUMMARY ***
Total pot $0.48 | Rake $0.02
Board [2h 3s Kd Td 3d]
Seat 1: Ramirres folded before Flop (didn't bet)
Seat 2: MojaMamka folded before Flop (didn't bet)
Seat 3: MOE.DINO (button) mucked
Seat 4: Leonardo Puel (small blind) showed [Jd Kh] and won ($0.46) with two pair, Kings and Threes
Seat 5: bichito72 (big blind) mucked


PokerStars Hand #238159883954:  Hold'em No Limit ($0.01/$0.02 USD) - 2022/08/22 21:56:36 ET
Table 'Achilles IV' 6-max Seat #4 is the button
Seat 1: Ramirres ($3.37 in chips)
Seat 3: MOE.DINO ($0.54 in chips)
Seat 4: Leonardo Puel ($2.99 in chips)
Seat 5: bichito72 ($1.75 in chips)
Seat 6: Koresh153 ($0.80 in chips)
bichito72: posts small blind $0.01
Koresh153: posts big blind $0.02
*** HOLE CARDS ***
Ramirres: folds
MOE.DINO: raises $0.04 to $0.06
Leonardo Puel: calls $0.06
bichito72: folds
Koresh153: folds
*** FLOP *** [Kh 2c 2d]
MOE.DINO: checks
Leonardo Puel: checks
*** TURN *** [Kh 2c 2d] [7c]
MOE.DINO: checks
Leonardo Puel: checks
*** RIVER *** [Kh 2c 2d 7c] [3d]
MOE.DINO: checks
Leonardo Puel: checks
*** SHOW DOWN ***
MOE.DINO: shows [Qs Tc] (a pair of Deuces)
Leonardo Puel: mucks hand
MOE.DINO collected $0.14 from pot
*** SUMMARY ***
Total pot $0.15 | Rake $0.01
Board [Kh 2c 2d 7c 3d]
Seat 1: Ramirres folded before Flop (didn't bet)
Seat 3: MOE.DINO showed [Qs Tc] and won ($0.14) with a pair of Deuces
Seat 4: Leonardo Puel (button) mucked
Seat 5: bichito72 (small blind) folded before Flop
Seat 6: Koresh153 (big blind) folded before Flop


PokerStars Hand #238159889527:  Hold'em No Limit ($0.01/$0.02 USD) - 2022/08/22 21:57:12 ET
Table 'Achilles IV' 6-max Seat #5 is the button
Seat 1: Ramirres ($3.37 in chips)
Seat 3: MOE.DINO ($0.62 in chips)
Seat 4: Leonardo Puel ($2.93 in chips)
Seat 5: bichito72 ($1.74 in chips)
Seat 6: Koresh153 ($0.80 in chips)
Koresh153: posts small blind $0.01
Ramirres: posts big blind $0.02
*** HOLE CARDS ***
MOE.DINO: calls $0.02
Leonardo Puel: calls $0.02
bichito72: folds
Koresh153: folds
Ramirres: checks
*** FLOP *** [Ac Ad 5d]
Ramirres: checks
MOE.DINO: checks
Leonardo Puel: bets $0.07
Ramirres: folds
MOE.DINO: folds
Uncalled bet ($0.07) returned to Leonardo Puel
Leonardo Puel collected $0.07 from pot
*** SUMMARY ***
Total pot $0.07 | Rake $0
Board [Ac Ad 5d]
Seat 1: Ramirres (big blind) folded on the Flop
Seat 3: MOE.DINO folded on the Flop
Seat 4: Leonardo Puel collected ($0.07)
Seat 5: bichito72 (button) folded before Flop (didn't bet)
Seat 6: Koresh153 (small blind) folded before Flop


PokerStars Hand #238159894820:  Hold'em No Limit ($0.01/$0.02 USD) - 2022/08/22 21:57:45 ET
Table 'Achilles IV' 6-max Seat #6 is the button
Seat 1: Ramirres ($3.35 in chips)
Seat 2: MojaMamka ($2.10 in chips)
Seat 3: MOE.DINO ($0.60 in chips)
Seat 4: Leonardo Puel ($2.98 in chips)
Seat 5: bichito72 ($1.74 in chips)
Seat 6: Koresh153 ($0.80 in chips)
Ramirres: posts small blind $0.01
MojaMamka: posts big blind $0.02
*** HOLE CARDS ***
MOE.DINO: calls $0.02
Leonardo Puel: calls $0.02
bichito72: raises $0.08 to $0.10
Koresh153: folds
Ramirres: folds
MojaMamka: folds
MOE.DINO: calls $0.08
Leonardo Puel: calls $0.08
*** FLOP *** [5h 2h 7s]
MOE.DINO: checks
Leonardo Puel: bets $0.12
bichito72: folds
MOE.DINO: folds
Uncalled bet ($0.12) returned to Leonardo Puel
Leonardo Puel collected $0.32 from pot
*** SUMMARY ***
Total pot $0.33 | Rake $0.01
Board [5h 2h 7s]
Seat 1: Ramirres (small blind) folded before Flop
Seat 2: MojaMamka (big blind) folded before Flop
Seat 3: MOE.DINO folded on the Flop
Seat 4: Leonardo Puel collected ($0.32)
Seat 5: bichito72 folded on the Flop
Seat 6: Koresh153 (button) folded before Flop (didn't bet)


PokerStars Hand #238159902666:  Hold'em No Limit ($0.01/$0.02 USD) - 2022/08/22 21:58:35 ET
Table 'Achilles IV' 6-max Seat #1 is the button
Seat 1: Ramirres ($3.34 in chips)
Seat 3: MOE.DINO ($0.50 in chips)
Seat 4: Leonardo Puel ($3.20 in chips)
Seat 5: bichito72 ($1.64 in chips)
Seat 6: Koresh153 ($0.80 in chips)
MOE.DINO: posts small blind $0.01
Leonardo Puel: posts big blind $0.02
*** HOLE CARDS ***
bichito72: folds
Koresh153: folds
Ramirres: folds
MOE.DINO: raises $0.04 to $0.06
Leonardo Puel: calls $0.04
*** FLOP *** [3h Qh 7s]
MOE.DINO: checks
Leonardo Puel: checks
*** TURN *** [3h Qh 7s] [Th]
MOE.DINO: bets $0.12
Leonardo Puel: calls $0.12
*** RIVER *** [3h Qh 7s Th] [9h]
MOE.DINO: checks
Leonardo Puel: bets $0.28
MOE.DINO: calls $0.28
*** SHOW DOWN ***
Leonardo Puel: shows [Ah 2s] (a flush, Ace high)
MOE.DINO: mucks hand
Leonardo Puel collected $0.89 from pot
*** SUMMARY ***
Total pot $0.92 | Rake $0.03
Board [3h Qh 7s Th 9h]
Seat 1: Ramirres (button) folded before Flop (didn't bet)
Seat 3: MOE.DINO (small blind) mucked
Seat 4: Leonardo Puel (big blind) showed [Ah 2s] and won ($0.89) with a flush, Ace high
Seat 5: bichito72 folded before Flop (didn't bet)
Seat 6: Koresh153 folded before Flop (didn't bet)


PokerStars Hand #238159910735:  Hold'em No Limit ($0.01/$0.02 USD) - 2022/08/22 21:59:26 ET
Table 'Achilles IV' 6-max Seat #3 is the button
Seat 1: Ramirres ($3.34 in chips)
Seat 3: MOE.DINO ($0.04 in chips)
Seat 4: Leonardo Puel ($3.63 in chips)
Seat 5: bichito72 ($1.64 in chips)
Seat 6: Koresh153 ($0.80 in chips)
Leonardo Puel: posts small blind $0.01
bichito72: posts big blind $0.02
MojaMamka: sits out
*** HOLE CARDS ***
Koresh153: folds
Ramirres: folds
MOE.DINO: raises $0.02 to $0.04 and is all-in
Leonardo Puel: folds
bichito72: calls $0.02
Leonardo Puel leaves the table
*** FLOP *** [8d 5h 2c]
terryfox1 joins the table at seat #4
*** TURN *** [8d 5h 2c] [4c]
*** RIVER *** [8d 5h 2c 4c] [Tc]
*** SHOW DOWN ***
bichito72: shows [Jd Qs] (high card Queen)
MOE.DINO: shows [Ad 4d] (a pair of Fours)
MOE.DINO collected $0.09 from pot
bichito72 cashed out the hand for $0.04
*** SUMMARY ***
Total pot $0.09 | Rake $0
Board [8d 5h 2c 4c Tc]
Seat 1: Ramirres folded before Flop (didn't bet)
Seat 3: MOE.DINO (button) showed [Ad 4d] and won ($0.09) with a pair of Fours
Seat 4: Leonardo Puel (small blind) folded before Flop
Seat 5: bichito72 (big blind) showed [Jd Qs] and lost with high card Queen (cashed out).
Seat 6: Koresh153 folded before Flop (didn't bet)


PokerStars Hand #238159914622:  Hold'em No Limit ($0.01/$0.02 USD) - 2022/08/22 21:59:50 ET
Table 'Achilles IV' 6-max Seat #5 is the button
Seat 1: Ramirres ($3.34 in chips)
Seat 2: MojaMamka ($2.08 in chips)
Seat 3: MOE.DINO ($0.09 in chips)
Seat 5: bichito72 ($1.64 in chips)
Seat 6: Koresh153 ($0.80 in chips)
Koresh153: posts small blind $0.01
Ramirres: posts big blind $0.02
MojaMamka: posts small blind $0.01
terryfox1: sits out
*** HOLE CARDS ***
MojaMamka: raises $0.04 to $0.06
MOE.DINO: folds
bichito72: folds
Koresh153: folds
Ramirres: calls $0.04
*** FLOP *** [5c Ac 5s]
Ramirres: checks
MojaMamka: bets $0.07
Ramirres: folds
Uncalled bet ($0.07) returned to MojaMamka
MojaMamka collected $0.14 from pot
MojaMamka: doesn't show hand
*** SUMMARY ***
Total pot $0.14 | Rake $0
Board [5c Ac 5s]
Seat 1: Ramirres (big blind) folded on the Flop
Seat 2: MojaMamka collected ($0.14)
Seat 3: MOE.DINO folded before Flop (didn't bet)
Seat 5: bichito72 (button) folded before Flop (didn't bet)
Seat 6: Koresh153 (small blind) folded before Flop


PokerStars Hand #238159922156:  Hold'em No Limit ($0.01/$0.02 USD) - 2022/08/22 22:00:37 ET
Table 'Achilles IV' 6-max Seat #6 is the button
Seat 1: Ramirres ($3.28 in chips)
Seat 2: MojaMamka ($2.15 in chips)
Seat 3: MOE.DINO ($0.09 in chips)
Seat 5: bichito72 ($1.64 in chips)
Seat 6: Koresh153 ($0.80 in chips)
Ramirres: posts small blind $0.01
MojaMamka: posts big blind $0.02
terryfox1: sits out
*** HOLE CARDS ***
MOE.DINO: calls $0.02
bichito72: folds
Koresh153 has timed out
Koresh153: folds
Ramirres: raises $0.08 to $0.10
MojaMamka: calls $0.08
MOE.DINO: calls $0.07 and is all-in
*** FLOP *** [As Th Td]
Ramirres: bets $0.08
MojaMamka: folds
Uncalled bet ($0.08) returned to Ramirres
*** TURN *** [As Th Td] [5d]
*** RIVER *** [As Th Td 5d] [5s]
*** SHOW DOWN ***
Ramirres: shows [Ac Ad] (a full house, Aces full of Tens)
Ramirres collected $0.02 from side pot
MOE.DINO: shows [6c 7c] (two pair, Tens and Fives)
Ramirres collected $0.26 from main pot
*** SUMMARY ***
Total pot $0.29 Main pot $0.26. Side pot $0.02. | Rake $0.01
Board [As Th Td 5d 5s]
Seat 1: Ramirres (small blind) showed [Ac Ad] and won ($0.28) with a full house, Aces full of Tens
Seat 2: MojaMamka (big blind) folded on the Flop
Seat 3: MOE.DINO showed [6c 7c] and lost with two pair, Tens and Fives
Seat 5: bichito72 folded before Flop (didn't bet)
Seat 6: Koresh153 (button) folded before Flop (didn't bet)


PokerStars Hand #238159930161:  Hold'em No Limit ($0.01/$0.02 USD) - 2022/08/22 22:01:21 ET
Table 'Achilles IV' 6-max Seat #1 is the button
Seat 1: Ramirres ($3.46 in chips)
Seat 2: MojaMamka ($2.05 in chips)
Seat 4: terryfox1 ($1.60 in chips)
Seat 5: bichito72 ($1.64 in chips)
Seat 6: Koresh153 ($2 in chips)
MojaMamka: posts small blind $0.01
terryfox1: posts big blind $0.02
*** HOLE CARDS ***
MOE.DINO leaves the table
bichito72: raises $0.04 to $0.06
Koresh153: folds
Ramirres: folds
MojaMamka: calls $0.05
terryfox1: folds
*** FLOP *** [Jh Kd Js]
MojaMamka: checks
bichito72: bets $0.08
MojaMamka: calls $0.08
*** TURN *** [Jh Kd Js] [Qc]
MojaMamka: checks
bichito72: checks
*** RIVER *** [Jh Kd Js Qc] [9c]
MojaMamka: bets $0.14
bichito72: folds
Uncalled bet ($0.14) returned to MojaMamka
MojaMamka collected $0.29 from pot
MojaMamka: doesn't show hand
*** SUMMARY ***
Total pot $0.30 | Rake $0.01
Board [Jh Kd Js Qc 9c]
Seat 1: Ramirres (button) folded before Flop (didn't bet)
Seat 2: MojaMamka (small blind) collected ($0.29)
Seat 4: terryfox1 (big blind) folded before Flop
Seat 5: bichito72 folded on the River
Seat 6: Koresh153 folded before Flop (didn't bet)


PokerStars Hand #238159941973:  Hold'em No Limit ($0.01/$0.02 USD) - 2022/08/22 22:02:23 ET
Table 'Achilles IV' 6-max Seat #2 is the button
Seat 1: Ramirres ($3.46 in chips)
Seat 2: MojaMamka ($2.20 in chips)
Seat 4: terryfox1 ($1.58 in chips)
Seat 5: bichito72 ($1.50 in chips)
Seat 6: Koresh153 ($2 in chips)
terryfox1: posts small blind $0.01
raduarte10 joins the table at seat #3
bichito72: posts big blind $0.02
*** HOLE CARDS ***
Koresh153: folds
Ramirres: folds
MojaMamka: folds
terryfox1: calls $0.01
bichito72: checks
*** FLOP *** [3d Ts Qs]
terryfox1: checks
bichito72: checks
*** TURN *** [3d Ts Qs] [9d]
terryfox1: bets $0.04
bichito72: calls $0.04
*** RIVER *** [3d Ts Qs 9d] [6c]
terryfox1: checks
bichito72: checks
*** SHOW DOWN ***
terryfox1: shows [Kh 4d] (high card King)
bichito72: shows [Qd 8s] (a pair of Queens)
bichito72 collected $0.12 from pot
*** SUMMARY ***
Total pot $0.12 | Rake $0
Board [3d Ts Qs 9d 6c]
Seat 1: Ramirres folded before Flop (didn't bet)
Seat 2: MojaMamka (button) folded before Flop (didn't bet)
Seat 4: terryfox1 (small blind) showed [Kh 4d] and lost with high card King
Seat 5: bichito72 (big blind) showed [Qd 8s] and won ($0.12) with a pair of Queens
Seat 6: Koresh153 folded before Flop (didn't bet)


PokerStars Hand #238159950501:  Hold'em No Limit ($0.01/$0.02 USD) - 2022/08/22 22:03:07 ET
Table 'Achilles IV' 6-max Seat #4 is the button
Seat 1: Ramirres ($3.46 in chips)
Seat 2: MojaMamka ($2.20 in chips)
Seat 3: raduarte10 ($1.17 in chips)
Seat 4: terryfox1 ($1.52 in chips)
Seat 5: bichito72 ($1.56 in chips)
Seat 6: Koresh153 ($2 in chips)
bichito72: posts small blind $0.01
Koresh153: posts big blind $0.02
raduarte10: posts big blind $0.02
*** HOLE CARDS ***
Ramirres: folds
MojaMamka: raises $0.07 to $0.09
raduarte10: calls $0.07
terryfox1: folds
bichito72: folds
Koresh153: folds
*** FLOP *** [3h Qd 4s]
MojaMamka: bets $0.10
raduarte10: calls $0.10
*** TURN *** [3h Qd 4s] [Ks]
MojaMamka: checks
raduarte10: bets $0.10
MojaMamka: folds
Uncalled bet ($0.10) returned to raduarte10
raduarte10 collected $0.40 from pot
*** SUMMARY ***
Total pot $0.41 | Rake $0.01
Board [3h Qd 4s Ks]
Seat 1: Ramirres folded before Flop (didn't bet)
Seat 2: MojaMamka folded on the Turn
Seat 3: raduarte10 collected ($0.40)
Seat 4: terryfox1 (button) folded before Flop (didn't bet)
Seat 5: bichito72 (small blind) folded before Flop
Seat 6: Koresh153 (big blind) folded before Flop


PokerStars Hand #238159961030:  Hold'em No Limit ($0.01/$0.02 USD) - 2022/08/22 22:04:01 ET
Table 'Achilles IV' 6-max Seat #5 is the button
Seat 1: Ramirres ($3.46 in chips)
Seat 2: MojaMamka ($2.01 in chips)
Seat 3: raduarte10 ($1.38 in chips)
Seat 4: terryfox1 ($1.52 in chips)
Seat 5: bichito72 ($1.55 in chips)
Seat 6: Koresh153 ($1.98 in chips)
Koresh153: posts small blind $0.01
Ramirres: posts big blind $0.02
*** HOLE CARDS ***
MojaMamka: calls $0.02
raduarte10: folds
terryfox1: raises $0.02 to $0.04
bichito72: folds
Koresh153: folds
Ramirres: folds
MojaMamka: calls $0.02
*** FLOP *** [Ts Kd 2c]
MojaMamka: bets $0.05
terryfox1: folds
Uncalled bet ($0.05) returned to MojaMamka
MojaMamka collected $0.11 from pot
MojaMamka: doesn't show hand
*** SUMMARY ***
Total pot $0.11 | Rake $0
Board [Ts Kd 2c]
Seat 1: Ramirres (big blind) folded before Flop
Seat 2: MojaMamka collected ($0.11)
Seat 3: raduarte10 folded before Flop (didn't bet)
Seat 4: terryfox1 folded on the Flop
Seat 5: bichito72 (button) folded before Flop (didn't bet)
Seat 6: Koresh153 (small blind) folded before Flop


PokerStars Hand #238159973319:  Hold'em No Limit ($0.01/$0.02 USD) - 2022/08/22 22:04:52 ET
Table 'Achilles IV' 6-max Seat #6 is the button
Seat 1: Ramirres ($3.44 in chips)
Seat 2: MojaMamka ($2.08 in chips)
Seat 3: raduarte10 ($1.38 in chips)
Seat 4: terryfox1 ($1.48 in chips)
Seat 5: bichito72 ($1.55 in chips)
Seat 6: Koresh153 ($1.97 in chips)
Ramirres: posts small blind $0.01
MojaMamka: posts big blind $0.02
*** HOLE CARDS ***
raduarte10: folds
terryfox1: calls $0.02
bichito72: folds
Koresh153: folds
Ramirres: folds
MojaMamka: checks
*** FLOP *** [5s 9d Kc]
MojaMamka: checks
terryfox1: bets $0.02
MojaMamka: calls $0.02
*** TURN *** [5s 9d Kc] [7h]
MojaMamka: checks
terryfox1: bets $0.06
MojaMamka: folds
Uncalled bet ($0.06) returned to terryfox1
terryfox1 collected $0.09 from pot
*** SUMMARY ***
Total pot $0.09 | Rake $0
Board [5s 9d Kc 7h]
Seat 1: Ramirres (small blind) folded before Flop
Seat 2: MojaMamka (big blind) folded on the Turn
Seat 3: raduarte10 folded before Flop (didn't bet)
Seat 4: terryfox1 collected ($0.09)
Seat 5: bichito72 folded before Flop (didn't bet)
Seat 6: Koresh153 (button) folded before Flop (didn't bet)


PokerStars Hand #238159982198:  Hold'em No Limit ($0.01/$0.02 USD) - 2022/08/22 22:05:38 ET
Table 'Achilles IV' 6-max Seat #1 is the button
Seat 1: Ramirres ($3.43 in chips)
Seat 2: MojaMamka ($2.04 in chips)
Seat 3: raduarte10 ($1.38 in chips)
Seat 4: terryfox1 ($1.53 in chips)
Seat 5: bichito72 ($1.55 in chips)
Seat 6: Koresh153 ($1.97 in chips)
MojaMamka: posts small blind $0.01
raduarte10: posts big blind $0.02
*** HOLE CARDS ***
terryfox1: folds
bichito72: folds
Koresh153: folds
Ramirres: folds
MojaMamka: calls $0.01
raduarte10: raises $0.04 to $0.06
MojaMamka: calls $0.04
*** FLOP *** [6h Jc 7d]
MojaMamka: checks
raduarte10: checks
*** TURN *** [6h Jc 7d] [5s]
MojaMamka: checks
raduarte10: checks
*** RIVER *** [6h Jc 7d 5s] [3s]
MojaMamka: checks
raduarte10: checks
*** SHOW DOWN ***
MojaMamka: shows [6s 9h] (a pair of Sixes)
raduarte10: mucks hand
MojaMamka collected $0.12 from pot
*** SUMMARY ***
Total pot $0.12 | Rake $0
Board [6h Jc 7d 5s 3s]
Seat 1: Ramirres (button) folded before Flop (didn't bet)
Seat 2: MojaMamka (small blind) showed [6s 9h] and won ($0.12) with a pair of Sixes
Seat 3: raduarte10 (big blind) mucked
Seat 4: terryfox1 folded before Flop (didn't bet)
Seat 5: bichito72 folded before Flop (didn't bet)
Seat 6: Koresh153 folded before Flop (didn't bet)


PokerStars Hand #238159992940:  Hold'em No Limit ($0.01/$0.02 USD) - 2022/08/22 22:06:33 ET
Table 'Achilles IV' 6-max Seat #2 is the button
Seat 1: Ramirres ($3.43 in chips)
Seat 2: MojaMamka ($2.10 in chips)
Seat 3: raduarte10 ($1.32 in chips)
Seat 4: terryfox1 ($1.53 in chips)
Seat 5: bichito72 ($1.55 in chips)
Seat 6: Koresh153 ($1.97 in chips)
raduarte10: posts small blind $0.01
terryfox1: posts big blind $0.02
*** HOLE CARDS ***
bichito72: raises $0.04 to $0.06
Koresh153: folds
Ramirres: folds
MojaMamka: folds
raduarte10: raises $0.06 to $0.12
terryfox1: folds
Koresh153 was removed from the table for failing to post
Koresh153 leaves the table
bichito72: calls $0.06
*** FLOP *** [As 8c Jc]
raduarte10: checks
bichito72: checks
*** TURN *** [As 8c Jc] [5s]
raduarte10: checks
bichito72: bets $0.10
raduarte10: calls $0.10
*** RIVER *** [As 8c Jc 5s] [Ts]
raduarte10: checks
bichito72: checks
*** SHOW DOWN ***
raduarte10: shows [Qs Qc] (a pair of Queens)
bichito72: mucks hand
raduarte10 collected $0.44 from pot
*** SUMMARY ***
Total pot $0.46 | Rake $0.02
Board [As 8c Jc 5s Ts]
Seat 1: Ramirres folded before Flop (didn't bet)
Seat 2: MojaMamka (button) folded before Flop (didn't bet)
Seat 3: raduarte10 (small blind) showed [Qs Qc] and won ($0.44) with a pair of Queens
Seat 4: terryfox1 (big blind) folded before Flop
Seat 5: bichito72 mucked
Seat 6: Koresh153 folded before Flop (didn't bet)


PokerStars Hand #238160006927:  Hold'em No Limit ($0.01/$0.02 USD) - 2022/08/22 22:07:45 ET
Table 'Achilles IV' 6-max Seat #3 is the button
Seat 1: Ramirres ($3.43 in chips)
Seat 2: MojaMamka ($2.10 in chips)
Seat 3: raduarte10 ($1.54 in chips)
Seat 4: terryfox1 ($1.51 in chips)
Seat 5: bichito72 ($1.33 in chips)
terryfox1: posts small blind $0.01
bichito72: posts big blind $0.02
*** HOLE CARDS ***
Ramirres: folds
MojaMamka: folds
raduarte10: calls $0.02
terryfox1: folds
bichito72: checks
*** FLOP *** [7c 4d 2c]
bichito72: checks
raduarte10: bets $0.06
bichito72: folds
Uncalled bet ($0.06) returned to raduarte10
raduarte10 collected $0.05 from pot
*** SUMMARY ***
Total pot $0.05 | Rake $0
Board [7c 4d 2c]
Seat 1: Ramirres folded before Flop (didn't bet)
Seat 2: MojaMamka folded before Flop (didn't bet)
Seat 3: raduarte10 (button) collected ($0.05)
Seat 4: terryfox1 (small blind) folded before Flop
Seat 5: bichito72 (big blind) folded on the Flop


PokerStars Hand #238160014792:  Hold'em No Limit ($0.01/$0.02 USD) - 2022/08/22 22:08:26 ET
Table 'Achilles IV' 6-max Seat #4 is the button
Seat 1: Ramirres ($3.43 in chips)
Seat 2: MojaMamka ($2.10 in chips)
Seat 3: raduarte10 ($1.57 in chips)
Seat 4: terryfox1 ($1.50 in chips)
Seat 5: bichito72 ($1.31 in chips)
bichito72: posts small blind $0.01
Ramirres: posts big blind $0.02
*** HOLE CARDS ***
MojaMamka: folds
raduarte10: folds
terryfox1: raises $0.04 to $0.06
bichito72: folds
Ramirres: calls $0.04
*** FLOP *** [9d 4d 6c]
Ramirres: checks
terryfox1: bets $0.06
Ramirres: raises $0.12 to $0.18
chrisluh81 joins the table at seat #6
terryfox1: folds
Uncalled bet ($0.12) returned to Ramirres
Ramirres collected $0.24 from pot
*** SUMMARY ***
Total pot $0.25 | Rake $0.01
Board [9d 4d 6c]
Seat 1: Ramirres (big blind) collected ($0.24)
Seat 2: MojaMamka folded before Flop (didn't bet)
Seat 3: raduarte10 folded before Flop (didn't bet)
Seat 4: terryfox1 (button) folded on the Flop
Seat 5: bichito72 (small blind) folded before Flop


PokerStars Hand #238160025960:  Hold'em No Limit ($0.01/$0.02 USD) - 2022/08/22 22:09:08 ET
Table 'Achilles IV' 6-max Seat #5 is the button
Seat 1: Ramirres ($3.55 in chips)
Seat 2: MojaMamka ($2.10 in chips)
Seat 3: raduarte10 ($1.57 in chips)
Seat 4: terryfox1 ($1.38 in chips)
Seat 5: bichito72 ($1.30 in chips)
Ramirres: posts small blind $0.01
MojaMamka: posts big blind $0.02
*** HOLE CARDS ***
raduarte10: calls $0.02
terryfox1: raises $0.06 to $0.08
bichito72: folds
Ramirres: folds
MojaMamka: folds
raduarte10: calls $0.06
*** FLOP *** [9h 3c Jc]
raduarte10: checks
terryfox1: bets $0.09
raduarte10: folds
Uncalled bet ($0.09) returned to terryfox1
terryfox1 collected $0.18 from pot
*** SUMMARY ***
Total pot $0.19 | Rake $0.01
Board [9h 3c Jc]
Seat 1: Ramirres (small blind) folded before Flop
Seat 2: MojaMamka (big blind) folded before Flop
Seat 3: raduarte10 folded on the Flop
Seat 4: terryfox1 collected ($0.18)
Seat 5: bichito72 (button) folded before Flop (didn't bet)


PokerStars Hand #238160031309:  Hold'em No Limit ($0.01/$0.02 USD) - 2022/08/22 22:09:36 ET
Table 'Achilles IV' 6-max Seat #1 is the button
Seat 1: Ramirres ($3.54 in chips)
Seat 2: MojaMamka ($2.08 in chips)
Seat 3: raduarte10 ($1.49 in chips)
Seat 4: terryfox1 ($1.48 in chips)
Seat 5: bichito72 ($1.30 in chips)
MojaMamka: posts small blind $0.01
raduarte10: posts big blind $0.02
chrisluh81: sits out
*** HOLE CARDS ***
terryfox1: folds
bichito72: folds
Ramirres: folds
MojaMamka: calls $0.01
raduarte10: raises $0.04 to $0.06
MojaMamka: folds
Uncalled bet ($0.04) returned to raduarte10
raduarte10 collected $0.04 from pot
*** SUMMARY ***
Total pot $0.04 | Rake $0
Seat 1: Ramirres (button) folded before Flop (didn't bet)
Seat 2: MojaMamka (small blind) folded before Flop
Seat 3: raduarte10 (big blind) collected ($0.04)
Seat 4: terryfox1 folded before Flop (didn't bet)
Seat 5: bichito72 folded before Flop (didn't bet)


PokerStars Hand #238160038483:  Hold'em No Limit ($0.01/$0.02 USD) - 2022/08/22 22:10:13 ET
Table 'Achilles IV' 6-max Seat #2 is the button
Seat 1: Ramirres ($3.54 in chips)
Seat 2: MojaMamka ($2.06 in chips)
Seat 3: raduarte10 ($1.51 in chips)
Seat 4: terryfox1 ($1.48 in chips)
Seat 5: bichito72 ($1.30 in chips)
Seat 6: chrisluh81 ($1.60 in chips)
raduarte10: posts small blind $0.01
terryfox1: posts big blind $0.02
chrisluh81: posts big blind $0.02
*** HOLE CARDS ***
bichito72: folds
chrisluh81: checks
Ramirres: folds
MojaMamka: folds
raduarte10: folds
terryfox1: checks
*** FLOP *** [Js 9s Jc]
terryfox1: checks
chrisluh81: bets $0.02
terryfox1: calls $0.02
*** TURN *** [Js 9s Jc] [Kh]
terryfox1: checks
chrisluh81: bets $0.02
terryfox1: calls $0.02
*** RIVER *** [Js 9s Jc Kh] [2s]
terryfox1: checks
chrisluh81: bets $0.30
terryfox1: raises $0.30 to $0.60
chrisluh81: calls $0.30
*** SHOW DOWN ***
terryfox1: shows [Jd 9c] (a full house, Jacks full of Nines)
chrisluh81: mucks hand
terryfox1 collected $1.28 from pot
*** SUMMARY ***
Total pot $1.33 | Rake $0.05
Board [Js 9s Jc Kh 2s]
Seat 1: Ramirres folded before Flop (didn't bet)
Seat 2: MojaMamka (button) folded before Flop (didn't bet)
Seat 3: raduarte10 (small blind) folded before Flop
Seat 4: terryfox1 (big blind) showed [Jd 9c] and won ($1.28) with a full house, Jacks full of Nines
Seat 5: bichito72 folded before Flop (didn't bet)
Seat 6: chrisluh81 mucked


PokerStars Hand #238160051492:  Hold'em No Limit ($0.01/$0.02 USD) - 2022/08/22 22:11:21 ET
Table 'Achilles IV' 6-max Seat #3 is the button
Seat 1: Ramirres ($3.54 in chips)
Seat 2: MojaMamka ($2.06 in chips)
Seat 3: raduarte10 ($1.50 in chips)
Seat 4: terryfox1 ($2.10 in chips)
Seat 5: bichito72 ($1.30 in chips)
Seat 6: chrisluh81 ($0.94 in chips)
terryfox1: posts small blind $0.01
bichito72: posts big blind $0.02
*** HOLE CARDS ***
chrisluh81: raises $0.02 to $0.04
Ramirres: folds
MojaMamka: folds
raduarte10: folds
terryfox1: folds
bichito72: folds
Uncalled bet ($0.02) returned to chrisluh81
chrisluh81 collected $0.05 from pot
*** SUMMARY ***
Total pot $0.05 | Rake $0
Seat 1: Ramirres folded before Flop (didn't bet)
Seat 2: MojaMamka folded before Flop (didn't bet)
Seat 3: raduarte10 (button) folded before Flop (didn't bet)
Seat 4: terryfox1 (small blind) folded before Flop
Seat 5: bichito72 (big blind) folded before Flop
Seat 6: chrisluh81 collected ($0.05)


PokerStars Hand #238160054352:  Hold'em No Limit ($0.01/$0.02 USD) - 2022/08/22 22:11:36 ET
Table 'Achilles IV' 6-max Seat #4 is the button
Seat 1: Ramirres ($3.54 in chips)
Seat 2: MojaMamka ($2.06 in chips)
Seat 3: raduarte10 ($1.50 in chips)
Seat 4: terryfox1 ($2.09 in chips)
Seat 5: bichito72 ($1.28 in chips)
Seat 6: chrisluh81 ($0.97 in chips)
bichito72: posts small blind $0.01
chrisluh81: posts big blind $0.02
*** HOLE CARDS ***
Ramirres: folds
MojaMamka: folds
raduarte10: folds
terryfox1: raises $0.02 to $0.04
bichito72: folds
chrisluh81: raises $0.02 to $0.06
terryfox1: calls $0.02
*** FLOP *** [Jd Qc 5d]
chrisluh81: bets $0.08
terryfox1: calls $0.08
*** TURN *** [Jd Qc 5d] [2d]
chrisluh81: bets $0.08
terryfox1: calls $0.08
*** RIVER *** [Jd Qc 5d 2d] [2s]
chrisluh81: bets $0.02
terryfox1: raises $0.24 to $0.26
chrisluh81: calls $0.24
*** SHOW DOWN ***
terryfox1: shows [6d Ad] (a flush, Ace high)
chrisluh81: mucks hand
terryfox1 collected $0.94 from pot
*** SUMMARY ***
Total pot $0.97 | Rake $0.03
Board [Jd Qc 5d 2d 2s]
Seat 1: Ramirres folded before Flop (didn't bet)
Seat 2: MojaMamka folded before Flop (didn't bet)
Seat 3: raduarte10 folded before Flop (didn't bet)
Seat 4: terryfox1 (button) showed [6d Ad] and won ($0.94) with a flush, Ace high
Seat 5: bichito72 (small blind) folded before Flop
Seat 6: chrisluh81 (big blind) mucked


PokerStars Hand #238160062321:  Hold'em No Limit ($0.01/$0.02 USD) - 2022/08/22 22:12:18 ET
Table 'Achilles IV' 6-max Seat #5 is the button
Seat 1: Ramirres ($3.54 in chips)
Seat 2: MojaMamka ($2.06 in chips)
Seat 3: raduarte10 ($1.50 in chips)
Seat 4: terryfox1 ($2.55 in chips)
Seat 5: bichito72 ($1.27 in chips)
Seat 6: chrisluh81 ($0.49 in chips)
chrisluh81: posts small blind $0.01
Ramirres: posts big blind $0.02
*** HOLE CARDS ***
MojaMamka: raises $0.04 to $0.06
raduarte10: folds
terryfox1: folds
bichito72: folds
chrisluh81: calls $0.05
Ramirres: folds
*** FLOP *** [Qc 8c 5c]
chrisluh81: bets $0.02
MojaMamka: folds
Uncalled bet ($0.02) returned to chrisluh81
chrisluh81 collected $0.14 from pot
*** SUMMARY ***
Total pot $0.14 | Rake $0
Board [Qc 8c 5c]
Seat 1: Ramirres (big blind) folded before Flop
Seat 2: MojaMamka folded on the Flop
Seat 3: raduarte10 folded before Flop (didn't bet)
Seat 4: terryfox1 folded before Flop (didn't bet)
Seat 5: bichito72 (button) folded before Flop (didn't bet)
Seat 6: chrisluh81 (small blind) collected ($0.14)


PokerStars Hand #238160066729:  Hold'em No Limit ($0.01/$0.02 USD) - 2022/08/22 22:12:41 ET
Table 'Achilles IV' 6-max Seat #6 is the button
Seat 1: Ramirres ($3.52 in chips)
Seat 2: MojaMamka ($2 in chips)
Seat 3: raduarte10 ($1.50 in chips)
Seat 4: terryfox1 ($2.55 in chips)
Seat 5: bichito72 ($1.27 in chips)
Seat 6: chrisluh81 ($0.57 in chips)
Ramirres: posts small blind $0.01
MojaMamka: posts big blind $0.02
*** HOLE CARDS ***
raduarte10: folds
terryfox1: folds
bichito72: calls $0.02
chrisluh81: raises $0.02 to $0.04
Ramirres: folds
MojaMamka: calls $0.02
bichito72: raises $0.55 to $0.59
chrisluh81: calls $0.53 and is all-in
MojaMamka: folds
Uncalled bet ($0.02) returned to bichito72
*** FLOP *** [Tc 3h Th]
*** TURN *** [Tc 3h Th] [8h]
*** RIVER *** [Tc 3h Th 8h] [3c]
*** SHOW DOWN ***
bichito72: shows [8c 8s] (a full house, Eights full of Tens)
chrisluh81: shows [Js 9d] (two pair, Tens and Threes)
bichito72 cashed out the hand for $0.62 | Cash Out Fee $0.01
*** SUMMARY ***
Total pot $1.19 | Rake $0.04
Board [Tc 3h Th 8h 3c]
Seat 1: Ramirres (small blind) folded before Flop
Seat 2: MojaMamka (big blind) folded before Flop
Seat 3: raduarte10 folded before Flop (didn't bet)
Seat 4: terryfox1 folded before Flop (didn't bet)
Seat 5: bichito72 showed [8c 8s] and won ($1.15) with a full house, Eights full of Tens (pot not awarded as player cashed out)
Seat 6: chrisluh81 (button) showed [Js 9d] and lost with two pair, Tens and Threes


PokerStars Hand #238160074232:  Hold'em No Limit ($0.01/$0.02 USD) - 2022/08/22 22:13:21 ET
Table 'Achilles IV' 6-max Seat #1 is the button
Seat 1: Ramirres ($3.51 in chips)
Seat 2: MojaMamka ($1.96 in chips)
Seat 3: raduarte10 ($1.50 in chips)
Seat 4: terryfox1 ($2.55 in chips)
Seat 5: bichito72 ($1.32 in chips)
MojaMamka: posts small blind $0.01
raduarte10: posts big blind $0.02
*** HOLE CARDS ***
terryfox1: raises $0.02 to $0.04
chrisluh81 leaves the table
bichito72: folds
Ramirres: raises $0.09 to $0.13
MojaMamka: folds
raduarte10: folds
TammyFs joins the table at seat #6
terryfox1: folds
Uncalled bet ($0.09) returned to Ramirres
Ramirres collected $0.11 from pot
*** SUMMARY ***
Total pot $0.11 | Rake $0
Seat 1: Ramirres (button) collected ($0.11)
Seat 2: MojaMamka (small blind) folded before Flop
Seat 3: raduarte10 (big blind) folded before Flop
Seat 4: terryfox1 folded before Flop
Seat 5: bichito72 folded before Flop (didn't bet)


PokerStars Hand #238160080794:  Hold'em No Limit ($0.01/$0.02 USD) - 2022/08/22 22:13:56 ET
Table 'Achilles IV' 6-max Seat #2 is the button
Seat 1: Ramirres ($3.58 in chips)
Seat 2: MojaMamka ($1.95 in chips)
Seat 3: raduarte10 ($1.48 in chips)
Seat 4: terryfox1 ($2.51 in chips)
Seat 5: bichito72 ($1.32 in chips)
raduarte10: posts small blind $0.01
terryfox1: posts big blind $0.02
TammyFs: sits out
*** HOLE CARDS ***
bichito72: folds
Ramirres: folds
MojaMamka: raises $0.04 to $0.06
raduarte10: folds
terryfox1: folds
Uncalled bet ($0.04) returned to MojaMamka
MojaMamka collected $0.05 from pot
MojaMamka: doesn't show hand
*** SUMMARY ***
Total pot $0.05 | Rake $0
Seat 1: Ramirres folded before Flop (didn't bet)
Seat 2: MojaMamka (button) collected ($0.05)
Seat 3: raduarte10 (small blind) folded before Flop
Seat 4: terryfox1 (big blind) folded before Flop
Seat 5: bichito72 folded before Flop (didn't bet)


PokerStars Hand #238160090241:  Hold'em No Limit ($0.01/$0.02 USD) - 2022/08/22 22:14:14 ET
Table 'Achilles IV' 6-max Seat #3 is the button
Seat 1: Ramirres ($3.58 in chips)
Seat 2: MojaMamka ($1.98 in chips)
Seat 3: raduarte10 ($1.47 in chips)
Seat 4: terryfox1 ($2.49 in chips)
Seat 5: bichito72 ($1.32 in chips)
terryfox1: posts small blind $0.01
bichito72: posts big blind $0.02
TammyFs: sits out
*** HOLE CARDS ***
Ramirres: folds
MojaMamka: folds
raduarte10: raises $0.04 to $0.06
terryfox1: folds
bichito72: folds
Uncalled bet ($0.04) returned to raduarte10
raduarte10 collected $0.05 from pot
*** SUMMARY ***
Total pot $0.05 | Rake $0
Seat 1: Ramirres folded before Flop (didn't bet)
Seat 2: MojaMamka folded before Flop (didn't bet)
Seat 3: raduarte10 (button) collected ($0.05)
Seat 4: terryfox1 (small blind) folded before Flop
Seat 5: bichito72 (big blind) folded before Flop


PokerStars Hand #238160093995:  Hold'em No Limit ($0.01/$0.02 USD) - 2022/08/22 22:14:34 ET
Table 'Achilles IV' 6-max Seat #4 is the button
Seat 1: Ramirres ($3.58 in chips)
Seat 2: MojaMamka ($1.98 in chips)
Seat 3: raduarte10 ($1.50 in chips)
Seat 4: terryfox1 ($2.48 in chips)
Seat 5: bichito72 ($1.30 in chips)
Seat 6: TammyFs ($0.80 in chips)
bichito72: posts small blind $0.01
TammyFs: posts big blind $0.02
*** HOLE CARDS ***
Ramirres: folds
MojaMamka: folds
raduarte10: folds
terryfox1: raises $0.04 to $0.06
bichito72: folds
TammyFs: calls $0.04
*** FLOP *** [2c 4h Qd]
TammyFs: bets $0.06
terryfox1: calls $0.06
*** TURN *** [2c 4h Qd] [Qs]
TammyFs: bets $0.10
terryfox1: folds
Uncalled bet ($0.10) returned to TammyFs
TammyFs collected $0.24 from pot
*** SUMMARY ***
Total pot $0.25 | Rake $0.01
Board [2c 4h Qd Qs]
Seat 1: Ramirres folded before Flop (didn't bet)
Seat 2: MojaMamka folded before Flop (didn't bet)
Seat 3: raduarte10 folded before Flop (didn't bet)
Seat 4: terryfox1 (button) folded on the Turn
Seat 5: bichito72 (small blind) folded before Flop
Seat 6: TammyFs (big blind) collected ($0.24)


PokerStars Hand #238160103082:  Hold'em No Limit ($0.01/$0.02 USD) - 2022/08/22 22:15:23 ET
Table 'Achilles IV' 6-max Seat #5 is the button
Seat 1: Ramirres ($3.58 in chips)
Seat 2: MojaMamka ($1.98 in chips)
Seat 3: raduarte10 ($1.50 in chips)
Seat 4: terryfox1 ($2.36 in chips)
Seat 5: bichito72 ($1.29 in chips)
Seat 6: TammyFs ($0.92 in chips)
TammyFs: posts small blind $0.01
Ramirres: posts big blind $0.02
*** HOLE CARDS ***
MojaMamka: folds
raduarte10: folds
terryfox1: folds
bichito72: raises $0.04 to $0.06
TammyFs: folds
Ramirres: folds
Uncalled bet ($0.04) returned to bichito72
bichito72 collected $0.05 from pot
bichito72: doesn't show hand
*** SUMMARY ***
Total pot $0.05 | Rake $0
Seat 1: Ramirres (big blind) folded before Flop
Seat 2: MojaMamka folded before Flop (didn't bet)
Seat 3: raduarte10 folded before Flop (didn't bet)
Seat 4: terryfox1 folded before Flop (didn't bet)
Seat 5: bichito72 (button) collected ($0.05)
Seat 6: TammyFs (small blind) folded before Flop


PokerStars Hand #238160109293:  Hold'em No Limit ($0.01/$0.02 USD) - 2022/08/22 22:15:56 ET
Table 'Achilles IV' 6-max Seat #6 is the button
Seat 1: Ramirres ($3.56 in chips)
Seat 2: MojaMamka ($1.98 in chips)
Seat 3: raduarte10 ($1.50 in chips)
Seat 4: terryfox1 ($2.36 in chips)
Seat 5: bichito72 ($1.32 in chips)
Seat 6: TammyFs ($0.91 in chips)
Ramirres: posts small blind $0.01
MojaMamka: posts big blind $0.02
*** HOLE CARDS ***
raduarte10: folds
terryfox1: folds
bichito72: folds
TammyFs: raises $0.02 to $0.04
Ramirres: folds
MojaMamka: calls $0.02
*** FLOP *** [8c Jh 6c]
MojaMamka: bets $0.04
TammyFs: calls $0.04
*** TURN *** [8c Jh 6c] [Qs]
MojaMamka: bets $0.08
TammyFs: calls $0.08
*** RIVER *** [8c Jh 6c Qs] [Ks]
MojaMamka: checks
TammyFs: bets $0.16
MojaMamka: calls $0.16
*** SHOW DOWN ***
TammyFs: shows [8h Kh] (two pair, Kings and Eights)
MojaMamka: mucks hand
TammyFs collected $0.63 from pot
*** SUMMARY ***
Total pot $0.65 | Rake $0.02
Board [8c Jh 6c Qs Ks]
Seat 1: Ramirres (small blind) folded before Flop
Seat 2: MojaMamka (big blind) mucked
Seat 3: raduarte10 folded before Flop (didn't bet)
Seat 4: terryfox1 folded before Flop (didn't bet)
Seat 5: bichito72 folded before Flop (didn't bet)
Seat 6: TammyFs (button) showed [8h Kh] and won ($0.63) with two pair, Kings and Eights


PokerStars Hand #238160118897:  Hold'em No Limit ($0.01/$0.02 USD) - 2022/08/22 22:16:48 ET
Table 'Achilles IV' 6-max Seat #1 is the button
Seat 1: Ramirres ($3.55 in chips)
Seat 2: MojaMamka ($1.66 in chips)
Seat 3: raduarte10 ($1.50 in chips)
Seat 4: terryfox1 ($2.36 in chips)
Seat 5: bichito72 ($1.32 in chips)
Seat 6: TammyFs ($1.22 in chips)
MojaMamka: posts small blind $0.01
raduarte10: posts big blind $0.02
*** HOLE CARDS ***
terryfox1: folds
bichito72: folds
TammyFs: raises $0.02 to $0.04
Ramirres: folds
terryfox1 leaves the table
MojaMamka: calls $0.03
raduarte10: folds
*** FLOP *** [Kc 2c 6d]
rjmnhs joins the table at seat #4
MojaMamka: bets $0.05
TammyFs: calls $0.05
*** TURN *** [Kc 2c 6d] [5d]
MojaMamka: bets $0.09
TammyFs: calls $0.09
*** RIVER *** [Kc 2c 6d 5d] [Jd]
MojaMamka: checks
TammyFs: checks
*** SHOW DOWN ***
MojaMamka: shows [Ks 8d] (a pair of Kings)
TammyFs: mucks hand
MojaMamka collected $0.37 from pot
*** SUMMARY ***
Total pot $0.38 | Rake $0.01
Board [Kc 2c 6d 5d Jd]
Seat 1: Ramirres (button) folded before Flop (didn't bet)
Seat 2: MojaMamka (small blind) showed [Ks 8d] and won ($0.37) with a pair of Kings
Seat 3: raduarte10 (big blind) folded before Flop
Seat 4: terryfox1 folded before Flop (didn't bet)
Seat 5: bichito72 folded before Flop (didn't bet)
Seat 6: TammyFs mucked


PokerStars Hand #238160136547:  Hold'em No Limit ($0.01/$0.02 USD) - 2022/08/22 22:17:32 ET
Table 'Achilles IV' 6-max Seat #2 is the button
Seat 1: Ramirres ($3.55 in chips)
Seat 2: MojaMamka ($1.85 in chips)
Seat 3: raduarte10 ($1.48 in chips)
Seat 4: rjmnhs ($0.80 in chips)
Seat 5: bichito72 ($1.32 in chips)
Seat 6: TammyFs ($1.04 in chips)
raduarte10: posts small blind $0.01
rjmnhs: posts big blind $0.02
*** HOLE CARDS ***
bichito72: raises $0.04 to $0.06
TammyFs: calls $0.06
Ramirres: calls $0.06
MojaMamka: folds
raduarte10: folds
rjmnhs: calls $0.04
*** FLOP *** [2d 2s 9h]
rjmnhs: checks
bichito72: bets $0.14
TammyFs: folds
Ramirres: folds
rjmnhs: folds
Uncalled bet ($0.14) returned to bichito72
bichito72 collected $0.24 from pot
bichito72: doesn't show hand
*** SUMMARY ***
Total pot $0.25 | Rake $0.01
Board [2d 2s 9h]
Seat 1: Ramirres folded on the Flop
Seat 2: MojaMamka (button) folded before Flop (didn't bet)
Seat 3: raduarte10 (small blind) folded before Flop
Seat 4: rjmnhs (big blind) folded on the Flop
Seat 5: bichito72 collected ($0.24)
Seat 6: TammyFs folded on the Flop


PokerStars Hand #238160146845:  Hold'em No Limit ($0.01/$0.02 USD) - 2022/08/22 22:18:27 ET
Table 'Achilles IV' 6-max Seat #3 is the button
Seat 1: Ramirres ($3.49 in chips)
Seat 2: MojaMamka ($1.85 in chips)
Seat 3: raduarte10 ($1.47 in chips)
Seat 4: rjmnhs ($0.74 in chips)
Seat 5: bichito72 ($1.50 in chips)
Seat 6: TammyFs ($0.98 in chips)
rjmnhs: posts small blind $0.01
bichito72: posts big blind $0.02
*** HOLE CARDS ***
TammyFs: folds
Ramirres: folds
MojaMamka: folds
raduarte10: folds
rjmnhs: folds
Uncalled bet ($0.01) returned to bichito72
bichito72 collected $0.02 from pot
bichito72: doesn't show hand
*** SUMMARY ***
Total pot $0.02 | Rake $0
Seat 1: Ramirres folded before Flop (didn't bet)
Seat 2: MojaMamka folded before Flop (didn't bet)
Seat 3: raduarte10 (button) folded before Flop (didn't bet)
Seat 4: rjmnhs (small blind) folded before Flop
Seat 5: bichito72 (big blind) collected ($0.02)
Seat 6: TammyFs folded before Flop (didn't bet)


PokerStars Hand #238160148931:  Hold'em No Limit ($0.01/$0.02 USD) - 2022/08/22 22:18:38 ET
Table 'Achilles IV' 6-max Seat #4 is the button
Seat 1: Ramirres ($3.49 in chips)
Seat 2: MojaMamka ($1.85 in chips)
Seat 3: raduarte10 ($1.47 in chips)
Seat 4: rjmnhs ($0.73 in chips)
Seat 5: bichito72 ($1.51 in chips)
Seat 6: TammyFs ($0.98 in chips)
bichito72: posts small blind $0.01
TammyFs: posts big blind $0.02
*** HOLE CARDS ***
Ramirres: folds
MojaMamka: folds
raduarte10: calls $0.02
rjmnhs: raises $0.04 to $0.06
bichito72: folds
TammyFs: folds
raduarte10: calls $0.04
*** FLOP *** [3s 7s 6s]
raduarte10: checks
rjmnhs: checks
*** TURN *** [3s 7s 6s] [9h]
raduarte10: checks
rjmnhs: checks
*** RIVER *** [3s 7s 6s 9h] [Js]
raduarte10: bets $0.06
rjmnhs: folds
Uncalled bet ($0.06) returned to raduarte10
raduarte10 collected $0.14 from pot
*** SUMMARY ***
Total pot $0.15 | Rake $0.01
Board [3s 7s 6s 9h Js]
Seat 1: Ramirres folded before Flop (didn't bet)
Seat 2: MojaMamka folded before Flop (didn't bet)
Seat 3: raduarte10 collected ($0.14)
Seat 4: rjmnhs (button) folded on the River
Seat 5: bichito72 (small blind) folded before Flop
Seat 6: TammyFs (big blind) folded before Flop


PokerStars Hand #238160154658:  Hold'em No Limit ($0.01/$0.02 USD) - 2022/08/22 22:19:09 ET
Table 'Achilles IV' 6-max Seat #5 is the button
Seat 1: Ramirres ($3.49 in chips)
Seat 2: MojaMamka ($1.85 in chips)
Seat 3: raduarte10 ($1.55 in chips)
Seat 4: rjmnhs ($0.67 in chips)
Seat 5: bichito72 ($1.50 in chips)
Seat 6: TammyFs ($0.96 in chips)
TammyFs: posts small blind $0.01
Ramirres: posts big blind $0.02
*** HOLE CARDS ***
MojaMamka: calls $0.02
raduarte10: raises $0.06 to $0.08
rjmnhs: folds
bichito72: calls $0.08
TammyFs: folds
Ramirres: folds
MojaMamka: calls $0.06
*** FLOP *** [Ks 9c 5c]
MojaMamka: checks
raduarte10: bets $0.10
bichito72: calls $0.10
MojaMamka: folds
*** TURN *** [Ks 9c 5c] [7d]
raduarte10: bets $0.10
bichito72: calls $0.10
*** RIVER *** [Ks 9c 5c 7d] [7c]
raduarte10: bets $0.10
bichito72: calls $0.10
*** SHOW DOWN ***
raduarte10: shows [9h 9s] (a full house, Nines full of Sevens)
bichito72: mucks hand
raduarte10 collected $0.84 from pot
*** SUMMARY ***
Total pot $0.87 | Rake $0.03
Board [Ks 9c 5c 7d 7c]
Seat 1: Ramirres (big blind) folded before Flop
Seat 2: MojaMamka folded on the Flop
Seat 3: raduarte10 showed [9h 9s] and won ($0.84) with a full house, Nines full of Sevens
Seat 4: rjmnhs folded before Flop (didn't bet)
Seat 5: bichito72 (button) mucked
Seat 6: TammyFs (small blind) folded before Flop


PokerStars Hand #238160169172:  Hold'em No Limit ($0.01/$0.02 USD) - 2022/08/22 22:20:26 ET
Table 'Achilles IV' 6-max Seat #6 is the button
Seat 2: MojaMamka ($1.77 in chips)
Seat 3: raduarte10 ($2.01 in chips)
Seat 4: rjmnhs ($0.67 in chips)
Seat 5: bichito72 ($1.12 in chips)
Seat 6: TammyFs ($0.95 in chips)
MojaMamka: posts small blind $0.01
raduarte10: posts big blind $0.02
*** HOLE CARDS ***
rjmnhs: folds
bichito72: folds
TammyFs: calls $0.02
MojaMamka: calls $0.01
raduarte10: checks
*** FLOP *** [2c 9c 6s]
MojaMamka: checks
raduarte10: checks
TammyFs: bets $0.03
MojaMamka: folds
raduarte10: folds
Uncalled bet ($0.03) returned to TammyFs
TammyFs collected $0.06 from pot
*** SUMMARY ***
Total pot $0.06 | Rake $0
Board [2c 9c 6s]
Seat 2: MojaMamka (small blind) folded on the Flop
Seat 3: raduarte10 (big blind) folded on the Flop
Seat 4: rjmnhs folded before Flop (didn't bet)
Seat 5: bichito72 folded before Flop (didn't bet)
Seat 6: TammyFs (button) collected ($0.06)


PokerStars Hand #238160174831:  Hold'em No Limit ($0.01/$0.02 USD) - 2022/08/22 22:20:57 ET
Table 'Achilles IV' 6-max Seat #2 is the button
Seat 2: MojaMamka ($1.75 in chips)
Seat 3: raduarte10 ($1.99 in chips)
Seat 4: rjmnhs ($0.67 in chips)
Seat 5: bichito72 ($1.12 in chips)
Seat 6: TammyFs ($0.99 in chips)
raduarte10: posts small blind $0.01
rjmnhs: posts big blind $0.02
Ramirres: sits out
*** HOLE CARDS ***
bichito72: folds
TammyFs: folds
MojaMamka: calls $0.02
raduarte10: folds
rjmnhs: raises $0.05 to $0.07
MojaMamka: calls $0.05
*** FLOP *** [4c 4h 2h]
rjmnhs: bets $0.07
MojaMamka: folds
Uncalled bet ($0.07) returned to rjmnhs
rjmnhs collected $0.14 from pot
*** SUMMARY ***
Total pot $0.15 | Rake $0.01
Board [4c 4h 2h]
Seat 2: MojaMamka (button) folded on the Flop
Seat 3: raduarte10 (small blind) folded before Flop
Seat 4: rjmnhs (big blind) collected ($0.14)
Seat 5: bichito72 folded before Flop (didn't bet)
Seat 6: TammyFs folded before Flop (didn't bet)


PokerStars Hand #238160178496:  Hold'em No Limit ($0.01/$0.02 USD) - 2022/08/22 22:21:16 ET
Table 'Achilles IV' 6-max Seat #3 is the button
Seat 2: MojaMamka ($1.68 in chips)
Seat 3: raduarte10 ($1.98 in chips)
Seat 4: rjmnhs ($0.74 in chips)
Seat 5: bichito72 ($2 in chips)
Seat 6: TammyFs ($0.99 in chips)
rjmnhs: posts small blind $0.01
bichito72: posts big blind $0.02
Ramirres: sits out
*** HOLE CARDS ***
TammyFs: raises $0.02 to $0.04
MojaMamka: calls $0.04
raduarte10: folds
rjmnhs: calls $0.03
bichito72: folds
*** FLOP *** [Jd Th 4c]
rjmnhs: checks
TammyFs: checks
MojaMamka: checks
*** TURN *** [Jd Th 4c] [5s]
rjmnhs: checks
TammyFs: bets $0.02
MojaMamka: folds
rjmnhs: calls $0.02
*** RIVER *** [Jd Th 4c 5s] [9s]
rjmnhs: checks
TammyFs: bets $0.08
rjmnhs: folds
Uncalled bet ($0.08) returned to TammyFs
TammyFs collected $0.17 from pot
*** SUMMARY ***
Total pot $0.18 | Rake $0.01
Board [Jd Th 4c 5s 9s]
Seat 2: MojaMamka folded on the Turn
Seat 3: raduarte10 (button) folded before Flop (didn't bet)
Seat 4: rjmnhs (small blind) folded on the River
Seat 5: bichito72 (big blind) folded before Flop
Seat 6: TammyFs collected ($0.17)


PokerStars Hand #238160184676:  Hold'em No Limit ($0.01/$0.02 USD) - 2022/08/22 22:21:49 ET
Table 'Achilles IV' 6-max Seat #4 is the button
Seat 2: MojaMamka ($1.64 in chips)
Seat 3: raduarte10 ($1.98 in chips)
Seat 4: rjmnhs ($0.68 in chips)
Seat 5: bichito72 ($1.98 in chips)
Seat 6: TammyFs ($1.10 in chips)
bichito72: posts small blind $0.01
TammyFs: posts big blind $0.02
Ramirres: sits out
*** HOLE CARDS ***
MojaMamka: folds
raduarte10: calls $0.02
rjmnhs: raises $0.04 to $0.06
bichito72: folds
TammyFs: calls $0.04
raduarte10: calls $0.04
*** FLOP *** [Qs Td Ah]
TammyFs: bets $0.09
raduarte10: folds
rjmnhs: calls $0.09
*** TURN *** [Qs Td Ah] [2d]
TammyFs: checks
rjmnhs: bets $0.18
TammyFs: folds
Uncalled bet ($0.18) returned to rjmnhs
rjmnhs collected $0.36 from pot
*** SUMMARY ***
Total pot $0.37 | Rake $0.01
Board [Qs Td Ah 2d]
Seat 2: MojaMamka folded before Flop (didn't bet)
Seat 3: raduarte10 folded on the Flop
Seat 4: rjmnhs (button) collected ($0.36)
Seat 5: bichito72 (small blind) folded before Flop
Seat 6: TammyFs (big blind) folded on the Turn


PokerStars Hand #238160193265:  Hold'em No Limit ($0.01/$0.02 USD) - 2022/08/22 22:22:36 ET
Table 'Achilles IV' 6-max Seat #5 is the button
Seat 1: Ramirres ($3.47 in chips)
Seat 2: MojaMamka ($1.64 in chips)
Seat 3: raduarte10 ($1.92 in chips)
Seat 4: rjmnhs ($0.89 in chips)
Seat 5: bichito72 ($1.97 in chips)
Seat 6: TammyFs ($0.95 in chips)
TammyFs: posts small blind $0.01
Ramirres: posts big blind $0.02
*** HOLE CARDS ***
MojaMamka: folds
raduarte10: raises $0.02 to $0.04
rjmnhs: folds
bichito72: folds
TammyFs: calls $0.03
Ramirres: folds
*** FLOP *** [7c 6s Kc]
TammyFs: bets $0.05
raduarte10: folds
Uncalled bet ($0.05) returned to TammyFs
TammyFs collected $0.10 from pot
*** SUMMARY ***
Total pot $0.10 | Rake $0
Board [7c 6s Kc]
Seat 1: Ramirres (big blind) folded before Flop
Seat 2: MojaMamka folded before Flop (didn't bet)
Seat 3: raduarte10 folded on the Flop
Seat 4: rjmnhs folded before Flop (didn't bet)
Seat 5: bichito72 (button) folded before Flop (didn't bet)
Seat 6: TammyFs (small blind) collected ($0.10)


PokerStars Hand #238160201200:  Hold'em No Limit ($0.01/$0.02 USD) - 2022/08/22 22:23:19 ET
Table 'Achilles IV' 6-max Seat #6 is the button
Seat 1: Ramirres ($3.45 in chips)
Seat 2: MojaMamka ($1.64 in chips)
Seat 3: raduarte10 ($1.88 in chips)
Seat 4: rjmnhs ($0.89 in chips)
Seat 5: bichito72 ($1.97 in chips)
Seat 6: TammyFs ($1.01 in chips)
Ramirres: posts small blind $0.01
MojaMamka: posts big blind $0.02
*** HOLE CARDS ***
raduarte10: folds
rjmnhs: folds
bichito72: folds
TammyFs: calls $0.02
Ramirres: raises $0.08 to $0.10
MojaMamka: folds
TammyFs: calls $0.08
*** FLOP *** [3d 2d 4c]
Ramirres: checks
TammyFs: checks
*** TURN *** [3d 2d 4c] [5c]
Ramirres: bets $0.14
TammyFs: folds
Uncalled bet ($0.14) returned to Ramirres
Ramirres collected $0.21 from pot
*** SUMMARY ***
Total pot $0.22 | Rake $0.01
Board [3d 2d 4c 5c]
Seat 1: Ramirres (small blind) collected ($0.21)
Seat 2: MojaMamka (big blind) folded before Flop
Seat 3: raduarte10 folded before Flop (didn't bet)
Seat 4: rjmnhs folded before Flop (didn't bet)
Seat 5: bichito72 folded before Flop (didn't bet)
Seat 6: TammyFs (button) folded on the Turn


PokerStars Hand #238160208153:  Hold'em No Limit ($0.01/$0.02 USD) - 2022/08/22 22:23:56 ET
Table 'Achilles IV' 6-max Seat #1 is the button
Seat 1: Ramirres ($3.56 in chips)
Seat 2: MojaMamka ($1.62 in chips)
Seat 3: raduarte10 ($1.88 in chips)
Seat 4: rjmnhs ($0.89 in chips)
Seat 5: bichito72 ($1.97 in chips)
Seat 6: TammyFs ($0.91 in chips)
MojaMamka: posts small blind $0.01
raduarte10: posts big blind $0.02
*** HOLE CARDS ***
rjmnhs: folds
bichito72: raises $0.04 to $0.06
TammyFs: folds
Ramirres: folds
MojaMamka: folds
raduarte10: folds
Uncalled bet ($0.04) returned to bichito72
bichito72 collected $0.05 from pot
bichito72: doesn't show hand
*** SUMMARY ***
Total pot $0.05 | Rake $0
Seat 1: Ramirres (button) folded before Flop (didn't bet)
Seat 2: MojaMamka (small blind) folded before Flop
Seat 3: raduarte10 (big blind) folded before Flop
Seat 4: rjmnhs folded before Flop (didn't bet)
Seat 5: bichito72 collected ($0.05)
Seat 6: TammyFs folded before Flop (didn't bet)


PokerStars Hand #238160221292:  Hold'em No Limit ($0.01/$0.02 USD) - 2022/08/22 22:24:19 ET
Table 'Achilles IV' 6-max Seat #2 is the button
Seat 1: Ramirres ($3.56 in chips)
Seat 2: MojaMamka ($1.61 in chips)
Seat 3: raduarte10 ($1.86 in chips)
Seat 4: rjmnhs ($0.89 in chips)
Seat 5: bichito72 ($2 in chips)
Seat 6: TammyFs ($0.91 in chips)
raduarte10: posts small blind $0.01
rjmnhs: posts big blind $0.02
*** HOLE CARDS ***
bichito72: folds
TammyFs: calls $0.02
Ramirres: folds
MojaMamka: folds
raduarte10: folds
rjmnhs: checks
*** FLOP *** [Ks Jc Qh]
rjmnhs: checks
TammyFs: checks
*** TURN *** [Ks Jc Qh] [6h]
rjmnhs: checks
TammyFs: checks
*** RIVER *** [Ks Jc Qh 6h] [Kh]
rjmnhs: checks
TammyFs: checks
*** SHOW DOWN ***
rjmnhs: shows [5d Qc] (two pair, Kings and Queens)
TammyFs: mucks hand
rjmnhs collected $0.05 from pot
*** SUMMARY ***
Total pot $0.05 | Rake $0
Board [Ks Jc Qh 6h Kh]
Seat 1: Ramirres folded before Flop (didn't bet)
Seat 2: MojaMamka (button) folded before Flop (didn't bet)
Seat 3: raduarte10 (small blind) folded before Flop
Seat 4: rjmnhs (big blind) showed [5d Qc] and won ($0.05) with two pair, Kings and Queens
Seat 5: bichito72 folded before Flop (didn't bet)
Seat 6: TammyFs mucked


PokerStars Hand #238160225716:  Hold'em No Limit ($0.01/$0.02 USD) - 2022/08/22 22:24:43 ET
Table 'Achilles IV' 6-max Seat #3 is the button
Seat 1: Ramirres ($3.56 in chips)
Seat 2: MojaMamka ($1.61 in chips)
Seat 3: raduarte10 ($1.85 in chips)
Seat 4: rjmnhs ($0.92 in chips)
Seat 5: bichito72 ($2 in chips)
Seat 6: TammyFs ($0.89 in chips)
rjmnhs: posts small blind $0.01
bichito72: posts big blind $0.02
*** HOLE CARDS ***
TammyFs: calls $0.02
Ramirres: folds
MojaMamka: calls $0.02
raduarte10: folds
rjmnhs: folds
bichito72: checks
*** FLOP *** [6c 3h Jd]
bichito72: checks
TammyFs: bets $0.02
MojaMamka: calls $0.02
bichito72: folds
*** TURN *** [6c 3h Jd] [Kd]
TammyFs: bets $0.05
MojaMamka: calls $0.05
*** RIVER *** [6c 3h Jd Kd] [As]
TammyFs: checks
MojaMamka: bets $0.10
TammyFs: calls $0.10
*** SHOW DOWN ***
MojaMamka: shows [Th Qh] (a straight, Ten to Ace)
TammyFs: mucks hand
MojaMamka collected $0.40 from pot
*** SUMMARY ***
Total pot $0.41 | Rake $0.01
Board [6c 3h Jd Kd As]
Seat 1: Ramirres folded before Flop (didn't bet)
Seat 2: MojaMamka showed [Th Qh] and won ($0.40) with a straight, Ten to Ace
Seat 3: raduarte10 (button) folded before Flop (didn't bet)
Seat 4: rjmnhs (small blind) folded before Flop
Seat 5: bichito72 (big blind) folded on the Flop
Seat 6: TammyFs mucked


PokerStars Hand #238160238094:  Hold'em No Limit ($0.01/$0.02 USD) - 2022/08/22 22:25:50 ET
Table 'Achilles IV' 6-max Seat #4 is the button
Seat 1: Ramirres ($3.56 in chips)
Seat 2: MojaMamka ($1.82 in chips)
Seat 3: raduarte10 ($1.85 in chips)
Seat 4: rjmnhs ($0.91 in chips)
Seat 5: bichito72 ($1.98 in chips)
Seat 6: TammyFs ($0.70 in chips)
bichito72: posts small blind $0.01
TammyFs: posts big blind $0.02
*** HOLE CARDS ***
Ramirres: raises $0.04 to $0.06
MojaMamka: folds
raduarte10: calls $0.06
rjmnhs: folds
bichito72: calls $0.05
TammyFs: folds
*** FLOP *** [3d Ks 9c]
bichito72: checks
Ramirres: checks
raduarte10: bets $0.08
bichito72: calls $0.08
Ramirres: folds
*** TURN *** [3d Ks 9c] [Jd]
bichito72: checks
raduarte10: checks
*** RIVER *** [3d Ks 9c Jd] [7d]
bichito72: bets $0.17
raduarte10: calls $0.17
*** SHOW DOWN ***
bichito72: shows [9d 9s] (three of a kind, Nines)
raduarte10: mucks hand
bichito72 collected $0.68 from pot
*** SUMMARY ***
Total pot $0.70 | Rake $0.02
Board [3d Ks 9c Jd 7d]
Seat 1: Ramirres folded on the Flop
Seat 2: MojaMamka folded before Flop (didn't bet)
Seat 3: raduarte10 mucked
Seat 4: rjmnhs (button) folded before Flop (didn't bet)
Seat 5: bichito72 (small blind) showed [9d 9s] and won ($0.68) with three of a kind, Nines
Seat 6: TammyFs (big blind) folded before Flop


PokerStars Hand #238160252240:  Hold'em No Limit ($0.01/$0.02 USD) - 2022/08/22 22:26:46 ET
Table 'Achilles IV' 6-max Seat #5 is the button
Seat 1: Ramirres ($3.50 in chips)
Seat 2: MojaMamka ($1.82 in chips)
Seat 3: raduarte10 ($1.54 in chips)
Seat 4: rjmnhs ($0.91 in chips)
Seat 5: bichito72 ($2.35 in chips)
Seat 6: TammyFs ($0.68 in chips)
TammyFs: posts small blind $0.01
Ramirres: posts big blind $0.02
*** HOLE CARDS ***
MojaMamka: raises $0.05 to $0.07
raduarte10: calls $0.07
rjmnhs: folds
bichito72: folds
TammyFs: folds
Ramirres: folds
*** FLOP *** [3c 6d Ac]
MojaMamka: bets $0.08
raduarte10: folds
Uncalled bet ($0.08) returned to MojaMamka
MojaMamka collected $0.16 from pot
MojaMamka: doesn't show hand
*** SUMMARY ***
Total pot $0.17 | Rake $0.01
Board [3c 6d Ac]
Seat 1: Ramirres (big blind) folded before Flop
Seat 2: MojaMamka collected ($0.16)
Seat 3: raduarte10 folded on the Flop
Seat 4: rjmnhs folded before Flop (didn't bet)
Seat 5: bichito72 (button) folded before Flop (didn't bet)
Seat 6: TammyFs (small blind) folded before Flop


PokerStars Hand #238160255498:  Hold'em No Limit ($0.01/$0.02 USD) - 2022/08/22 22:27:04 ET
Table 'Achilles IV' 6-max Seat #6 is the button
Seat 1: Ramirres ($3.48 in chips)
Seat 2: MojaMamka ($1.91 in chips)
Seat 3: raduarte10 ($1.47 in chips)
Seat 4: rjmnhs ($0.91 in chips)
Seat 5: bichito72 ($2.35 in chips)
Seat 6: TammyFs ($0.67 in chips)
Ramirres: posts small blind $0.01
MojaMamka: posts big blind $0.02
*** HOLE CARDS ***
raduarte10: calls $0.02
rjmnhs: raises $0.07 to $0.09
bichito72: folds
TammyFs: calls $0.09
Ramirres: folds
MojaMamka: folds
raduarte10: calls $0.07
*** FLOP *** [8h Qd 8c]
raduarte10: checks
rjmnhs: bets $0.14
TammyFs: folds
raduarte10: folds
Uncalled bet ($0.14) returned to rjmnhs
rjmnhs collected $0.29 from pot
*** SUMMARY ***
Total pot $0.30 | Rake $0.01
Board [8h Qd 8c]
Seat 1: Ramirres (small blind) folded before Flop
Seat 2: MojaMamka (big blind) folded before Flop
Seat 3: raduarte10 folded on the Flop
Seat 4: rjmnhs collected ($0.29)
Seat 5: bichito72 folded before Flop (didn't bet)
Seat 6: TammyFs (button) folded on the Flop


PokerStars Hand #238160263645:  Hold'em No Limit ($0.01/$0.02 USD) - 2022/08/22 22:27:49 ET
Table 'Achilles IV' 6-max Seat #1 is the button
Seat 1: Ramirres ($3.47 in chips)
Seat 2: MojaMamka ($1.89 in chips)
Seat 3: raduarte10 ($1.38 in chips)
Seat 4: rjmnhs ($1.11 in chips)
Seat 5: bichito72 ($2.35 in chips)
Seat 6: TammyFs ($0.58 in chips)
MojaMamka: posts small blind $0.01
raduarte10: posts big blind $0.02
*** HOLE CARDS ***
rjmnhs: folds
bichito72: folds
TammyFs: calls $0.02
Ramirres: folds
MojaMamka: calls $0.01
raduarte10: checks
*** FLOP *** [7c 3h 5s]
MojaMamka: checks
raduarte10: checks
TammyFs: checks
*** TURN *** [7c 3h 5s] [2s]
MojaMamka: checks
raduarte10: checks
TammyFs: checks
*** RIVER *** [7c 3h 5s 2s] [Kh]
MojaMamka: checks
raduarte10: bets $0.08
TammyFs: calls $0.08
MojaMamka: calls $0.08
*** SHOW DOWN ***
raduarte10: shows [2c Ks] (two pair, Kings and Deuces)
TammyFs: mucks hand
MojaMamka: mucks hand
raduarte10 collected $0.29 from pot
*** SUMMARY ***
Total pot $0.30 | Rake $0.01
Board [7c 3h 5s 2s Kh]
Seat 1: Ramirres (button) folded before Flop (didn't bet)
Seat 2: MojaMamka (small blind) mucked
Seat 3: raduarte10 (big blind) showed [2c Ks] and won ($0.29) with two pair, Kings and Deuces
Seat 4: rjmnhs folded before Flop (didn't bet)
Seat 5: bichito72 folded before Flop (didn't bet)
Seat 6: TammyFs mucked


PokerStars Hand #238160273508:  Hold'em No Limit ($0.01/$0.02 USD) - 2022/08/22 22:28:44 ET
Table 'Achilles IV' 6-max Seat #2 is the button
Seat 1: Ramirres ($3.47 in chips)
Seat 2: MojaMamka ($1.79 in chips)
Seat 3: raduarte10 ($1.57 in chips)
Seat 4: rjmnhs ($1.11 in chips)
Seat 5: bichito72 ($2.35 in chips)
Seat 6: TammyFs ($0.48 in chips)
raduarte10: posts small blind $0.01
rjmnhs: posts big blind $0.02
*** HOLE CARDS ***
bichito72: folds
TammyFs: calls $0.02
Ramirres: folds
MojaMamka: folds
raduarte10: folds
rjmnhs: checks
*** FLOP *** [7s 5s Kh]
rjmnhs: checks
TammyFs: bets $0.05
rjmnhs: folds
Uncalled bet ($0.05) returned to TammyFs
TammyFs collected $0.05 from pot
*** SUMMARY ***
Total pot $0.05 | Rake $0
Board [7s 5s Kh]
Seat 1: Ramirres folded before Flop (didn't bet)
Seat 2: MojaMamka (button) folded before Flop (didn't bet)
Seat 3: raduarte10 (small blind) folded before Flop
Seat 4: rjmnhs (big blind) folded on the Flop
Seat 5: bichito72 folded before Flop (didn't bet)
Seat 6: TammyFs collected ($0.05)


PokerStars Hand #238160277910:  Hold'em No Limit ($0.01/$0.02 USD) - 2022/08/22 22:29:07 ET
Table 'Achilles IV' 6-max Seat #3 is the button
Seat 1: Ramirres ($3.47 in chips)
Seat 2: MojaMamka ($1.79 in chips)
Seat 3: raduarte10 ($1.56 in chips)
Seat 4: rjmnhs ($1.09 in chips)
Seat 5: bichito72 ($2.35 in chips)
Seat 6: TammyFs ($0.51 in chips)
rjmnhs: posts small blind $0.01
bichito72: posts big blind $0.02
*** HOLE CARDS ***
TammyFs: calls $0.02
Ramirres: folds
MojaMamka has timed out
MojaMamka: folds
raduarte10: calls $0.02
rjmnhs: raises $0.08 to $0.10
bichito72: calls $0.08
TammyFs: folds
raduarte10: folds
*** FLOP *** [7c 6d Ah]
rjmnhs: bets $0.11
bichito72: calls $0.11
*** TURN *** [7c 6d Ah] [9c]
rjmnhs: bets $0.22
bichito72: folds
Uncalled bet ($0.22) returned to rjmnhs
rjmnhs collected $0.44 from pot
*** SUMMARY ***
Total pot $0.46 | Rake $0.02
Board [7c 6d Ah 9c]
Seat 1: Ramirres folded before Flop (didn't bet)
Seat 2: MojaMamka folded before Flop (didn't bet)
Seat 3: raduarte10 (button) folded before Flop
Seat 4: rjmnhs (small blind) collected ($0.44)
Seat 5: bichito72 (big blind) folded on the Turn
Seat 6: TammyFs folded before Flop


PokerStars Hand #238160288064:  Hold'em No Limit ($0.01/$0.02 USD) - 2022/08/22 22:30:03 ET
Table 'Achilles IV' 6-max Seat #4 is the button
Seat 2: MojaMamka ($1.79 in chips)
Seat 3: raduarte10 ($1.54 in chips)
Seat 4: rjmnhs ($1.32 in chips)
Seat 5: bichito72 ($2.14 in chips)
Seat 6: TammyFs ($0.49 in chips)
bichito72: posts small blind $0.01
TammyFs: posts big blind $0.02
*** HOLE CARDS ***
MojaMamka: folds
raduarte10: calls $0.02
rjmnhs: folds
bichito72: raises $0.08 to $0.10
TammyFs: folds
raduarte10: folds
Uncalled bet ($0.08) returned to bichito72
bichito72 collected $0.06 from pot
bichito72: doesn't show hand
*** SUMMARY ***
Total pot $0.06 | Rake $0
Seat 2: MojaMamka folded before Flop (didn't bet)
Seat 3: raduarte10 folded before Flop
Seat 4: rjmnhs (button) folded before Flop (didn't bet)
Seat 5: bichito72 (small blind) collected ($0.06)
Seat 6: TammyFs (big blind) folded before Flop


PokerStars Hand #238160293289:  Hold'em No Limit ($0.01/$0.02 USD) - 2022/08/22 22:30:33 ET
Table 'Achilles IV' 6-max Seat #5 is the button
Seat 1: Ramirres ($3.47 in chips)
Seat 2: MojaMamka ($1.79 in chips)
Seat 3: raduarte10 ($1.52 in chips)
Seat 4: rjmnhs ($1.32 in chips)
Seat 5: bichito72 ($2.18 in chips)
Seat 6: TammyFs ($0.47 in chips)
TammyFs: posts small blind $0.01
Ramirres: posts big blind $0.02
*** HOLE CARDS ***
MojaMamka: raises $0.05 to $0.07
raduarte10: folds
rjmnhs: folds
bichito72: folds
TammyFs: calls $0.06
Ramirres: calls $0.05
*** FLOP *** [Kc 2s 5s]
TammyFs: checks
Ramirres: bets $0.14
MojaMamka: folds
TammyFs: calls $0.14
*** TURN *** [Kc 2s 5s] [Kh]
TammyFs: checks
Ramirres: bets $0.31
TammyFs: folds
Uncalled bet ($0.31) returned to Ramirres
Ramirres collected $0.47 from pot
*** SUMMARY ***
Total pot $0.49 | Rake $0.02
Board [Kc 2s 5s Kh]
Seat 1: Ramirres (big blind) collected ($0.47)
Seat 2: MojaMamka folded on the Flop
Seat 3: raduarte10 folded before Flop (didn't bet)
Seat 4: rjmnhs folded before Flop (didn't bet)
Seat 5: bichito72 (button) folded before Flop (didn't bet)
Seat 6: TammyFs (small blind) folded on the Turn


PokerStars Hand #238160304932:  Hold'em No Limit ($0.01/$0.02 USD) - 2022/08/22 22:31:37 ET
Table 'Achilles IV' 6-max Seat #6 is the button
Seat 1: Ramirres ($3.73 in chips)
Seat 2: MojaMamka ($1.72 in chips)
Seat 3: raduarte10 ($1.52 in chips)
Seat 4: rjmnhs ($1.32 in chips)
Seat 5: bichito72 ($2.18 in chips)
Seat 6: TammyFs ($0.26 in chips)
Ramirres: posts small blind $0.01
MojaMamka: posts big blind $0.02
*** HOLE CARDS ***
raduarte10: folds
rjmnhs: folds
bichito72: folds
TammyFs: calls $0.02
Ramirres: raises $0.08 to $0.10
MojaMamka: folds
TammyFs: folds
Uncalled bet ($0.08) returned to Ramirres
Ramirres collected $0.06 from pot
*** SUMMARY ***
Total pot $0.06 | Rake $0
Seat 1: Ramirres (small blind) collected ($0.06)
Seat 2: MojaMamka (big blind) folded before Flop
Seat 3: raduarte10 folded before Flop (didn't bet)
Seat 4: rjmnhs folded before Flop (didn't bet)
Seat 5: bichito72 folded before Flop (didn't bet)
Seat 6: TammyFs (button) folded before Flop


PokerStars Hand #238160308316:  Hold'em No Limit ($0.01/$0.02 USD) - 2022/08/22 22:31:56 ET
Table 'Achilles IV' 6-max Seat #1 is the button
Seat 1: Ramirres ($3.77 in chips)
Seat 2: MojaMamka ($1.70 in chips)
Seat 3: raduarte10 ($1.52 in chips)
Seat 4: rjmnhs ($1.32 in chips)
Seat 5: bichito72 ($2.18 in chips)
Seat 6: TammyFs ($0.24 in chips)
MojaMamka: posts small blind $0.01
raduarte10: posts big blind $0.02
*** HOLE CARDS ***
rjmnhs: folds
bichito72: folds
TammyFs: calls $0.02
Ramirres: folds
MojaMamka: calls $0.01
raduarte10: checks
*** FLOP *** [6s Kc 5c]
MojaMamka: checks
raduarte10: checks
TammyFs: checks
*** TURN *** [6s Kc 5c] [Ah]
MojaMamka: checks
raduarte10: checks
TammyFs: bets $0.06
MojaMamka: calls $0.06
raduarte10: folds
*** RIVER *** [6s Kc 5c Ah] [4s]
MojaMamka: checks
TammyFs: checks
*** SHOW DOWN ***
MojaMamka: shows [Ac 3c] (a pair of Aces)
TammyFs: mucks hand
MojaMamka collected $0.17 from pot
*** SUMMARY ***
Total pot $0.18 | Rake $0.01
Board [6s Kc 5c Ah 4s]
Seat 1: Ramirres (button) folded before Flop (didn't bet)
Seat 2: MojaMamka (small blind) showed [Ac 3c] and won ($0.17) with a pair of Aces
Seat 3: raduarte10 (big blind) folded on the Turn
Seat 4: rjmnhs folded before Flop (didn't bet)
Seat 5: bichito72 folded before Flop (didn't bet)
Seat 6: TammyFs mucked


PokerStars Hand #238160315416:  Hold'em No Limit ($0.01/$0.02 USD) - 2022/08/22 22:32:35 ET
Table 'Achilles IV' 6-max Seat #2 is the button
Seat 1: Ramirres ($3.77 in chips)
Seat 2: MojaMamka ($1.79 in chips)
Seat 3: raduarte10 ($1.50 in chips)
Seat 4: rjmnhs ($1.32 in chips)
Seat 5: bichito72 ($2.18 in chips)
Seat 6: TammyFs ($0.16 in chips)
raduarte10: posts small blind $0.01
rjmnhs: posts big blind $0.02
*** HOLE CARDS ***
bichito72: folds
TammyFs: raises $0.02 to $0.04
Ramirres: folds
MojaMamka: folds
raduarte10: calls $0.03
rjmnhs: calls $0.02
*** FLOP *** [Jc 5d Kh]
raduarte10: checks
rjmnhs: checks
TammyFs: checks
*** TURN *** [Jc 5d Kh] [4d]
raduarte10: checks
rjmnhs: checks
TammyFs: checks
*** RIVER *** [Jc 5d Kh 4d] [5h]
raduarte10: checks
rjmnhs: bets $0.06
TammyFs: folds
raduarte10: folds
Uncalled bet ($0.06) returned to rjmnhs
rjmnhs collected $0.12 from pot
*** SUMMARY ***
Total pot $0.12 | Rake $0
Board [Jc 5d Kh 4d 5h]
Seat 1: Ramirres folded before Flop (didn't bet)
Seat 2: MojaMamka (button) folded before Flop (didn't bet)
Seat 3: raduarte10 (small blind) folded on the River
Seat 4: rjmnhs (big blind) collected ($0.12)
Seat 5: bichito72 folded before Flop (didn't bet)
Seat 6: TammyFs folded on the River


PokerStars Hand #238160322918:  Hold'em No Limit ($0.01/$0.02 USD) - 2022/08/22 22:33:17 ET
Table 'Achilles IV' 6-max Seat #3 is the button
Seat 1: Ramirres ($3.77 in chips)
Seat 2: MojaMamka ($1.79 in chips)
Seat 3: raduarte10 ($1.46 in chips)
Seat 4: rjmnhs ($1.40 in chips)
Seat 5: bichito72 ($2.18 in chips)
Seat 6: TammyFs ($0.12 in chips)
rjmnhs: posts small blind $0.01
bichito72: posts big blind $0.02
*** HOLE CARDS ***
TammyFs: folds
Ramirres: folds
MojaMamka: folds
raduarte10: folds
rjmnhs: folds
Uncalled bet ($0.01) returned to bichito72
bichito72 collected $0.02 from pot
bichito72: doesn't show hand
*** SUMMARY ***
Total pot $0.02 | Rake $0
Seat 1: Ramirres folded before Flop (didn't bet)
Seat 2: MojaMamka folded before Flop (didn't bet)
Seat 3: raduarte10 (button) folded before Flop (didn't bet)
Seat 4: rjmnhs (small blind) folded before Flop
Seat 5: bichito72 (big blind) collected ($0.02)
Seat 6: TammyFs folded before Flop (didn't bet)


PokerStars Hand #238160324896:  Hold'em No Limit ($0.01/$0.02 USD) - 2022/08/22 22:33:28 ET
Table 'Achilles IV' 6-max Seat #4 is the button
Seat 1: Ramirres ($3.77 in chips)
Seat 2: MojaMamka ($1.79 in chips)
Seat 3: raduarte10 ($1.46 in chips)
Seat 4: rjmnhs ($1.39 in chips)
Seat 5: bichito72 ($2.19 in chips)
Seat 6: TammyFs ($0.12 in chips)
bichito72: posts small blind $0.01
TammyFs: posts big blind $0.02
*** HOLE CARDS ***
Ramirres: folds
MojaMamka: calls $0.02
raduarte10 has timed out
raduarte10: folds
rjmnhs: folds
raduarte10 is disconnected
bichito72: raises $0.10 to $0.12
TammyFs: folds
MojaMamka: calls $0.10
*** FLOP *** [7h Js 6h]
bichito72: bets $0.18
MojaMamka: folds
Uncalled bet ($0.18) returned to bichito72
bichito72 collected $0.25 from pot
bichito72: doesn't show hand
*** SUMMARY ***
Total pot $0.26 | Rake $0.01
Board [7h Js 6h]
Seat 1: Ramirres folded before Flop (didn't bet)
Seat 2: MojaMamka folded on the Flop
Seat 3: raduarte10 folded before Flop (didn't bet)
Seat 4: rjmnhs (button) folded before Flop (didn't bet)
Seat 5: bichito72 (small blind) collected ($0.25)
Seat 6: TammyFs (big blind) folded before Flop


PokerStars Hand #238160342911:  Hold'em No Limit ($0.01/$0.02 USD) - 2022/08/22 22:34:38 ET
Table 'Achilles IV' 6-max Seat #5 is the button
Seat 2: MojaMamka ($1.67 in chips)
Seat 4: rjmnhs ($1.39 in chips)
Seat 5: bichito72 ($2.32 in chips)
Seat 6: TammyFs ($0.10 in chips)
TammyFs: posts small blind $0.01
MojaMamka: posts big blind $0.02
*** HOLE CARDS ***
rjmnhs: folds
bichito72: folds
TammyFs: calls $0.01
MojaMamka: checks
*** FLOP *** [3c 5h 9s]
TammyFs: checks
MojaMamka: checks
*** TURN *** [3c 5h 9s] [Ts]
TammyFs: bets $0.04
MojaMamka: calls $0.04
*** RIVER *** [3c 5h 9s Ts] [8s]
TammyFs: bets $0.04 and is all-in
MojaMamka: folds
Uncalled bet ($0.04) returned to TammyFs
TammyFs collected $0.12 from pot
*** SUMMARY ***
Total pot $0.12 | Rake $0
Board [3c 5h 9s Ts 8s]
Seat 2: MojaMamka (big blind) folded on the River
Seat 4: rjmnhs folded before Flop (didn't bet)
Seat 5: bichito72 (button) folded before Flop (didn't bet)
Seat 6: TammyFs (small blind) collected ($0.12)


PokerStars Hand #238160350559:  Hold'em No Limit ($0.01/$0.02 USD) - 2022/08/22 22:35:21 ET
Table 'Achilles IV' 6-max Seat #6 is the button
Seat 2: MojaMamka ($1.61 in chips)
Seat 4: rjmnhs ($1.39 in chips)
Seat 5: bichito72 ($2.32 in chips)
Seat 6: TammyFs ($0.16 in chips)
MojaMamka: posts small blind $0.01
rjmnhs: posts big blind $0.02
*** HOLE CARDS ***
bichito72: folds
TammyFs: calls $0.02
MojaMamka: calls $0.01
rjmnhs: checks
*** FLOP *** [6h 6c 2h]
MojaMamka: checks
rjmnhs: checks
TammyFs: checks
*** TURN *** [6h 6c 2h] [4s]
MojaMamka: checks
rjmnhs: checks
TammyFs: checks
*** RIVER *** [6h 6c 2h 4s] [7c]
MojaMamka: checks
rjmnhs: checks
TammyFs: checks
*** SHOW DOWN ***
MojaMamka: shows [Js Ks] (a pair of Sixes)
rjmnhs: shows [5s 4h] (two pair, Sixes and Fours)
TammyFs: mucks hand
rjmnhs collected $0.06 from pot
*** SUMMARY ***
Total pot $0.06 | Rake $0
Board [6h 6c 2h 4s 7c]
Seat 2: MojaMamka (small blind) showed [Js Ks] and lost with a pair of Sixes
Seat 4: rjmnhs (big blind) showed [5s 4h] and won ($0.06) with two pair, Sixes and Fours
Seat 5: bichito72 folded before Flop (didn't bet)
Seat 6: TammyFs (button) mucked


PokerStars Hand #238160357131:  Hold'em No Limit ($0.01/$0.02 USD) - 2022/08/22 22:35:57 ET
Table 'Achilles IV' 6-max Seat #2 is the button
Seat 2: MojaMamka ($1.59 in chips)
Seat 4: rjmnhs ($1.43 in chips)
Seat 5: bichito72 ($2.32 in chips)
Seat 6: TammyFs ($0.14 in chips)
rjmnhs: posts small blind $0.01
bichito72: posts big blind $0.02
*** HOLE CARDS ***
TammyFs: folds
MojaMamka: folds
rjmnhs: folds
Uncalled bet ($0.01) returned to bichito72
bichito72 collected $0.02 from pot
bichito72: doesn't show hand
*** SUMMARY ***
Total pot $0.02 | Rake $0
Seat 2: MojaMamka (button) folded before Flop (didn't bet)
Seat 4: rjmnhs (small blind) folded before Flop
Seat 5: bichito72 (big blind) collected ($0.02)
Seat 6: TammyFs folded before Flop (didn't bet)


PokerStars Hand #238160359004:  Hold'em No Limit ($0.01/$0.02 USD) - 2022/08/22 22:36:08 ET
Table 'Achilles IV' 6-max Seat #4 is the button
Seat 2: MojaMamka ($1.59 in chips)
Seat 3: raduarte10 ($1.46 in chips)
Seat 4: rjmnhs ($1.42 in chips)
Seat 5: bichito72 ($2.33 in chips)
Seat 6: TammyFs ($0.14 in chips)
bichito72: posts small blind $0.01
TammyFs: posts big blind $0.02
raduarte10: posts small & big blinds $0.03
*** HOLE CARDS ***
MojaMamka: calls $0.02
raduarte10: checks
rjmnhs: folds
bichito72: folds
TammyFs: checks
*** FLOP *** [Ks Th As]
TammyFs: checks
MojaMamka: bets $0.04
raduarte10: raises $0.04 to $0.08
TammyFs: folds
MojaMamka: calls $0.04
*** TURN *** [Ks Th As] [2s]
MojaMamka: checks
raduarte10: bets $0.06
MojaMamka: calls $0.06
*** RIVER *** [Ks Th As 2s] [Td]
MojaMamka: checks
raduarte10: bets $0.08
MojaMamka: calls $0.08
*** SHOW DOWN ***
raduarte10: shows [Qc Jd] (a straight, Ten to Ace)
MojaMamka: mucks hand
raduarte10 collected $0.50 from pot
*** SUMMARY ***
Total pot $0.52 | Rake $0.02
Board [Ks Th As 2s Td]
Seat 2: MojaMamka mucked
Seat 3: raduarte10 showed [Qc Jd] and won ($0.50) with a straight, Ten to Ace
Seat 4: rjmnhs (button) folded before Flop (didn't bet)
Seat 5: bichito72 (small blind) folded before Flop
Seat 6: TammyFs (big blind) folded on the Flop


PokerStars Hand #238160366031:  Hold'em No Limit ($0.01/$0.02 USD) - 2022/08/22 22:36:48 ET
Table 'Achilles IV' 6-max Seat #5 is the button
Seat 1: Ramirres ($3.77 in chips)
Seat 2: MojaMamka ($1.35 in chips)
Seat 3: raduarte10 ($1.71 in chips)
Seat 4: rjmnhs ($1.42 in chips)
Seat 5: bichito72 ($2.32 in chips)
Seat 6: TammyFs ($0.12 in chips)
TammyFs: posts small blind $0.01
Ramirres: posts big blind $0.02
*** HOLE CARDS ***
MojaMamka: folds
MojaMamka leaves the table
raduarte10: raises $0.04 to $0.06
rjmnhs: folds
bichito72: folds
TammyFs: calls $0.05
Ramirres: folds
*** FLOP *** [Kc 8c Ad]
TammyFs: checks
raduarte10: bets $0.06
TammyFs: folds
Uncalled bet ($0.06) returned to raduarte10
raduarte10 collected $0.14 from pot
*** SUMMARY ***
Total pot $0.14 | Rake $0
Board [Kc 8c Ad]
Seat 1: Ramirres (big blind) folded before Flop
Seat 2: MojaMamka folded before Flop (didn't bet)
Seat 3: raduarte10 collected ($0.14)
Seat 4: rjmnhs folded before Flop (didn't bet)
Seat 5: bichito72 (button) folded before Flop (didn't bet)
Seat 6: TammyFs (small blind) folded on the Flop


PokerStars Hand #238160371387:  Hold'em No Limit ($0.01/$0.02 USD) - 2022/08/22 22:37:18 ET
Table 'Achilles IV' 6-max Seat #6 is the button
Seat 1: Ramirres ($3.75 in chips)
Seat 3: raduarte10 ($1.79 in chips)
Seat 4: rjmnhs ($1.42 in chips)
Seat 5: bichito72 ($2.32 in chips)
Seat 6: TammyFs ($0.06 in chips)
Ramirres: posts small blind $0.01
raduarte10: posts big blind $0.02
*** HOLE CARDS ***
rjmnhs: folds
bichito72: raises $0.04 to $0.06
rjmnhs leaves the table
TammyFs: calls $0.06 and is all-in
Ramirres: folds
raduarte10: folds
*** FLOP *** [8h 9d 4d]
*** TURN *** [8h 9d 4d] [8s]
*** RIVER *** [8h 9d 4d 8s] [6c]
*** SHOW DOWN ***
bichito72: shows [Kc Ks] (two pair, Kings and Eights)
TammyFs: shows [9s Qs] (two pair, Nines and Eights)
bichito72 cashed out the hand for $0.12
*** SUMMARY ***
Total pot $0.15 | Rake $0.01
Board [8h 9d 4d 8s 6c]
Seat 1: Ramirres (small blind) folded before Flop
Seat 3: raduarte10 (big blind) folded before Flop
Seat 4: rjmnhs folded before Flop (didn't bet)
Seat 5: bichito72 showed [Kc Ks] and won ($0.14) with two pair, Kings and Eights (pot not awarded as player cashed out)
Seat 6: TammyFs (button) showed [9s Qs] and lost with two pair, Nines and Eights


PokerStars Hand #238160375666:  Hold'em No Limit ($0.01/$0.02 USD) - 2022/08/22 22:37:43 ET
Table 'Achilles IV' 6-max Seat #1 is the button
Seat 1: Ramirres ($3.74 in chips)
Seat 3: raduarte10 ($1.77 in chips)
Seat 5: bichito72 ($2.38 in chips)
raduarte10: posts small blind $0.01
bichito72: posts big blind $0.02
*** HOLE CARDS ***
Ramirres: folds
raduarte10: calls $0.01
bichito72: checks
*** FLOP *** [4d 3s 7s]
raduarte10: checks
TammyFs leaves the table
bichito72: bets $0.02
raduarte10: folds
Uncalled bet ($0.02) returned to bichito72
bichito72 collected $0.04 from pot
bichito72: doesn't show hand
*** SUMMARY ***
Total pot $0.04 | Rake $0
Board [4d 3s 7s]
Seat 1: Ramirres (button) folded before Flop (didn't bet)
Seat 3: raduarte10 (small blind) folded on the Flop
Seat 5: bichito72 (big blind) collected ($0.04)


PokerStars Hand #238160379061:  Hold'em No Limit ($0.01/$0.02 USD) - 2022/08/22 22:38:02 ET
Table 'Achilles IV' 6-max Seat #3 is the button
Seat 1: Ramirres ($3.74 in chips)
Seat 3: raduarte10 ($1.75 in chips)
Seat 5: bichito72 ($2.40 in chips)
bichito72: posts small blind $0.01
Ramirres: posts big blind $0.02
*** HOLE CARDS ***
raduarte10: folds
bichito72: folds
Uncalled bet ($0.01) returned to Ramirres
Ramirres collected $0.02 from pot
*** SUMMARY ***
Total pot $0.02 | Rake $0
Seat 1: Ramirres (big blind) collected ($0.02)
Seat 3: raduarte10 (button) folded before Flop (didn't bet)
Seat 5: bichito72 (small blind) folded before Flop


PokerStars Hand #238160448010:  Hold'em No Limit ($0.01/$0.02 USD) - 2022/08/22 22:44:45 ET
Table 'Achilles IV' 6-max Seat #1 is the button
Seat 1: Ramirres ($3.75 in chips)
Seat 2: Lazypandas420 ($1.63 in chips)
Seat 3: padel73 ($1.60 in chips)
Lazypandas420: posts small blind $0.01
padel73: posts big blind $0.02
kcarrion30: sits out
*** HOLE CARDS ***
Roogrid joins the table at seat #5
Ramirres: folds
Lazypandas420: raises $0.02 to $0.04
NikoRamos14 joins the table at seat #6
padel73: calls $0.02
*** FLOP *** [Ad 3d 2h]
Lazypandas420: checks
padel73: bets $0.02
Lazypandas420: calls $0.02
*** TURN *** [Ad 3d 2h] [Ks]
Lazypandas420: bets $0.04
padel73: folds
Uncalled bet ($0.04) returned to Lazypandas420
Lazypandas420 collected $0.12 from pot
*** SUMMARY ***
Total pot $0.12 | Rake $0
Board [Ad 3d 2h Ks]
Seat 1: Ramirres (button) folded before Flop (didn't bet)
Seat 2: Lazypandas420 (small blind) collected ($0.12)
Seat 3: padel73 (big blind) folded on the Turn


PokerStars Hand #238160452910:  Hold'em No Limit ($0.01/$0.02 USD) - 2022/08/22 22:45:14 ET
Table 'Achilles IV' 6-max Seat #2 is the button
Seat 1: Ramirres ($3.75 in chips)
Seat 2: Lazypandas420 ($1.69 in chips)
Seat 3: padel73 ($1.54 in chips)
Seat 4: kcarrion30 ($2 in chips)
padel73: posts small blind $0.01
kcarrion30: posts big blind $0.02
Roogrid: sits out
NikoRamos14: sits out
*** HOLE CARDS ***
Ramirres: raises $0.03 to $0.05
Lazypandas420: raises $0.03 to $0.08
padel73: folds
kcarrion30: folds
Ramirres: calls $0.03
*** FLOP *** [Ac 6c 4c]
Ramirres: checks
Lazypandas420: checks
*** TURN *** [Ac 6c 4c] [2d]
Ramirres: checks
Lazypandas420: checks
*** RIVER *** [Ac 6c 4c 2d] [Jc]
Ramirres: checks
Lazypandas420: checks
*** SHOW DOWN ***
Ramirres: shows [As 5s] (a pair of Aces)
Lazypandas420: mucks hand
Ramirres collected $0.18 from pot
*** SUMMARY ***
Total pot $0.19 | Rake $0.01
Board [Ac 6c 4c 2d Jc]
Seat 1: Ramirres showed [As 5s] and won ($0.18) with a pair of Aces
Seat 2: Lazypandas420 (button) mucked
Seat 3: padel73 (small blind) folded before Flop
Seat 4: kcarrion30 (big blind) folded before Flop


PokerStars Hand #238160458217:  Hold'em No Limit ($0.01/$0.02 USD) - 2022/08/22 22:45:45 ET
Table 'Achilles IV' 6-max Seat #3 is the button
Seat 1: Ramirres ($3.85 in chips)
Seat 2: Lazypandas420 ($1.61 in chips)
Seat 3: padel73 ($1.53 in chips)
Seat 4: kcarrion30 ($1.98 in chips)
Seat 5: Roogrid ($0.80 in chips)
kcarrion30: posts small blind $0.01
Roogrid: posts big blind $0.02
NikoRamos14: sits out
*** HOLE CARDS ***
Ramirres: raises $0.04 to $0.06
Lazypandas420: raises $0.04 to $0.10
padel73: folds
kcarrion30: folds
Roogrid: folds
Ramirres: calls $0.04
*** FLOP *** [9s 7c 3s]
Ramirres: checks
Lazypandas420: checks
*** TURN *** [9s 7c 3s] [2d]
Ramirres: checks
Lazypandas420: checks
*** RIVER *** [9s 7c 3s 2d] [9c]
Ramirres: checks
Lazypandas420: bets $0.06
Ramirres: folds
Uncalled bet ($0.06) returned to Lazypandas420
Lazypandas420 collected $0.22 from pot
*** SUMMARY ***
Total pot $0.23 | Rake $0.01
Board [9s 7c 3s 2d 9c]
Seat 1: Ramirres folded on the River
Seat 2: Lazypandas420 collected ($0.22)
Seat 3: padel73 (button) folded before Flop (didn't bet)
Seat 4: kcarrion30 (small blind) folded before Flop
Seat 5: Roogrid (big blind) folded before Flop


PokerStars Hand #238160465867:  Hold'em No Limit ($0.01/$0.02 USD) - 2022/08/22 22:46:31 ET
Table 'Achilles IV' 6-max Seat #4 is the button
Seat 1: Ramirres ($3.75 in chips)
Seat 2: Lazypandas420 ($1.73 in chips)
Seat 3: padel73 ($1.53 in chips)
Seat 4: kcarrion30 ($1.97 in chips)
Seat 5: Roogrid ($0.78 in chips)
Seat 6: NikoRamos14 ($2 in chips)
Roogrid: posts small blind $0.01
NikoRamos14: posts big blind $0.02
*** HOLE CARDS ***
Ramirres: raises $0.04 to $0.06
Lazypandas420: folds
padel73: calls $0.06
kcarrion30: folds
Roogrid: folds
NikoRamos14: folds
*** FLOP *** [7c 8h 5s]
Ramirres: bets $0.09
padel73: calls $0.09
*** TURN *** [7c 8h 5s] [6h]
Ramirres: bets $0.26
padel73: folds
Uncalled bet ($0.26) returned to Ramirres
Ramirres collected $0.32 from pot
*** SUMMARY ***
Total pot $0.33 | Rake $0.01
Board [7c 8h 5s 6h]
Seat 1: Ramirres collected ($0.32)
Seat 2: Lazypandas420 folded before Flop (didn't bet)
Seat 3: padel73 folded on the Turn
Seat 4: kcarrion30 (button) folded before Flop (didn't bet)
Seat 5: Roogrid (small blind) folded before Flop
Seat 6: NikoRamos14 (big blind) folded before Flop


PokerStars Hand #238160478279:  Hold'em No Limit ($0.01/$0.02 USD) - 2022/08/22 22:47:32 ET
Table 'Achilles IV' 6-max Seat #5 is the button
Seat 1: Ramirres ($3.92 in chips)
Seat 2: Lazypandas420 ($1.73 in chips)
Seat 3: padel73 ($1.38 in chips)
Seat 4: kcarrion30 ($1.97 in chips)
Seat 5: Roogrid ($0.77 in chips)
Seat 6: NikoRamos14 ($1.98 in chips)
NikoRamos14: posts small blind $0.01
Ramirres: posts big blind $0.02
*** HOLE CARDS ***
Lazypandas420: folds
padel73: folds
kcarrion30: folds
Roogrid: raises $0.02 to $0.04
NikoRamos14: calls $0.03
Ramirres: folds
*** FLOP *** [7s 2c 4d]
NikoRamos14: checks
Roogrid: checks
*** TURN *** [7s 2c 4d] [Jd]
NikoRamos14: checks
Roogrid: checks
*** RIVER *** [7s 2c 4d Jd] [4c]
NikoRamos14: bets $0.10
Roogrid: folds
Uncalled bet ($0.10) returned to NikoRamos14
NikoRamos14 collected $0.10 from pot
*** SUMMARY ***
Total pot $0.10 | Rake $0
Board [7s 2c 4d Jd 4c]
Seat 1: Ramirres (big blind) folded before Flop
Seat 2: Lazypandas420 folded before Flop (didn't bet)
Seat 3: padel73 folded before Flop (didn't bet)
Seat 4: kcarrion30 folded before Flop (didn't bet)
Seat 5: Roogrid (button) folded on the River
Seat 6: NikoRamos14 (small blind) collected ($0.10)


PokerStars Hand #238160485268:  Hold'em No Limit ($0.01/$0.02 USD) - 2022/08/22 22:48:14 ET
Table 'Achilles IV' 6-max Seat #6 is the button
Seat 1: Ramirres ($3.90 in chips)
Seat 2: Lazypandas420 ($1.73 in chips)
Seat 3: padel73 ($1.38 in chips)
Seat 4: kcarrion30 ($1.97 in chips)
Seat 5: Roogrid ($0.73 in chips)
Seat 6: NikoRamos14 ($2.04 in chips)
Ramirres: posts small blind $0.01
Lazypandas420: posts big blind $0.02
*** HOLE CARDS ***
padel73: folds
kcarrion30: folds
Roogrid: folds
NikoRamos14: calls $0.02
Ramirres: folds
Lazypandas420: raises $0.04 to $0.06
NikoRamos14: calls $0.04
*** FLOP *** [Tc 7d 6s]
Lazypandas420: checks
NikoRamos14: bets $0.06
Lazypandas420: calls $0.06
*** TURN *** [Tc 7d 6s] [Jd]
Lazypandas420: checks
NikoRamos14: bets $0.12
Lazypandas420: folds
Uncalled bet ($0.12) returned to NikoRamos14
NikoRamos14 collected $0.24 from pot
*** SUMMARY ***
Total pot $0.25 | Rake $0.01
Board [Tc 7d 6s Jd]
Seat 1: Ramirres (small blind) folded before Flop
Seat 2: Lazypandas420 (big blind) folded on the Turn
Seat 3: padel73 folded before Flop (didn't bet)
Seat 4: kcarrion30 folded before Flop (didn't bet)
Seat 5: Roogrid folded before Flop (didn't bet)
Seat 6: NikoRamos14 (button) collected ($0.24)


PokerStars Hand #238160494232:  Hold'em No Limit ($0.01/$0.02 USD) - 2022/08/22 22:49:07 ET
Table 'Achilles IV' 6-max Seat #1 is the button
Seat 1: Ramirres ($3.89 in chips)
Seat 2: Lazypandas420 ($1.61 in chips)
Seat 3: padel73 ($1.38 in chips)
Seat 4: kcarrion30 ($1.97 in chips)
Seat 5: Roogrid ($0.73 in chips)
Seat 6: NikoRamos14 ($2.16 in chips)
Lazypandas420: posts small blind $0.01
padel73: posts big blind $0.02
*** HOLE CARDS ***
kcarrion30: folds
Roogrid: raises $0.02 to $0.04
NikoRamos14: calls $0.04
Ramirres: calls $0.04
Lazypandas420: folds
padel73: calls $0.02
*** FLOP *** [9d As Kh]
padel73: checks
Roogrid: checks
NikoRamos14: checks
Ramirres: checks
*** TURN *** [9d As Kh] [6c]
padel73: checks
Roogrid: checks
NikoRamos14: checks
Ramirres: checks
*** RIVER *** [9d As Kh 6c] [7h]
padel73: bets $0.06
Roogrid: raises $0.06 to $0.12
NikoRamos14: folds
Ramirres: folds
padel73: folds
Uncalled bet ($0.06) returned to Roogrid
Roogrid collected $0.28 from pot
Roogrid: doesn't show hand
*** SUMMARY ***
Total pot $0.29 | Rake $0.01
Board [9d As Kh 6c 7h]
Seat 1: Ramirres (button) folded on the River
Seat 2: Lazypandas420 (small blind) folded before Flop
Seat 3: padel73 (big blind) folded on the River
Seat 4: kcarrion30 folded before Flop (didn't bet)
Seat 5: Roogrid collected ($0.28)
Seat 6: NikoRamos14 folded on the River


PokerStars Hand #238160504207:  Hold'em No Limit ($0.01/$0.02 USD) - 2022/08/22 22:50:06 ET
Table 'Achilles IV' 6-max Seat #2 is the button
Seat 1: Ramirres ($3.85 in chips)
Seat 2: Lazypandas420 ($1.60 in chips)
Seat 3: padel73 ($1.28 in chips)
Seat 4: kcarrion30 ($1.97 in chips)
Seat 5: Roogrid ($0.91 in chips)
Seat 6: NikoRamos14 ($2.12 in chips)
padel73: posts small blind $0.01
kcarrion30: posts big blind $0.02
*** HOLE CARDS ***
Roogrid: folds
NikoRamos14: calls $0.02
Ramirres: folds
Lazypandas420: raises $0.02 to $0.04
padel73: folds
kcarrion30: calls $0.02
NikoRamos14: calls $0.02
*** FLOP *** [2s Jh 7d]
kcarrion30: checks
NikoRamos14: checks
Lazypandas420: bets $0.06
kcarrion30: folds
NikoRamos14: folds
Uncalled bet ($0.06) returned to Lazypandas420
Lazypandas420 collected $0.13 from pot
*** SUMMARY ***
Total pot $0.13 | Rake $0
Board [2s Jh 7d]
Seat 1: Ramirres folded before Flop (didn't bet)
Seat 2: Lazypandas420 (button) collected ($0.13)
Seat 3: padel73 (small blind) folded before Flop
Seat 4: kcarrion30 (big blind) folded on the Flop
Seat 5: Roogrid folded before Flop (didn't bet)
Seat 6: NikoRamos14 folded on the Flop


PokerStars Hand #238160513760:  Hold'em No Limit ($0.01/$0.02 USD) - 2022/08/22 22:50:56 ET
Table 'Achilles IV' 6-max Seat #3 is the button
Seat 1: Ramirres ($3.85 in chips)
Seat 2: Lazypandas420 ($1.69 in chips)
Seat 3: padel73 ($1.27 in chips)
Seat 4: kcarrion30 ($1.93 in chips)
Seat 5: Roogrid ($0.91 in chips)
Seat 6: NikoRamos14 ($2.08 in chips)
kcarrion30: posts small blind $0.01
Roogrid: posts big blind $0.02
*** HOLE CARDS ***
NikoRamos14: calls $0.02
Ramirres: folds
Lazypandas420: raises $0.04 to $0.06
padel73: folds
padel73 leaves the table
kcarrion30: calls $0.05
Roogrid: calls $0.04
NikoRamos14: calls $0.04
*** FLOP *** [5c 9h 5s]
Christianzt1 joins the table at seat #3
kcarrion30: checks
Roogrid: checks
NikoRamos14: checks
Lazypandas420: checks
*** TURN *** [5c 9h 5s] [3h]
kcarrion30: checks
Roogrid: checks
NikoRamos14: bets $0.09
Lazypandas420: calls $0.09
kcarrion30: folds
Roogrid: calls $0.09
*** RIVER *** [5c 9h 5s 3h] [3d]
Roogrid: bets $0.02
NikoRamos14: folds
Lazypandas420: calls $0.02
*** SHOW DOWN ***
Roogrid: shows [7d 7c] (two pair, Sevens and Fives)
Lazypandas420: mucks hand
Roogrid collected $0.53 from pot
*** SUMMARY ***
Total pot $0.55 | Rake $0.02
Board [5c 9h 5s 3h 3d]
Seat 1: Ramirres folded before Flop (didn't bet)
Seat 2: Lazypandas420 mucked
Seat 3: padel73 (button) folded before Flop (didn't bet)
Seat 4: kcarrion30 (small blind) folded on the Turn
Seat 5: Roogrid (big blind) showed [7d 7c] and won ($0.53) with two pair, Sevens and Fives
Seat 6: NikoRamos14 folded on the River


PokerStars Hand #238160530589:  Hold'em No Limit ($0.01/$0.02 USD) - 2022/08/22 22:52:25 ET
Table 'Achilles IV' 6-max Seat #4 is the button
Seat 1: Ramirres ($3.85 in chips)
Seat 2: Lazypandas420 ($1.52 in chips)
Seat 4: kcarrion30 ($1.87 in chips)
Seat 5: Roogrid ($1.27 in chips)
Seat 6: NikoRamos14 ($1.93 in chips)
Roogrid: posts small blind $0.01
NikoRamos14: posts big blind $0.02
Christianzt1: sits out
*** HOLE CARDS ***
Ramirres: folds
Lazypandas420: raises $0.04 to $0.06
kcarrion30: folds
Roogrid: folds
NikoRamos14: calls $0.04
*** FLOP *** [2h Ks Jc]
NikoRamos14: checks
Lazypandas420: bets $0.04
NikoRamos14: calls $0.04
*** TURN *** [2h Ks Jc] [Ac]
NikoRamos14: checks
Lazypandas420: bets $0.10
NikoRamos14: calls $0.10
*** RIVER *** [2h Ks Jc Ac] [Kh]
NikoRamos14: checks
Lazypandas420: bets $0.10
NikoRamos14: raises $0.30 to $0.40
Lazypandas420: calls $0.30
*** SHOW DOWN ***
NikoRamos14: shows [Qs 4d] (a pair of Kings)
Lazypandas420: shows [9s As] (two pair, Aces and Kings)
Lazypandas420 collected $1.17 from pot
*** SUMMARY ***
Total pot $1.21 | Rake $0.04
Board [2h Ks Jc Ac Kh]
Seat 1: Ramirres folded before Flop (didn't bet)
Seat 2: Lazypandas420 showed [9s As] and won ($1.17) with two pair, Aces and Kings
Seat 4: kcarrion30 (button) folded before Flop (didn't bet)
Seat 5: Roogrid (small blind) folded before Flop
Seat 6: NikoRamos14 (big blind) showed [Qs 4d] and lost with a pair of Kings


PokerStars Hand #238160543425:  Hold'em No Limit ($0.01/$0.02 USD) - 2022/08/22 22:53:43 ET
Table 'Achilles IV' 6-max Seat #5 is the button
Seat 1: Ramirres ($3.85 in chips)
Seat 2: Lazypandas420 ($2.09 in chips)
Seat 4: kcarrion30 ($1.87 in chips)
Seat 5: Roogrid ($1.26 in chips)
Seat 6: NikoRamos14 ($1.33 in chips)
NikoRamos14: posts small blind $0.01
Ramirres: posts big blind $0.02
Christianzt1: sits out
*** HOLE CARDS ***
Lazypandas420: folds
kcarrion30: folds
Roogrid: folds
NikoRamos14: calls $0.01
Ramirres: raises $0.04 to $0.06
NikoRamos14: calls $0.04
*** FLOP *** [9s 6s 9d]
NikoRamos14: checks
Ramirres: bets $0.08
NikoRamos14: folds
Uncalled bet ($0.08) returned to Ramirres
Ramirres collected $0.12 from pot
*** SUMMARY ***
Total pot $0.12 | Rake $0
Board [9s 6s 9d]
Seat 1: Ramirres (big blind) collected ($0.12)
Seat 2: Lazypandas420 folded before Flop (didn't bet)
Seat 4: kcarrion30 folded before Flop (didn't bet)
Seat 5: Roogrid (button) folded before Flop (didn't bet)
Seat 6: NikoRamos14 (small blind) folded on the Flop


PokerStars Hand #238160548950:  Hold'em No Limit ($0.01/$0.02 USD) - 2022/08/22 22:54:16 ET
Table 'Achilles IV' 6-max Seat #6 is the button
Seat 1: Ramirres ($3.91 in chips)
Seat 2: Lazypandas420 ($2.09 in chips)
Seat 4: kcarrion30 ($1.87 in chips)
Seat 5: Roogrid ($1.26 in chips)
Seat 6: NikoRamos14 ($1.27 in chips)
Ramirres: posts small blind $0.01
Lazypandas420: posts big blind $0.02
Christianzt1: sits out
*** HOLE CARDS ***
kcarrion30: folds
Roogrid: raises $0.02 to $0.04
NikoRamos14: folds
Ramirres: folds
Lazypandas420: raises $0.12 to $0.16
Roogrid: folds
Uncalled bet ($0.12) returned to Lazypandas420
Lazypandas420 collected $0.09 from pot
*** SUMMARY ***
Total pot $0.09 | Rake $0
Seat 1: Ramirres (small blind) folded before Flop
Seat 2: Lazypandas420 (big blind) collected ($0.09)
Seat 4: kcarrion30 folded before Flop (didn't bet)
Seat 5: Roogrid folded before Flop
Seat 6: NikoRamos14 (button) folded before Flop (didn't bet)


PokerStars Hand #238160552271:  Hold'em No Limit ($0.01/$0.02 USD) - 2022/08/22 22:54:36 ET
Table 'Achilles IV' 6-max Seat #1 is the button
Seat 1: Ramirres ($3.90 in chips)
Seat 2: Lazypandas420 ($2.14 in chips)
Seat 3: Christianzt1 ($2 in chips)
Seat 4: kcarrion30 ($1.87 in chips)
Seat 5: Roogrid ($1.22 in chips)
Seat 6: NikoRamos14 ($1.27 in chips)
Lazypandas420: posts small blind $0.01
Christianzt1: posts big blind $0.02
*** HOLE CARDS ***
kcarrion30: raises $0.04 to $0.06
Roogrid: folds
NikoRamos14: calls $0.06
Ramirres: folds
Lazypandas420: folds
Christianzt1: calls $0.04
*** FLOP *** [Kd Kc Qs]
Christianzt1: checks
kcarrion30: bets $0.08
NikoRamos14: calls $0.08
Christianzt1: folds
*** TURN *** [Kd Kc Qs] [4c]
kcarrion30: checks
NikoRamos14: checks
*** RIVER *** [Kd Kc Qs 4c] [9s]
kcarrion30: checks
NikoRamos14: bets $0.34
kcarrion30: folds
Uncalled bet ($0.34) returned to NikoRamos14
NikoRamos14 collected $0.34 from pot
NikoRamos14: doesn't show hand
*** SUMMARY ***
Total pot $0.35 | Rake $0.01
Board [Kd Kc Qs 4c 9s]
Seat 1: Ramirres (button) folded before Flop (didn't bet)
Seat 2: Lazypandas420 (small blind) folded before Flop
Seat 3: Christianzt1 (big blind) folded on the Flop
Seat 4: kcarrion30 folded on the River
Seat 5: Roogrid folded before Flop (didn't bet)
Seat 6: NikoRamos14 collected ($0.34)


PokerStars Hand #238160570856:  Hold'em No Limit ($0.01/$0.02 USD) - 2022/08/22 22:55:50 ET
Table 'Achilles IV' 6-max Seat #2 is the button
Seat 1: Ramirres ($3.90 in chips)
Seat 2: Lazypandas420 ($2.13 in chips)
Seat 3: Christianzt1 ($2 in chips)
Seat 4: kcarrion30 ($1.73 in chips)
Seat 5: Roogrid ($1.22 in chips)
Seat 6: NikoRamos14 ($1.47 in chips)
Christianzt1: posts small blind $0.01
kcarrion30: posts big blind $0.02
*** HOLE CARDS ***
Roogrid: folds
NikoRamos14: calls $0.02
Ramirres: folds
Lazypandas420: folds
Christianzt1: folds
kcarrion30: raises $0.04 to $0.06
NikoRamos14: calls $0.04
*** FLOP *** [4s 2h 6h]
kcarrion30: checks
NikoRamos14: bets $0.08
kcarrion30: folds
Uncalled bet ($0.08) returned to NikoRamos14
NikoRamos14 collected $0.13 from pot
NikoRamos14: doesn't show hand
*** SUMMARY ***
Total pot $0.13 | Rake $0
Board [4s 2h 6h]
Seat 1: Ramirres folded before Flop (didn't bet)
Seat 2: Lazypandas420 (button) folded before Flop (didn't bet)
Seat 3: Christianzt1 (small blind) folded before Flop
Seat 4: kcarrion30 (big blind) folded on the Flop
Seat 5: Roogrid folded before Flop (didn't bet)
Seat 6: NikoRamos14 collected ($0.13)


PokerStars Hand #238160583146:  Hold'em No Limit ($0.01/$0.02 USD) - 2022/08/22 22:56:29 ET
Table 'Achilles IV' 6-max Seat #3 is the button
Seat 1: Ramirres ($3.90 in chips)
Seat 2: Lazypandas420 ($2.13 in chips)
Seat 3: Christianzt1 ($2 in chips)
Seat 4: kcarrion30 ($1.67 in chips)
Seat 5: Roogrid ($1.22 in chips)
Seat 6: NikoRamos14 ($1.54 in chips)
kcarrion30: posts small blind $0.01
Roogrid: posts big blind $0.02
*** HOLE CARDS ***
NikoRamos14: calls $0.02
Ramirres: folds
Lazypandas420: raises $0.02 to $0.04
Christianzt1: raises $0.14 to $0.18
kcarrion30: folds
Roogrid: folds
NikoRamos14: folds
Lazypandas420: folds
Uncalled bet ($0.14) returned to Christianzt1
Christianzt1 collected $0.13 from pot
Christianzt1: doesn't show hand
*** SUMMARY ***
Total pot $0.13 | Rake $0
Seat 1: Ramirres folded before Flop (didn't bet)
Seat 2: Lazypandas420 folded before Flop
Seat 3: Christianzt1 (button) collected ($0.13)
Seat 4: kcarrion30 (small blind) folded before Flop
Seat 5: Roogrid (big blind) folded before Flop
Seat 6: NikoRamos14 folded before Flop


PokerStars Hand #238160586056:  Hold'em No Limit ($0.01/$0.02 USD) - 2022/08/22 22:56:49 ET
Table 'Achilles IV' 6-max Seat #4 is the button
Seat 1: Ramirres ($3.90 in chips)
Seat 2: Lazypandas420 ($2.09 in chips)
Seat 3: Christianzt1 ($2.09 in chips)
Seat 4: kcarrion30 ($1.66 in chips)
Seat 5: Roogrid ($1.20 in chips)
Seat 6: NikoRamos14 ($1.52 in chips)
Roogrid: posts small blind $0.01
NikoRamos14: posts big blind $0.02
*** HOLE CARDS ***
Ramirres: folds
Lazypandas420: folds
Christianzt1: folds
kcarrion30: folds
Roogrid: folds
Uncalled bet ($0.01) returned to NikoRamos14
NikoRamos14 collected $0.02 from pot
*** SUMMARY ***
Total pot $0.02 | Rake $0
Seat 1: Ramirres folded before Flop (didn't bet)
Seat 2: Lazypandas420 folded before Flop (didn't bet)
Seat 3: Christianzt1 folded before Flop (didn't bet)
Seat 4: kcarrion30 (button) folded before Flop (didn't bet)
Seat 5: Roogrid (small blind) folded before Flop
Seat 6: NikoRamos14 (big blind) collected ($0.02)


PokerStars Hand #238160587230:  Hold'em No Limit ($0.01/$0.02 USD) - 2022/08/22 22:56:57 ET
Table 'Achilles IV' 6-max Seat #5 is the button
Seat 1: Ramirres ($3.90 in chips)
Seat 2: Lazypandas420 ($2.09 in chips)
Seat 3: Christianzt1 ($2.09 in chips)
Seat 4: kcarrion30 ($1.66 in chips)
Seat 5: Roogrid ($1.19 in chips)
Seat 6: NikoRamos14 ($1.53 in chips)
NikoRamos14: posts small blind $0.01
Ramirres: posts big blind $0.02
*** HOLE CARDS ***
Lazypandas420: folds
Christianzt1: folds
kcarrion30: folds
Roogrid: folds
NikoRamos14: folds
Uncalled bet ($0.01) returned to Ramirres
Ramirres collected $0.02 from pot
*** SUMMARY ***
Total pot $0.02 | Rake $0
Seat 1: Ramirres (big blind) collected ($0.02)
Seat 2: Lazypandas420 folded before Flop (didn't bet)
Seat 3: Christianzt1 folded before Flop (didn't bet)
Seat 4: kcarrion30 folded before Flop (didn't bet)
Seat 5: Roogrid (button) folded before Flop (didn't bet)
Seat 6: NikoRamos14 (small blind) folded before Flop


PokerStars Hand #238160588648:  Hold'em No Limit ($0.01/$0.02 USD) - 2022/08/22 22:57:07 ET
Table 'Achilles IV' 6-max Seat #6 is the button
Seat 1: Ramirres ($3.91 in chips)
Seat 2: Lazypandas420 ($2.09 in chips)
Seat 3: Christianzt1 ($2.09 in chips)
Seat 4: kcarrion30 ($1.66 in chips)
Seat 5: Roogrid ($1.19 in chips)
Seat 6: NikoRamos14 ($1.52 in chips)
Ramirres: posts small blind $0.01
Lazypandas420: posts big blind $0.02
*** HOLE CARDS ***
Christianzt1: folds
kcarrion30: raises $0.04 to $0.06
Roogrid: calls $0.06
NikoRamos14: folds
Ramirres: folds
Lazypandas420: folds
*** FLOP *** [5c 2d 4d]
kcarrion30: bets $0.07
Roogrid: calls $0.07
*** TURN *** [5c 2d 4d] [Tc]
kcarrion30: bets $0.24
Roogrid: folds
Uncalled bet ($0.24) returned to kcarrion30
kcarrion30 collected $0.28 from pot
*** SUMMARY ***
Total pot $0.29 | Rake $0.01
Board [5c 2d 4d Tc]
Seat 1: Ramirres (small blind) folded before Flop
Seat 2: Lazypandas420 (big blind) folded before Flop
Seat 3: Christianzt1 folded before Flop (didn't bet)
Seat 4: kcarrion30 collected ($0.28)
Seat 5: Roogrid folded on the Turn
Seat 6: NikoRamos14 (button) folded before Flop (didn't bet)


PokerStars Hand #238160593993:  Hold'em No Limit ($0.01/$0.02 USD) - 2022/08/22 22:57:45 ET
Table 'Achilles IV' 6-max Seat #1 is the button
Seat 1: Ramirres ($3.90 in chips)
Seat 2: Lazypandas420 ($2.07 in chips)
Seat 3: Christianzt1 ($2.09 in chips)
Seat 4: kcarrion30 ($1.81 in chips)
Seat 5: Roogrid ($1.06 in chips)
Seat 6: NikoRamos14 ($1.52 in chips)
Lazypandas420: posts small blind $0.01
Christianzt1: posts big blind $0.02
*** HOLE CARDS ***
kcarrion30: folds
Roogrid: folds
NikoRamos14: calls $0.02
Ramirres: raises $0.04 to $0.06
Lazypandas420: folds
Christianzt1: folds
NikoRamos14: calls $0.04
*** FLOP *** [Th 8c 8d]
NikoRamos14: checks
Ramirres: bets $0.09
NikoRamos14: folds
Uncalled bet ($0.09) returned to Ramirres
Ramirres collected $0.14 from pot
*** SUMMARY ***
Total pot $0.15 | Rake $0.01
Board [Th 8c 8d]
Seat 1: Ramirres (button) collected ($0.14)
Seat 2: Lazypandas420 (small blind) folded before Flop
Seat 3: Christianzt1 (big blind) folded before Flop
Seat 4: kcarrion30 folded before Flop (didn't bet)
Seat 5: Roogrid folded before Flop (didn't bet)
Seat 6: NikoRamos14 folded on the Flop


PokerStars Hand #238160599133:  Hold'em No Limit ($0.01/$0.02 USD) - 2022/08/22 22:58:22 ET
Table 'Achilles IV' 6-max Seat #2 is the button
Seat 1: Ramirres ($3.98 in chips)
Seat 2: Lazypandas420 ($2.06 in chips)
Seat 3: Christianzt1 ($2.07 in chips)
Seat 4: kcarrion30 ($1.81 in chips)
Seat 5: Roogrid ($1.06 in chips)
Seat 6: NikoRamos14 ($1.46 in chips)
Christianzt1: posts small blind $0.01
kcarrion30: posts big blind $0.02
*** HOLE CARDS ***
Roogrid: folds
NikoRamos14: calls $0.02
Ramirres: folds
Lazypandas420: folds
Christianzt1: folds
kcarrion30: raises $0.04 to $0.06
NikoRamos14: calls $0.04
*** FLOP *** [7s 3s Th]
kcarrion30: bets $0.08
NikoRamos14: calls $0.08
*** TURN *** [7s 3s Th] [Ah]
kcarrion30: bets $0.16
NikoRamos14: raises $0.16 to $0.32
kcarrion30: folds
Uncalled bet ($0.16) returned to NikoRamos14
NikoRamos14 collected $0.59 from pot
*** SUMMARY ***
Total pot $0.61 | Rake $0.02
Board [7s 3s Th Ah]
Seat 1: Ramirres folded before Flop (didn't bet)
Seat 2: Lazypandas420 (button) folded before Flop (didn't bet)
Seat 3: Christianzt1 (small blind) folded before Flop
Seat 4: kcarrion30 (big blind) folded on the Turn
Seat 5: Roogrid folded before Flop (didn't bet)
Seat 6: NikoRamos14 collected ($0.59)


PokerStars Hand #238160608011:  Hold'em No Limit ($0.01/$0.02 USD) - 2022/08/22 22:59:27 ET
Table 'Achilles IV' 6-max Seat #3 is the button
Seat 1: Ramirres ($3.98 in chips)
Seat 2: Lazypandas420 ($2.06 in chips)
Seat 3: Christianzt1 ($2.06 in chips)
Seat 4: kcarrion30 ($1.51 in chips)
Seat 5: Roogrid ($1.06 in chips)
Seat 6: NikoRamos14 ($1.75 in chips)
kcarrion30: posts small blind $0.01
Roogrid: posts big blind $0.02
*** HOLE CARDS ***
NikoRamos14: calls $0.02
Ramirres: folds
Lazypandas420: folds
Christianzt1: folds
kcarrion30: folds
Roogrid: raises $0.02 to $0.04
NikoRamos14: calls $0.02
*** FLOP *** [6s 3d Jc]
Roogrid: checks
NikoRamos14: checks
*** TURN *** [6s 3d Jc] [8c]
Roogrid: checks
NikoRamos14: checks
*** RIVER *** [6s 3d Jc 8c] [2c]
Roogrid: bets $0.02
NikoRamos14: folds
Uncalled bet ($0.02) returned to Roogrid
Roogrid collected $0.09 from pot
Roogrid: doesn't show hand
*** SUMMARY ***
Total pot $0.09 | Rake $0
Board [6s 3d Jc 8c 2c]
Seat 1: Ramirres folded before Flop (didn't bet)
Seat 2: Lazypandas420 folded before Flop (didn't bet)
Seat 3: Christianzt1 (button) folded before Flop (didn't bet)
Seat 4: kcarrion30 (small blind) folded before Flop
Seat 5: Roogrid (big blind) collected ($0.09)
Seat 6: NikoRamos14 folded on the River


PokerStars Hand #238160615268:  Hold'em No Limit ($0.01/$0.02 USD) - 2022/08/22 23:00:20 ET
Table 'Achilles IV' 6-max Seat #4 is the button
Seat 1: Ramirres ($3.98 in chips)
Seat 2: Lazypandas420 ($2.06 in chips)
Seat 3: Christianzt1 ($2.06 in chips)
Seat 4: kcarrion30 ($1.50 in chips)
Seat 5: Roogrid ($1.11 in chips)
Seat 6: NikoRamos14 ($1.71 in chips)
Roogrid: posts small blind $0.01
NikoRamos14: posts big blind $0.02
*** HOLE CARDS ***
Ramirres: folds
Lazypandas420: raises $0.02 to $0.04
Christianzt1: folds
kcarrion30: folds
Roogrid: folds
NikoRamos14: calls $0.02
*** FLOP *** [Jh 5d Ts]
NikoRamos14: checks
Lazypandas420: checks
*** TURN *** [Jh 5d Ts] [Qd]
NikoRamos14: bets $0.09
Lazypandas420: calls $0.09
*** RIVER *** [Jh 5d Ts Qd] [4h]
NikoRamos14: bets $0.11
Lazypandas420: folds
Uncalled bet ($0.11) returned to NikoRamos14
NikoRamos14 collected $0.26 from pot
*** SUMMARY ***
Total pot $0.27 | Rake $0.01
Board [Jh 5d Ts Qd 4h]
Seat 1: Ramirres folded before Flop (didn't bet)
Seat 2: Lazypandas420 folded on the River
Seat 3: Christianzt1 folded before Flop (didn't bet)
Seat 4: kcarrion30 (button) folded before Flop (didn't bet)
Seat 5: Roogrid (small blind) folded before Flop
Seat 6: NikoRamos14 (big blind) collected ($0.26)


PokerStars Hand #238160624036:  Hold'em No Limit ($0.01/$0.02 USD) - 2022/08/22 23:01:18 ET
Table 'Achilles IV' 6-max Seat #5 is the button
Seat 1: Ramirres ($3.98 in chips)
Seat 2: Lazypandas420 ($1.93 in chips)
Seat 3: Christianzt1 ($2.06 in chips)
Seat 4: kcarrion30 ($1.50 in chips)
Seat 5: Roogrid ($1.10 in chips)
Seat 6: NikoRamos14 ($1.84 in chips)
NikoRamos14: posts small blind $0.01
Ramirres: posts big blind $0.02
*** HOLE CARDS ***
Lazypandas420: folds
Christianzt1: folds
kcarrion30: folds
Roogrid: folds
NikoRamos14: calls $0.01
Ramirres: checks
*** FLOP *** [Qc 2h Tc]
NikoRamos14: bets $0.04
Ramirres: folds
Uncalled bet ($0.04) returned to NikoRamos14
NikoRamos14 collected $0.04 from pot
*** SUMMARY ***
Total pot $0.04 | Rake $0
Board [Qc 2h Tc]
Seat 1: Ramirres (big blind) folded on the Flop
Seat 2: Lazypandas420 folded before Flop (didn't bet)
Seat 3: Christianzt1 folded before Flop (didn't bet)
Seat 4: kcarrion30 folded before Flop (didn't bet)
Seat 5: Roogrid (button) folded before Flop (didn't bet)
Seat 6: NikoRamos14 (small blind) collected ($0.04)


PokerStars Hand #238160629196:  Hold'em No Limit ($0.01/$0.02 USD) - 2022/08/22 23:01:50 ET
Table 'Achilles IV' 6-max Seat #6 is the button
Seat 1: Ramirres ($3.96 in chips)
Seat 2: Lazypandas420 ($1.93 in chips)
Seat 3: Christianzt1 ($2.06 in chips)
Seat 4: kcarrion30 ($1.50 in chips)
Seat 5: Roogrid ($1.10 in chips)
Seat 6: NikoRamos14 ($1.86 in chips)
Ramirres: posts small blind $0.01
Lazypandas420: posts big blind $0.02
*** HOLE CARDS ***
Christianzt1: folds
kcarrion30: folds
Roogrid: folds
NikoRamos14: calls $0.02
Ramirres: folds
Lazypandas420: checks
*** FLOP *** [8h 8s Qd]
Lazypandas420: checks
NikoRamos14: checks
*** TURN *** [8h 8s Qd] [3s]
Lazypandas420: checks
NikoRamos14: checks
*** RIVER *** [8h 8s Qd 3s] [Ks]
Lazypandas420: checks
NikoRamos14: bets $0.05
Lazypandas420: folds
Uncalled bet ($0.05) returned to NikoRamos14
NikoRamos14 collected $0.05 from pot
NikoRamos14: doesn't show hand
*** SUMMARY ***
Total pot $0.05 | Rake $0
Board [8h 8s Qd 3s Ks]
Seat 1: Ramirres (small blind) folded before Flop
Seat 2: Lazypandas420 (big blind) folded on the River
Seat 3: Christianzt1 folded before Flop (didn't bet)
Seat 4: kcarrion30 folded before Flop (didn't bet)
Seat 5: Roogrid folded before Flop (didn't bet)
Seat 6: NikoRamos14 (button) collected ($0.05)


PokerStars Hand #238160636094:  Hold'em No Limit ($0.01/$0.02 USD) - 2022/08/22 23:02:33 ET
Table 'Achilles IV' 6-max Seat #1 is the button
Seat 1: Ramirres ($3.95 in chips)
Seat 2: Lazypandas420 ($1.91 in chips)
Seat 3: Christianzt1 ($2.06 in chips)
Seat 4: kcarrion30 ($1.50 in chips)
Seat 5: Roogrid ($1.10 in chips)
Seat 6: NikoRamos14 ($1.89 in chips)
Lazypandas420: posts small blind $0.01
Christianzt1: posts big blind $0.02
*** HOLE CARDS ***
kcarrion30: folds
Roogrid: raises $0.02 to $0.04
NikoRamos14: folds
Ramirres: folds
Lazypandas420: folds
Christianzt1: calls $0.02
*** FLOP *** [5s Kd Jc]
Christianzt1: checks
Roogrid: checks
*** TURN *** [5s Kd Jc] [9s]
Christianzt1: checks
Roogrid: checks
*** RIVER *** [5s Kd Jc 9s] [Tc]
Christianzt1: checks
Roogrid: bets $0.02
Christianzt1: calls $0.02
*** SHOW DOWN ***
Roogrid: shows [Jh Kc] (two pair, Kings and Jacks)
Christianzt1: mucks hand
Roogrid collected $0.13 from pot
*** SUMMARY ***
Total pot $0.13 | Rake $0
Board [5s Kd Jc 9s Tc]
Seat 1: Ramirres (button) folded before Flop (didn't bet)
Seat 2: Lazypandas420 (small blind) folded before Flop
Seat 3: Christianzt1 (big blind) mucked
Seat 4: kcarrion30 folded before Flop (didn't bet)
Seat 5: Roogrid showed [Jh Kc] and won ($0.13) with two pair, Kings and Jacks
Seat 6: NikoRamos14 folded before Flop (didn't bet)


PokerStars Hand #238160643401:  Hold'em No Limit ($0.01/$0.02 USD) - 2022/08/22 23:03:20 ET
Table 'Achilles IV' 6-max Seat #2 is the button
Seat 1: Ramirres ($3.95 in chips)
Seat 2: Lazypandas420 ($1.90 in chips)
Seat 3: Christianzt1 ($2 in chips)
Seat 4: kcarrion30 ($1.50 in chips)
Seat 5: Roogrid ($1.17 in chips)
Seat 6: NikoRamos14 ($1.89 in chips)
Christianzt1: posts small blind $0.01
kcarrion30: posts big blind $0.02
*** HOLE CARDS ***
Roogrid: folds
NikoRamos14: calls $0.02
Ramirres: raises $0.05 to $0.07
Lazypandas420: folds
Christianzt1: calls $0.06
kcarrion30: calls $0.05
NikoRamos14: raises $0.07 to $0.14
Ramirres: calls $0.07
Christianzt1: calls $0.07
kcarrion30: calls $0.07
*** FLOP *** [Kd Tc 9s]
Christianzt1: checks
kcarrion30: bets $0.28
NikoRamos14: calls $0.28
Ramirres: calls $0.28
Christianzt1: folds
*** TURN *** [Kd Tc 9s] [Jd]
kcarrion30: checks
NikoRamos14: checks
Ramirres: checks
*** RIVER *** [Kd Tc 9s Jd] [3s]
kcarrion30: bets $0.28
NikoRamos14: raises $0.54 to $0.82
Ramirres: folds
kcarrion30: calls $0.54
*** SHOW DOWN ***
NikoRamos14: shows [Ac Qs] (a straight, Ten to Ace)
kcarrion30: mucks hand
NikoRamos14 collected $2.93 from pot
*** SUMMARY ***
Total pot $3.04 | Rake $0.11
Board [Kd Tc 9s Jd 3s]
Seat 1: Ramirres folded on the River
Seat 2: Lazypandas420 (button) folded before Flop (didn't bet)
Seat 3: Christianzt1 (small blind) folded on the Flop
Seat 4: kcarrion30 (big blind) mucked
Seat 5: Roogrid folded before Flop (didn't bet)
Seat 6: NikoRamos14 showed [Ac Qs] and won ($2.93) with a straight, Ten to Ace


PokerStars Hand #238160670382:  Hold'em No Limit ($0.01/$0.02 USD) - 2022/08/22 23:06:08 ET
Table 'Achilles IV' 6-max Seat #3 is the button
Seat 1: Ramirres ($3.53 in chips)
Seat 2: Lazypandas420 ($1.90 in chips)
Seat 3: Christianzt1 ($2 in chips)
Seat 4: kcarrion30 ($0.26 in chips)
Seat 5: Roogrid ($1.17 in chips)
Seat 6: NikoRamos14 ($3.58 in chips)
kcarrion30: posts small blind $0.01
Roogrid: posts big blind $0.02
*** HOLE CARDS ***
NikoRamos14: calls $0.02
Ramirres: folds
Lazypandas420 has timed out
Lazypandas420: folds
Christianzt1: raises $0.06 to $0.08
kcarrion30: calls $0.07
Roogrid: folds
NikoRamos14: calls $0.06
*** FLOP *** [2c Th 3h]
kcarrion30: checks
NikoRamos14: checks
Christianzt1: checks
*** TURN *** [2c Th 3h] [6s]
kcarrion30: checks
NikoRamos14: bets $0.10
Christianzt1: folds
kcarrion30: folds
Uncalled bet ($0.10) returned to NikoRamos14
NikoRamos14 collected $0.25 from pot
*** SUMMARY ***
Total pot $0.26 | Rake $0.01
Board [2c Th 3h 6s]
Seat 1: Ramirres folded before Flop (didn't bet)
Seat 2: Lazypandas420 folded before Flop (didn't bet)
Seat 3: Christianzt1 (button) folded on the Turn
Seat 4: kcarrion30 (small blind) folded on the Turn
Seat 5: Roogrid (big blind) folded before Flop
Seat 6: NikoRamos14 collected ($0.25)


PokerStars Hand #238160683237:  Hold'em No Limit ($0.01/$0.02 USD) - 2022/08/22 23:07:27 ET
Table 'Achilles IV' 6-max Seat #4 is the button
Seat 1: Ramirres ($3.53 in chips)
Seat 2: Lazypandas420 ($1.90 in chips)
Seat 3: Christianzt1 ($2 in chips)
Seat 4: kcarrion30 ($0.18 in chips)
Seat 5: Roogrid ($1.15 in chips)
Seat 6: NikoRamos14 ($3.75 in chips)
Roogrid: posts small blind $0.01
NikoRamos14: posts big blind $0.02
*** HOLE CARDS ***
Ramirres: folds
Lazypandas420 has timed out
Lazypandas420: folds
Christianzt1: folds
kcarrion30: raises $0.16 to $0.18 and is all-in
Roogrid: folds
NikoRamos14: calls $0.16
*** FLOP *** [Ks 4d Kd]
*** TURN *** [Ks 4d Kd] [6c]
*** RIVER *** [Ks 4d Kd 6c] [5h]
*** SHOW DOWN ***
NikoRamos14: shows [As Th] (a pair of Kings)
kcarrion30: shows [7c Qs] (a pair of Kings - lower kicker)
NikoRamos14 collected $0.36 from pot
*** SUMMARY ***
Total pot $0.37 | Rake $0.01
Board [Ks 4d Kd 6c 5h]
Seat 1: Ramirres folded before Flop (didn't bet)
Seat 2: Lazypandas420 folded before Flop (didn't bet)
Seat 3: Christianzt1 folded before Flop (didn't bet)
Seat 4: kcarrion30 (button) showed [7c Qs] and lost with a pair of Kings
Seat 5: Roogrid (small blind) folded before Flop
Seat 6: NikoRamos14 (big blind) showed [As Th] and won ($0.36) with a pair of Kings


PokerStars Hand #238160689570:  Hold'em No Limit ($0.01/$0.02 USD) - 2022/08/22 23:08:07 ET
Table 'Achilles IV' 6-max Seat #5 is the button
Seat 1: Ramirres ($3.53 in chips)
Seat 3: Christianzt1 ($2 in chips)
Seat 5: Roogrid ($1.14 in chips)
Seat 6: NikoRamos14 ($3.93 in chips)
NikoRamos14: posts small blind $0.01
Ramirres: posts big blind $0.02
*** HOLE CARDS ***
Christianzt1: folds
Roogrid: folds
NikoRamos14: calls $0.01
Ramirres: raises $0.04 to $0.06
NikoRamos14: calls $0.04
*** FLOP *** [8d 9d Ks]
NikoRamos14: checks
Ramirres: bets $0.08
NikoRamos14: calls $0.08
*** TURN *** [8d 9d Ks] [3c]
NikoRamos14: checks
Ramirres: checks
*** RIVER *** [8d 9d Ks 3c] [Jc]
NikoRamos14: bets $0.27
Ramirres: calls $0.27
*** SHOW DOWN ***
NikoRamos14: shows [8c Jd] (two pair, Jacks and Eights)
Ramirres: mucks hand
NikoRamos14 collected $0.79 from pot
*** SUMMARY ***
Total pot $0.82 | Rake $0.03
Board [8d 9d Ks 3c Jc]
Seat 1: Ramirres (big blind) mucked
Seat 3: Christianzt1 folded before Flop (didn't bet)
Seat 5: Roogrid (button) folded before Flop (didn't bet)
Seat 6: NikoRamos14 (small blind) showed [8c Jd] and won ($0.79) with two pair, Jacks and Eights


PokerStars Hand #238160698980:  Hold'em No Limit ($0.01/$0.02 USD) - 2022/08/22 23:09:07 ET
Table 'Achilles IV' 6-max Seat #6 is the button
Seat 1: Ramirres ($3.12 in chips)
Seat 3: Christianzt1 ($2 in chips)
Seat 4: kcarrion30 ($2 in chips)
Seat 5: Roogrid ($1.14 in chips)
Seat 6: NikoRamos14 ($4.31 in chips)
Ramirres: posts small blind $0.01
Christianzt1: posts big blind $0.02
*** HOLE CARDS ***
kcarrion30: folds
Roogrid: folds
NikoRamos14: calls $0.02
Ramirres: folds
Christianzt1: checks
*** FLOP *** [5c 5h 5d]
Christianzt1: checks
NikoRamos14: checks
*** TURN *** [5c 5h 5d] [2h]
Christianzt1: checks
NikoRamos14: bets $0.05
Christianzt1: folds
Uncalled bet ($0.05) returned to NikoRamos14
NikoRamos14 collected $0.05 from pot
*** SUMMARY ***
Total pot $0.05 | Rake $0
Board [5c 5h 5d 2h]
Seat 1: Ramirres (small blind) folded before Flop
Seat 3: Christianzt1 (big blind) folded on the Turn
Seat 4: kcarrion30 folded before Flop (didn't bet)
Seat 5: Roogrid folded before Flop (didn't bet)
Seat 6: NikoRamos14 (button) collected ($0.05)


PokerStars Hand #238160704486:  Hold'em No Limit ($0.01/$0.02 USD) - 2022/08/22 23:09:42 ET
Table 'Achilles IV' 6-max Seat #1 is the button
Seat 1: Ramirres ($3.11 in chips)
Seat 3: Christianzt1 ($2 in chips)
Seat 4: kcarrion30 ($2 in chips)
Seat 5: Roogrid ($1.14 in chips)
Seat 6: NikoRamos14 ($4.34 in chips)
Christianzt1: posts small blind $0.01
kcarrion30: posts big blind $0.02
*** HOLE CARDS ***
Roogrid: folds
NikoRamos14: calls $0.02
Ramirres: folds
Christianzt1: folds
kcarrion30: checks
*** FLOP *** [Qh 2d Kd]
kcarrion30: checks
NikoRamos14: checks
*** TURN *** [Qh 2d Kd] [8s]
kcarrion30: checks
NikoRamos14: checks
*** RIVER *** [Qh 2d Kd 8s] [Tc]
kcarrion30: checks
NikoRamos14: bets $0.05
kcarrion30: folds
Uncalled bet ($0.05) returned to NikoRamos14
NikoRamos14 collected $0.05 from pot
NikoRamos14: doesn't show hand
*** SUMMARY ***
Total pot $0.05 | Rake $0
Board [Qh 2d Kd 8s Tc]
Seat 1: Ramirres (button) folded before Flop (didn't bet)
Seat 3: Christianzt1 (small blind) folded before Flop
Seat 4: kcarrion30 (big blind) folded on the River
Seat 5: Roogrid folded before Flop (didn't bet)
Seat 6: NikoRamos14 collected ($0.05)


PokerStars Hand #238160709754:  Hold'em No Limit ($0.01/$0.02 USD) - 2022/08/22 23:10:15 ET
Table 'Achilles IV' 6-max Seat #3 is the button
Seat 1: Ramirres ($3.11 in chips)
Seat 3: Christianzt1 ($2 in chips)
Seat 4: kcarrion30 ($1.98 in chips)
Seat 5: Roogrid ($1.14 in chips)
Seat 6: NikoRamos14 ($4.37 in chips)
kcarrion30: posts small blind $0.01
Roogrid: posts big blind $0.02
*** HOLE CARDS ***
NikoRamos14: folds
Ramirres: raises $0.03 to $0.05
Christianzt1: folds
kcarrion30: folds
Roogrid: calls $0.03
*** FLOP *** [8d Qh 6s]
Roogrid: checks
Ramirres: checks
*** TURN *** [8d Qh 6s] [Qs]
Roogrid: checks
Ramirres: checks
*** RIVER *** [8d Qh 6s Qs] [5d]
Roogrid: bets $0.02
Ramirres: calls $0.02
*** SHOW DOWN ***
Roogrid: shows [3c Ad] (a pair of Queens)
Ramirres: shows [Td Ac] (a pair of Queens - Ace+Ten kicker)
Ramirres collected $0.14 from pot
*** SUMMARY ***
Total pot $0.15 | Rake $0.01
Board [8d Qh 6s Qs 5d]
Seat 1: Ramirres showed [Td Ac] and won ($0.14) with a pair of Queens
Seat 3: Christianzt1 (button) folded before Flop (didn't bet)
Seat 4: kcarrion30 (small blind) folded before Flop
Seat 5: Roogrid (big blind) showed [3c Ad] and lost with a pair of Queens
Seat 6: NikoRamos14 folded before Flop (didn't bet)


PokerStars Hand #238160713881:  Hold'em No Limit ($0.01/$0.02 USD) - 2022/08/22 23:10:42 ET
Table 'Achilles IV' 6-max Seat #4 is the button
Seat 1: Ramirres ($3.18 in chips)
Seat 3: Christianzt1 ($2 in chips)
Seat 4: kcarrion30 ($1.97 in chips)
Seat 5: Roogrid ($1.07 in chips)
Seat 6: NikoRamos14 ($4.37 in chips)
Roogrid: posts small blind $0.01
NikoRamos14: posts big blind $0.02
*** HOLE CARDS ***
Ramirres: folds
Christianzt1: folds
kcarrion30: raises $0.04 to $0.06
Roogrid: folds
NikoRamos14: raises $0.06 to $0.12
kcarrion30: calls $0.06
*** FLOP *** [4s Th 5h]
NikoRamos14: checks
kcarrion30: checks
*** TURN *** [4s Th 5h] [Ad]
NikoRamos14: checks
kcarrion30: checks
*** RIVER *** [4s Th 5h Ad] [Jd]
NikoRamos14: bets $0.24
kcarrion30: folds
Uncalled bet ($0.24) returned to NikoRamos14
NikoRamos14 collected $0.24 from pot
*** SUMMARY ***
Total pot $0.25 | Rake $0.01
Board [4s Th 5h Ad Jd]
Seat 1: Ramirres folded before Flop (didn't bet)
Seat 3: Christianzt1 folded before Flop (didn't bet)
Seat 4: kcarrion30 (button) folded on the River
Seat 5: Roogrid (small blind) folded before Flop
Seat 6: NikoRamos14 (big blind) collected ($0.24)


PokerStars Hand #238160721764:  Hold'em No Limit ($0.01/$0.02 USD) - 2022/08/22 23:11:33 ET
Table 'Achilles IV' 6-max Seat #5 is the button
Seat 1: Ramirres ($3.18 in chips)
Seat 3: Christianzt1 ($2 in chips)
Seat 4: kcarrion30 ($1.85 in chips)
Seat 5: Roogrid ($1.06 in chips)
Seat 6: NikoRamos14 ($4.49 in chips)
NikoRamos14: posts small blind $0.01
Ramirres: posts big blind $0.02
*** HOLE CARDS ***
Christianzt1: folds
kcarrion30: folds
Roogrid: folds
NikoRamos14: calls $0.01
Ramirres: checks
*** FLOP *** [5d 7d 4s]
NikoRamos14: checks
Ramirres: bets $0.04
NikoRamos14: calls $0.04
*** TURN *** [5d 7d 4s] [Qc]
NikoRamos14: checks
Ramirres: bets $0.15
NikoRamos14: folds
Uncalled bet ($0.15) returned to Ramirres
Ramirres collected $0.12 from pot
*** SUMMARY ***
Total pot $0.12 | Rake $0
Board [5d 7d 4s Qc]
Seat 1: Ramirres (big blind) collected ($0.12)
Seat 3: Christianzt1 folded before Flop (didn't bet)
Seat 4: kcarrion30 folded before Flop (didn't bet)
Seat 5: Roogrid (button) folded before Flop (didn't bet)
Seat 6: NikoRamos14 (small blind) folded on the Turn


PokerStars Hand #238160728583:  Hold'em No Limit ($0.01/$0.02 USD) - 2022/08/22 23:12:16 ET
Table 'Achilles IV' 6-max Seat #6 is the button
Seat 1: Ramirres ($3.24 in chips)
Seat 3: Christianzt1 ($2 in chips)
Seat 4: kcarrion30 ($1.85 in chips)
Seat 5: Roogrid ($1.06 in chips)
Seat 6: NikoRamos14 ($4.43 in chips)
Ramirres: posts small blind $0.01
Christianzt1: posts big blind $0.02
*** HOLE CARDS ***
kcarrion30: folds
Roogrid: raises $0.02 to $0.04
NikoRamos14: calls $0.04
Ramirres: folds
Christianzt1: folds
*** FLOP *** [2d 9h Js]
Roogrid: checks
NikoRamos14: checks
*** TURN *** [2d 9h Js] [3s]
Roogrid: checks
NikoRamos14: bets $0.05
Roogrid: folds
Uncalled bet ($0.05) returned to NikoRamos14
NikoRamos14 collected $0.11 from pot
NikoRamos14: doesn't show hand
*** SUMMARY ***
Total pot $0.11 | Rake $0
Board [2d 9h Js 3s]
Seat 1: Ramirres (small blind) folded before Flop
Seat 3: Christianzt1 (big blind) folded before Flop
Seat 4: kcarrion30 folded before Flop (didn't bet)
Seat 5: Roogrid folded on the Turn
Seat 6: NikoRamos14 (button) collected ($0.11)


PokerStars Hand #238160734102:  Hold'em No Limit ($0.01/$0.02 USD) - 2022/08/22 23:12:52 ET
Table 'Achilles IV' 6-max Seat #1 is the button
Seat 1: Ramirres ($3.23 in chips)
Seat 3: Christianzt1 ($2 in chips)
Seat 4: kcarrion30 ($1.85 in chips)
Seat 5: Roogrid ($1.02 in chips)
Seat 6: NikoRamos14 ($4.50 in chips)
Christianzt1: posts small blind $0.01
kcarrion30: posts big blind $0.02
*** HOLE CARDS ***
Roogrid: folds
NikoRamos14: calls $0.02
Ramirres: folds
Christianzt1: folds
kcarrion30: raises $0.04 to $0.06
NikoRamos14: calls $0.04
*** FLOP *** [Ac 2h 5d]
kcarrion30: checks
NikoRamos14: checks
*** TURN *** [Ac 2h 5d] [3h]
kcarrion30: checks
NikoRamos14: bets $0.06
kcarrion30: folds
Uncalled bet ($0.06) returned to NikoRamos14
NikoRamos14 collected $0.13 from pot
NikoRamos14: doesn't show hand
*** SUMMARY ***
Total pot $0.13 | Rake $0
Board [Ac 2h 5d 3h]
Seat 1: Ramirres (button) folded before Flop (didn't bet)
Seat 3: Christianzt1 (small blind) folded before Flop
Seat 4: kcarrion30 (big blind) folded on the Turn
Seat 5: Roogrid folded before Flop (didn't bet)
Seat 6: NikoRamos14 collected ($0.13)


PokerStars Hand #238160744089:  Hold'em No Limit ($0.01/$0.02 USD) - 2022/08/22 23:13:34 ET
Table 'Achilles IV' 6-max Seat #3 is the button
Seat 1: Ramirres ($3.23 in chips)
Seat 3: Christianzt1 ($2 in chips)
Seat 4: kcarrion30 ($1.79 in chips)
Seat 5: Roogrid ($1.02 in chips)
Seat 6: NikoRamos14 ($4.57 in chips)
kcarrion30: posts small blind $0.01
Roogrid: posts big blind $0.02
*** HOLE CARDS ***
NikoRamos14: calls $0.02
Ramirres: folds
Christianzt1: folds
kcarrion30: folds
Roogrid: raises $0.02 to $0.04
NikoRamos14: calls $0.02
*** FLOP *** [Jd 9c 2s]
Roogrid: checks
NikoRamos14: checks
*** TURN *** [Jd 9c 2s] [7c]
Roogrid: checks
NikoRamos14: checks
*** RIVER *** [Jd 9c 2s 7c] [4h]
Roogrid: bets $0.02
NikoRamos14: folds
Uncalled bet ($0.02) returned to Roogrid
Roogrid collected $0.09 from pot
Roogrid: doesn't show hand
*** SUMMARY ***
Total pot $0.09 | Rake $0
Board [Jd 9c 2s 7c 4h]
Seat 1: Ramirres folded before Flop (didn't bet)
Seat 3: Christianzt1 (button) folded before Flop (didn't bet)
Seat 4: kcarrion30 (small blind) folded before Flop
Seat 5: Roogrid (big blind) collected ($0.09)
Seat 6: NikoRamos14 folded on the River


PokerStars Hand #238160750172:  Hold'em No Limit ($0.01/$0.02 USD) - 2022/08/22 23:14:13 ET
Table 'Achilles IV' 6-max Seat #4 is the button
Seat 1: Ramirres ($3.23 in chips)
Seat 3: Christianzt1 ($2 in chips)
Seat 4: kcarrion30 ($1.78 in chips)
Seat 5: Roogrid ($1.07 in chips)
Seat 6: NikoRamos14 ($4.53 in chips)
Roogrid: posts small blind $0.01
NikoRamos14: posts big blind $0.02
*** HOLE CARDS ***
Ramirres: folds
Christianzt1: folds
kcarrion30: folds
Roogrid: raises $0.02 to $0.04
NikoRamos14: calls $0.02
*** FLOP *** [Qs Qc Ah]
Roogrid: checks
NikoRamos14: checks
*** TURN *** [Qs Qc Ah] [2c]
Roogrid: checks
NikoRamos14: bets $0.04
Roogrid: folds
Uncalled bet ($0.04) returned to NikoRamos14
NikoRamos14 collected $0.08 from pot
*** SUMMARY ***
Total pot $0.08 | Rake $0
Board [Qs Qc Ah 2c]
Seat 1: Ramirres folded before Flop (didn't bet)
Seat 3: Christianzt1 folded before Flop (didn't bet)
Seat 4: kcarrion30 (button) folded before Flop (didn't bet)
Seat 5: Roogrid (small blind) folded on the Turn
Seat 6: NikoRamos14 (big blind) collected ($0.08)


PokerStars Hand #238160757105:  Hold'em No Limit ($0.01/$0.02 USD) - 2022/08/22 23:14:57 ET
Table 'Achilles IV' 6-max Seat #5 is the button
Seat 1: Ramirres ($3.23 in chips)
Seat 3: Christianzt1 ($2 in chips)
Seat 4: kcarrion30 ($1.78 in chips)
Seat 5: Roogrid ($1.03 in chips)
Seat 6: NikoRamos14 ($4.57 in chips)
NikoRamos14: posts small blind $0.01
Ramirres: posts big blind $0.02
*** HOLE CARDS ***
Christianzt1: folds
kcarrion30: folds
Roogrid: folds
NikoRamos14: calls $0.01
Ramirres: checks
*** FLOP *** [Jh Js Ts]
NikoRamos14: checks
Ramirres: checks
*** TURN *** [Jh Js Ts] [9s]
NikoRamos14: checks
Ramirres: checks
*** RIVER *** [Jh Js Ts 9s] [3s]
NikoRamos14: bets $0.04
Ramirres: folds
Uncalled bet ($0.04) returned to NikoRamos14
NikoRamos14 collected $0.04 from pot
NikoRamos14: doesn't show hand
*** SUMMARY ***
Total pot $0.04 | Rake $0
Board [Jh Js Ts 9s 3s]
Seat 1: Ramirres (big blind) folded on the River
Seat 3: Christianzt1 folded before Flop (didn't bet)
Seat 4: kcarrion30 folded before Flop (didn't bet)
Seat 5: Roogrid (button) folded before Flop (didn't bet)
Seat 6: NikoRamos14 (small blind) collected ($0.04)


PokerStars Hand #238160766079:  Hold'em No Limit ($0.01/$0.02 USD) - 2022/08/22 23:15:54 ET
Table 'Achilles IV' 6-max Seat #6 is the button
Seat 1: Ramirres ($3.21 in chips)
Seat 4: kcarrion30 ($1.78 in chips)
Seat 5: Roogrid ($1.03 in chips)
Seat 6: NikoRamos14 ($4.59 in chips)
Ramirres: posts small blind $0.01
Christianzt1: is sitting out
kcarrion30: posts big blind $0.02
*** HOLE CARDS ***
Christianzt1 leaves the table
Roogrid: raises $0.02 to $0.04
NikoRamos14: calls $0.04
sopapunk joins the table at seat #3
Ramirres: folds
kcarrion30: folds
*** FLOP *** [Js 4h 7d]
Roogrid: checks
NikoRamos14: checks
*** TURN *** [Js 4h 7d] [4s]
Roogrid: checks
NikoRamos14: checks
*** RIVER *** [Js 4h 7d 4s] [Ad]
Roogrid: bets $0.02
NikoRamos14: folds
Uncalled bet ($0.02) returned to Roogrid
Roogrid collected $0.11 from pot
Roogrid: doesn't show hand
*** SUMMARY ***
Total pot $0.11 | Rake $0
Board [Js 4h 7d 4s Ad]
Seat 1: Ramirres (small blind) folded before Flop
Seat 4: kcarrion30 (big blind) folded before Flop
Seat 5: Roogrid collected ($0.11)
Seat 6: NikoRamos14 (button) folded on the River


PokerStars Hand #238160771232:  Hold'em No Limit ($0.01/$0.02 USD) - 2022/08/22 23:16:27 ET
Table 'Achilles IV' 6-max Seat #1 is the button
Seat 1: Ramirres ($3.20 in chips)
Seat 4: kcarrion30 ($1.76 in chips)
Seat 5: Roogrid ($1.10 in chips)
Seat 6: NikoRamos14 ($4.55 in chips)
kcarrion30: posts small blind $0.01
Roogrid: posts big blind $0.02
*** HOLE CARDS ***
NikoRamos14: folds
Ramirres: raises $0.03 to $0.05
kcarrion30: folds
Roogrid: folds
Uncalled bet ($0.03) returned to Ramirres
Ramirres collected $0.05 from pot
*** SUMMARY ***
Total pot $0.05 | Rake $0
Seat 1: Ramirres (button) collected ($0.05)
Seat 4: kcarrion30 (small blind) folded before Flop
Seat 5: Roogrid (big blind) folded before Flop
Seat 6: NikoRamos14 folded before Flop (didn't bet)


PokerStars Hand #238160776578:  Hold'em No Limit ($0.01/$0.02 USD) - 2022/08/22 23:17:01 ET
Table 'Achilles IV' 6-max Seat #5 is the button
Seat 1: Ramirres ($3.23 in chips)
Seat 4: kcarrion30 ($1.75 in chips)
Seat 5: Roogrid ($1.04 in chips)
Seat 6: NikoRamos14 ($4.59 in chips)
NikoRamos14: posts small blind $0.01
Ramirres: posts big blind $0.02
sopapunk: sits out
*** HOLE CARDS ***
kcarrion30: raises $0.04 to $0.06
Roogrid: folds
NikoRamos14: folds
Ramirres: folds
Uncalled bet ($0.04) returned to kcarrion30
kcarrion30 collected $0.05 from pot
*** SUMMARY ***
Total pot $0.05 | Rake $0
Seat 1: Ramirres (big blind) folded before Flop
Seat 4: kcarrion30 collected ($0.05)
Seat 5: Roogrid (button) folded before Flop (didn't bet)
Seat 6: NikoRamos14 (small blind) folded before Flop


PokerStars Hand #238160773218:  Hold'em No Limit ($0.01/$0.02 USD) - 2022/08/22 23:16:40 ET
Table 'Achilles IV' 6-max Seat #4 is the button
Seat 1: Ramirres ($3.23 in chips)
Seat 4: kcarrion30 ($1.75 in chips)
Seat 5: Roogrid ($1.08 in chips)
Seat 6: NikoRamos14 ($4.55 in chips)
Roogrid: posts small blind $0.01
NikoRamos14: posts big blind $0.02
sopapunk: sits out
*** HOLE CARDS ***
Ramirres: folds
kcarrion30: folds
Roogrid: raises $0.02 to $0.04
NikoRamos14: calls $0.02
*** FLOP *** [8h 5c 3c]
Roogrid: checks
NikoRamos14: bets $0.08
Roogrid: folds
Uncalled bet ($0.08) returned to NikoRamos14
NikoRamos14 collected $0.08 from pot
NikoRamos14: doesn't show hand
*** SUMMARY ***
Total pot $0.08 | Rake $0
Board [8h 5c 3c]
Seat 1: Ramirres folded before Flop (didn't bet)
Seat 4: kcarrion30 (button) folded before Flop (didn't bet)
Seat 5: Roogrid (small blind) folded on the Flop
Seat 6: NikoRamos14 (big blind) collected ($0.08)


PokerStars Hand #238160779184:  Hold'em No Limit ($0.01/$0.02 USD) - 2022/08/22 23:17:18 ET
Table 'Achilles IV' 6-max Seat #6 is the button
Seat 1: Ramirres ($3.21 in chips)
Seat 3: sopapunk ($2 in chips)
Seat 4: kcarrion30 ($1.78 in chips)
Seat 5: Roogrid ($1.04 in chips)
Seat 6: NikoRamos14 ($4.58 in chips)
Ramirres: posts small blind $0.01
sopapunk: posts big blind $0.02
*** HOLE CARDS ***
kcarrion30: folds
Roogrid: folds
NikoRamos14: calls $0.02
Ramirres: folds
sopapunk: raises $0.08 to $0.10
NikoRamos14: folds
Uncalled bet ($0.08) returned to sopapunk
sopapunk collected $0.05 from pot
Lazypandas420 was removed from the table for failing to post
Lazypandas420 leaves the table
sopapunk: doesn't show hand
*** SUMMARY ***
Total pot $0.05 | Rake $0
Seat 1: Ramirres (small blind) folded before Flop
Seat 3: sopapunk (big blind) collected ($0.05)
Seat 4: kcarrion30 folded before Flop (didn't bet)
Seat 5: Roogrid folded before Flop (didn't bet)
Seat 6: NikoRamos14 (button) folded before Flop


PokerStars Hand #238160784172:  Hold'em No Limit ($0.01/$0.02 USD) - 2022/08/22 23:17:50 ET
Table 'Achilles IV' 6-max Seat #1 is the button
Seat 1: Ramirres ($3.20 in chips)
Seat 3: sopapunk ($2.03 in chips)
Seat 4: kcarrion30 ($1.78 in chips)
Seat 5: Roogrid ($1.04 in chips)
Seat 6: NikoRamos14 ($4.56 in chips)
sopapunk: posts small blind $0.01
kcarrion30: posts big blind $0.02
*** HOLE CARDS ***
Roogrid: folds
Bakhangya01 joins the table at seat #2
NikoRamos14: calls $0.02
Ramirres: folds
sopapunk: folds
kcarrion30: checks
*** FLOP *** [7d 7s Qd]
kcarrion30: checks
NikoRamos14: checks
*** TURN *** [7d 7s Qd] [4h]
kcarrion30: checks
NikoRamos14: checks
*** RIVER *** [7d 7s Qd 4h] [3h]
kcarrion30: bets $0.04
NikoRamos14: calls $0.04
*** SHOW DOWN ***
kcarrion30: shows [5c 6c] (a straight, Three to Seven)
NikoRamos14: mucks hand
kcarrion30 collected $0.13 from pot
*** SUMMARY ***
Total pot $0.13 | Rake $0
Board [7d 7s Qd 4h 3h]
Seat 1: Ramirres (button) folded before Flop (didn't bet)
Seat 3: sopapunk (small blind) folded before Flop
Seat 4: kcarrion30 (big blind) showed [5c 6c] and won ($0.13) with a straight, Three to Seven
Seat 5: Roogrid folded before Flop (didn't bet)
Seat 6: NikoRamos14 mucked


PokerStars Hand #238160790503:  Hold'em No Limit ($0.01/$0.02 USD) - 2022/08/22 23:18:30 ET
Table 'Achilles IV' 6-max Seat #3 is the button
Seat 1: Ramirres ($3.20 in chips)
Seat 2: Bakhangya01 ($0.80 in chips)
Seat 3: sopapunk ($2.02 in chips)
Seat 4: kcarrion30 ($1.85 in chips)
Seat 5: Roogrid ($1.04 in chips)
Seat 6: NikoRamos14 ($4.50 in chips)
kcarrion30: posts small blind $0.01
Roogrid: posts big blind $0.02
Bakhangya01: posts big blind $0.02
*** HOLE CARDS ***
NikoRamos14: calls $0.02
Ramirres: folds
Bakhangya01: checks
sopapunk: folds
kcarrion30: folds
Roogrid: raises $0.02 to $0.04
NikoRamos14: calls $0.02
Bakhangya01: folds
*** FLOP *** [4h 4d 7d]
Roogrid: checks
NikoRamos14: checks
*** TURN *** [4h 4d 7d] [6s]
Roogrid: checks
NikoRamos14: bets $0.05
Roogrid: raises $0.05 to $0.10
NikoRamos14: calls $0.05
*** RIVER *** [4h 4d 7d 6s] [Kd]
Roogrid: bets $0.15
NikoRamos14: folds
Uncalled bet ($0.15) returned to Roogrid
Roogrid collected $0.30 from pot
Roogrid: doesn't show hand
*** SUMMARY ***
Total pot $0.31 | Rake $0.01
Board [4h 4d 7d 6s Kd]
Seat 1: Ramirres folded before Flop (didn't bet)
Seat 2: Bakhangya01 folded before Flop (didn't bet)
Seat 3: sopapunk (button) folded before Flop (didn't bet)
Seat 4: kcarrion30 (small blind) folded before Flop
Seat 5: Roogrid (big blind) collected ($0.30)
Seat 6: NikoRamos14 folded on the River


PokerStars Hand #238160801181:  Hold'em No Limit ($0.01/$0.02 USD) - 2022/08/22 23:19:38 ET
Table 'Achilles IV' 6-max Seat #4 is the button
Seat 2: Bakhangya01 ($0.78 in chips)
Seat 3: sopapunk ($2.02 in chips)
Seat 4: kcarrion30 ($1.84 in chips)
Seat 5: Roogrid ($1.20 in chips)
Seat 6: NikoRamos14 ($4.36 in chips)
Roogrid: posts small blind $0.01
NikoRamos14: posts big blind $0.02
*** HOLE CARDS ***
Bakhangya01: folds
sopapunk: raises $0.03 to $0.05
kcarrion30: calls $0.05
Roogrid: folds
NikoRamos14: calls $0.03
*** FLOP *** [5d 4h 4c]
NikoRamos14: checks
sopapunk: checks
kcarrion30: bets $0.11
NikoRamos14: folds
sopapunk: folds
Uncalled bet ($0.11) returned to kcarrion30
kcarrion30 collected $0.15 from pot
*** SUMMARY ***
Total pot $0.16 | Rake $0.01
Board [5d 4h 4c]
Seat 2: Bakhangya01 folded before Flop (didn't bet)
Seat 3: sopapunk folded on the Flop
Seat 4: kcarrion30 (button) collected ($0.15)
Seat 5: Roogrid (small blind) folded before Flop
Seat 6: NikoRamos14 (big blind) folded on the Flop


PokerStars Hand #238160808410:  Hold'em No Limit ($0.01/$0.02 USD) - 2022/08/22 23:20:24 ET
Table 'Achilles IV' 6-max Seat #6 is the button
Seat 2: Bakhangya01 ($0.78 in chips)
Seat 3: sopapunk ($2 in chips)
Seat 4: kcarrion30 ($1.94 in chips)
Seat 6: NikoRamos14 ($4.31 in chips)
Bakhangya01: posts small blind $0.01
sopapunk: posts big blind $0.02
*** HOLE CARDS ***
kcarrion30: raises $0.04 to $0.06
NikoRamos14: folds
Bakhangya01: folds
sopapunk: folds
Uncalled bet ($0.04) returned to kcarrion30
kcarrion30 collected $0.05 from pot
*** SUMMARY ***
Total pot $0.05 | Rake $0
Seat 2: Bakhangya01 (small blind) folded before Flop
Seat 3: sopapunk (big blind) folded before Flop
Seat 4: kcarrion30 collected ($0.05)
Seat 6: NikoRamos14 (button) folded before Flop (didn't bet)


PokerStars Hand #238160811138:  Hold'em No Limit ($0.01/$0.02 USD) - 2022/08/22 23:20:41 ET
Table 'Achilles IV' 6-max Seat #2 is the button
Seat 2: Bakhangya01 ($0.77 in chips)
Seat 3: sopapunk ($2 in chips)
Seat 4: kcarrion30 ($1.97 in chips)
Seat 6: NikoRamos14 ($4.31 in chips)
sopapunk: posts small blind $0.01
kcarrion30: posts big blind $0.02
*** HOLE CARDS ***
NikoRamos14: calls $0.02
Bakhangya01: folds
sopapunk: folds
kcarrion30: checks
*** FLOP *** [8s 7c Qh]
kcarrion30: checks
Bakhangya01 leaves the table
NikoRamos14: checks
*** TURN *** [8s 7c Qh] [Ks]
kcarrion30: checks
NikoRamos14: checks
*** RIVER *** [8s 7c Qh Ks] [2d]
kcarrion30: checks
NikoRamos14: bets $0.05
kcarrion30: folds
Uncalled bet ($0.05) returned to NikoRamos14
NikoRamos14 collected $0.05 from pot
*** SUMMARY ***
Total pot $0.05 | Rake $0
Board [8s 7c Qh Ks 2d]
Seat 2: Bakhangya01 (button) folded before Flop (didn't bet)
Seat 3: sopapunk (small blind) folded before Flop
Seat 4: kcarrion30 (big blind) folded on the River
Seat 6: NikoRamos14 collected ($0.05)


PokerStars Hand #238160821938:  Hold'em No Limit ($0.01/$0.02 USD) - 2022/08/22 23:21:11 ET
Table 'Achilles IV' 6-max Seat #3 is the button
Seat 3: sopapunk ($2 in chips)
Seat 4: kcarrion30 ($1.95 in chips)
Seat 5: Roogrid ($1.19 in chips)
Seat 6: NikoRamos14 ($4.34 in chips)
kcarrion30: posts small blind $0.01
Roogrid: posts big blind $0.02
*** HOLE CARDS ***
NikoRamos14: calls $0.02
sopapunk: folds
kcarrion30: folds
Roogrid: checks
*** FLOP *** [Kh 9c 3h]
Roogrid: checks
NikoRamos14: checks
*** TURN *** [Kh 9c 3h] [Qd]
Roogrid: checks
BeeboXD joins the table at seat #2
NikoRamos14: bets $0.05
Roogrid: folds
Uncalled bet ($0.05) returned to NikoRamos14
NikoRamos14 collected $0.05 from pot
*** SUMMARY ***
Total pot $0.05 | Rake $0
Board [Kh 9c 3h Qd]
Seat 3: sopapunk (button) folded before Flop (didn't bet)
Seat 4: kcarrion30 (small blind) folded before Flop
Seat 5: Roogrid (big blind) folded on the Turn
Seat 6: NikoRamos14 collected ($0.05)


PokerStars Hand #238160826564:  Hold'em No Limit ($0.01/$0.02 USD) - 2022/08/22 23:21:41 ET
Table 'Achilles IV' 6-max Seat #4 is the button
Seat 3: sopapunk ($2 in chips)
Seat 4: kcarrion30 ($1.94 in chips)
Seat 5: Roogrid ($1.17 in chips)
Seat 6: NikoRamos14 ($4.37 in chips)
Roogrid: posts small blind $0.01
NikoRamos14: posts big blind $0.02
BeeboXD: sits out
*** HOLE CARDS ***
sopapunk: folds
kcarrion30: folds
Roogrid: raises $0.02 to $0.04
NikoRamos14: calls $0.02
*** FLOP *** [9s 9d Js]
Roogrid: checks
NikoRamos14: checks
*** TURN *** [9s 9d Js] [4h]
Roogrid: checks
NikoRamos14: bets $0.04
Roogrid: raises $0.04 to $0.08
NikoRamos14: calls $0.04
*** RIVER *** [9s 9d Js 4h] [Qd]
Roogrid: bets $0.11
NikoRamos14: folds
Uncalled bet ($0.11) returned to Roogrid
Roogrid collected $0.23 from pot
Roogrid: doesn't show hand
*** SUMMARY ***
Total pot $0.24 | Rake $0.01
Board [9s 9d Js 4h Qd]
Seat 3: sopapunk folded before Flop (didn't bet)
Seat 4: kcarrion30 (button) folded before Flop (didn't bet)
Seat 5: Roogrid (small blind) collected ($0.23)
Seat 6: NikoRamos14 (big blind) folded on the River


PokerStars Hand #238160840315:  Hold'em No Limit ($0.01/$0.02 USD) - 2022/08/22 23:22:36 ET
Table 'Achilles IV' 6-max Seat #5 is the button
Seat 2: BeeboXD ($2 in chips)
Seat 3: sopapunk ($2 in chips)
Seat 4: kcarrion30 ($1.94 in chips)
Seat 5: Roogrid ($1.28 in chips)
Seat 6: NikoRamos14 ($4.25 in chips)
NikoRamos14: posts small blind $0.01
BeeboXD: posts big blind $0.02
*** HOLE CARDS ***
sopapunk: folds
kcarrion30: folds
Roogrid: folds
NikoRamos14: calls $0.01
BeeboXD: checks
*** FLOP *** [6d 5h 8c]
NikoRamos14: checks
BeeboXD: checks
*** TURN *** [6d 5h 8c] [4c]
NikoRamos14: checks
BeeboXD: bets $0.04
NikoRamos14: calls $0.04
*** RIVER *** [6d 5h 8c 4c] [6h]
NikoRamos14: checks
BeeboXD: bets $0.12
NikoRamos14: folds
Uncalled bet ($0.12) returned to BeeboXD
BeeboXD collected $0.12 from pot
*** SUMMARY ***
Total pot $0.12 | Rake $0
Board [6d 5h 8c 4c 6h]
Seat 2: BeeboXD (big blind) collected ($0.12)
Seat 3: sopapunk folded before Flop (didn't bet)
Seat 4: kcarrion30 folded before Flop (didn't bet)
Seat 5: Roogrid (button) folded before Flop (didn't bet)
Seat 6: NikoRamos14 (small blind) folded on the River


PokerStars Hand #238160848705:  Hold'em No Limit ($0.01/$0.02 USD) - 2022/08/22 23:23:31 ET
Table 'Achilles IV' 6-max Seat #6 is the button
Seat 2: BeeboXD ($2.06 in chips)
Seat 3: sopapunk ($2 in chips)
Seat 4: kcarrion30 ($1.94 in chips)
Seat 5: Roogrid ($1.28 in chips)
Seat 6: NikoRamos14 ($4.19 in chips)
BeeboXD: posts small blind $0.01
sopapunk: posts big blind $0.02
*** HOLE CARDS ***
kcarrion30: folds
Roogrid: folds
NikoRamos14: folds
BeeboXD: folds
Uncalled bet ($0.01) returned to sopapunk
sopapunk collected $0.02 from pot
sopapunk: doesn't show hand
*** SUMMARY ***
Total pot $0.02 | Rake $0
Seat 2: BeeboXD (small blind) folded before Flop
Seat 3: sopapunk (big blind) collected ($0.02)
Seat 4: kcarrion30 folded before Flop (didn't bet)
Seat 5: Roogrid folded before Flop (didn't bet)
Seat 6: NikoRamos14 (button) folded before Flop (didn't bet)


PokerStars Hand #238160850491:  Hold'em No Limit ($0.01/$0.02 USD) - 2022/08/22 23:23:42 ET
Table 'Achilles IV' 6-max Seat #2 is the button
Seat 2: BeeboXD ($2.05 in chips)
Seat 3: sopapunk ($2.01 in chips)
Seat 4: kcarrion30 ($1.94 in chips)
Seat 5: Roogrid ($1.28 in chips)
Seat 6: NikoRamos14 ($4.19 in chips)
sopapunk: posts small blind $0.01
kcarrion30: posts big blind $0.02
*** HOLE CARDS ***
Roogrid: folds
NikoRamos14: folds
BeeboXD: folds
sopapunk: folds
Uncalled bet ($0.01) returned to kcarrion30
kcarrion30 collected $0.02 from pot
*** SUMMARY ***
Total pot $0.02 | Rake $0
Seat 2: BeeboXD (button) folded before Flop (didn't bet)
Seat 3: sopapunk (small blind) folded before Flop
Seat 4: kcarrion30 (big blind) collected ($0.02)
Seat 5: Roogrid folded before Flop (didn't bet)
Seat 6: NikoRamos14 folded before Flop (didn't bet)


PokerStars Hand #238160852887:  Hold'em No Limit ($0.01/$0.02 USD) - 2022/08/22 23:23:57 ET
Table 'Achilles IV' 6-max Seat #3 is the button
Seat 2: BeeboXD ($2.05 in chips)
Seat 3: sopapunk ($2 in chips)
Seat 4: kcarrion30 ($1.95 in chips)
Seat 5: Roogrid ($1.28 in chips)
Seat 6: NikoRamos14 ($4.19 in chips)
kcarrion30: posts small blind $0.01
Roogrid: posts big blind $0.02
*** HOLE CARDS ***
NikoRamos14: calls $0.02
BeeboXD: calls $0.02
sopapunk: folds
kcarrion30: folds
Roogrid: raises $0.02 to $0.04
NikoRamos14: calls $0.02
BeeboXD: calls $0.02
*** FLOP *** [5c 5h 9s]
Roogrid: checks
NikoRamos14: checks
BeeboXD: checks
*** TURN *** [5c 5h 9s] [8d]
Roogrid: checks
NikoRamos14: bets $0.08
BeeboXD: folds
Roogrid: folds
Uncalled bet ($0.08) returned to NikoRamos14
NikoRamos14 collected $0.13 from pot
NikoRamos14: doesn't show hand
*** SUMMARY ***
Total pot $0.13 | Rake $0
Board [5c 5h 9s 8d]
Seat 2: BeeboXD folded on the Turn
Seat 3: sopapunk (button) folded before Flop (didn't bet)
Seat 4: kcarrion30 (small blind) folded before Flop
Seat 5: Roogrid (big blind) folded on the Turn
Seat 6: NikoRamos14 collected ($0.13)


PokerStars Hand #238160860306:  Hold'em No Limit ($0.01/$0.02 USD) - 2022/08/22 23:24:46 ET
Table 'Achilles IV' 6-max Seat #4 is the button
Seat 2: BeeboXD ($2.01 in chips)
Seat 3: sopapunk ($2 in chips)
Seat 4: kcarrion30 ($1.94 in chips)
Seat 5: Roogrid ($1.24 in chips)
Seat 6: NikoRamos14 ($4.28 in chips)
Roogrid: posts small blind $0.01
NikoRamos14: posts big blind $0.02
Ramirres: sits out
*** HOLE CARDS ***
BeeboXD: folds
sopapunk: folds
kcarrion30: raises $0.04 to $0.06
Roogrid: folds
NikoRamos14: calls $0.04
*** FLOP *** [9c Kd 6s]
NikoRamos14: checks
kcarrion30: bets $0.04
NikoRamos14: calls $0.04
*** TURN *** [9c Kd 6s] [Kc]
NikoRamos14: checks
kcarrion30: bets $0.08
NikoRamos14: raises $0.08 to $0.16
kcarrion30: calls $0.08
*** RIVER *** [9c Kd 6s Kc] [9h]
NikoRamos14: bets $0.51
kcarrion30: raises $1.17 to $1.68 and is all-in
NikoRamos14: calls $1.17
*** SHOW DOWN ***
kcarrion30: shows [Kh Qc] (a full house, Kings full of Nines)
NikoRamos14: shows [9s Qs] (a full house, Nines full of Kings)
kcarrion30 collected $3.75 from pot
*** SUMMARY ***
Total pot $3.89 | Rake $0.14
Board [9c Kd 6s Kc 9h]
Seat 2: BeeboXD folded before Flop (didn't bet)
Seat 3: sopapunk folded before Flop (didn't bet)
Seat 4: kcarrion30 (button) showed [Kh Qc] and won ($3.75) with a full house, Kings full of Nines
Seat 5: Roogrid (small blind) folded before Flop
Seat 6: NikoRamos14 (big blind) showed [9s Qs] and lost with a full house, Nines full of Kings


PokerStars Hand #238160878182:  Hold'em No Limit ($0.01/$0.02 USD) - 2022/08/22 23:26:22 ET
Table 'Achilles IV' 6-max Seat #5 is the button
Seat 1: Ramirres ($3.20 in chips)
Seat 2: BeeboXD ($2.01 in chips)
Seat 3: sopapunk ($2 in chips)
Seat 4: kcarrion30 ($3.75 in chips)
Seat 5: Roogrid ($1.23 in chips)
Seat 6: NikoRamos14 ($2.34 in chips)
NikoRamos14: posts small blind $0.01
Ramirres: posts big blind $0.02
*** HOLE CARDS ***
BeeboXD: folds
sopapunk: folds
kcarrion30: folds
Roogrid: raises $0.02 to $0.04
NikoRamos14: calls $0.03
Ramirres: folds
*** FLOP *** [2h Jh Td]
NikoRamos14: bets $0.10
Roogrid: folds
Uncalled bet ($0.10) returned to NikoRamos14
NikoRamos14 collected $0.10 from pot
NikoRamos14: doesn't show hand
*** SUMMARY ***
Total pot $0.10 | Rake $0
Board [2h Jh Td]
Seat 1: Ramirres (big blind) folded before Flop
Seat 2: BeeboXD folded before Flop (didn't bet)
Seat 3: sopapunk folded before Flop (didn't bet)
Seat 4: kcarrion30 folded before Flop (didn't bet)
Seat 5: Roogrid (button) folded on the Flop
Seat 6: NikoRamos14 (small blind) collected ($0.10)


PokerStars Hand #238160883678:  Hold'em No Limit ($0.01/$0.02 USD) - 2022/08/22 23:26:58 ET
Table 'Achilles IV' 6-max Seat #6 is the button
Seat 1: Ramirres ($3.18 in chips)
Seat 2: BeeboXD ($2.01 in chips)
Seat 3: sopapunk ($2 in chips)
Seat 5: Roogrid ($1.19 in chips)
Seat 6: NikoRamos14 ($2.40 in chips)
Ramirres: posts small blind $0.01
BeeboXD: posts big blind $0.02
*** HOLE CARDS ***
sopapunk: folds
Roogrid: raises $0.02 to $0.04
NikoRamos14: calls $0.04
Ramirres: folds
BeeboXD: calls $0.02
*** FLOP *** [7h Ts 8c]
BeeboXD: checks
Roogrid: checks
NikoRamos14: checks
*** TURN *** [7h Ts 8c] [Tc]
BeeboXD: bets $0.10
Roogrid: folds
NikoRamos14: raises $0.10 to $0.20
BeeboXD: calls $0.10
*** RIVER *** [7h Ts 8c Tc] [9d]
BeeboXD: checks
NikoRamos14: checks
*** SHOW DOWN ***
BeeboXD: shows [6s Js] (a straight, Seven to Jack)
NikoRamos14: mucks hand
BeeboXD collected $0.51 from pot
*** SUMMARY ***
Total pot $0.53 | Rake $0.02
Board [7h Ts 8c Tc 9d]
Seat 1: Ramirres (small blind) folded before Flop
Seat 2: BeeboXD (big blind) showed [6s Js] and won ($0.51) with a straight, Seven to Jack
Seat 3: sopapunk folded before Flop (didn't bet)
Seat 5: Roogrid folded on the Turn
Seat 6: NikoRamos14 (button) mucked


PokerStars Hand #238160896322:  Hold'em No Limit ($0.01/$0.02 USD) - 2022/08/22 23:28:21 ET
Table 'Achilles IV' 6-max Seat #1 is the button
Seat 1: Ramirres ($3.17 in chips)
Seat 2: BeeboXD ($2.28 in chips)
Seat 3: sopapunk ($2 in chips)
Seat 5: Roogrid ($1.15 in chips)
Seat 6: NikoRamos14 ($2.16 in chips)
BeeboXD: posts small blind $0.01
sopapunk: posts big blind $0.02
*** HOLE CARDS ***
Roogrid: raises $0.02 to $0.04
NikoRamos14: calls $0.04
Ramirres: folds
BeeboXD: folds
sopapunk: folds
*** FLOP *** [2h As 9d]
Roogrid: checks
NikoRamos14: checks
*** TURN *** [2h As 9d] [Ks]
Roogrid: checks
NikoRamos14: checks
*** RIVER *** [2h As 9d Ks] [Ad]
Roogrid: bets $0.02
NikoRamos14: folds
Uncalled bet ($0.02) returned to Roogrid
Roogrid collected $0.11 from pot
Roogrid: doesn't show hand
*** SUMMARY ***
Total pot $0.11 | Rake $0
Board [2h As 9d Ks Ad]
Seat 1: Ramirres (button) folded before Flop (didn't bet)
Seat 2: BeeboXD (small blind) folded before Flop
Seat 3: sopapunk (big blind) folded before Flop
Seat 5: Roogrid collected ($0.11)
Seat 6: NikoRamos14 folded on the River


PokerStars Hand #238160905720:  Hold'em No Limit ($0.01/$0.02 USD) - 2022/08/22 23:29:23 ET
Table 'Achilles IV' 6-max Seat #2 is the button
Seat 1: Ramirres ($3.17 in chips)
Seat 2: BeeboXD ($2.27 in chips)
Seat 3: sopapunk ($2 in chips)
Seat 4: kcarrion30 ($3.75 in chips)
Seat 5: Roogrid ($1.22 in chips)
Seat 6: NikoRamos14 ($2.12 in chips)
sopapunk: posts small blind $0.01
kcarrion30: posts big blind $0.02
*** HOLE CARDS ***
Roogrid: folds
NikoRamos14: calls $0.02
Ramirres: folds
BeeboXD: raises $0.08 to $0.10
sopapunk: raises $0.20 to $0.30
kcarrion30: folds
NikoRamos14: folds
BeeboXD: folds
Uncalled bet ($0.20) returned to sopapunk
sopapunk collected $0.24 from pot
sopapunk: doesn't show hand
*** SUMMARY ***
Total pot $0.24 | Rake $0
Seat 1: Ramirres folded before Flop (didn't bet)
Seat 2: BeeboXD (button) folded before Flop
Seat 3: sopapunk (small blind) collected ($0.24)
Seat 4: kcarrion30 (big blind) folded before Flop
Seat 5: Roogrid folded before Flop (didn't bet)
Seat 6: NikoRamos14 folded before Flop


PokerStars Hand #238160911024:  Hold'em No Limit ($0.01/$0.02 USD) - 2022/08/22 23:29:59 ET
Table 'Achilles IV' 6-max Seat #3 is the button
Seat 1: Ramirres ($3.17 in chips)
Seat 2: BeeboXD ($2.17 in chips)
Seat 3: sopapunk ($2.14 in chips)
Seat 4: kcarrion30 ($3.73 in chips)
Seat 5: Roogrid ($1.22 in chips)
Seat 6: NikoRamos14 ($2.10 in chips)
kcarrion30: posts small blind $0.01
Roogrid: posts big blind $0.02
*** HOLE CARDS ***
NikoRamos14: folds
Ramirres: folds
BeeboXD: raises $0.04 to $0.06
sopapunk: folds
kcarrion30: calls $0.05
Roogrid: folds
*** FLOP *** [Ah Td 5h]
kcarrion30: checks
BeeboXD: checks
*** TURN *** [Ah Td 5h] [4s]
kcarrion30: bets $0.06
BeeboXD: calls $0.06
*** RIVER *** [Ah Td 5h 4s] [7d]
kcarrion30: checks
BeeboXD: checks
*** SHOW DOWN ***
kcarrion30: shows [Jc 8h] (high card Ace)
BeeboXD: shows [Js Ts] (a pair of Tens)
BeeboXD collected $0.25 from pot
*** SUMMARY ***
Total pot $0.26 | Rake $0.01
Board [Ah Td 5h 4s 7d]
Seat 1: Ramirres folded before Flop (didn't bet)
Seat 2: BeeboXD showed [Js Ts] and won ($0.25) with a pair of Tens
Seat 3: sopapunk (button) folded before Flop (didn't bet)
Seat 4: kcarrion30 (small blind) showed [Jc 8h] and lost with high card Ace
Seat 5: Roogrid (big blind) folded before Flop
Seat 6: NikoRamos14 folded before Flop (didn't bet)


PokerStars Hand #238160923744:  Hold'em No Limit ($0.01/$0.02 USD) - 2022/08/22 23:31:24 ET
Table 'Achilles IV' 6-max Seat #4 is the button
Seat 1: Ramirres ($3.17 in chips)
Seat 2: BeeboXD ($2.30 in chips)
Seat 3: sopapunk ($2.14 in chips)
Seat 4: kcarrion30 ($3.61 in chips)
Seat 5: Roogrid ($1.20 in chips)
Seat 6: NikoRamos14 ($2.10 in chips)
Roogrid: posts small blind $0.01
NikoRamos14: posts big blind $0.02
*** HOLE CARDS ***
Ramirres: folds
BeeboXD: folds
sopapunk: folds
kcarrion30: folds
Roogrid: raises $0.02 to $0.04
NikoRamos14: calls $0.02
*** FLOP *** [6s 8c Ad]
Roogrid: checks
NikoRamos14: checks
*** TURN *** [6s 8c Ad] [Kd]
Roogrid: checks
NikoRamos14: bets $0.08
Roogrid: calls $0.08
*** RIVER *** [6s 8c Ad Kd] [Jh]
Roogrid: bets $0.02
NikoRamos14: calls $0.02
*** SHOW DOWN ***
Roogrid: shows [7d 6d] (a pair of Sixes)
NikoRamos14: shows [8h 7h] (a pair of Eights)
NikoRamos14 collected $0.27 from pot
*** SUMMARY ***
Total pot $0.28 | Rake $0.01
Board [6s 8c Ad Kd Jh]
Seat 1: Ramirres folded before Flop (didn't bet)
Seat 2: BeeboXD folded before Flop (didn't bet)
Seat 3: sopapunk folded before Flop (didn't bet)
Seat 4: kcarrion30 (button) folded before Flop (didn't bet)
Seat 5: Roogrid (small blind) showed [7d 6d] and lost with a pair of Sixes
Seat 6: NikoRamos14 (big blind) showed [8h 7h] and won ($0.27) with a pair of Eights


PokerStars Hand #238160929853:  Hold'em No Limit ($0.01/$0.02 USD) - 2022/08/22 23:32:05 ET
Table 'Achilles IV' 6-max Seat #5 is the button
Seat 2: BeeboXD ($2.30 in chips)
Seat 3: sopapunk ($2.14 in chips)
Seat 4: kcarrion30 ($3.61 in chips)
Seat 5: Roogrid ($1.06 in chips)
Seat 6: NikoRamos14 ($2.23 in chips)
NikoRamos14: posts small blind $0.01
Ramirres: is sitting out
Ramirres leaves the table
BeeboXD: posts big blind $0.02
*** HOLE CARDS ***
sopapunk: folds
kcarrion30: folds
Roogrid: folds
NikoRamos14: calls $0.01
BeeboXD: checks
*** FLOP *** [3h Ah 7s]
NikoRamos14: checks
BeeboXD: checks
*** TURN *** [3h Ah 7s] [Kc]
Andy Oldani joins the table at seat #1
NikoRamos14: bets $0.04
BeeboXD: folds
Uncalled bet ($0.04) returned to NikoRamos14
NikoRamos14 collected $0.04 from pot
*** SUMMARY ***
Total pot $0.04 | Rake $0
Board [3h Ah 7s Kc]
Seat 2: BeeboXD (big blind) folded on the Turn
Seat 3: sopapunk folded before Flop (didn't bet)
Seat 4: kcarrion30 folded before Flop (didn't bet)
Seat 5: Roogrid (button) folded before Flop (didn't bet)
Seat 6: NikoRamos14 (small blind) collected ($0.04)


PokerStars Hand #238160934569:  Hold'em No Limit ($0.01/$0.02 USD) - 2022/08/22 23:32:37 ET
Table 'Achilles IV' 6-max Seat #6 is the button
Seat 2: BeeboXD ($2.28 in chips)
Seat 3: sopapunk ($2.14 in chips)
Seat 4: kcarrion30 ($3.61 in chips)
Seat 5: Roogrid ($1.06 in chips)
Seat 6: NikoRamos14 ($2.25 in chips)
BeeboXD: posts small blind $0.01
sopapunk: posts big blind $0.02
*** HOLE CARDS ***
kcarrion30: folds
Roogrid: raises $0.02 to $0.04
NikoRamos14: calls $0.04
BeeboXD: folds
sopapunk: calls $0.02
*** FLOP *** [6d 6c 2d]
sopapunk: checks
Roogrid: checks
NikoRamos14: checks
*** TURN *** [6d 6c 2d] [3s]
sopapunk: checks
Roogrid: checks
NikoRamos14: checks
*** RIVER *** [6d 6c 2d 3s] [4s]
sopapunk: checks
Roogrid: bets $0.02
NikoRamos14: raises $0.09 to $0.11
sopapunk: folds
Roogrid: folds
Uncalled bet ($0.09) returned to NikoRamos14
NikoRamos14 collected $0.16 from pot
NikoRamos14: doesn't show hand
*** SUMMARY ***
Total pot $0.17 | Rake $0.01
Board [6d 6c 2d 3s 4s]
Seat 2: BeeboXD (small blind) folded before Flop
Seat 3: sopapunk (big blind) folded on the River
Seat 4: kcarrion30 folded before Flop (didn't bet)
Seat 5: Roogrid folded on the River
Seat 6: NikoRamos14 (button) collected ($0.16)


PokerStars Hand #238160944990:  Hold'em No Limit ($0.01/$0.02 USD) - 2022/08/22 23:33:47 ET
Table 'Achilles IV' 6-max Seat #2 is the button
Seat 1: Andy Oldani ($2 in chips)
Seat 2: BeeboXD ($2.27 in chips)
Seat 3: sopapunk ($2.10 in chips)
Seat 4: kcarrion30 ($3.61 in chips)
Seat 5: Roogrid ($1 in chips)
Seat 6: NikoRamos14 ($2.35 in chips)
sopapunk: posts small blind $0.01
kcarrion30: posts big blind $0.02
Andy Oldani: posts big blind $0.02
*** HOLE CARDS ***
Roogrid: folds
NikoRamos14: folds
Andy Oldani: checks
BeeboXD: folds
sopapunk: raises $0.08 to $0.10
kcarrion30: folds
Andy Oldani: folds
Uncalled bet ($0.08) returned to sopapunk
sopapunk collected $0.06 from pot
sopapunk: doesn't show hand
*** SUMMARY ***
Total pot $0.06 | Rake $0
Seat 1: Andy Oldani folded before Flop (didn't bet)
Seat 2: BeeboXD (button) folded before Flop (didn't bet)
Seat 3: sopapunk (small blind) collected ($0.06)
Seat 4: kcarrion30 (big blind) folded before Flop
Seat 5: Roogrid folded before Flop (didn't bet)
Seat 6: NikoRamos14 folded before Flop (didn't bet)


PokerStars Hand #238160949462:  Hold'em No Limit ($0.01/$0.02 USD) - 2022/08/22 23:34:18 ET
Table 'Achilles IV' 6-max Seat #3 is the button
Seat 1: Andy Oldani ($2 in chips)
Seat 2: BeeboXD ($2.27 in chips)
Seat 3: sopapunk ($2.14 in chips)
Seat 4: kcarrion30 ($3.59 in chips)
Seat 5: Roogrid ($1 in chips)
Seat 6: NikoRamos14 ($2.35 in chips)
kcarrion30: posts small blind $0.01
Roogrid: posts big blind $0.02
*** HOLE CARDS ***
NikoRamos14: calls $0.02
Andy Oldani: folds
BeeboXD: folds
sopapunk: folds
kcarrion30: raises $0.04 to $0.06
Roogrid: folds
NikoRamos14: calls $0.04
*** FLOP *** [Jd Js 4h]
kcarrion30: checks
NikoRamos14: checks
*** TURN *** [Jd Js 4h] [Td]
kcarrion30: checks
NikoRamos14: checks
*** RIVER *** [Jd Js 4h Td] [3c]
kcarrion30: checks
NikoRamos14: bets $0.14
kcarrion30: calls $0.14
*** SHOW DOWN ***
NikoRamos14: shows [Jh 6h] (three of a kind, Jacks)
kcarrion30: mucks hand
NikoRamos14 collected $0.41 from pot
*** SUMMARY ***
Total pot $0.42 | Rake $0.01
Board [Jd Js 4h Td 3c]
Seat 1: Andy Oldani folded before Flop (didn't bet)
Seat 2: BeeboXD folded before Flop (didn't bet)
Seat 3: sopapunk (button) folded before Flop (didn't bet)
Seat 4: kcarrion30 (small blind) mucked
Seat 5: Roogrid (big blind) folded before Flop
Seat 6: NikoRamos14 showed [Jh 6h] and won ($0.41) with three of a kind, Jacks


PokerStars Hand #238160959715:  Hold'em No Limit ($0.01/$0.02 USD) - 2022/08/22 23:35:28 ET
Table 'Achilles IV' 6-max Seat #4 is the button
Seat 1: Andy Oldani ($2 in chips)
Seat 2: BeeboXD ($2.27 in chips)
Seat 3: sopapunk ($2.14 in chips)
Seat 4: kcarrion30 ($3.39 in chips)
Seat 5: Roogrid ($0.98 in chips)
Seat 6: NikoRamos14 ($2.56 in chips)
Roogrid: posts small blind $0.01
NikoRamos14: posts big blind $0.02
*** HOLE CARDS ***
Andy Oldani: raises $0.04 to $0.06
BeeboXD: folds
sopapunk: folds
kcarrion30: folds
Roogrid: folds
NikoRamos14: calls $0.04
*** FLOP *** [8c 8d 5d]
NikoRamos14: checks
Andy Oldani: checks
*** TURN *** [8c 8d 5d] [9h]
NikoRamos14: bets $0.06
Andy Oldani: folds
Uncalled bet ($0.06) returned to NikoRamos14
NikoRamos14 collected $0.13 from pot
NikoRamos14: doesn't show hand
*** SUMMARY ***
Total pot $0.13 | Rake $0
Board [8c 8d 5d 9h]
Seat 1: Andy Oldani folded on the Turn
Seat 2: BeeboXD folded before Flop (didn't bet)
Seat 3: sopapunk folded before Flop (didn't bet)
Seat 4: kcarrion30 (button) folded before Flop (didn't bet)
Seat 5: Roogrid (small blind) folded before Flop
Seat 6: NikoRamos14 (big blind) collected ($0.13)


PokerStars Hand #238160970195:  Hold'em No Limit ($0.01/$0.02 USD) - 2022/08/22 23:36:11 ET
Table 'Achilles IV' 6-max Seat #5 is the button
Seat 1: Andy Oldani ($2 in chips)
Seat 2: BeeboXD ($2.27 in chips)
Seat 3: sopapunk ($2.14 in chips)
Seat 4: kcarrion30 ($3.39 in chips)
Seat 5: Roogrid ($0.97 in chips)
Seat 6: NikoRamos14 ($2.63 in chips)
NikoRamos14: posts small blind $0.01
Andy Oldani: posts big blind $0.02
*** HOLE CARDS ***
BeeboXD: folds
sopapunk: folds
kcarrion30: folds
Roogrid: folds
NikoRamos14: calls $0.01
Andy Oldani: checks
*** FLOP *** [5h 5d 7h]
NikoRamos14: checks
Andy Oldani: checks
*** TURN *** [5h 5d 7h] [Ac]
NikoRamos14: checks
Andy Oldani: checks
*** RIVER *** [5h 5d 7h Ac] [6h]
NikoRamos14: checks
Andy Oldani: checks
*** SHOW DOWN ***
NikoRamos14: shows [2h Td] (a pair of Fives)
Andy Oldani: shows [Kh 3d] (a pair of Fives - Ace+King kicker)
Andy Oldani collected $0.04 from pot
*** SUMMARY ***
Total pot $0.04 | Rake $0
Board [5h 5d 7h Ac 6h]
Seat 1: Andy Oldani (big blind) showed [Kh 3d] and won ($0.04) with a pair of Fives
Seat 2: BeeboXD folded before Flop (didn't bet)
Seat 3: sopapunk folded before Flop (didn't bet)
Seat 4: kcarrion30 folded before Flop (didn't bet)
Seat 5: Roogrid (button) folded before Flop (didn't bet)
Seat 6: NikoRamos14 (small blind) showed [2h Td] and lost with a pair of Fives


PokerStars Hand #238160976751:  Hold'em No Limit ($0.01/$0.02 USD) - 2022/08/22 23:36:55 ET
Table 'Achilles IV' 6-max Seat #6 is the button
Seat 1: Andy Oldani ($2.02 in chips)
Seat 2: BeeboXD ($2.27 in chips)
Seat 3: sopapunk ($2.14 in chips)
Seat 4: kcarrion30 ($3.39 in chips)
Seat 5: Roogrid ($0.97 in chips)
Seat 6: NikoRamos14 ($2.61 in chips)
Andy Oldani: posts small blind $0.01
BeeboXD: posts big blind $0.02
*** HOLE CARDS ***
sopapunk: folds
kcarrion30: folds
Roogrid: raises $0.02 to $0.04
NikoRamos14: folds
Andy Oldani: folds
BeeboXD: calls $0.02
*** FLOP *** [Jh 5s 7s]
BeeboXD: checks
Roogrid: checks
*** TURN *** [Jh 5s 7s] [4c]
BeeboXD: bets $0.04
Roogrid: raises $0.04 to $0.08
BeeboXD: calls $0.04
*** RIVER *** [Jh 5s 7s 4c] [Ac]
BeeboXD: checks
Roogrid: bets $0.12
BeeboXD: calls $0.12
*** SHOW DOWN ***
Roogrid: shows [Qh 4h] (a pair of Fours)
BeeboXD: shows [6h As] (a pair of Aces)
BeeboXD collected $0.47 from pot
*** SUMMARY ***
Total pot $0.49 | Rake $0.02
Board [Jh 5s 7s 4c Ac]
Seat 1: Andy Oldani (small blind) folded before Flop
Seat 2: BeeboXD (big blind) showed [6h As] and won ($0.47) with a pair of Aces
Seat 3: sopapunk folded before Flop (didn't bet)
Seat 4: kcarrion30 folded before Flop (didn't bet)
Seat 5: Roogrid showed [Qh 4h] and lost with a pair of Fours
Seat 6: NikoRamos14 (button) folded before Flop (didn't bet)


PokerStars Hand #238160987921:  Hold'em No Limit ($0.01/$0.02 USD) - 2022/08/22 23:38:10 ET
Table 'Achilles IV' 6-max Seat #1 is the button
Seat 1: Andy Oldani ($2.01 in chips)
Seat 2: BeeboXD ($2.50 in chips)
Seat 3: sopapunk ($2.14 in chips)
Seat 4: kcarrion30 ($3.39 in chips)
Seat 5: Roogrid ($0.73 in chips)
Seat 6: NikoRamos14 ($2.61 in chips)
BeeboXD: posts small blind $0.01
sopapunk: posts big blind $0.02
*** HOLE CARDS ***
kcarrion30: folds
Roogrid: raises $0.02 to $0.04
NikoRamos14: folds
Andy Oldani: calls $0.04
BeeboXD: folds
sopapunk: folds
*** FLOP *** [9d 3c Ts]
Roogrid: checks
Andy Oldani: checks
*** TURN *** [9d 3c Ts] [Kh]
Roogrid: checks
Andy Oldani: checks
*** RIVER *** [9d 3c Ts Kh] [Tc]
Roogrid: bets $0.02
Andy Oldani: folds
Uncalled bet ($0.02) returned to Roogrid
Roogrid collected $0.11 from pot
Roogrid: doesn't show hand
*** SUMMARY ***
Total pot $0.11 | Rake $0
Board [9d 3c Ts Kh Tc]
Seat 1: Andy Oldani (button) folded on the River
Seat 2: BeeboXD (small blind) folded before Flop
Seat 3: sopapunk (big blind) folded before Flop
Seat 4: kcarrion30 folded before Flop (didn't bet)
Seat 5: Roogrid collected ($0.11)
Seat 6: NikoRamos14 folded before Flop (didn't bet)


PokerStars Hand #238160993087:  Hold'em No Limit ($0.01/$0.02 USD) - 2022/08/22 23:38:45 ET
Table 'Achilles IV' 6-max Seat #2 is the button
Seat 1: Andy Oldani ($2 in chips)
Seat 2: BeeboXD ($2.49 in chips)
Seat 3: sopapunk ($2.12 in chips)
Seat 4: kcarrion30 ($3.39 in chips)
Seat 5: Roogrid ($0.80 in chips)
Seat 6: NikoRamos14 ($2.61 in chips)
sopapunk: posts small blind $0.01
kcarrion30: posts big blind $0.02
*** HOLE CARDS ***
Roogrid: folds
NikoRamos14: calls $0.02
Andy Oldani: folds
BeeboXD: folds
sopapunk: folds
kcarrion30: checks
*** FLOP *** [4h 6c Jd]
kcarrion30: checks
NikoRamos14: checks
*** TURN *** [4h 6c Jd] [2h]
kcarrion30: checks
NikoRamos14: checks
*** RIVER *** [4h 6c Jd 2h] [2s]
kcarrion30: checks
NikoRamos14: bets $0.05
kcarrion30: folds
Uncalled bet ($0.05) returned to NikoRamos14
NikoRamos14 collected $0.05 from pot
*** SUMMARY ***
Total pot $0.05 | Rake $0
Board [4h 6c Jd 2h 2s]
Seat 1: Andy Oldani folded before Flop (didn't bet)
Seat 2: BeeboXD (button) folded before Flop (didn't bet)
Seat 3: sopapunk (small blind) folded before Flop
Seat 4: kcarrion30 (big blind) folded on the River
Seat 5: Roogrid folded before Flop (didn't bet)
Seat 6: NikoRamos14 collected ($0.05)


PokerStars Hand #238160999522:  Hold'em No Limit ($0.01/$0.02 USD) - 2022/08/22 23:39:30 ET
Table 'Achilles IV' 6-max Seat #3 is the button
Seat 1: Andy Oldani ($2 in chips)
Seat 2: BeeboXD ($2.49 in chips)
Seat 3: sopapunk ($2.11 in chips)
Seat 4: kcarrion30 ($3.37 in chips)
Seat 5: Roogrid ($0.80 in chips)
Seat 6: NikoRamos14 ($2.64 in chips)
kcarrion30: posts small blind $0.01
Roogrid: posts big blind $0.02
*** HOLE CARDS ***
NikoRamos14: calls $0.02
Andy Oldani: folds
BeeboXD: folds
sopapunk: folds
kcarrion30: folds
Roogrid: checks
*** FLOP *** [7s 2c 8s]
Roogrid: checks
NikoRamos14: checks
*** TURN *** [7s 2c 8s] [Jh]
Roogrid: checks
NikoRamos14: checks
*** RIVER *** [7s 2c 8s Jh] [7c]
Roogrid: bets $0.02
NikoRamos14: folds
Uncalled bet ($0.02) returned to Roogrid
Roogrid collected $0.05 from pot
Roogrid: doesn't show hand
*** SUMMARY ***
Total pot $0.05 | Rake $0
Board [7s 2c 8s Jh 7c]
Seat 1: Andy Oldani folded before Flop (didn't bet)
Seat 2: BeeboXD folded before Flop (didn't bet)
Seat 3: sopapunk (button) folded before Flop (didn't bet)
Seat 4: kcarrion30 (small blind) folded before Flop
Seat 5: Roogrid (big blind) collected ($0.05)
Seat 6: NikoRamos14 folded on the River


PokerStars Hand #238161012334:  Hold'em No Limit ($0.01/$0.02 USD) - 2022/08/22 23:40:07 ET
Table 'Achilles IV' 6-max Seat #4 is the button
Seat 1: Andy Oldani ($2 in chips)
Seat 2: BeeboXD ($2.49 in chips)
Seat 3: sopapunk ($2.11 in chips)
Seat 4: kcarrion30 ($3.36 in chips)
Seat 5: Roogrid ($0.83 in chips)
Seat 6: NikoRamos14 ($2.62 in chips)
Roogrid: posts small blind $0.01
NikoRamos14: posts big blind $0.02
*** HOLE CARDS ***
Andy Oldani: folds
BeeboXD: raises $0.04 to $0.06
sopapunk: folds
kcarrion30: folds
Roogrid: raises $0.77 to $0.83 and is all-in
NikoRamos14: folds
BeeboXD: folds
Uncalled bet ($0.77) returned to Roogrid
Roogrid collected $0.14 from pot
Roogrid: doesn't show hand
*** SUMMARY ***
Total pot $0.14 | Rake $0
Seat 1: Andy Oldani folded before Flop (didn't bet)
Seat 2: BeeboXD folded before Flop
Seat 3: sopapunk folded before Flop (didn't bet)
Seat 4: kcarrion30 (button) folded before Flop (didn't bet)
Seat 5: Roogrid (small blind) collected ($0.14)
Seat 6: NikoRamos14 (big blind) folded before Flop


PokerStars Hand #238161015982:  Hold'em No Limit ($0.01/$0.02 USD) - 2022/08/22 23:40:33 ET
Table 'Achilles IV' 6-max Seat #5 is the button
Seat 1: Andy Oldani ($2 in chips)
Seat 2: BeeboXD ($2.43 in chips)
Seat 3: sopapunk ($2.11 in chips)
Seat 4: kcarrion30 ($3.36 in chips)
Seat 5: Roogrid ($0.91 in chips)
Seat 6: NikoRamos14 ($2.60 in chips)
NikoRamos14: posts small blind $0.01
Andy Oldani: posts big blind $0.02
*** HOLE CARDS ***
BeeboXD: folds
sopapunk: folds
kcarrion30: raises $0.04 to $0.06
Roogrid: folds
NikoRamos14: folds
Andy Oldani: calls $0.04
*** FLOP *** [5d Qs 8c]
Andy Oldani: checks
kcarrion30: bets $0.08
Andy Oldani: calls $0.08
*** TURN *** [5d Qs 8c] [2c]
Andy Oldani: checks
kcarrion30: bets $0.16
Andy Oldani: calls $0.16
*** RIVER *** [5d Qs 8c 2c] [Jc]
Andy Oldani: checks
kcarrion30: checks
*** SHOW DOWN ***
Andy Oldani: shows [Qh 9h] (a pair of Queens)
kcarrion30: mucks hand
Andy Oldani collected $0.59 from pot
*** SUMMARY ***
Total pot $0.61 | Rake $0.02
Board [5d Qs 8c 2c Jc]
Seat 1: Andy Oldani (big blind) showed [Qh 9h] and won ($0.59) with a pair of Queens
Seat 2: BeeboXD folded before Flop (didn't bet)
Seat 3: sopapunk folded before Flop (didn't bet)
Seat 4: kcarrion30 mucked
Seat 5: Roogrid (button) folded before Flop (didn't bet)
Seat 6: NikoRamos14 (small blind) folded before Flop


PokerStars Hand #238161024852:  Hold'em No Limit ($0.01/$0.02 USD) - 2022/08/22 23:41:35 ET
Table 'Achilles IV' 6-max Seat #6 is the button
Seat 1: Andy Oldani ($2.29 in chips)
Seat 2: BeeboXD ($2.43 in chips)
Seat 3: sopapunk ($2.11 in chips)
Seat 4: kcarrion30 ($3.06 in chips)
Seat 5: Roogrid ($0.91 in chips)
Seat 6: NikoRamos14 ($2.59 in chips)
Andy Oldani: posts small blind $0.01
BeeboXD: posts big blind $0.02
*** HOLE CARDS ***
sopapunk: folds
kcarrion30: raises $0.04 to $0.06
Roogrid: raises $0.85 to $0.91 and is all-in
NikoRamos14: folds
Andy Oldani: folds
BeeboXD: folds
kcarrion30: folds
Uncalled bet ($0.85) returned to Roogrid
Roogrid collected $0.15 from pot
Roogrid: doesn't show hand
*** SUMMARY ***
Total pot $0.15 | Rake $0
Seat 1: Andy Oldani (small blind) folded before Flop
Seat 2: BeeboXD (big blind) folded before Flop
Seat 3: sopapunk folded before Flop (didn't bet)
Seat 4: kcarrion30 folded before Flop
Seat 5: Roogrid collected ($0.15)
Seat 6: NikoRamos14 (button) folded before Flop (didn't bet)


PokerStars Hand #238161028182:  Hold'em No Limit ($0.01/$0.02 USD) - 2022/08/22 23:41:57 ET
Table 'Achilles IV' 6-max Seat #1 is the button
Seat 1: Andy Oldani ($2.28 in chips)
Seat 2: BeeboXD ($2.41 in chips)
Seat 3: sopapunk ($2.11 in chips)
Seat 4: kcarrion30 ($3 in chips)
Seat 5: Roogrid ($1 in chips)
Seat 6: NikoRamos14 ($2.59 in chips)
BeeboXD: posts small blind $0.01
sopapunk: posts big blind $0.02
*** HOLE CARDS ***
kcarrion30: raises $0.04 to $0.06
Roogrid: folds
NikoRamos14: calls $0.06
Andy Oldani: folds
BeeboXD: folds
sopapunk: folds
*** FLOP *** [3s 7d Ts]
kcarrion30: checks
NikoRamos14: checks
*** TURN *** [3s 7d Ts] [Qh]
kcarrion30: checks
NikoRamos14: checks
*** RIVER *** [3s 7d Ts Qh] [Qd]
kcarrion30: checks
NikoRamos14: bets $0.14
kcarrion30: folds
Uncalled bet ($0.14) returned to NikoRamos14
NikoRamos14 collected $0.14 from pot
NikoRamos14: doesn't show hand
*** SUMMARY ***
Total pot $0.15 | Rake $0.01
Board [3s 7d Ts Qh Qd]
Seat 1: Andy Oldani (button) folded before Flop (didn't bet)
Seat 2: BeeboXD (small blind) folded before Flop
Seat 3: sopapunk (big blind) folded before Flop
Seat 4: kcarrion30 folded on the River
Seat 5: Roogrid folded before Flop (didn't bet)
Seat 6: NikoRamos14 collected ($0.14)


PokerStars Hand #238161033693:  Hold'em No Limit ($0.01/$0.02 USD) - 2022/08/22 23:42:36 ET
Table 'Achilles IV' 6-max Seat #2 is the button
Seat 1: Andy Oldani ($2.28 in chips)
Seat 2: BeeboXD ($2.40 in chips)
Seat 3: sopapunk ($2.09 in chips)
Seat 4: kcarrion30 ($2.94 in chips)
Seat 5: Roogrid ($1 in chips)
Seat 6: NikoRamos14 ($2.67 in chips)
sopapunk: posts small blind $0.01
kcarrion30: posts big blind $0.02
*** HOLE CARDS ***
Roogrid: folds
NikoRamos14: folds
Andy Oldani: folds
BeeboXD: folds
sopapunk: raises $0.04 to $0.06
kcarrion30: calls $0.04
*** FLOP *** [3h As 4s]
sopapunk: bets $0.09
kcarrion30: calls $0.09
*** TURN *** [3h As 4s] [8s]
sopapunk: checks
kcarrion30: checks
*** RIVER *** [3h As 4s 8s] [3d]
sopapunk: checks
kcarrion30: bets $0.10
sopapunk: folds
Uncalled bet ($0.10) returned to kcarrion30
kcarrion30 collected $0.29 from pot
*** SUMMARY ***
Total pot $0.30 | Rake $0.01
Board [3h As 4s 8s 3d]
Seat 1: Andy Oldani folded before Flop (didn't bet)
Seat 2: BeeboXD (button) folded before Flop (didn't bet)
Seat 3: sopapunk (small blind) folded on the River
Seat 4: kcarrion30 (big blind) collected ($0.29)
Seat 5: Roogrid folded before Flop (didn't bet)
Seat 6: NikoRamos14 folded before Flop (didn't bet)


PokerStars Hand #238161043254:  Hold'em No Limit ($0.01/$0.02 USD) - 2022/08/22 23:43:43 ET
Table 'Achilles IV' 6-max Seat #3 is the button
Seat 1: Andy Oldani ($2.28 in chips)
Seat 2: BeeboXD ($2.40 in chips)
Seat 3: sopapunk ($2 in chips)
Seat 4: kcarrion30 ($3.08 in chips)
Seat 5: Roogrid ($1 in chips)
Seat 6: NikoRamos14 ($2.67 in chips)
kcarrion30: posts small blind $0.01
Roogrid: posts big blind $0.02
*** HOLE CARDS ***
NikoRamos14: calls $0.02
Andy Oldani: folds
BeeboXD: folds
sopapunk: raises $0.08 to $0.10
kcarrion30: calls $0.09
Roogrid: folds
NikoRamos14: calls $0.08
*** FLOP *** [Ks Td 3h]
kcarrion30: checks
NikoRamos14: checks
sopapunk: checks
*** TURN *** [Ks Td 3h] [Qs]
kcarrion30: checks
NikoRamos14: bets $0.15
sopapunk: raises $0.25 to $0.40
kcarrion30: folds
NikoRamos14: calls $0.25
*** RIVER *** [Ks Td 3h Qs] [As]
NikoRamos14: checks
sopapunk: checks
*** SHOW DOWN ***
NikoRamos14: shows [5s 9s] (a flush, Ace high)
sopapunk: mucks hand
NikoRamos14 collected $1.08 from pot
*** SUMMARY ***
Total pot $1.12 | Rake $0.04
Board [Ks Td 3h Qs As]
Seat 1: Andy Oldani folded before Flop (didn't bet)
Seat 2: BeeboXD folded before Flop (didn't bet)
Seat 3: sopapunk (button) mucked
Seat 4: kcarrion30 (small blind) folded on the Turn
Seat 5: Roogrid (big blind) folded before Flop
Seat 6: NikoRamos14 showed [5s 9s] and won ($1.08) with a flush, Ace high


PokerStars Hand #238161054059:  Hold'em No Limit ($0.01/$0.02 USD) - 2022/08/22 23:44:59 ET
Table 'Achilles IV' 6-max Seat #4 is the button
Seat 1: Andy Oldani ($2.28 in chips)
Seat 2: BeeboXD ($2.40 in chips)
Seat 3: sopapunk ($2 in chips)
Seat 4: kcarrion30 ($2.98 in chips)
Seat 5: Roogrid ($0.98 in chips)
Seat 6: NikoRamos14 ($3.25 in chips)
Roogrid: posts small blind $0.01
NikoRamos14: posts big blind $0.02
*** HOLE CARDS ***
Andy Oldani: folds
BeeboXD: folds
sopapunk: raises $0.03 to $0.05
kcarrion30: folds
Roogrid: calls $0.04
NikoRamos14: folds
*** FLOP *** [6c As Qs]
Roogrid: checks
sopapunk: bets $0.09
Roogrid: raises $0.09 to $0.18
sopapunk: calls $0.09
*** TURN *** [6c As Qs] [8d]
Roogrid: bets $0.23
sopapunk: raises $0.63 to $0.86
Roogrid: calls $0.52 and is all-in
Uncalled bet ($0.11) returned to sopapunk
*** RIVER *** [6c As Qs 8d] [5d]
*** SHOW DOWN ***
Roogrid: shows [4s Ah] (a pair of Aces)
sopapunk: shows [8c 8s] (three of a kind, Eights)
sopapunk collected $1.91 from pot
*** SUMMARY ***
Total pot $1.98 | Rake $0.07
Board [6c As Qs 8d 5d]
Seat 1: Andy Oldani folded before Flop (didn't bet)
Seat 2: BeeboXD folded before Flop (didn't bet)
Seat 3: sopapunk showed [8c 8s] and won ($1.91) with three of a kind, Eights
Seat 4: kcarrion30 (button) folded before Flop (didn't bet)
Seat 5: Roogrid (small blind) showed [4s Ah] and lost with a pair of Aces
Seat 6: NikoRamos14 (big blind) folded before Flop


PokerStars Hand #238161061998:  Hold'em No Limit ($0.01/$0.02 USD) - 2022/08/22 23:45:54 ET
Table 'Achilles IV' 6-max Seat #6 is the button
Seat 1: Andy Oldani ($2.28 in chips)
Seat 2: BeeboXD ($2.40 in chips)
Seat 3: sopapunk ($2.93 in chips)
Seat 4: kcarrion30 ($2.98 in chips)
Seat 6: NikoRamos14 ($3.23 in chips)
Andy Oldani: posts small blind $0.01
BeeboXD: posts big blind $0.02
*** HOLE CARDS ***
sopapunk: folds
Roogrid is disconnected
kcarrion30: raises $0.04 to $0.06
NikoRamos14: calls $0.06
Andy Oldani: folds
BeeboXD: folds
*** FLOP *** [Qc 3c Js]
kcarrion30: bets $0.09
NikoRamos14: folds
Uncalled bet ($0.09) returned to kcarrion30
kcarrion30 collected $0.14 from pot
*** SUMMARY ***
Total pot $0.15 | Rake $0.01
Board [Qc 3c Js]
Seat 1: Andy Oldani (small blind) folded before Flop
Seat 2: BeeboXD (big blind) folded before Flop
Seat 3: sopapunk folded before Flop (didn't bet)
Seat 4: kcarrion30 collected ($0.14)
Seat 6: NikoRamos14 (button) folded on the Flop


PokerStars Hand #238161067614:  Hold'em No Limit ($0.01/$0.02 USD) - 2022/08/22 23:46:34 ET
Table 'Achilles IV' 6-max Seat #1 is the button
Seat 1: Andy Oldani ($2.27 in chips)
Seat 2: BeeboXD ($2.38 in chips)
Seat 3: sopapunk ($2.93 in chips)
Seat 4: kcarrion30 ($3.06 in chips)
Seat 6: NikoRamos14 ($3.17 in chips)
BeeboXD: posts small blind $0.01
sopapunk: posts big blind $0.02
*** HOLE CARDS ***
kcarrion30: folds
NikoRamos14: calls $0.02
Andy Oldani: folds
BeeboXD: folds
sopapunk: checks
*** FLOP *** [5s Qc Kc]
sopapunk: checks
NikoRamos14: checks
*** TURN *** [5s Qc Kc] [5d]
sopapunk: checks
NikoRamos14: checks
*** RIVER *** [5s Qc Kc 5d] [8c]
sopapunk: checks
NikoRamos14: bets $0.05
sopapunk: folds
Uncalled bet ($0.05) returned to NikoRamos14
NikoRamos14 collected $0.05 from pot
NikoRamos14: doesn't show hand
*** SUMMARY ***
Total pot $0.05 | Rake $0
Board [5s Qc Kc 5d 8c]
Seat 1: Andy Oldani (button) folded before Flop (didn't bet)
Seat 2: BeeboXD (small blind) folded before Flop
Seat 3: sopapunk (big blind) folded on the River
Seat 4: kcarrion30 folded before Flop (didn't bet)
Seat 6: NikoRamos14 collected ($0.05)


PokerStars Hand #238161073339:  Hold'em No Limit ($0.01/$0.02 USD) - 2022/08/22 23:47:15 ET
Table 'Achilles IV' 6-max Seat #2 is the button
Seat 1: Andy Oldani ($2.27 in chips)
Seat 2: BeeboXD ($2.37 in chips)
Seat 3: sopapunk ($2.91 in chips)
Seat 4: kcarrion30 ($3.06 in chips)
Seat 6: NikoRamos14 ($3.20 in chips)
sopapunk: posts small blind $0.01
kcarrion30: posts big blind $0.02
*** HOLE CARDS ***
NikoRamos14: calls $0.02
Andy Oldani: folds
BeeboXD: raises $0.08 to $0.10
sopapunk: folds
kcarrion30: calls $0.08
NikoRamos14: calls $0.08
*** FLOP *** [Th 3c 9h]
kcarrion30: checks
NikoRamos14: checks
BeeboXD: bets $0.21
kcarrion30: folds
NikoRamos14: folds
Uncalled bet ($0.21) returned to BeeboXD
BeeboXD collected $0.30 from pot
*** SUMMARY ***
Total pot $0.31 | Rake $0.01
Board [Th 3c 9h]
Seat 1: Andy Oldani folded before Flop (didn't bet)
Seat 2: BeeboXD (button) collected ($0.30)
Seat 3: sopapunk (small blind) folded before Flop
Seat 4: kcarrion30 (big blind) folded on the Flop
Seat 6: NikoRamos14 folded on the Flop


PokerStars Hand #238161086152:  Hold'em No Limit ($0.01/$0.02 USD) - 2022/08/22 23:48:11 ET
Table 'Achilles IV' 6-max Seat #3 is the button
Seat 1: Andy Oldani ($2.27 in chips)
Seat 2: BeeboXD ($2.57 in chips)
Seat 3: sopapunk ($2.90 in chips)
Seat 4: kcarrion30 ($2.96 in chips)
Seat 6: NikoRamos14 ($3.10 in chips)
kcarrion30: posts small blind $0.01
NikoRamos14: posts big blind $0.02
*** HOLE CARDS ***
Andy Oldani: folds
BeeboXD: raises $0.04 to $0.06
sopapunk: folds
kcarrion30: folds
NikoRamos14: calls $0.04
*** FLOP *** [9d Js Qc]
NikoRamos14: checks
BeeboXD: bets $0.04
NikoRamos14: folds
Uncalled bet ($0.04) returned to BeeboXD
BeeboXD collected $0.13 from pot
*** SUMMARY ***
Total pot $0.13 | Rake $0
Board [9d Js Qc]
Seat 1: Andy Oldani folded before Flop (didn't bet)
Seat 2: BeeboXD collected ($0.13)
Seat 3: sopapunk (button) folded before Flop (didn't bet)
Seat 4: kcarrion30 (small blind) folded before Flop
Seat 6: NikoRamos14 (big blind) folded on the Flop


PokerStars Hand #238161096743:  Hold'em No Limit ($0.01/$0.02 USD) - 2022/08/22 23:49:25 ET
Table 'Achilles IV' 6-max Seat #6 is the button
Seat 1: Andy Oldani ($2.25 in chips)
Seat 2: BeeboXD ($2.64 in chips)
Seat 3: sopapunk ($2.98 in chips)
Seat 4: kcarrion30 ($2.90 in chips)
Seat 6: NikoRamos14 ($3.03 in chips)
Andy Oldani: posts small blind $0.01
BeeboXD: posts big blind $0.02
*** HOLE CARDS ***
sopapunk: folds
kcarrion30: folds
NikoRamos14: calls $0.02
Andy Oldani: calls $0.01
BeeboXD: raises $0.12 to $0.14
NikoRamos14: folds
Andy Oldani: folds
Uncalled bet ($0.12) returned to BeeboXD
BeeboXD collected $0.06 from pot
*** SUMMARY ***
Total pot $0.06 | Rake $0
Seat 1: Andy Oldani (small blind) folded before Flop
Seat 2: BeeboXD (big blind) collected ($0.06)
Seat 3: sopapunk folded before Flop (didn't bet)
Seat 4: kcarrion30 folded before Flop (didn't bet)
Seat 6: NikoRamos14 (button) folded before Flop


PokerStars Hand #238161101194:  Hold'em No Limit ($0.01/$0.02 USD) - 2022/08/22 23:49:57 ET
Table 'Achilles IV' 6-max Seat #1 is the button
Seat 1: Andy Oldani ($2.23 in chips)
Seat 2: BeeboXD ($2.68 in chips)
Seat 3: sopapunk ($2.98 in chips)
Seat 4: kcarrion30 ($2.90 in chips)
Seat 6: NikoRamos14 ($3.01 in chips)
BeeboXD: posts small blind $0.01
sopapunk: posts big blind $0.02
*** HOLE CARDS ***
kcarrion30: folds
NikoRamos14: calls $0.02
Andy Oldani: folds
BeeboXD: raises $0.10 to $0.12
sopapunk: folds
NikoRamos14: folds
Uncalled bet ($0.10) returned to BeeboXD
BeeboXD collected $0.06 from pot
*** SUMMARY ***
Total pot $0.06 | Rake $0
Seat 1: Andy Oldani (button) folded before Flop (didn't bet)
Seat 2: BeeboXD (small blind) collected ($0.06)
Seat 3: sopapunk (big blind) folded before Flop
Seat 4: kcarrion30 folded before Flop (didn't bet)
Seat 6: NikoRamos14 folded before Flop


PokerStars Hand #238161121769:  Hold'em No Limit ($0.01/$0.02 USD) - 2022/08/22 23:52:21 ET
Table 'Achilles IV' 6-max Seat #3 is the button
Seat 1: Andy Oldani ($2.23 in chips)
Seat 3: sopapunk ($5.66 in chips)
Seat 4: kcarrion30 ($2.72 in chips)
Seat 6: NikoRamos14 ($2.99 in chips)
kcarrion30: posts small blind $0.01
NikoRamos14: posts big blind $0.02
*** HOLE CARDS ***
Andy Oldani: folds
sopapunk: folds
kcarrion30: folds
Uncalled bet ($0.01) returned to NikoRamos14
NikoRamos14 collected $0.02 from pot
*** SUMMARY ***
Total pot $0.02 | Rake $0
Seat 1: Andy Oldani folded before Flop (didn't bet)
Seat 3: sopapunk (button) folded before Flop (didn't bet)
Seat 4: kcarrion30 (small blind) folded before Flop
Seat 6: NikoRamos14 (big blind) collected ($0.02)


PokerStars Hand #238161105439:  Hold'em No Limit ($0.01/$0.02 USD) - 2022/08/22 23:50:27 ET
Table 'Achilles IV' 6-max Seat #2 is the button
Seat 1: Andy Oldani ($2.23 in chips)
Seat 2: BeeboXD ($2.72 in chips)
Seat 3: sopapunk ($2.96 in chips)
Seat 4: kcarrion30 ($2.90 in chips)
Seat 6: NikoRamos14 ($2.99 in chips)
sopapunk: posts small blind $0.01
kcarrion30: posts big blind $0.02
*** HOLE CARDS ***
NikoRamos14: folds
Andy Oldani: folds
BeeboXD: raises $0.04 to $0.06
sopapunk: raises $0.12 to $0.18
kcarrion30: calls $0.16
BeeboXD: calls $0.12
*** FLOP *** [Qd Ah 9s]
sopapunk: bets $0.18
kcarrion30: folds
BeeboXD: calls $0.18
*** TURN *** [Qd Ah 9s] [7c]
sopapunk: bets $0.65
BeeboXD: calls $0.65
*** RIVER *** [Qd Ah 9s 7c] [3c]
sopapunk: bets $1.95 and is all-in
BeeboXD: calls $1.71 and is all-in
Uncalled bet ($0.24) returned to sopapunk
*** SHOW DOWN ***
sopapunk: shows [As Ad] (three of a kind, Aces)
BeeboXD: shows [Qc Ac] (two pair, Aces and Queens)
sopapunk collected $5.42 from pot
*** SUMMARY ***
Total pot $5.62 | Rake $0.20
Board [Qd Ah 9s 7c 3c]
Seat 1: Andy Oldani folded before Flop (didn't bet)
Seat 2: BeeboXD (button) showed [Qc Ac] and lost with two pair, Aces and Queens
Seat 3: sopapunk (small blind) showed [As Ad] and won ($5.42) with three of a kind, Aces
Seat 4: kcarrion30 (big blind) folded on the Flop
Seat 6: NikoRamos14 folded before Flop (didn't bet)


PokerStars Hand #238161123163:  Hold'em No Limit ($0.01/$0.02 USD) - 2022/08/22 23:52:31 ET
Table 'Achilles IV' 6-max Seat #4 is the button
Seat 1: Andy Oldani ($2.23 in chips)
Seat 3: sopapunk ($5.66 in chips)
Seat 4: kcarrion30 ($2.71 in chips)
Seat 6: NikoRamos14 ($3 in chips)
NikoRamos14: posts small blind $0.01
Andy Oldani: posts big blind $0.02
*** HOLE CARDS ***
sopapunk: folds
kcarrion30: folds
NikoRamos14: folds
Uncalled bet ($0.01) returned to Andy Oldani
Andy Oldani collected $0.02 from pot
Andy Oldani: doesn't show hand
*** SUMMARY ***
Total pot $0.02 | Rake $0
Seat 1: Andy Oldani (big blind) collected ($0.02)
Seat 3: sopapunk folded before Flop (didn't bet)
Seat 4: kcarrion30 (button) folded before Flop (didn't bet)
Seat 6: NikoRamos14 (small blind) folded before Flop


PokerStars Hand #238161125046:  Hold'em No Limit ($0.01/$0.02 USD) - 2022/08/22 23:52:44 ET
Table 'Achilles IV' 6-max Seat #6 is the button
Seat 1: Andy Oldani ($2.24 in chips)
Seat 3: sopapunk ($5.66 in chips)
Seat 4: kcarrion30 ($2.71 in chips)
Seat 6: NikoRamos14 ($2.99 in chips)
Andy Oldani: posts small blind $0.01
sopapunk: posts big blind $0.02
*** HOLE CARDS ***
kcarrion30: folds
NikoRamos14: calls $0.02
Andy Oldani: folds
sopapunk: checks
*** FLOP *** [2s Jd Ad]
sopapunk: checks
NikoRamos14: checks
*** TURN *** [2s Jd Ad] [9d]
sopapunk: checks
NikoRamos14: bets $0.05
sopapunk: folds
Uncalled bet ($0.05) returned to NikoRamos14
NikoRamos14 collected $0.05 from pot
NikoRamos14: doesn't show hand
*** SUMMARY ***
Total pot $0.05 | Rake $0
Board [2s Jd Ad 9d]
Seat 1: Andy Oldani (small blind) folded before Flop
Seat 3: sopapunk (big blind) folded on the Turn
Seat 4: kcarrion30 folded before Flop (didn't bet)
Seat 6: NikoRamos14 (button) collected ($0.05)


PokerStars Hand #238161130195:  Hold'em No Limit ($0.01/$0.02 USD) - 2022/08/22 23:53:21 ET
Table 'Achilles IV' 6-max Seat #1 is the button
Seat 1: Andy Oldani ($2.23 in chips)
Seat 3: sopapunk ($5.64 in chips)
Seat 4: kcarrion30 ($2.71 in chips)
Seat 6: NikoRamos14 ($3.02 in chips)
sopapunk: posts small blind $0.01
kcarrion30: posts big blind $0.02
*** HOLE CARDS ***
NikoRamos14: calls $0.02
Andy Oldani: folds
sopapunk: raises $0.10 to $0.12
kcarrion30: folds
NikoRamos14: folds
Uncalled bet ($0.10) returned to sopapunk
sopapunk collected $0.06 from pot
sopapunk: doesn't show hand
*** SUMMARY ***
Total pot $0.06 | Rake $0
Seat 1: Andy Oldani (button) folded before Flop (didn't bet)
Seat 3: sopapunk (small blind) collected ($0.06)
Seat 4: kcarrion30 (big blind) folded before Flop
Seat 6: NikoRamos14 folded before Flop


PokerStars Hand #238161132747:  Hold'em No Limit ($0.01/$0.02 USD) - 2022/08/22 23:53:39 ET
Table 'Achilles IV' 6-max Seat #3 is the button
Seat 1: Andy Oldani ($2.23 in chips)
Seat 3: sopapunk ($5.68 in chips)
Seat 4: kcarrion30 ($2.69 in chips)
Seat 6: NikoRamos14 ($3 in chips)
kcarrion30: posts small blind $0.01
NikoRamos14: posts big blind $0.02
*** HOLE CARDS ***
Andy Oldani: folds
sopapunk: folds
kcarrion30: folds
Uncalled bet ($0.01) returned to NikoRamos14
NikoRamos14 collected $0.02 from pot
NikoRamos14: doesn't show hand
*** SUMMARY ***
Total pot $0.02 | Rake $0
Seat 1: Andy Oldani folded before Flop (didn't bet)
Seat 3: sopapunk (button) folded before Flop (didn't bet)
Seat 4: kcarrion30 (small blind) folded before Flop
Seat 6: NikoRamos14 (big blind) collected ($0.02)


PokerStars Hand #238161134284:  Hold'em No Limit ($0.01/$0.02 USD) - 2022/08/22 23:53:51 ET
Table 'Achilles IV' 6-max Seat #4 is the button
Seat 1: Andy Oldani ($2.23 in chips)
Seat 2: BeeboXD ($2 in chips)
Seat 3: sopapunk ($5.68 in chips)
Seat 4: kcarrion30 ($2.68 in chips)
Seat 6: NikoRamos14 ($3.01 in chips)
NikoRamos14: posts small blind $0.01
Andy Oldani: posts big blind $0.02
BeeboXD: posts small & big blinds $0.03
*** HOLE CARDS ***
BeeboXD: checks
sopapunk: folds
kcarrion30: folds
NikoRamos14: folds
Andy Oldani: checks
*** FLOP *** [3c As 5c]
Andy Oldani: checks
NikoRamos14 leaves the table
BeeboXD: bets $0.04
Andy Oldani: folds
Uncalled bet ($0.04) returned to BeeboXD
BeeboXD collected $0.06 from pot
*** SUMMARY ***
Total pot $0.06 | Rake $0
Board [3c As 5c]
Seat 1: Andy Oldani (big blind) folded on the Flop
Seat 2: BeeboXD collected ($0.06)
Seat 3: sopapunk folded before Flop (didn't bet)
Seat 4: kcarrion30 (button) folded before Flop (didn't bet)
Seat 6: NikoRamos14 (small blind) folded before Flop


PokerStars Hand #238161138802:  Hold'em No Limit ($0.01/$0.02 USD) - 2022/08/22 23:54:23 ET
Table 'Achilles IV' 6-max Seat #1 is the button
Seat 1: Andy Oldani ($2.21 in chips)
Seat 2: BeeboXD ($2.03 in chips)
Seat 3: sopapunk ($5.68 in chips)
Seat 4: kcarrion30 ($2.68 in chips)
BeeboXD: posts small blind $0.01
sopapunk: posts big blind $0.02
*** HOLE CARDS ***
kcarrion30: folds
Andy Oldani: raises $0.04 to $0.06
BeeboXD: raises $0.18 to $0.24
sopapunk: folds
kcarrion30 leaves the table
Andy Oldani: calls $0.18
*** FLOP *** [Qc Kc 2d]
BeeboXD: checks
Andy Oldani: checks
*** TURN *** [Qc Kc 2d] [4c]
BeeboXD: checks
Andy Oldani: bets $0.10
BeeboXD: calls $0.10
*** RIVER *** [Qc Kc 2d 4c] [Ks]
NZcardplayer joins the table at seat #6
Kalliminoy joins the table at seat #4
BeeboXD: checks
Andy Oldani: checks
*** SHOW DOWN ***
BeeboXD: shows [Qh Ah] (two pair, Kings and Queens)
Andy Oldani: mucks hand
BeeboXD collected $0.68 from pot
*** SUMMARY ***
Total pot $0.70 | Rake $0.02
Board [Qc Kc 2d 4c Ks]
Seat 1: Andy Oldani (button) mucked
Seat 2: BeeboXD (small blind) showed [Qh Ah] and won ($0.68) with two pair, Kings and Queens
Seat 3: sopapunk (big blind) folded before Flop
Seat 4: kcarrion30 folded before Flop (didn't bet)


PokerStars Hand #238161149837:  Hold'em No Limit ($0.01/$0.02 USD) - 2022/08/22 23:55:48 ET
Table 'Achilles IV' 6-max Seat #2 is the button
Seat 1: Andy Oldani ($2 in chips)
Seat 2: BeeboXD ($2.37 in chips)
Seat 3: sopapunk ($5.66 in chips)
Seat 4: Kalliminoy ($1.60 in chips)
sopapunk: posts small blind $0.01
Kalliminoy: posts big blind $0.02
NZcardplayer: sits out
*** HOLE CARDS ***
Andy Oldani: raises $0.04 to $0.06
BeeboXD: folds
Roogrid was removed from the table for failing to post
Roogrid leaves the table
sopapunk: folds
Kalliminoy: calls $0.04
*** FLOP *** [5d 9c 3d]
Kalliminoy: bets $0.07
Andy Oldani: raises $0.13 to $0.20
Kalliminoy: calls $0.13
*** TURN *** [5d 9c 3d] [2s]
Kalliminoy: checks
Andy Oldani: bets $0.30
Kalliminoy: folds
Uncalled bet ($0.30) returned to Andy Oldani
Andy Oldani collected $0.51 from pot
Andy Oldani: doesn't show hand
*** SUMMARY ***
Total pot $0.53 | Rake $0.02
Board [5d 9c 3d 2s]
Seat 1: Andy Oldani collected ($0.51)
Seat 2: BeeboXD (button) folded before Flop (didn't bet)
Seat 3: sopapunk (small blind) folded before Flop
Seat 4: Kalliminoy (big blind) folded on the Turn


PokerStars Hand #238161160714:  Hold'em No Limit ($0.01/$0.02 USD) - 2022/08/22 23:57:19 ET
Table 'Achilles IV' 6-max Seat #6 is the button
Seat 1: Andy Oldani ($2.37 in chips)
Seat 2: BeeboXD ($2.37 in chips)
Seat 3: sopapunk ($5.65 in chips)
Seat 6: NZcardplayer ($0.87 in chips)
Andy Oldani: posts small blind $0.01
BeeboXD: posts big blind $0.02
cordobes555: sits out
HenriquimDelas: sits out
*** HOLE CARDS ***
sopapunk: folds
NZcardplayer: folds
Andy Oldani: folds
Uncalled bet ($0.01) returned to BeeboXD
BeeboXD collected $0.02 from pot
*** SUMMARY ***
Total pot $0.02 | Rake $0
Seat 1: Andy Oldani (small blind) folded before Flop
Seat 2: BeeboXD (big blind) collected ($0.02)
Seat 3: sopapunk folded before Flop (didn't bet)
Seat 6: NZcardplayer (button) folded before Flop (didn't bet)


PokerStars Hand #238161155142:  Hold'em No Limit ($0.01/$0.02 USD) - 2022/08/22 23:56:33 ET
Table 'Achilles IV' 6-max Seat #3 is the button
Seat 1: Andy Oldani ($2.25 in chips)
Seat 2: BeeboXD ($2.37 in chips)
Seat 3: sopapunk ($5.65 in chips)
Seat 4: Kalliminoy ($1.34 in chips)
Seat 6: NZcardplayer ($0.99 in chips)
Kalliminoy: posts small blind $0.01
NZcardplayer: posts big blind $0.02
*** HOLE CARDS ***
Andy Oldani: raises $0.04 to $0.06
BeeboXD: folds
sopapunk: folds
Kalliminoy: folds
NZcardplayer: calls $0.04
*** FLOP *** [7s Qc Ah]
Kalliminoy leaves the table
NZcardplayer: checks
Andy Oldani: bets $0.06
NZcardplayer: calls $0.06
*** TURN *** [7s Qc Ah] [5c]
NZcardplayer: checks
Andy Oldani: checks
*** RIVER *** [7s Qc Ah 5c] [Kh]
HenriquimDelas joins the table at seat #5
cordobes555 joins the table at seat #4
NZcardplayer: checks
Andy Oldani: checks
*** SHOW DOWN ***
NZcardplayer: shows [4d 7d] (a pair of Sevens)
Andy Oldani: shows [6d Ad] (a pair of Aces)
Andy Oldani collected $0.24 from pot
*** SUMMARY ***
Total pot $0.25 | Rake $0.01
Board [7s Qc Ah 5c Kh]
Seat 1: Andy Oldani showed [6d Ad] and won ($0.24) with a pair of Aces
Seat 2: BeeboXD folded before Flop (didn't bet)
Seat 3: sopapunk (button) folded before Flop (didn't bet)
Seat 4: Kalliminoy (small blind) folded before Flop
Seat 6: NZcardplayer (big blind) showed [4d 7d] and lost with a pair of Sevens


PokerStars Hand #238161161861:  Hold'em No Limit ($0.01/$0.02 USD) - 2022/08/22 23:57:29 ET
Table 'Achilles IV' 6-max Seat #1 is the button
Seat 1: Andy Oldani ($2.36 in chips)
Seat 2: BeeboXD ($2.38 in chips)
Seat 3: sopapunk ($5.65 in chips)
Seat 6: NZcardplayer ($0.87 in chips)
BeeboXD: posts small blind $0.01
sopapunk: posts big blind $0.02
cordobes555: sits out
HenriquimDelas: sits out
*** HOLE CARDS ***
NZcardplayer: raises $0.08 to $0.10
Andy Oldani: folds
BeeboXD: folds
sopapunk: folds
Uncalled bet ($0.08) returned to NZcardplayer
NZcardplayer collected $0.05 from pot
NZcardplayer: doesn't show hand
*** SUMMARY ***
Total pot $0.05 | Rake $0
Seat 1: Andy Oldani (button) folded before Flop (didn't bet)
Seat 2: BeeboXD (small blind) folded before Flop
Seat 3: sopapunk (big blind) folded before Flop
Seat 6: NZcardplayer collected ($0.05)


PokerStars Hand #238161164410:  Hold'em No Limit ($0.01/$0.02 USD) - 2022/08/22 23:57:50 ET
Table 'Achilles IV' 6-max Seat #2 is the button
Seat 1: Andy Oldani ($2.36 in chips)
Seat 2: BeeboXD ($2.37 in chips)
Seat 3: sopapunk ($5.63 in chips)
Seat 4: cordobes555 ($2 in chips)
Seat 6: NZcardplayer ($0.90 in chips)
sopapunk: posts small blind $0.01
cordobes555: posts big blind $0.02
HenriquimDelas: sits out
*** HOLE CARDS ***
NZcardplayer: folds
Andy Oldani: folds
BeeboXD: raises $0.04 to $0.06
sopapunk: folds
cordobes555: calls $0.04
*** FLOP *** [9c 7d Ks]
cordobes555: checks
BeeboXD: bets $0.06
cordobes555: calls $0.06
*** TURN *** [9c 7d Ks] [Ad]
cordobes555: checks
BeeboXD: checks
*** RIVER *** [9c 7d Ks Ad] [Qc]
cordobes555: bets $0.12
BeeboXD: calls $0.12
*** SHOW DOWN ***
cordobes555: shows [9s Qs] (two pair, Queens and Nines)
BeeboXD: mucks hand
cordobes555 collected $0.47 from pot
*** SUMMARY ***
Total pot $0.49 | Rake $0.02
Board [9c 7d Ks Ad Qc]
Seat 1: Andy Oldani folded before Flop (didn't bet)
Seat 2: BeeboXD (button) mucked
Seat 3: sopapunk (small blind) folded before Flop
Seat 4: cordobes555 (big blind) showed [9s Qs] and won ($0.47) with two pair, Queens and Nines
Seat 6: NZcardplayer folded before Flop (didn't bet)


PokerStars Hand #238161175285:  Hold'em No Limit ($0.01/$0.02 USD) - 2022/08/22 23:59:23 ET
Table 'Achilles IV' 6-max Seat #3 is the button
Seat 1: Andy Oldani ($2.36 in chips)
Seat 2: BeeboXD ($2.13 in chips)
Seat 3: sopapunk ($5.62 in chips)
Seat 4: cordobes555 ($2.23 in chips)
Seat 5: HenriquimDelas ($1 in chips)
Seat 6: NZcardplayer ($0.90 in chips)
cordobes555: posts small blind $0.01
HenriquimDelas: posts big blind $0.02
*** HOLE CARDS ***
NZcardplayer: folds
Andy Oldani: folds
BeeboXD: folds
sopapunk: folds
cordobes555: folds
Uncalled bet ($0.01) returned to HenriquimDelas
HenriquimDelas collected $0.02 from pot
HenriquimDelas: doesn't show hand
*** SUMMARY ***
Total pot $0.02 | Rake $0
Seat 1: Andy Oldani folded before Flop (didn't bet)
Seat 2: BeeboXD folded before Flop (didn't bet)
Seat 3: sopapunk (button) folded before Flop (didn't bet)
Seat 4: cordobes555 (small blind) folded before Flop
Seat 5: HenriquimDelas (big blind) collected ($0.02)
Seat 6: NZcardplayer folded before Flop (didn't bet)


PokerStars Hand #238161177349:  Hold'em No Limit ($0.01/$0.02 USD) - 2022/08/22 23:59:40 ET
Table 'Achilles IV' 6-max Seat #4 is the button
Seat 1: Andy Oldani ($2.36 in chips)
Seat 2: BeeboXD ($2.13 in chips)
Seat 3: sopapunk ($5.62 in chips)
Seat 4: cordobes555 ($2.22 in chips)
Seat 5: HenriquimDelas ($1.01 in chips)
Seat 6: NZcardplayer ($0.90 in chips)
HenriquimDelas: posts small blind $0.01
NZcardplayer: posts big blind $0.02
*** HOLE CARDS ***
Andy Oldani: folds
BeeboXD: folds
sopapunk: folds
cordobes555 has timed out
cordobes555: folds
HenriquimDelas: calls $0.01
NZcardplayer: checks
*** FLOP *** [2d 8c 4h]
HenriquimDelas: bets $0.04
NZcardplayer: calls $0.04
*** TURN *** [2d 8c 4h] [Ac]
HenriquimDelas: checks
NZcardplayer: bets $0.12
HenriquimDelas: folds
Uncalled bet ($0.12) returned to NZcardplayer
NZcardplayer collected $0.12 from pot
NZcardplayer: doesn't show hand
*** SUMMARY ***
Total pot $0.12 | Rake $0
Board [2d 8c 4h Ac]
Seat 1: Andy Oldani folded before Flop (didn't bet)
Seat 2: BeeboXD folded before Flop (didn't bet)
Seat 3: sopapunk folded before Flop (didn't bet)
Seat 4: cordobes555 (button) folded before Flop (didn't bet)
Seat 5: HenriquimDelas (small blind) folded on the Turn
Seat 6: NZcardplayer (big blind) collected ($0.12)


PokerStars Hand #238161184649:  Hold'em No Limit ($0.01/$0.02 USD) - 2022/08/23 0:00:41 ET
Table 'Achilles IV' 6-max Seat #5 is the button
Seat 1: Andy Oldani ($2.36 in chips)
Seat 2: BeeboXD ($2.13 in chips)
Seat 3: sopapunk ($5.62 in chips)
Seat 5: HenriquimDelas ($0.95 in chips)
Seat 6: NZcardplayer ($0.96 in chips)
NZcardplayer: posts small blind $0.01
Andy Oldani: posts big blind $0.02
*** HOLE CARDS ***
BeeboXD: folds
sopapunk: raises $0.03 to $0.05
HenriquimDelas: folds
NZcardplayer: calls $0.04
Andy Oldani: calls $0.03
*** FLOP *** [2d Ad 6s]
NZcardplayer: checks
Andy Oldani: checks
sopapunk: checks
*** TURN *** [2d Ad 6s] [5c]
NZcardplayer: bets $0.12
Andy Oldani: folds
sopapunk: folds
Uncalled bet ($0.12) returned to NZcardplayer
NZcardplayer collected $0.14 from pot
NZcardplayer: doesn't show hand
*** SUMMARY ***
Total pot $0.15 | Rake $0.01
Board [2d Ad 6s 5c]
Seat 1: Andy Oldani (big blind) folded on the Turn
Seat 2: BeeboXD folded before Flop (didn't bet)
Seat 3: sopapunk folded on the Turn
Seat 5: HenriquimDelas (button) folded before Flop (didn't bet)
Seat 6: NZcardplayer (small blind) collected ($0.14)


PokerStars Hand #238161190076:  Hold'em No Limit ($0.01/$0.02 USD) - 2022/08/23 0:01:23 ET
Table 'Achilles IV' 6-max Seat #6 is the button
Seat 1: Andy Oldani ($2.31 in chips)
Seat 2: BeeboXD ($2.13 in chips)
Seat 3: sopapunk ($5.57 in chips)
Seat 5: HenriquimDelas ($0.95 in chips)
Seat 6: NZcardplayer ($1.05 in chips)
Andy Oldani: posts small blind $0.01
BeeboXD: posts big blind $0.02
*** HOLE CARDS ***
sopapunk: raises $0.03 to $0.05
HenriquimDelas: calls $0.05
NZcardplayer: folds
Andy Oldani: folds
BeeboXD: raises $0.21 to $0.26
sopapunk: raises $0.34 to $0.60
HenriquimDelas: folds
BeeboXD: folds
Uncalled bet ($0.34) returned to sopapunk
sopapunk collected $0.58 from pot
sopapunk: doesn't show hand
*** SUMMARY ***
Total pot $0.58 | Rake $0
Seat 1: Andy Oldani (small blind) folded before Flop
Seat 2: BeeboXD (big blind) folded before Flop
Seat 3: sopapunk collected ($0.58)
Seat 5: HenriquimDelas folded before Flop
Seat 6: NZcardplayer (button) folded before Flop (didn't bet)


PokerStars Hand #238161201151:  Hold'em No Limit ($0.01/$0.02 USD) - 2022/08/23 0:02:19 ET
Table 'Achilles IV' 6-max Seat #1 is the button
Seat 1: Andy Oldani ($2.30 in chips)
Seat 2: BeeboXD ($1.87 in chips)
Seat 3: sopapunk ($5.89 in chips)
Seat 4: cordobes555 ($2.22 in chips)
Seat 5: HenriquimDelas ($0.90 in chips)
Seat 6: NZcardplayer ($1.05 in chips)
BeeboXD: posts small blind $0.01
sopapunk: posts big blind $0.02
*** HOLE CARDS ***
cordobes555: raises $0.04 to $0.06
HenriquimDelas: folds
NZcardplayer: folds
Andy Oldani: raises $0.12 to $0.18
BeeboXD: folds
sopapunk: folds
cordobes555: calls $0.12
*** FLOP *** [7d Td 9h]
cordobes555: checks
Andy Oldani: checks
*** TURN *** [7d Td 9h] [Th]
cordobes555: bets $0.15
Andy Oldani: calls $0.15
*** RIVER *** [7d Td 9h Th] [Kc]
cordobes555: bets $0.39
Andy Oldani: raises $1.58 to $1.97 and is all-in
cordobes555: folds
Uncalled bet ($1.58) returned to Andy Oldani
Andy Oldani collected $1.42 from pot
Andy Oldani: doesn't show hand
*** SUMMARY ***
Total pot $1.47 | Rake $0.05
Board [7d Td 9h Th Kc]
Seat 1: Andy Oldani (button) collected ($1.42)
Seat 2: BeeboXD (small blind) folded before Flop
Seat 3: sopapunk (big blind) folded before Flop
Seat 4: cordobes555 folded on the River
Seat 5: HenriquimDelas folded before Flop (didn't bet)
Seat 6: NZcardplayer folded before Flop (didn't bet)


PokerStars Hand #238161212303:  Hold'em No Limit ($0.01/$0.02 USD) - 2022/08/23 0:03:44 ET
Table 'Achilles IV' 6-max Seat #2 is the button
Seat 1: Andy Oldani ($3 in chips)
Seat 2: BeeboXD ($1.86 in chips)
Seat 3: sopapunk ($5.87 in chips)
Seat 4: cordobes555 ($1.50 in chips)
Seat 5: HenriquimDelas ($0.90 in chips)
Seat 6: NZcardplayer ($1.05 in chips)
sopapunk: posts small blind $0.01
cordobes555: posts big blind $0.02
*** HOLE CARDS ***
HenriquimDelas: folds
NZcardplayer: folds
Andy Oldani: folds
BeeboXD: raises $0.04 to $0.06
sopapunk: folds
cordobes555: folds
Uncalled bet ($0.04) returned to BeeboXD
BeeboXD collected $0.05 from pot
*** SUMMARY ***
Total pot $0.05 | Rake $0
Seat 1: Andy Oldani folded before Flop (didn't bet)
Seat 2: BeeboXD (button) collected ($0.05)
Seat 3: sopapunk (small blind) folded before Flop
Seat 4: cordobes555 (big blind) folded before Flop
Seat 5: HenriquimDelas folded before Flop (didn't bet)
Seat 6: NZcardplayer folded before Flop (didn't bet)


PokerStars Hand #238161214372:  Hold'em No Limit ($0.01/$0.02 USD) - 2022/08/23 0:03:59 ET
Table 'Achilles IV' 6-max Seat #3 is the button
Seat 1: Andy Oldani ($3 in chips)
Seat 2: BeeboXD ($1.89 in chips)
Seat 3: sopapunk ($5.86 in chips)
Seat 4: cordobes555 ($1.48 in chips)
Seat 5: HenriquimDelas ($0.90 in chips)
Seat 6: NZcardplayer ($1.05 in chips)
cordobes555: posts small blind $0.01
HenriquimDelas: posts big blind $0.02
*** HOLE CARDS ***
NZcardplayer: folds
Andy Oldani: folds
BeeboXD: folds
sopapunk: raises $0.03 to $0.05
cordobes555: calls $0.04
HenriquimDelas: calls $0.03
*** FLOP *** [8h Jh 4c]
cordobes555: checks
HenriquimDelas: bets $0.14
sopapunk: folds
cordobes555: folds
Uncalled bet ($0.14) returned to HenriquimDelas
HenriquimDelas collected $0.14 from pot
HenriquimDelas: doesn't show hand
*** SUMMARY ***
Total pot $0.15 | Rake $0.01
Board [8h Jh 4c]
Seat 1: Andy Oldani folded before Flop (didn't bet)
Seat 2: BeeboXD folded before Flop (didn't bet)
Seat 3: sopapunk (button) folded on the Flop
Seat 4: cordobes555 (small blind) folded on the Flop
Seat 5: HenriquimDelas (big blind) collected ($0.14)
Seat 6: NZcardplayer folded before Flop (didn't bet)


PokerStars Hand #238161219353:  Hold'em No Limit ($0.01/$0.02 USD) - 2022/08/23 0:04:37 ET
Table 'Achilles IV' 6-max Seat #4 is the button
Seat 1: Andy Oldani ($3 in chips)
Seat 2: BeeboXD ($1.89 in chips)
Seat 3: sopapunk ($5.81 in chips)
Seat 4: cordobes555 ($1.43 in chips)
Seat 5: HenriquimDelas ($0.99 in chips)
Seat 6: NZcardplayer ($1.05 in chips)
HenriquimDelas: posts small blind $0.01
NZcardplayer: posts big blind $0.02
*** HOLE CARDS ***
Andy Oldani: folds
BeeboXD: raises $0.04 to $0.06
sopapunk: folds
cordobes555: folds
HenriquimDelas: raises $0.93 to $0.99 and is all-in
NZcardplayer: folds
BeeboXD: calls $0.93
*** FLOP *** [4h 3d 3s]
*** TURN *** [4h 3d 3s] [4s]
*** RIVER *** [4h 3d 3s 4s] [5c]
*** SHOW DOWN ***
HenriquimDelas: shows [Qc Qd] (two pair, Queens and Fours)
BeeboXD: shows [7d 7h] (two pair, Sevens and Fours)
HenriquimDelas collected $1.93 from pot
*** SUMMARY ***
Total pot $2 | Rake $0.07
Board [4h 3d 3s 4s 5c]
Seat 1: Andy Oldani folded before Flop (didn't bet)
Seat 2: BeeboXD showed [7d 7h] and lost with two pair, Sevens and Fours
Seat 3: sopapunk folded before Flop (didn't bet)
Seat 4: cordobes555 (button) folded before Flop (didn't bet)
Seat 5: HenriquimDelas (small blind) showed [Qc Qd] and won ($1.93) with two pair, Queens and Fours
Seat 6: NZcardplayer (big blind) folded before Flop


PokerStars Hand #238161234058:  Hold'em No Limit ($0.01/$0.02 USD) - 2022/08/23 0:05:14 ET
Table 'Achilles IV' 6-max Seat #5 is the button
Seat 1: Andy Oldani ($3 in chips)
Seat 2: BeeboXD ($0.90 in chips)
Seat 3: sopapunk ($5.81 in chips)
Seat 4: cordobes555 ($1.43 in chips)
Seat 5: HenriquimDelas ($1.93 in chips)
Seat 6: NZcardplayer ($1.03 in chips)
NZcardplayer: posts small blind $0.01
Andy Oldani: posts big blind $0.02
*** HOLE CARDS ***
BeeboXD: raises $0.04 to $0.06
sopapunk: folds
cordobes555: folds
HenriquimDelas: calls $0.06
NZcardplayer: folds
Andy Oldani: folds
*** FLOP *** [Jd Ah Js]
BeeboXD: checks
HenriquimDelas: bets $0.14
BeeboXD: folds
Uncalled bet ($0.14) returned to HenriquimDelas
HenriquimDelas collected $0.14 from pot
HenriquimDelas: doesn't show hand
*** SUMMARY ***
Total pot $0.15 | Rake $0.01
Board [Jd Ah Js]
Seat 1: Andy Oldani (big blind) folded before Flop
Seat 2: BeeboXD folded on the Flop
Seat 3: sopapunk folded before Flop (didn't bet)
Seat 4: cordobes555 folded before Flop (didn't bet)
Seat 5: HenriquimDelas (button) collected ($0.14)
Seat 6: NZcardplayer (small blind) folded before Flop


PokerStars Hand #238161237083:  Hold'em No Limit ($0.01/$0.02 USD) - 2022/08/23 0:05:37 ET
Table 'Achilles IV' 6-max Seat #6 is the button
Seat 1: Andy Oldani ($2.98 in chips)
Seat 2: BeeboXD ($0.84 in chips)
Seat 3: sopapunk ($5.81 in chips)
Seat 4: cordobes555 ($1.43 in chips)
Seat 5: HenriquimDelas ($2.01 in chips)
Seat 6: NZcardplayer ($1.02 in chips)
Andy Oldani: posts small blind $0.01
BeeboXD: posts big blind $0.02
*** HOLE CARDS ***
sopapunk: folds
cordobes555: raises $0.04 to $0.06
HenriquimDelas: folds
NZcardplayer: calls $0.06
Andy Oldani: folds
BeeboXD: calls $0.04
*** FLOP *** [Qs Ts 9s]
BeeboXD: checks
cordobes555: checks
NZcardplayer: checks
*** TURN *** [Qs Ts 9s] [Th]
BeeboXD: checks
cordobes555: checks
NZcardplayer: checks
*** RIVER *** [Qs Ts 9s Th] [3d]
BeeboXD: bets $0.18
cordobes555: folds
NZcardplayer: folds
Uncalled bet ($0.18) returned to BeeboXD
BeeboXD collected $0.18 from pot
*** SUMMARY ***
Total pot $0.19 | Rake $0.01
Board [Qs Ts 9s Th 3d]
Seat 1: Andy Oldani (small blind) folded before Flop
Seat 2: BeeboXD (big blind) collected ($0.18)
Seat 3: sopapunk folded before Flop (didn't bet)
Seat 4: cordobes555 folded on the River
Seat 5: HenriquimDelas folded before Flop (didn't bet)
Seat 6: NZcardplayer (button) folded on the River


PokerStars Hand #238161243829:  Hold'em No Limit ($0.01/$0.02 USD) - 2022/08/23 0:06:29 ET
Table 'Achilles IV' 6-max Seat #1 is the button
Seat 1: Andy Oldani ($2.97 in chips)
Seat 2: BeeboXD ($0.96 in chips)
Seat 3: sopapunk ($5.81 in chips)
Seat 4: cordobes555 ($1.37 in chips)
Seat 5: HenriquimDelas ($2.01 in chips)
Seat 6: NZcardplayer ($0.96 in chips)
BeeboXD: posts small blind $0.01
sopapunk: posts big blind $0.02
*** HOLE CARDS ***
cordobes555: folds
HenriquimDelas: folds
NZcardplayer: folds
Andy Oldani: folds
BeeboXD: folds
Uncalled bet ($0.01) returned to sopapunk
BeeboXD leaves the table
sopapunk collected $0.02 from pot
sopapunk: doesn't show hand
*** SUMMARY ***
Total pot $0.02 | Rake $0
Seat 1: Andy Oldani (button) folded before Flop (didn't bet)
Seat 2: BeeboXD (small blind) folded before Flop
Seat 3: sopapunk (big blind) collected ($0.02)
Seat 4: cordobes555 folded before Flop (didn't bet)
Seat 5: HenriquimDelas folded before Flop (didn't bet)
Seat 6: NZcardplayer folded before Flop (didn't bet)


PokerStars Hand #238161245109:  Hold'em No Limit ($0.01/$0.02 USD) - 2022/08/23 0:06:39 ET
Table 'Achilles IV' 6-max Seat #3 is the button
Seat 1: Andy Oldani ($2.97 in chips)
Seat 3: sopapunk ($5.82 in chips)
Seat 4: cordobes555 ($1.37 in chips)
Seat 5: HenriquimDelas ($2.01 in chips)
Seat 6: NZcardplayer ($0.96 in chips)
cordobes555: posts small blind $0.01
HenriquimDelas: posts big blind $0.02
*** HOLE CARDS ***
NZcardplayer: folds
Andy Oldani: folds
sopapunk: raises $0.03 to $0.05
emptytyty joins the table at seat #2
cordobes555: folds
HenriquimDelas: calls $0.03
*** FLOP *** [3s 3d Td]
HenriquimDelas: checks
sopapunk: bets $0.06
HenriquimDelas: folds
Uncalled bet ($0.06) returned to sopapunk
sopapunk collected $0.11 from pot
sopapunk: doesn't show hand
*** SUMMARY ***
Total pot $0.11 | Rake $0
Board [3s 3d Td]
Seat 1: Andy Oldani folded before Flop (didn't bet)
Seat 3: sopapunk (button) collected ($0.11)
Seat 4: cordobes555 (small blind) folded before Flop
Seat 5: HenriquimDelas (big blind) folded on the Flop
Seat 6: NZcardplayer folded before Flop (didn't bet)


PokerStars Hand #238161251919:  Hold'em No Limit ($0.01/$0.02 USD) - 2022/08/23 0:07:31 ET
Table 'Achilles IV' 6-max Seat #4 is the button
Seat 1: Andy Oldani ($2.97 in chips)
Seat 3: sopapunk ($5.88 in chips)
Seat 4: cordobes555 ($1.36 in chips)
Seat 5: HenriquimDelas ($1.96 in chips)
Seat 6: NZcardplayer ($0.96 in chips)
HenriquimDelas: posts small blind $0.01
NZcardplayer: posts big blind $0.02
emptytyty: sits out
*** HOLE CARDS ***
Andy Oldani: folds
sopapunk: raises $0.03 to $0.05
cordobes555: folds
HenriquimDelas: folds
NZcardplayer: folds
Uncalled bet ($0.03) returned to sopapunk
sopapunk collected $0.05 from pot
sopapunk: doesn't show hand
*** SUMMARY ***
Total pot $0.05 | Rake $0
Seat 1: Andy Oldani folded before Flop (didn't bet)
Seat 3: sopapunk collected ($0.05)
Seat 4: cordobes555 (button) folded before Flop (didn't bet)
Seat 5: HenriquimDelas (small blind) folded before Flop
Seat 6: NZcardplayer (big blind) folded before Flop


PokerStars Hand #238161255182:  Hold'em No Limit ($0.01/$0.02 USD) - 2022/08/23 0:07:56 ET
Table 'Achilles IV' 6-max Seat #5 is the button
Seat 1: Andy Oldani ($2.97 in chips)
Seat 2: emptytyty ($1.23 in chips)
Seat 3: sopapunk ($5.91 in chips)
Seat 4: cordobes555 ($1.36 in chips)
Seat 5: HenriquimDelas ($1.95 in chips)
Seat 6: NZcardplayer ($0.94 in chips)
NZcardplayer: posts small blind $0.01
Andy Oldani: posts big blind $0.02
emptytyty: posts big blind $0.02
*** HOLE CARDS ***
emptytyty: checks
sopapunk: folds
cordobes555 has timed out
cordobes555: folds
HenriquimDelas: folds
NZcardplayer: calls $0.01
Andy Oldani: checks
*** FLOP *** [6s Kd 6h]
NZcardplayer: checks
Andy Oldani: checks
emptytyty: checks
*** TURN *** [6s Kd 6h] [7s]
NZcardplayer: checks
Andy Oldani: checks
emptytyty: checks
*** RIVER *** [6s Kd 6h 7s] [2d]
NZcardplayer: checks
Andy Oldani: checks
emptytyty: checks
*** SHOW DOWN ***
NZcardplayer: shows [Qc Ts] (a pair of Sixes)
Andy Oldani: shows [As 9d] (a pair of Sixes - Ace kicker)
emptytyty: mucks hand
Andy Oldani collected $0.06 from pot
*** SUMMARY ***
Total pot $0.06 | Rake $0
Board [6s Kd 6h 7s 2d]
Seat 1: Andy Oldani (big blind) showed [As 9d] and won ($0.06) with a pair of Sixes
Seat 2: emptytyty mucked
Seat 3: sopapunk folded before Flop (didn't bet)
Seat 4: cordobes555 folded before Flop (didn't bet)
Seat 5: HenriquimDelas (button) folded before Flop (didn't bet)
Seat 6: NZcardplayer (small blind) showed [Qc Ts] and lost with a pair of Sixes


PokerStars Hand #238161263484:  Hold'em No Limit ($0.01/$0.02 USD) - 2022/08/23 0:09:02 ET
Table 'Achilles IV' 6-max Seat #6 is the button
Seat 1: Andy Oldani ($3.01 in chips)
Seat 2: emptytyty ($1.21 in chips)
Seat 3: sopapunk ($5.91 in chips)
Seat 5: HenriquimDelas ($1.95 in chips)
Seat 6: NZcardplayer ($0.92 in chips)
Andy Oldani: posts small blind $0.01
emptytyty: posts big blind $0.02
*** HOLE CARDS ***
sopapunk: raises $0.03 to $0.05
HenriquimDelas: folds
NZcardplayer: folds
Andy Oldani: raises $0.11 to $0.16
emptytyty: folds
sopapunk: calls $0.11
*** FLOP *** [Ad Kc Tc]
Andy Oldani: checks
sopapunk: checks
*** TURN *** [Ad Kc Tc] [7h]
Andy Oldani: bets $0.14
sopapunk: calls $0.14
*** RIVER *** [Ad Kc Tc 7h] [4d]
Andy Oldani: checks
sopapunk: bets $0.45
Andy Oldani: folds
Uncalled bet ($0.45) returned to sopapunk
sopapunk collected $0.60 from pot
sopapunk: doesn't show hand
*** SUMMARY ***
Total pot $0.62 | Rake $0.02
Board [Ad Kc Tc 7h 4d]
Seat 1: Andy Oldani (small blind) folded on the River
Seat 2: emptytyty (big blind) folded before Flop
Seat 3: sopapunk collected ($0.60)
Seat 5: HenriquimDelas folded before Flop (didn't bet)
Seat 6: NZcardplayer (button) folded before Flop (didn't bet)


PokerStars Hand #238161273905:  Hold'em No Limit ($0.01/$0.02 USD) - 2022/08/23 0:10:22 ET
Table 'Achilles IV' 6-max Seat #1 is the button
Seat 1: Andy Oldani ($2.71 in chips)
Seat 2: emptytyty ($1.19 in chips)
Seat 3: sopapunk ($6.21 in chips)
Seat 4: cordobes555 ($1.36 in chips)
Seat 5: HenriquimDelas ($1.95 in chips)
Seat 6: NZcardplayer ($0.92 in chips)
emptytyty: posts small blind $0.01
sopapunk: posts big blind $0.02
*** HOLE CARDS ***
cordobes555 has timed out
cordobes555: folds
HenriquimDelas: raises $0.12 to $0.14
NZcardplayer: folds
Andy Oldani: folds
emptytyty: calls $0.13
sopapunk: folds
*** FLOP *** [3d 2s 7c]
emptytyty: checks
HenriquimDelas: bets $0.10
emptytyty: calls $0.10
*** TURN *** [3d 2s 7c] [Qh]
emptytyty: checks
HenriquimDelas: checks
*** RIVER *** [3d 2s 7c Qh] [6h]
emptytyty: checks
HenriquimDelas: checks
*** SHOW DOWN ***
emptytyty: shows [6c 5s] (a pair of Sixes)
HenriquimDelas: mucks hand
emptytyty collected $0.48 from pot
*** SUMMARY ***
Total pot $0.50 | Rake $0.02
Board [3d 2s 7c Qh 6h]
Seat 1: Andy Oldani (button) folded before Flop (didn't bet)
Seat 2: emptytyty (small blind) showed [6c 5s] and won ($0.48) with a pair of Sixes
Seat 3: sopapunk (big blind) folded before Flop
Seat 4: cordobes555 folded before Flop (didn't bet)
Seat 5: HenriquimDelas mucked
Seat 6: NZcardplayer folded before Flop (didn't bet)


PokerStars Hand #238161281173:  Hold'em No Limit ($0.01/$0.02 USD) - 2022/08/23 0:11:19 ET
Table 'Achilles IV' 6-max Seat #2 is the button
Seat 1: Andy Oldani ($2.71 in chips)
Seat 2: emptytyty ($1.43 in chips)
Seat 3: sopapunk ($6.19 in chips)
Seat 5: HenriquimDelas ($1.71 in chips)
Seat 6: NZcardplayer ($0.92 in chips)
sopapunk: posts small blind $0.01
HenriquimDelas: posts big blind $0.02
*** HOLE CARDS ***
NZcardplayer: folds
Andy Oldani: folds
emptytyty: calls $0.02
sopapunk: raises $0.08 to $0.10
HenriquimDelas: calls $0.08
emptytyty: calls $0.08
*** FLOP *** [As 4c 8c]
sopapunk: checks
HenriquimDelas: bets $0.14
emptytyty: calls $0.14
sopapunk: folds
*** TURN *** [As 4c 8c] [2c]
HenriquimDelas: bets $1.47 and is all-in
emptytyty: calls $1.19 and is all-in
Uncalled bet ($0.28) returned to HenriquimDelas
*** RIVER *** [As 4c 8c 2c] [3s]
*** SHOW DOWN ***
HenriquimDelas: shows [3c 5c] (a flush, Eight high)
emptytyty: shows [7c 5s] (a straight, Ace to Five)
HenriquimDelas collected $2.86 from pot
*** SUMMARY ***
Total pot $2.96 | Rake $0.10
Board [As 4c 8c 2c 3s]
Seat 1: Andy Oldani folded before Flop (didn't bet)
Seat 2: emptytyty (button) showed [7c 5s] and lost with a straight, Ace to Five
Seat 3: sopapunk (small blind) folded on the Flop
Seat 5: HenriquimDelas (big blind) showed [3c 5c] and won ($2.86) with a flush, Eight high
Seat 6: NZcardplayer folded before Flop (didn't bet)


PokerStars Hand #238161288366:  Hold'em No Limit ($0.01/$0.02 USD) - 2022/08/23 0:12:15 ET
Table 'Achilles IV' 6-max Seat #3 is the button
Seat 1: Andy Oldani ($2.71 in chips)
Seat 3: sopapunk ($6.09 in chips)
Seat 5: HenriquimDelas ($3.14 in chips)
Seat 6: NZcardplayer ($0.92 in chips)
HenriquimDelas: posts small blind $0.01
NZcardplayer: posts big blind $0.02
*** HOLE CARDS ***
Andy Oldani: raises $0.04 to $0.06
sopapunk: folds
HenriquimDelas: calls $0.05
NZcardplayer: folds
*** FLOP *** [Kh 5h 8s]
HenriquimDelas: checks
Andy Oldani: checks
*** TURN *** [Kh 5h 8s] [5d]
HenriquimDelas: bets $0.07
Andy Oldani: calls $0.07
*** RIVER *** [Kh 5h 8s 5d] [4h]
HenriquimDelas: checks
Andy Oldani: checks
*** SHOW DOWN ***
HenriquimDelas: shows [7d Js] (a pair of Fives)
Andy Oldani: shows [Td Ts] (two pair, Tens and Fives)
Andy Oldani collected $0.27 from pot
*** SUMMARY ***
Total pot $0.28 | Rake $0.01
Board [Kh 5h 8s 5d 4h]
Seat 1: Andy Oldani showed [Td Ts] and won ($0.27) with two pair, Tens and Fives
Seat 3: sopapunk (button) folded before Flop (didn't bet)
Seat 5: HenriquimDelas (small blind) showed [7d Js] and lost with a pair of Fives
Seat 6: NZcardplayer (big blind) folded before Flop


PokerStars Hand #238161292945:  Hold'em No Limit ($0.01/$0.02 USD) - 2022/08/23 0:12:51 ET
Table 'Achilles IV' 6-max Seat #5 is the button
Seat 1: Andy Oldani ($2.85 in chips)
Seat 2: emptytyty ($1.21 in chips)
Seat 3: sopapunk ($6.09 in chips)
Seat 5: HenriquimDelas ($3.01 in chips)
Seat 6: NZcardplayer ($0.90 in chips)
NZcardplayer: posts small blind $0.01
Andy Oldani: posts big blind $0.02
*** HOLE CARDS ***
emptytyty: calls $0.02
sopapunk: folds
HenriquimDelas: raises $2.99 to $3.01 and is all-in
NZcardplayer: folds
Andy Oldani: folds
emptytyty: folds
Uncalled bet ($2.99) returned to HenriquimDelas
HenriquimDelas collected $0.07 from pot
HenriquimDelas: doesn't show hand
*** SUMMARY ***
Total pot $0.07 | Rake $0
Seat 1: Andy Oldani (big blind) folded before Flop
Seat 2: emptytyty folded before Flop
Seat 3: sopapunk folded before Flop (didn't bet)
Seat 5: HenriquimDelas (button) collected ($0.07)
Seat 6: NZcardplayer (small blind) folded before Flop


PokerStars Hand #238161296159:  Hold'em No Limit ($0.01/$0.02 USD) - 2022/08/23 0:13:16 ET
Table 'Achilles IV' 6-max Seat #6 is the button
Seat 1: Andy Oldani ($2.83 in chips)
Seat 2: emptytyty ($1.19 in chips)
Seat 3: sopapunk ($6.09 in chips)
Seat 5: HenriquimDelas ($3.06 in chips)
Seat 6: NZcardplayer ($0.89 in chips)
Andy Oldani: posts small blind $0.01
emptytyty: posts big blind $0.02
*** HOLE CARDS ***
sopapunk: folds
HenriquimDelas: folds
NZcardplayer: folds
Andy Oldani: raises $0.04 to $0.06
emptytyty: calls $0.04
*** FLOP *** [Js 8h 4d]
HenriquimDelas leaves the table
Andy Oldani: checks
emptytyty: checks
*** TURN *** [Js 8h 4d] [2h]
Andy Oldani: checks
emptytyty: checks
*** RIVER *** [Js 8h 4d 2h] [2d]
Andy Oldani: bets $0.04
emptytyty: calls $0.04
*** SHOW DOWN ***
Andy Oldani: shows [9s 9h] (two pair, Nines and Deuces)
emptytyty: mucks hand
Andy Oldani collected $0.19 from pot
*** SUMMARY ***
Total pot $0.20 | Rake $0.01
Board [Js 8h 4d 2h 2d]
Seat 1: Andy Oldani (small blind) showed [9s 9h] and won ($0.19) with two pair, Nines and Deuces
Seat 2: emptytyty (big blind) mucked
Seat 3: sopapunk folded before Flop (didn't bet)
Seat 5: HenriquimDelas folded before Flop (didn't bet)
Seat 6: NZcardplayer (button) folded before Flop (didn't bet)


PokerStars Hand #238161304355:  Hold'em No Limit ($0.01/$0.02 USD) - 2022/08/23 0:13:55 ET
Table 'Achilles IV' 6-max Seat #1 is the button
Seat 1: Andy Oldani ($2.92 in chips)
Seat 2: emptytyty ($1.09 in chips)
Seat 3: sopapunk ($6.09 in chips)
Seat 6: NZcardplayer ($0.89 in chips)
emptytyty: posts small blind $0.01
sopapunk: posts big blind $0.02
*** HOLE CARDS ***
NZcardplayer: folds
ajrestrepo joins the table at seat #5
Andy Oldani: raises $0.04 to $0.06
emptytyty: calls $0.05
sopapunk: calls $0.04
*** FLOP *** [6s 2c 2h]
emptytyty: checks
sopapunk: checks
Andy Oldani: checks
*** TURN *** [6s 2c 2h] [3s]
emptytyty: checks
sopapunk: bets $0.13
Andy Oldani: calls $0.13
emptytyty: folds
*** RIVER *** [6s 2c 2h 3s] [Jc]
sopapunk: checks
Andy Oldani: checks
*** SHOW DOWN ***
sopapunk: shows [7c 5c] (a pair of Deuces)
Andy Oldani: shows [As 4s] (a pair of Deuces - Ace kicker)
Andy Oldani collected $0.42 from pot
*** SUMMARY ***
Total pot $0.44 | Rake $0.02
Board [6s 2c 2h 3s Jc]
Seat 1: Andy Oldani (button) showed [As 4s] and won ($0.42) with a pair of Deuces
Seat 2: emptytyty (small blind) folded on the Turn
Seat 3: sopapunk (big blind) showed [7c 5c] and lost with a pair of Deuces
Seat 6: NZcardplayer folded before Flop (didn't bet)


PokerStars Hand #238161309952:  Hold'em No Limit ($0.01/$0.02 USD) - 2022/08/23 0:14:40 ET
Table 'Achilles IV' 6-max Seat #2 is the button
Seat 1: Andy Oldani ($3.15 in chips)
Seat 2: emptytyty ($1.03 in chips)
Seat 3: sopapunk ($5.90 in chips)
Seat 5: ajrestrepo ($2 in chips)
Seat 6: NZcardplayer ($0.89 in chips)
sopapunk: posts small blind $0.01
ajrestrepo: posts big blind $0.02
*** HOLE CARDS ***
NZcardplayer: folds
Andy Oldani: raises $0.04 to $0.06
emptytyty: calls $0.06
sopapunk: folds
ajrestrepo: folds
*** FLOP *** [9h Jh 5h]
Andy Oldani: checks
emptytyty: checks
*** TURN *** [9h Jh 5h] [Kd]
Andy Oldani: checks
emptytyty: checks
*** RIVER *** [9h Jh 5h Kd] [8h]
Andy Oldani: checks
emptytyty: checks
*** SHOW DOWN ***
Andy Oldani: shows [As Qs] (high card Ace)
emptytyty: shows [7h 6c] (a flush, Jack high)
emptytyty collected $0.14 from pot
*** SUMMARY ***
Total pot $0.15 | Rake $0.01
Board [9h Jh 5h Kd 8h]
Seat 1: Andy Oldani showed [As Qs] and lost with high card Ace
Seat 2: emptytyty (button) showed [7h 6c] and won ($0.14) with a flush, Jack high
Seat 3: sopapunk (small blind) folded before Flop
Seat 5: ajrestrepo (big blind) folded before Flop
Seat 6: NZcardplayer folded before Flop (didn't bet)


PokerStars Hand #238161313089:  Hold'em No Limit ($0.01/$0.02 USD) - 2022/08/23 0:15:04 ET
Table 'Achilles IV' 6-max Seat #3 is the button
Seat 1: Andy Oldani ($3.09 in chips)
Seat 2: emptytyty ($1.11 in chips)
Seat 3: sopapunk ($5.89 in chips)
Seat 5: ajrestrepo ($1.98 in chips)
Seat 6: NZcardplayer ($0.89 in chips)
ajrestrepo: posts small blind $0.01
NZcardplayer: posts big blind $0.02
*** HOLE CARDS ***
Andy Oldani: folds
emptytyty: calls $0.02
sopapunk: folds
ajrestrepo: folds
NZcardplayer: checks
*** FLOP *** [4s Qc 9c]
NZcardplayer: bets $0.05
emptytyty: folds
Uncalled bet ($0.05) returned to NZcardplayer
NZcardplayer collected $0.05 from pot
NZcardplayer: doesn't show hand
*** SUMMARY ***
Total pot $0.05 | Rake $0
Board [4s Qc 9c]
Seat 1: Andy Oldani folded before Flop (didn't bet)
Seat 2: emptytyty folded on the Flop
Seat 3: sopapunk (button) folded before Flop (didn't bet)
Seat 5: ajrestrepo (small blind) folded before Flop
Seat 6: NZcardplayer (big blind) collected ($0.05)


PokerStars Hand #238161317250:  Hold'em No Limit ($0.01/$0.02 USD) - 2022/08/23 0:15:37 ET
Table 'Achilles IV' 6-max Seat #5 is the button
Seat 1: Andy Oldani ($3.09 in chips)
Seat 2: emptytyty ($1.09 in chips)
Seat 3: sopapunk ($5.89 in chips)
Seat 5: ajrestrepo ($1.97 in chips)
Seat 6: NZcardplayer ($0.92 in chips)
NZcardplayer: posts small blind $0.01
Andy Oldani: posts big blind $0.02
*** HOLE CARDS ***
emptytyty: calls $0.02
sopapunk: folds
cordobes555 is disconnected
ajrestrepo: calls $0.02
NZcardplayer: folds
Andy Oldani: checks
*** FLOP *** [Kh 6s 8c]
Andy Oldani: checks
emptytyty: checks
ajrestrepo: bets $0.06
Andy Oldani: folds
emptytyty: folds
Uncalled bet ($0.06) returned to ajrestrepo
ajrestrepo collected $0.07 from pot
*** SUMMARY ***
Total pot $0.07 | Rake $0
Board [Kh 6s 8c]
Seat 1: Andy Oldani (big blind) folded on the Flop
Seat 2: emptytyty folded on the Flop
Seat 3: sopapunk folded before Flop (didn't bet)
Seat 5: ajrestrepo (button) collected ($0.07)
Seat 6: NZcardplayer (small blind) folded before Flop


PokerStars Hand #238161321844:  Hold'em No Limit ($0.01/$0.02 USD) - 2022/08/23 0:16:13 ET
Table 'Achilles IV' 6-max Seat #6 is the button
Seat 1: Andy Oldani ($3.07 in chips)
Seat 2: emptytyty ($1.07 in chips)
Seat 3: sopapunk ($5.89 in chips)
Seat 5: ajrestrepo ($2.02 in chips)
Seat 6: NZcardplayer ($0.91 in chips)
Andy Oldani: posts small blind $0.01
emptytyty: posts big blind $0.02
*** HOLE CARDS ***
sopapunk: folds
ajrestrepo: calls $0.02
NZcardplayer: calls $0.02
Andy Oldani: raises $0.08 to $0.10
emptytyty: calls $0.08
ajrestrepo: calls $0.08
NZcardplayer: calls $0.08
*** FLOP *** [6c Kd Qc]
Andy Oldani: checks
emptytyty: checks
ajrestrepo: checks
NZcardplayer: checks
*** TURN *** [6c Kd Qc] [5h]
Andy Oldani: checks
emptytyty: checks
ajrestrepo: checks
NZcardplayer: checks
*** RIVER *** [6c Kd Qc 5h] [4d]
Andy Oldani: checks
emptytyty: bets $0.12
ajrestrepo: folds
NZcardplayer: folds
Andy Oldani: folds
Uncalled bet ($0.12) returned to emptytyty
emptytyty collected $0.39 from pot
*** SUMMARY ***
Total pot $0.40 | Rake $0.01
Board [6c Kd Qc 5h 4d]
Seat 1: Andy Oldani (small blind) folded on the River
Seat 2: emptytyty (big blind) collected ($0.39)
Seat 3: sopapunk folded before Flop (didn't bet)
Seat 5: ajrestrepo folded on the River
Seat 6: NZcardplayer (button) folded on the River


PokerStars Hand #238161329205:  Hold'em No Limit ($0.01/$0.02 USD) - 2022/08/23 0:17:12 ET
Table 'Achilles IV' 6-max Seat #1 is the button
Seat 1: Andy Oldani ($2.97 in chips)
Seat 2: emptytyty ($1.36 in chips)
Seat 3: sopapunk ($5.89 in chips)
Seat 5: ajrestrepo ($1.92 in chips)
Seat 6: NZcardplayer ($0.81 in chips)
emptytyty: posts small blind $0.01
sopapunk: posts big blind $0.02
*** HOLE CARDS ***
ajrestrepo: folds
NZcardplayer: folds
NZcardplayer leaves the table
Andy Oldani: folds
emptytyty: calls $0.01
sopapunk: raises $0.08 to $0.10
emptytyty: calls $0.08
*** FLOP *** [7s 9d Ks]
emptytyty: checks
sopapunk: bets $0.14
emptytyty: calls $0.14
*** TURN *** [7s 9d Ks] [4c]
emptytyty: checks
rsxcd479 joins the table at seat #6
sopapunk: bets $0.35
emptytyty: calls $0.35
*** RIVER *** [7s 9d Ks 4c] [Ad]
emptytyty: checks
sopapunk: checks
*** SHOW DOWN ***
emptytyty: shows [3s 6s] (high card Ace)
sopapunk: shows [Kd Td] (a pair of Kings)
sopapunk collected $1.14 from pot
*** SUMMARY ***
Total pot $1.18 | Rake $0.04
Board [7s 9d Ks 4c Ad]
Seat 1: Andy Oldani (button) folded before Flop (didn't bet)
Seat 2: emptytyty (small blind) showed [3s 6s] and lost with high card Ace
Seat 3: sopapunk (big blind) showed [Kd Td] and won ($1.14) with a pair of Kings
Seat 5: ajrestrepo folded before Flop (didn't bet)
Seat 6: NZcardplayer folded before Flop (didn't bet)


PokerStars Hand #238161333350:  Hold'em No Limit ($0.01/$0.02 USD) - 2022/08/23 0:17:44 ET
Table 'Achilles IV' 6-max Seat #2 is the button
Seat 1: Andy Oldani ($2.97 in chips)
Seat 2: emptytyty ($0.77 in chips)
Seat 3: sopapunk ($6.44 in chips)
Seat 5: ajrestrepo ($1.92 in chips)
sopapunk: posts small blind $0.01
ajrestrepo: posts big blind $0.02
rsxcd479: sits out
*** HOLE CARDS ***
Andy Oldani: folds
emptytyty: calls $0.02
sopapunk: folds
ajrestrepo: checks
*** FLOP *** [6h Kd Ad]
ajrestrepo: checks
emptytyty: checks
*** TURN *** [6h Kd Ad] [7c]
ajrestrepo: checks
emptytyty: checks
*** RIVER *** [6h Kd Ad 7c] [Ts]
ajrestrepo: checks
emptytyty: checks
*** SHOW DOWN ***
ajrestrepo: shows [Qd 6d] (a pair of Sixes)
emptytyty: mucks hand
ajrestrepo collected $0.05 from pot
*** SUMMARY ***
Total pot $0.05 | Rake $0
Board [6h Kd Ad 7c Ts]
Seat 1: Andy Oldani folded before Flop (didn't bet)
Seat 2: emptytyty (button) mucked
Seat 3: sopapunk (small blind) folded before Flop
Seat 5: ajrestrepo (big blind) showed [Qd 6d] and won ($0.05) with a pair of Sixes


PokerStars Hand #238161338272:  Hold'em No Limit ($0.01/$0.02 USD) - 2022/08/23 0:18:23 ET
Table 'Achilles IV' 6-max Seat #3 is the button
Seat 1: Andy Oldani ($2.97 in chips)
Seat 2: emptytyty ($0.75 in chips)
Seat 3: sopapunk ($6.43 in chips)
Seat 5: ajrestrepo ($1.95 in chips)
Seat 6: rsxcd479 ($2 in chips)
ajrestrepo: posts small blind $0.01
rsxcd479: posts big blind $0.02
*** HOLE CARDS ***
Andy Oldani: folds
emptytyty: calls $0.02
sopapunk: folds
ajrestrepo: raises $0.02 to $0.04
rsxcd479: calls $0.02
emptytyty: calls $0.02
*** FLOP *** [Td Ad Tc]
ajrestrepo: checks
rsxcd479: checks
emptytyty: checks
*** TURN *** [Td Ad Tc] [Qs]
ajrestrepo: bets $0.02
rsxcd479: raises $0.12 to $0.14
emptytyty: calls $0.14
ajrestrepo: calls $0.12
*** RIVER *** [Td Ad Tc Qs] [4c]
ajrestrepo: checks
rsxcd479: bets $0.39
emptytyty: calls $0.39
ajrestrepo: calls $0.39
*** SHOW DOWN ***
rsxcd479: shows [Jd Ts] (three of a kind, Tens)
emptytyty: mucks hand
ajrestrepo: shows [Kh Jh] (a straight, Ten to Ace)
ajrestrepo collected $1.65 from pot
*** SUMMARY ***
Total pot $1.71 | Rake $0.06
Board [Td Ad Tc Qs 4c]
Seat 1: Andy Oldani folded before Flop (didn't bet)
Seat 2: emptytyty mucked
Seat 3: sopapunk (button) folded before Flop (didn't bet)
Seat 5: ajrestrepo (small blind) showed [Kh Jh] and won ($1.65) with a straight, Ten to Ace
Seat 6: rsxcd479 (big blind) showed [Jd Ts] and lost with three of a kind, Tens


PokerStars Hand #238161354477:  Hold'em No Limit ($0.01/$0.02 USD) - 2022/08/23 0:19:14 ET
Table 'Achilles IV' 6-max Seat #5 is the button
Seat 1: Andy Oldani ($2.97 in chips)
Seat 2: emptytyty ($0.18 in chips)
Seat 3: sopapunk ($6.43 in chips)
Seat 5: ajrestrepo ($3.03 in chips)
Seat 6: rsxcd479 ($2 in chips)
rsxcd479: posts small blind $0.01
Andy Oldani: posts big blind $0.02
*** HOLE CARDS ***
emptytyty: calls $0.02
sopapunk: raises $0.08 to $0.10
ajrestrepo: folds
rsxcd479: calls $0.09
Andy Oldani: folds
emptytyty: calls $0.08
*** FLOP *** [Ad 6s 9s]
rsxcd479: checks
emptytyty: checks
sopapunk: checks
*** TURN *** [Ad 6s 9s] [8h]
rsxcd479: checks
emptytyty: checks
sopapunk: checks
*** RIVER *** [Ad 6s 9s 8h] [9d]
rsxcd479: checks
emptytyty: checks
sopapunk: bets $0.10
rsxcd479: folds
emptytyty: folds
Uncalled bet ($0.10) returned to sopapunk
sopapunk collected $0.31 from pot
sopapunk: doesn't show hand
*** SUMMARY ***
Total pot $0.32 | Rake $0.01
Board [Ad 6s 9s 8h 9d]
Seat 1: Andy Oldani (big blind) folded before Flop
Seat 2: emptytyty folded on the River
Seat 3: sopapunk collected ($0.31)
Seat 5: ajrestrepo (button) folded before Flop (didn't bet)
Seat 6: rsxcd479 (small blind) folded on the River


PokerStars Hand #238161359817:  Hold'em No Limit ($0.01/$0.02 USD) - 2022/08/23 0:19:56 ET
Table 'Achilles IV' 6-max Seat #6 is the button
Seat 1: Andy Oldani ($2.95 in chips)
Seat 2: emptytyty ($0.08 in chips)
Seat 3: sopapunk ($6.64 in chips)
Seat 5: ajrestrepo ($3.03 in chips)
Seat 6: rsxcd479 ($2 in chips)
Andy Oldani: posts small blind $0.01
emptytyty: posts big blind $0.02
*** HOLE CARDS ***
sopapunk: folds
ajrestrepo: folds
rsxcd479: folds
Andy Oldani: folds
Uncalled bet ($0.01) returned to emptytyty
emptytyty collected $0.02 from pot
*** SUMMARY ***
Total pot $0.02 | Rake $0
Seat 1: Andy Oldani (small blind) folded before Flop
Seat 2: emptytyty (big blind) collected ($0.02)
Seat 3: sopapunk folded before Flop (didn't bet)
Seat 5: ajrestrepo folded before Flop (didn't bet)
Seat 6: rsxcd479 (button) folded before Flop (didn't bet)


PokerStars Hand #238161361510:  Hold'em No Limit ($0.01/$0.02 USD) - 2022/08/23 0:20:10 ET
Table 'Achilles IV' 6-max Seat #1 is the button
Seat 1: Andy Oldani ($2.94 in chips)
Seat 2: emptytyty ($0.09 in chips)
Seat 3: sopapunk ($6.64 in chips)
Seat 5: ajrestrepo ($3.03 in chips)
Seat 6: rsxcd479 ($2 in chips)
emptytyty: posts small blind $0.01
sopapunk: posts big blind $0.02
*** HOLE CARDS ***
ajrestrepo: folds
rsxcd479 has timed out
rsxcd479: folds
Andy Oldani: raises $0.04 to $0.06
emptytyty: calls $0.05
sopapunk: folds
*** FLOP *** [3s 9c 8h]
emptytyty: checks
Andy Oldani: bets $0.07
emptytyty: calls $0.03 and is all-in
Uncalled bet ($0.04) returned to Andy Oldani
*** TURN *** [3s 9c 8h] [8c]
*** RIVER *** [3s 9c 8h 8c] [5s]
*** SHOW DOWN ***
emptytyty: shows [Jc 2d] (a pair of Eights)
Andy Oldani: shows [8d Qd] (three of a kind, Eights)
Andy Oldani collected $0.19 from pot
*** SUMMARY ***
Total pot $0.20 | Rake $0.01
Board [3s 9c 8h 8c 5s]
Seat 1: Andy Oldani (button) showed [8d Qd] and won ($0.19) with three of a kind, Eights
Seat 2: emptytyty (small blind) showed [Jc 2d] and lost with a pair of Eights
Seat 3: sopapunk (big blind) folded before Flop
Seat 5: ajrestrepo folded before Flop (didn't bet)
Seat 6: rsxcd479 folded before Flop (didn't bet)


PokerStars Hand #238161368469:  Hold'em No Limit ($0.01/$0.02 USD) - 2022/08/23 0:21:06 ET
Table 'Achilles IV' 6-max Seat #3 is the button
Seat 1: Andy Oldani ($3.04 in chips)
Seat 3: sopapunk ($6.62 in chips)
Seat 5: ajrestrepo ($3.03 in chips)
Seat 6: rsxcd479 ($2 in chips)
ajrestrepo: posts small blind $0.01
rsxcd479: posts big blind $0.02
*** HOLE CARDS ***
Andy Oldani: folds
emptytyty leaves the table
sopapunk: raises $0.03 to $0.05
ajrestrepo: folds
rsxcd479: folds
Uncalled bet ($0.03) returned to sopapunk
sopapunk collected $0.05 from pot
sopapunk: doesn't show hand
*** SUMMARY ***
Total pot $0.05 | Rake $0
Seat 1: Andy Oldani folded before Flop (didn't bet)
Seat 3: sopapunk (button) collected ($0.05)
Seat 5: ajrestrepo (small blind) folded before Flop
Seat 6: rsxcd479 (big blind) folded before Flop


PokerStars Hand #238161369916:  Hold'em No Limit ($0.01/$0.02 USD) - 2022/08/23 0:21:18 ET
Table 'Achilles IV' 6-max Seat #5 is the button
Seat 1: Andy Oldani ($3.04 in chips)
Seat 3: sopapunk ($6.65 in chips)
Seat 5: ajrestrepo ($3.02 in chips)
Seat 6: rsxcd479 ($2 in chips)
rsxcd479: posts small blind $0.01
Andy Oldani: posts big blind $0.02
*** HOLE CARDS ***
sopapunk: folds
ajrestrepo: folds
black.pantherx joins the table at seat #2
rsxcd479: raises $0.05 to $0.07
Andy Oldani: calls $0.05
*** FLOP *** [3d 6h 5c]
rsxcd479: checks
Andy Oldani: checks
*** TURN *** [3d 6h 5c] [6c]
rsxcd479: checks
Andy Oldani: checks
*** RIVER *** [3d 6h 5c 6c] [5d]
rsxcd479: checks
Andy Oldani: checks
*** SHOW DOWN ***
rsxcd479: shows [Ah Ts] (two pair, Sixes and Fives)
Andy Oldani: mucks hand
rsxcd479 collected $0.14 from pot
*** SUMMARY ***
Total pot $0.14 | Rake $0
Board [3d 6h 5c 6c 5d]
Seat 1: Andy Oldani (big blind) mucked
Seat 3: sopapunk folded before Flop (didn't bet)
Seat 5: ajrestrepo (button) folded before Flop (didn't bet)
Seat 6: rsxcd479 (small blind) showed [Ah Ts] and won ($0.14) with two pair, Sixes and Fives


PokerStars Hand #238161374729:  Hold'em No Limit ($0.01/$0.02 USD) - 2022/08/23 0:21:57 ET
Table 'Achilles IV' 6-max Seat #6 is the button
Seat 1: Andy Oldani ($2.97 in chips)
Seat 2: black.pantherx ($2 in chips)
Seat 3: sopapunk ($6.65 in chips)
Seat 5: ajrestrepo ($3.02 in chips)
Seat 6: rsxcd479 ($2.07 in chips)
Andy Oldani: posts small blind $0.01
black.pantherx: posts big blind $0.02
*** HOLE CARDS ***
sopapunk: folds
ajrestrepo: folds
rsxcd479: folds
Andy Oldani: raises $0.04 to $0.06
black.pantherx: folds
Uncalled bet ($0.04) returned to Andy Oldani
Andy Oldani collected $0.04 from pot
Andy Oldani: doesn't show hand
*** SUMMARY ***
Total pot $0.04 | Rake $0
Seat 1: Andy Oldani (small blind) collected ($0.04)
Seat 2: black.pantherx (big blind) folded before Flop
Seat 3: sopapunk folded before Flop (didn't bet)
Seat 5: ajrestrepo folded before Flop (didn't bet)
Seat 6: rsxcd479 (button) folded before Flop (didn't bet)


PokerStars Hand #238161377758:  Hold'em No Limit ($0.01/$0.02 USD) - 2022/08/23 0:22:23 ET
Table 'Achilles IV' 6-max Seat #1 is the button
Seat 1: Andy Oldani ($2.99 in chips)
Seat 2: black.pantherx ($2 in chips)
Seat 3: sopapunk ($6.65 in chips)
Seat 5: ajrestrepo ($3.02 in chips)
Seat 6: rsxcd479 ($2.07 in chips)
black.pantherx: posts small blind $0.01
sopapunk: posts big blind $0.02
*** HOLE CARDS ***
ajrestrepo: folds
rsxcd479: raises $0.04 to $0.06
Andy Oldani: folds
black.pantherx: folds
sopapunk: folds
Uncalled bet ($0.04) returned to rsxcd479
rsxcd479 collected $0.05 from pot
*** SUMMARY ***
Total pot $0.05 | Rake $0
Seat 1: Andy Oldani (button) folded before Flop (didn't bet)
Seat 2: black.pantherx (small blind) folded before Flop
Seat 3: sopapunk (big blind) folded before Flop
Seat 5: ajrestrepo folded before Flop (didn't bet)
Seat 6: rsxcd479 collected ($0.05)


PokerStars Hand #238161379470:  Hold'em No Limit ($0.01/$0.02 USD) - 2022/08/23 0:22:36 ET
Table 'Achilles IV' 6-max Seat #2 is the button
Seat 1: Andy Oldani ($2.99 in chips)
Seat 2: black.pantherx ($2 in chips)
Seat 3: sopapunk ($6.63 in chips)
Seat 5: ajrestrepo ($3.02 in chips)
Seat 6: rsxcd479 ($2.10 in chips)
sopapunk: posts small blind $0.01
ajrestrepo: posts big blind $0.02
*** HOLE CARDS ***
rsxcd479: folds
Andy Oldani: folds
black.pantherx: folds
sopapunk: folds
Uncalled bet ($0.01) returned to ajrestrepo
ajrestrepo collected $0.02 from pot
cordobes555 was removed from the table for failing to post
cordobes555 leaves the table
*** SUMMARY ***
Total pot $0.02 | Rake $0
Seat 1: Andy Oldani folded before Flop (didn't bet)
Seat 2: black.pantherx (button) folded before Flop (didn't bet)
Seat 3: sopapunk (small blind) folded before Flop
Seat 5: ajrestrepo (big blind) collected ($0.02)
Seat 6: rsxcd479 folded before Flop (didn't bet)


PokerStars Hand #238161381922:  Hold'em No Limit ($0.01/$0.02 USD) - 2022/08/23 0:22:56 ET
Table 'Achilles IV' 6-max Seat #3 is the button
Seat 1: Andy Oldani ($2.99 in chips)
Seat 2: black.pantherx ($2 in chips)
Seat 3: sopapunk ($6.62 in chips)
Seat 5: ajrestrepo ($3.03 in chips)
Seat 6: rsxcd479 ($2.10 in chips)
ajrestrepo: posts small blind $0.01
rsxcd479: posts big blind $0.02
*** HOLE CARDS ***
Andy Oldani: folds
black.pantherx: folds
sopapunk: raises $0.03 to $0.05
ajrestrepo: folds
rsxcd479: folds
Uncalled bet ($0.03) returned to sopapunk
sopapunk collected $0.05 from pot
sopapunk: doesn't show hand
*** SUMMARY ***
Total pot $0.05 | Rake $0
Seat 1: Andy Oldani folded before Flop (didn't bet)
Seat 2: black.pantherx folded before Flop (didn't bet)
Seat 3: sopapunk (button) collected ($0.05)
Seat 5: ajrestrepo (small blind) folded before Flop
Seat 6: rsxcd479 (big blind) folded before Flop


PokerStars Hand #238161383976:  Hold'em No Limit ($0.01/$0.02 USD) - 2022/08/23 0:23:13 ET
Table 'Achilles IV' 6-max Seat #5 is the button
Seat 1: Andy Oldani ($2.99 in chips)
Seat 2: black.pantherx ($2 in chips)
Seat 3: sopapunk ($6.65 in chips)
Seat 5: ajrestrepo ($3.02 in chips)
Seat 6: rsxcd479 ($2.08 in chips)
rsxcd479: posts small blind $0.01
Andy Oldani: posts big blind $0.02
*** HOLE CARDS ***
black.pantherx: folds
Recafer68 joins the table at seat #4
sopapunk: folds
ajrestrepo: folds
rsxcd479: folds
Uncalled bet ($0.01) returned to Andy Oldani
Andy Oldani collected $0.02 from pot
Andy Oldani: doesn't show hand
*** SUMMARY ***
Total pot $0.02 | Rake $0
Seat 1: Andy Oldani (big blind) collected ($0.02)
Seat 2: black.pantherx folded before Flop (didn't bet)
Seat 3: sopapunk folded before Flop (didn't bet)
Seat 5: ajrestrepo (button) folded before Flop (didn't bet)
Seat 6: rsxcd479 (small blind) folded before Flop


PokerStars Hand #238161386778:  Hold'em No Limit ($0.01/$0.02 USD) - 2022/08/23 0:23:36 ET
Table 'Achilles IV' 6-max Seat #6 is the button
Seat 1: Andy Oldani ($3 in chips)
Seat 2: black.pantherx ($2 in chips)
Seat 3: sopapunk ($6.65 in chips)
Seat 4: Recafer68 ($0.87 in chips)
Seat 5: ajrestrepo ($3.02 in chips)
Seat 6: rsxcd479 ($2.07 in chips)
Andy Oldani: posts small blind $0.01
black.pantherx: posts big blind $0.02
Recafer68: posts big blind $0.02
*** HOLE CARDS ***
sopapunk: folds
Recafer68: checks
ajrestrepo: folds
rsxcd479: folds
Andy Oldani: folds
black.pantherx: checks
*** FLOP *** [Jd 5h 6d]
black.pantherx: checks
Recafer68: checks
*** TURN *** [Jd 5h 6d] [Qs]
black.pantherx: checks
Recafer68: checks
*** RIVER *** [Jd 5h 6d Qs] [8d]
black.pantherx: checks
Recafer68: checks
*** SHOW DOWN ***
black.pantherx: shows [9c As] (high card Ace)
Recafer68: mucks hand
black.pantherx collected $0.05 from pot
*** SUMMARY ***
Total pot $0.05 | Rake $0
Board [Jd 5h 6d Qs 8d]
Seat 1: Andy Oldani (small blind) folded before Flop
Seat 2: black.pantherx (big blind) showed [9c As] and won ($0.05) with high card Ace
Seat 3: sopapunk folded before Flop (didn't bet)
Seat 4: Recafer68 mucked
Seat 5: ajrestrepo folded before Flop (didn't bet)
Seat 6: rsxcd479 (button) folded before Flop (didn't bet)


PokerStars Hand #238161391589:  Hold'em No Limit ($0.01/$0.02 USD) - 2022/08/23 0:24:10 ET
Table 'Achilles IV' 6-max Seat #1 is the button
Seat 1: Andy Oldani ($2.99 in chips)
Seat 2: black.pantherx ($2.03 in chips)
Seat 3: sopapunk ($6.65 in chips)
Seat 4: Recafer68 ($0.85 in chips)
Seat 5: ajrestrepo ($3.02 in chips)
Seat 6: rsxcd479 ($2.07 in chips)
black.pantherx: posts small blind $0.01
sopapunk: posts big blind $0.02
*** HOLE CARDS ***
Recafer68: calls $0.02
ajrestrepo: folds
rsxcd479: folds
Andy Oldani: folds
black.pantherx: calls $0.01
sopapunk: checks
*** FLOP *** [Td 8d As]
black.pantherx: checks
sopapunk: checks
Recafer68: bets $0.02
black.pantherx: folds
sopapunk: calls $0.02
*** TURN *** [Td 8d As] [5h]
sopapunk: checks
Recafer68: bets $0.02
sopapunk: folds
Uncalled bet ($0.02) returned to Recafer68
Recafer68 collected $0.10 from pot
*** SUMMARY ***
Total pot $0.10 | Rake $0
Board [Td 8d As 5h]
Seat 1: Andy Oldani (button) folded before Flop (didn't bet)
Seat 2: black.pantherx (small blind) folded on the Flop
Seat 3: sopapunk (big blind) folded on the Turn
Seat 4: Recafer68 collected ($0.10)
Seat 5: ajrestrepo folded before Flop (didn't bet)
Seat 6: rsxcd479 folded before Flop (didn't bet)


PokerStars Hand #238161395872:  Hold'em No Limit ($0.01/$0.02 USD) - 2022/08/23 0:24:45 ET
Table 'Achilles IV' 6-max Seat #2 is the button
Seat 1: Andy Oldani ($2.99 in chips)
Seat 2: black.pantherx ($2.01 in chips)
Seat 3: sopapunk ($6.61 in chips)
Seat 4: Recafer68 ($0.91 in chips)
Seat 5: ajrestrepo ($3.02 in chips)
Seat 6: rsxcd479 ($2.07 in chips)
sopapunk: posts small blind $0.01
Recafer68: posts big blind $0.02
*** HOLE CARDS ***
ajrestrepo: folds
rsxcd479: raises $0.04 to $0.06
Andy Oldani: folds
black.pantherx: calls $0.06
sopapunk: folds
Recafer68: calls $0.04
*** FLOP *** [9s 7s 9h]
Recafer68: bets $0.02
rsxcd479: folds
black.pantherx: raises $1.93 to $1.95 and is all-in
Recafer68: calls $0.83 and is all-in
Uncalled bet ($1.10) returned to black.pantherx
*** TURN *** [9s 7s 9h] [Ad]
*** RIVER *** [9s 7s 9h Ad] [7c]
*** SHOW DOWN ***
Recafer68: shows [Qs 8s] (two pair, Nines and Sevens)
black.pantherx: shows [Th Tc] (two pair, Tens and Nines)
black.pantherx cashed out the hand for $1.06 | Cash Out Fee $0.01
*** SUMMARY ***
Total pot $1.89 | Rake $0.07
Board [9s 7s 9h Ad 7c]
Seat 1: Andy Oldani folded before Flop (didn't bet)
Seat 2: black.pantherx (button) showed [Th Tc] and won ($1.82) with two pair, Tens and Nines (pot not awarded as player cashed out)
Seat 3: sopapunk (small blind) folded before Flop
Seat 4: Recafer68 (big blind) showed [Qs 8s] and lost with two pair, Nines and Sevens
Seat 5: ajrestrepo folded before Flop (didn't bet)
Seat 6: rsxcd479 folded on the Flop


PokerStars Hand #238161401836:  Hold'em No Limit ($0.01/$0.02 USD) - 2022/08/23 0:25:33 ET
Table 'Achilles IV' 6-max Seat #3 is the button
Seat 1: Andy Oldani ($2.99 in chips)
Seat 2: black.pantherx ($2.16 in chips)
Seat 3: sopapunk ($6.60 in chips)
Seat 5: ajrestrepo ($3.02 in chips)
Seat 6: rsxcd479 ($2.01 in chips)
ajrestrepo: posts small blind $0.01
rsxcd479: posts big blind $0.02
*** HOLE CARDS ***
Andy Oldani: folds
black.pantherx: folds
sopapunk: raises $0.03 to $0.05
ajrestrepo: folds
rsxcd479: folds
Uncalled bet ($0.03) returned to sopapunk
sopapunk collected $0.05 from pot
sopapunk: doesn't show hand
*** SUMMARY ***
Total pot $0.05 | Rake $0
Seat 1: Andy Oldani folded before Flop (didn't bet)
Seat 2: black.pantherx folded before Flop (didn't bet)
Seat 3: sopapunk (button) collected ($0.05)
Seat 5: ajrestrepo (small blind) folded before Flop
Seat 6: rsxcd479 (big blind) folded before Flop


PokerStars Hand #238161403711:  Hold'em No Limit ($0.01/$0.02 USD) - 2022/08/23 0:25:49 ET
Table 'Achilles IV' 6-max Seat #5 is the button
Seat 1: Andy Oldani ($2.99 in chips)
Seat 2: black.pantherx ($2.16 in chips)
Seat 3: sopapunk ($6.63 in chips)
Seat 4: Recafer68 ($0.80 in chips)
Seat 5: ajrestrepo ($3.01 in chips)
Seat 6: rsxcd479 ($2 in chips)
rsxcd479: posts small blind $0.01
Andy Oldani: posts big blind $0.02
Recafer68: posts small blind $0.01
*** HOLE CARDS ***
black.pantherx: folds
sopapunk: folds
Recafer68: calls $0.02
ajrestrepo: calls $0.02
rsxcd479: calls $0.01
Andy Oldani: checks
*** FLOP *** [4h 6c 8s]
rsxcd479: bets $0.07
Andy Oldani: folds
Recafer68: folds
ajrestrepo: calls $0.07
*** TURN *** [4h 6c 8s] [5h]
rsxcd479: checks
ajrestrepo: bets $0.22
rsxcd479: folds
Uncalled bet ($0.22) returned to ajrestrepo
ajrestrepo collected $0.22 from pot
*** SUMMARY ***
Total pot $0.23 | Rake $0.01
Board [4h 6c 8s 5h]
Seat 1: Andy Oldani (big blind) folded on the Flop
Seat 2: black.pantherx folded before Flop (didn't bet)
Seat 3: sopapunk folded before Flop (didn't bet)
Seat 4: Recafer68 folded on the Flop
Seat 5: ajrestrepo (button) collected ($0.22)
Seat 6: rsxcd479 (small blind) folded on the Turn


PokerStars Hand #238161413238:  Hold'em No Limit ($0.01/$0.02 USD) - 2022/08/23 0:26:46 ET
Table 'Achilles IV' 6-max Seat #6 is the button
Seat 1: Andy Oldani ($2.97 in chips)
Seat 2: black.pantherx ($2.16 in chips)
Seat 3: sopapunk ($6.63 in chips)
Seat 4: Recafer68 ($0.77 in chips)
Seat 5: ajrestrepo ($3.14 in chips)
Seat 6: rsxcd479 ($2 in chips)
Andy Oldani: posts small blind $0.01
black.pantherx: posts big blind $0.02
*** HOLE CARDS ***
sopapunk: folds
Recafer68: calls $0.02
ajrestrepo: folds
rsxcd479: raises $0.10 to $0.12
Andy Oldani: folds
black.pantherx: folds
Recafer68: folds
Uncalled bet ($0.10) returned to rsxcd479
rsxcd479 collected $0.07 from pot
*** SUMMARY ***
Total pot $0.07 | Rake $0
Seat 1: Andy Oldani (small blind) folded before Flop
Seat 2: black.pantherx (big blind) folded before Flop
Seat 3: sopapunk folded before Flop (didn't bet)
Seat 4: Recafer68 folded before Flop
Seat 5: ajrestrepo folded before Flop (didn't bet)
Seat 6: rsxcd479 (button) collected ($0.07)


PokerStars Hand #238161415181:  Hold'em No Limit ($0.01/$0.02 USD) - 2022/08/23 0:27:01 ET
Table 'Achilles IV' 6-max Seat #1 is the button
Seat 1: Andy Oldani ($2.96 in chips)
Seat 2: black.pantherx ($2.14 in chips)
Seat 3: sopapunk ($6.63 in chips)
Seat 4: Recafer68 ($0.75 in chips)
Seat 5: ajrestrepo ($3.14 in chips)
Seat 6: rsxcd479 ($2.05 in chips)
black.pantherx: posts small blind $0.01
sopapunk: posts big blind $0.02
*** HOLE CARDS ***
Recafer68: calls $0.02
ajrestrepo: folds
rsxcd479: folds
Andy Oldani: folds
black.pantherx: calls $0.01
sopapunk: checks
*** FLOP *** [Th 3s Qh]
black.pantherx: checks
sopapunk: checks
Recafer68: bets $0.04
black.pantherx: folds
sopapunk: calls $0.04
*** TURN *** [Th 3s Qh] [6s]
sopapunk: checks
Recafer68: bets $0.07
sopapunk: folds
Uncalled bet ($0.07) returned to Recafer68
Recafer68 collected $0.14 from pot
*** SUMMARY ***
Total pot $0.14 | Rake $0
Board [Th 3s Qh 6s]
Seat 1: Andy Oldani (button) folded before Flop (didn't bet)
Seat 2: black.pantherx (small blind) folded on the Flop
Seat 3: sopapunk (big blind) folded on the Turn
Seat 4: Recafer68 collected ($0.14)
Seat 5: ajrestrepo folded before Flop (didn't bet)
Seat 6: rsxcd479 folded before Flop (didn't bet)


PokerStars Hand #238161420027:  Hold'em No Limit ($0.01/$0.02 USD) - 2022/08/23 0:27:41 ET
Table 'Achilles IV' 6-max Seat #2 is the button
Seat 1: Andy Oldani ($2.96 in chips)
Seat 2: black.pantherx ($2.12 in chips)
Seat 3: sopapunk ($6.57 in chips)
Seat 4: Recafer68 ($0.83 in chips)
Seat 5: ajrestrepo ($3.14 in chips)
Seat 6: rsxcd479 ($2.05 in chips)
sopapunk: posts small blind $0.01
Recafer68: posts big blind $0.02
*** HOLE CARDS ***
ajrestrepo: folds
rsxcd479: folds
Andy Oldani: folds
black.pantherx: raises $0.03 to $0.05
sopapunk: raises $0.10 to $0.15
Recafer68: calls $0.13
black.pantherx: calls $0.10
*** FLOP *** [8c 4s Ac]
sopapunk: bets $0.15
Recafer68: raises $0.15 to $0.30
black.pantherx: folds
sopapunk: calls $0.15
*** TURN *** [8c 4s Ac] [5s]
sopapunk: checks
Recafer68: bets $0.38 and is all-in
sopapunk: calls $0.38
*** RIVER *** [8c 4s Ac 5s] [9s]
*** SHOW DOWN ***
sopapunk: shows [As Qh] (a pair of Aces)
Recafer68: shows [Ah 7d] (a pair of Aces - lower kicker)
sopapunk cashed out the hand for $1.47 | Cash Out Fee $0.01
Recafer68 cashed out the hand for $0.27
*** SUMMARY ***
Total pot $1.81 | Rake $0.06
Board [8c 4s Ac 5s 9s]
Seat 1: Andy Oldani folded before Flop (didn't bet)
Seat 2: black.pantherx (button) folded on the Flop
Seat 3: sopapunk (small blind) showed [As Qh] and won ($1.75) with a pair of Aces (pot not awarded as player cashed out)
Seat 4: Recafer68 (big blind) showed [Ah 7d] and lost with a pair of Aces (cashed out).
Seat 5: ajrestrepo folded before Flop (didn't bet)
Seat 6: rsxcd479 folded before Flop (didn't bet)


PokerStars Hand #238161428327:  Hold'em No Limit ($0.01/$0.02 USD) - 2022/08/23 0:28:48 ET
Table 'Achilles IV' 6-max Seat #3 is the button
Seat 1: Andy Oldani ($2.96 in chips)
Seat 2: black.pantherx ($2 in chips)
Seat 3: sopapunk ($7.21 in chips)
Seat 4: Recafer68 ($0.27 in chips)
Seat 5: ajrestrepo ($3.14 in chips)
Seat 6: rsxcd479 ($2.05 in chips)
Recafer68: posts small blind $0.01
ajrestrepo: posts big blind $0.02
*** HOLE CARDS ***
rsxcd479: folds
Andy Oldani: raises $0.04 to $0.06
black.pantherx: folds
black.pantherx leaves the table
sopapunk: folds
Recafer68: folds
ajrestrepo: folds
Uncalled bet ($0.04) returned to Andy Oldani
Andy Oldani collected $0.05 from pot
Andy Oldani: doesn't show hand
*** SUMMARY ***
Total pot $0.05 | Rake $0
Seat 1: Andy Oldani collected ($0.05)
Seat 2: black.pantherx folded before Flop (didn't bet)
Seat 3: sopapunk (button) folded before Flop (didn't bet)
Seat 4: Recafer68 (small blind) folded before Flop
Seat 5: ajrestrepo (big blind) folded before Flop
Seat 6: rsxcd479 folded before Flop (didn't bet)


PokerStars Hand #238161430376:  Hold'em No Limit ($0.01/$0.02 USD) - 2022/08/23 0:29:05 ET
Table 'Achilles IV' 6-max Seat #4 is the button
Seat 1: Andy Oldani ($2.99 in chips)
Seat 3: sopapunk ($7.21 in chips)
Seat 4: Recafer68 ($0.26 in chips)
Seat 5: ajrestrepo ($3.12 in chips)
Seat 6: rsxcd479 ($2.05 in chips)
ajrestrepo: posts small blind $0.01
rsxcd479: posts big blind $0.02
*** HOLE CARDS ***
NicolasMitma17 joins the table at seat #2
Andy Oldani: raises $0.04 to $0.06
sopapunk: folds
Recafer68: folds
ajrestrepo: folds
rsxcd479: folds
Uncalled bet ($0.04) returned to Andy Oldani
Andy Oldani collected $0.05 from pot
Andy Oldani: doesn't show hand
*** SUMMARY ***
Total pot $0.05 | Rake $0
Seat 1: Andy Oldani collected ($0.05)
Seat 3: sopapunk folded before Flop (didn't bet)
Seat 4: Recafer68 (button) folded before Flop (didn't bet)
Seat 5: ajrestrepo (small blind) folded before Flop
Seat 6: rsxcd479 (big blind) folded before Flop


PokerStars Hand #238161434468:  Hold'em No Limit ($0.01/$0.02 USD) - 2022/08/23 0:29:38 ET
Table 'Achilles IV' 6-max Seat #5 is the button
Seat 1: Andy Oldani ($3.02 in chips)
Seat 2: NicolasMitma17 ($1.60 in chips)
Seat 3: sopapunk ($7.21 in chips)
Seat 4: Recafer68 ($0.26 in chips)
Seat 5: ajrestrepo ($3.11 in chips)
Seat 6: rsxcd479 ($2.03 in chips)
rsxcd479: posts small blind $0.01
Andy Oldani: posts big blind $0.02
NicolasMitma17: posts big blind $0.02
*** HOLE CARDS ***
NicolasMitma17 has timed out
NicolasMitma17: checks
sopapunk: folds
Recafer68: calls $0.02
ajrestrepo: folds
rsxcd479: folds
Andy Oldani: checks
*** FLOP *** [Qs 6c Js]
Andy Oldani: checks
NicolasMitma17: checks
Recafer68: bets $0.02
Andy Oldani: calls $0.02
NicolasMitma17: calls $0.02
*** TURN *** [Qs 6c Js] [Td]
Andy Oldani: checks
NicolasMitma17: checks
Recafer68: bets $0.04
Andy Oldani: folds
NicolasMitma17: folds
Uncalled bet ($0.04) returned to Recafer68
Recafer68 collected $0.13 from pot
*** SUMMARY ***
Total pot $0.13 | Rake $0
Board [Qs 6c Js Td]
Seat 1: Andy Oldani (big blind) folded on the Turn
Seat 2: NicolasMitma17 folded on the Turn
Seat 3: sopapunk folded before Flop (didn't bet)
Seat 4: Recafer68 collected ($0.13)
Seat 5: ajrestrepo (button) folded before Flop (didn't bet)
Seat 6: rsxcd479 (small blind) folded before Flop


PokerStars Hand #238161445363:  Hold'em No Limit ($0.01/$0.02 USD) - 2022/08/23 0:31:09 ET
Table 'Achilles IV' 6-max Seat #6 is the button
Seat 1: Andy Oldani ($2.98 in chips)
Seat 2: NicolasMitma17 ($1.56 in chips)
Seat 3: sopapunk ($7.21 in chips)
Seat 4: Recafer68 ($0.35 in chips)
Seat 5: ajrestrepo ($3.11 in chips)
Seat 6: rsxcd479 ($2.02 in chips)
Andy Oldani: posts small blind $0.01
NicolasMitma17: posts big blind $0.02
*** HOLE CARDS ***
sopapunk: folds
Recafer68: calls $0.02
ajrestrepo: folds
sopapunk leaves the table
rsxcd479 has timed out
rsxcd479: folds
Andy Oldani: folds
NicolasMitma17: checks
*** FLOP *** [6c Td 2h]
NicolasMitma17: checks
Recafer68: checks
*** TURN *** [6c Td 2h] [Kd]
NicolasMitma17: checks
Recafer68: bets $0.02
NicolasMitma17: folds
Uncalled bet ($0.02) returned to Recafer68
Recafer68 collected $0.05 from pot
*** SUMMARY ***
Total pot $0.05 | Rake $0
Board [6c Td 2h Kd]
Seat 1: Andy Oldani (small blind) folded before Flop
Seat 2: NicolasMitma17 (big blind) folded on the Turn
Seat 3: sopapunk folded before Flop (didn't bet)
Seat 4: Recafer68 collected ($0.05)
Seat 5: ajrestrepo folded before Flop (didn't bet)
Seat 6: rsxcd479 (button) folded before Flop (didn't bet)


PokerStars Hand #238161452046:  Hold'em No Limit ($0.01/$0.02 USD) - 2022/08/23 0:32:04 ET
Table 'Achilles IV' 6-max Seat #1 is the button
Seat 1: Andy Oldani ($2.97 in chips)
Seat 2: NicolasMitma17 ($1.54 in chips)
Seat 4: Recafer68 ($0.38 in chips)
Seat 5: ajrestrepo ($3.11 in chips)
NicolasMitma17: posts small blind $0.01
Recafer68: posts big blind $0.02
*** HOLE CARDS ***
ajrestrepo: folds
Andy Oldani: folds
ajrestrepo leaves the table
Numakin joins the table at seat #5
NicolasMitma17 has timed out
NicolasMitma17: folds
Uncalled bet ($0.01) returned to Recafer68
Recafer68 collected $0.02 from pot
*** SUMMARY ***
Total pot $0.02 | Rake $0
Seat 1: Andy Oldani (button) folded before Flop (didn't bet)
Seat 2: NicolasMitma17 (small blind) folded before Flop
Seat 4: Recafer68 (big blind) collected ($0.02)
Seat 5: ajrestrepo folded before Flop (didn't bet)


PokerStars Hand #238161456210:  Hold'em No Limit ($0.01/$0.02 USD) - 2022/08/23 0:32:39 ET
Table 'Achilles IV' 6-max Seat #1 is the button
Seat 1: Andy Oldani ($2.95 in chips)
Seat 4: Recafer68 ($0.41 in chips)
Seat 5: Numakin ($2 in chips)
Recafer68: posts small blind $0.01
Numakin: posts big blind $0.02
*** HOLE CARDS ***
BigBen-AA1982 leaves the table
Andy Oldani: folds
Overdiewings joins the table at seat #3
Recafer68: calls $0.01
Overdiewings leaves the table
Numakin: checks
*** FLOP *** [9h Jc 5c]
southalllegend joins the table at seat #3
Recafer68: checks
Numakin: bets $0.02
Recafer68: calls $0.02
*** TURN *** [9h Jc 5c] [8h]
Recafer68: checks
Numakin: bets $0.04
Recafer68: raises $0.33 to $0.37 and is all-in
Numakin: folds
Uncalled bet ($0.33) returned to Recafer68
Recafer68 collected $0.15 from pot
*** SUMMARY ***
Total pot $0.16 | Rake $0.01
Board [9h Jc 5c 8h]
Seat 1: Andy Oldani (button) folded before Flop (didn't bet)
Seat 4: Recafer68 (small blind) collected ($0.15)
Seat 5: Numakin (big blind) folded on the Turn


PokerStars Hand #238161462179:  Hold'em No Limit ($0.01/$0.02 USD) - 2022/08/23 0:33:29 ET
Table 'Achilles IV' 6-max Seat #4 is the button
Seat 1: Andy Oldani ($2.95 in chips)
Seat 2: NicolasMitma17 ($1.53 in chips)
Seat 3: southalllegend ($0.80 in chips)
Seat 4: Recafer68 ($0.48 in chips)
Seat 5: Numakin ($2 in chips)
Numakin: posts small blind $0.01
Andy Oldani: posts big blind $0.02
NicolasMitma17: posts small & big blinds $0.03
southalllegend: posts big blind $0.02
*** HOLE CARDS ***
NicolasMitma17: checks
southalllegend: checks
Recafer68: raises $0.04 to $0.06
Numakin: folds
Andy Oldani: folds
NicolasMitma17: calls $0.04
southalllegend: calls $0.04
*** FLOP *** [5c Tc 2c]
NicolasMitma17: bets $0.04
southalllegend: calls $0.04
Recafer68: raises $0.08 to $0.12
NicolasMitma17: calls $0.08
southalllegend: calls $0.08
*** TURN *** [5c Tc 2c] [6d]
NicolasMitma17: checks
southalllegend: checks
Recafer68: bets $0.28
NicolasMitma17: calls $0.28
southalllegend: calls $0.28
*** RIVER *** [5c Tc 2c 6d] [7s]
NicolasMitma17: checks
southalllegend: bets $0.34 and is all-in
Recafer68: calls $0.02 and is all-in
NicolasMitma17: folds
Uncalled bet ($0.32) returned to southalllegend
*** SHOW DOWN ***
southalllegend: shows [4c 8s] (a straight, Four to Eight)
Recafer68: shows [5h 5d] (three of a kind, Fives)
southalllegend collected $1.41 from pot
*** SUMMARY ***
Total pot $1.46 | Rake $0.05
Board [5c Tc 2c 6d 7s]
Seat 1: Andy Oldani (big blind) folded before Flop
Seat 2: NicolasMitma17 folded on the River
Seat 3: southalllegend showed [4c 8s] and won ($1.41) with a straight, Four to Eight
Seat 4: Recafer68 (button) showed [5h 5d] and lost with three of a kind, Fives
Seat 5: Numakin (small blind) folded before Flop


PokerStars Hand #238161473145:  Hold'em No Limit ($0.01/$0.02 USD) - 2022/08/23 0:35:00 ET
Table 'Achilles IV' 6-max Seat #5 is the button
Seat 1: Andy Oldani ($2.93 in chips)
Seat 2: NicolasMitma17 ($1.06 in chips)
Seat 3: southalllegend ($1.73 in chips)
Seat 5: Numakin ($2 in chips)
Andy Oldani: posts small blind $0.01
NicolasMitma17: posts big blind $0.02
*** HOLE CARDS ***
southalllegend: calls $0.02
Numakin: folds
Andy Oldani: folds
NicolasMitma17: checks
*** FLOP *** [5s 3h 2c]
NicolasMitma17: checks
southalllegend: checks
*** TURN *** [5s 3h 2c] [Qc]
NicolasMitma17: checks
southalllegend: bets $0.56
NicolasMitma17: folds
Uncalled bet ($0.56) returned to southalllegend
southalllegend collected $0.05 from pot
southalllegend: shows [4h 6c] (a straight, Deuce to Six)
*** SUMMARY ***
Total pot $0.05 | Rake $0
Board [5s 3h 2c Qc]
Seat 1: Andy Oldani (small blind) folded before Flop
Seat 2: NicolasMitma17 (big blind) folded on the Turn
Seat 3: southalllegend collected ($0.05)
Seat 5: Numakin (button) folded before Flop (didn't bet)


PokerStars Hand #238161483194:  Hold'em No Limit ($0.01/$0.02 USD) - 2022/08/23 0:35:37 ET
Table 'Achilles IV' 6-max Seat #1 is the button
Seat 1: Andy Oldani ($2.92 in chips)
Seat 2: NicolasMitma17 ($1.04 in chips)
Seat 3: southalllegend ($1.76 in chips)
Seat 5: Numakin ($2 in chips)
NicolasMitma17: posts small blind $0.01
southalllegend: posts big blind $0.02
rsxcd479: sits out
*** HOLE CARDS ***
Numakin: raises $0.03 to $0.05
Andy Oldani: folds
Recafer68 leaves the table
NicolasMitma17: folds
southalllegend: calls $0.03
*** FLOP *** [2d Ks 4d]
southalllegend: checks
Numakin: bets $0.04
southalllegend: calls $0.04
*** TURN *** [2d Ks 4d] [7d]
southalllegend: checks
Numakin: checks
*** RIVER *** [2d Ks 4d 7d] [4h]
southalllegend: checks
Numakin: checks
*** SHOW DOWN ***
southalllegend: shows [Ts 2c] (two pair, Fours and Deuces)
Numakin: shows [8h 8c] (two pair, Eights and Fours)
Numakin collected $0.18 from pot
*** SUMMARY ***
Total pot $0.19 | Rake $0.01
Board [2d Ks 4d 7d 4h]
Seat 1: Andy Oldani (button) folded before Flop (didn't bet)
Seat 2: NicolasMitma17 (small blind) folded before Flop
Seat 3: southalllegend (big blind) showed [Ts 2c] and lost with two pair, Fours and Deuces
Seat 5: Numakin showed [8h 8c] and won ($0.18) with two pair, Eights and Fours


PokerStars Hand #238161486789:  Hold'em No Limit ($0.01/$0.02 USD) - 2022/08/23 0:36:06 ET
Table 'Achilles IV' 6-max Seat #2 is the button
Seat 1: Andy Oldani ($2.92 in chips)
Seat 2: NicolasMitma17 ($1.03 in chips)
Seat 3: southalllegend ($1.67 in chips)
Seat 5: Numakin ($2.09 in chips)
southalllegend: posts small blind $0.01
Numakin: posts big blind $0.02
rsxcd479: sits out
*** HOLE CARDS ***
Andy Oldani: folds
NicolasMitma17: folds
southalllegend: raises $0.04 to $0.06
LeMiguelo joins the table at seat #4
Numakin: calls $0.04
*** FLOP *** [Jh 2h 9c]
southalllegend: checks
Numakin: bets $0.04
southalllegend: raises $0.20 to $0.24
Numakin: raises $0.40 to $0.64
southalllegend: calls $0.40
*** TURN *** [Jh 2h 9c] [4c]
southalllegend: checks
Numakin: bets $1.22
southalllegend: calls $0.97 and is all-in
Uncalled bet ($0.25) returned to Numakin
*** RIVER *** [Jh 2h 9c 4c] [4s]
*** SHOW DOWN ***
southalllegend: shows [Js Ks] (two pair, Jacks and Fours)
Numakin: shows [2d 2c] (a full house, Deuces full of Fours)
Numakin collected $3.22 from pot
*** SUMMARY ***
Total pot $3.34 | Rake $0.12
Board [Jh 2h 9c 4c 4s]
Seat 1: Andy Oldani folded before Flop (didn't bet)
Seat 2: NicolasMitma17 (button) folded before Flop (didn't bet)
Seat 3: southalllegend (small blind) showed [Js Ks] and lost with two pair, Jacks and Fours
Seat 5: Numakin (big blind) showed [2d 2c] and won ($3.22) with a full house, Deuces full of Fours


PokerStars Hand #238161490172:  Hold'em No Limit ($0.01/$0.02 USD) - 2022/08/23 0:36:34 ET
Table 'Achilles IV' 6-max Seat #5 is the button
Seat 1: Andy Oldani ($2.92 in chips)
Seat 2: NicolasMitma17 ($1.03 in chips)
Seat 5: Numakin ($3.64 in chips)
Andy Oldani: posts small blind $0.01
NicolasMitma17: posts big blind $0.02
LeMiguelo: sits out
*** HOLE CARDS ***
Numakin: raises $0.03 to $0.05
Andy Oldani: folds
NicolasMitma17: folds
Uncalled bet ($0.03) returned to Numakin
Numakin collected $0.05 from pot
Numakin: doesn't show hand
*** SUMMARY ***
Total pot $0.05 | Rake $0
Seat 1: Andy Oldani (small blind) folded before Flop
Seat 2: NicolasMitma17 (big blind) folded before Flop
Seat 5: Numakin (button) collected ($0.05)


PokerStars Hand #238161491807:  Hold'em No Limit ($0.01/$0.02 USD) - 2022/08/23 0:36:48 ET
Table 'Achilles IV' 6-max Seat #1 is the button
Seat 1: Andy Oldani ($2.91 in chips)
Seat 2: NicolasMitma17 ($1.01 in chips)
Seat 4: LeMiguelo ($2 in chips)
Seat 5: Numakin ($3.67 in chips)
NicolasMitma17: posts small blind $0.01
LeMiguelo: posts big blind $0.02
rsxcd479: sits out
*** HOLE CARDS ***
Numakin: raises $0.03 to $0.05
Andy Oldani: raises $0.09 to $0.14
NicolasMitma17: folds
LeMiguelo: folds
Numakin: folds
Uncalled bet ($0.09) returned to Andy Oldani
Andy Oldani collected $0.13 from pot
Andy Oldani: doesn't show hand
*** SUMMARY ***
Total pot $0.13 | Rake $0
Seat 1: Andy Oldani (button) collected ($0.13)
Seat 2: NicolasMitma17 (small blind) folded before Flop
Seat 4: LeMiguelo (big blind) folded before Flop
Seat 5: Numakin folded before Flop


PokerStars Hand #238161495931:  Hold'em No Limit ($0.01/$0.02 USD) - 2022/08/23 0:37:22 ET
Table 'Achilles IV' 6-max Seat #2 is the button
Seat 1: Andy Oldani ($2.99 in chips)
Seat 2: NicolasMitma17 ($1 in chips)
Seat 4: LeMiguelo ($2 in chips)
Seat 5: Numakin ($3.62 in chips)
LeMiguelo: posts small blind $0.01
Numakin: posts big blind $0.02
rsxcd479: sits out
*** HOLE CARDS ***
Andy Oldani: calls $0.02
NicolasMitma17: raises $0.06 to $0.08
LeMiguelo: folds
Numakin: folds
Andy Oldani: calls $0.06
*** FLOP *** [Kd Jh Kh]
Andy Oldani: checks
NicolasMitma17: checks
*** TURN *** [Kd Jh Kh] [6s]
Andy Oldani: checks
NicolasMitma17: bets $0.08
Andy Oldani: folds
Uncalled bet ($0.08) returned to NicolasMitma17
NicolasMitma17 collected $0.18 from pot
NicolasMitma17: doesn't show hand
*** SUMMARY ***
Total pot $0.19 | Rake $0.01
Board [Kd Jh Kh 6s]
Seat 1: Andy Oldani folded on the Turn
Seat 2: NicolasMitma17 (button) collected ($0.18)
Seat 4: LeMiguelo (small blind) folded before Flop
Seat 5: Numakin (big blind) folded before Flop


PokerStars Hand #238161500477:  Hold'em No Limit ($0.01/$0.02 USD) - 2022/08/23 0:38:00 ET
Table 'Achilles IV' 6-max Seat #4 is the button
Seat 1: Andy Oldani ($2.91 in chips)
Seat 2: NicolasMitma17 ($1.10 in chips)
Seat 3: southalllegend ($2 in chips)
Seat 4: LeMiguelo ($2 in chips)
Seat 5: Numakin ($3.60 in chips)
Seat 6: rsxcd479 ($2.02 in chips)
Numakin: posts small blind $0.01
rsxcd479: posts big blind $0.02
southalllegend: posts small & big blinds $0.03
*** HOLE CARDS ***
Andy Oldani: folds
NicolasMitma17: folds
southalllegend: checks
LeMiguelo: folds
Numakin: folds
rsxcd479: checks
*** FLOP *** [5c Qs 2h]
rsxcd479: checks
southalllegend: checks
*** TURN *** [5c Qs 2h] [Ac]
rsxcd479: checks
southalllegend: checks
*** RIVER *** [5c Qs 2h Ac] [7s]
rsxcd479: checks
southalllegend: checks
*** SHOW DOWN ***
rsxcd479: shows [4d 8d] (high card Ace)
southalllegend: shows [Tc 7h] (a pair of Sevens)
southalllegend collected $0.06 from pot
*** SUMMARY ***
Total pot $0.06 | Rake $0
Board [5c Qs 2h Ac 7s]
Seat 1: Andy Oldani folded before Flop (didn't bet)
Seat 2: NicolasMitma17 folded before Flop (didn't bet)
Seat 3: southalllegend showed [Tc 7h] and won ($0.06) with a pair of Sevens
Seat 4: LeMiguelo (button) folded before Flop (didn't bet)
Seat 5: Numakin (small blind) folded before Flop
Seat 6: rsxcd479 (big blind) showed [4d 8d] and lost with high card Ace


PokerStars Hand #238161508454:  Hold'em No Limit ($0.01/$0.02 USD) - 2022/08/23 0:39:08 ET
Table 'Achilles IV' 6-max Seat #5 is the button
Seat 1: Andy Oldani ($2.91 in chips)
Seat 2: NicolasMitma17 ($1.10 in chips)
Seat 3: southalllegend ($2.03 in chips)
Seat 4: LeMiguelo ($2 in chips)
Seat 5: Numakin ($3.59 in chips)
Seat 6: rsxcd479 ($2 in chips)
rsxcd479: posts small blind $0.01
Andy Oldani: posts big blind $0.02
*** HOLE CARDS ***
NicolasMitma17: folds
southalllegend: raises $0.02 to $0.04
LeMiguelo: folds
Numakin: folds
rsxcd479: folds
Andy Oldani: calls $0.02
*** FLOP *** [5h Th Ac]
Andy Oldani: checks
southalllegend: bets $0.09
Andy Oldani: folds
Uncalled bet ($0.09) returned to southalllegend
southalllegend collected $0.09 from pot
*** SUMMARY ***
Total pot $0.09 | Rake $0
Board [5h Th Ac]
Seat 1: Andy Oldani (big blind) folded on the Flop
Seat 2: NicolasMitma17 folded before Flop (didn't bet)
Seat 3: southalllegend collected ($0.09)
Seat 4: LeMiguelo folded before Flop (didn't bet)
Seat 5: Numakin (button) folded before Flop (didn't bet)
Seat 6: rsxcd479 (small blind) folded before Flop


PokerStars Hand #238161511682:  Hold'em No Limit ($0.01/$0.02 USD) - 2022/08/23 0:39:35 ET
Table 'Achilles IV' 6-max Seat #6 is the button
Seat 1: Andy Oldani ($2.87 in chips)
Seat 2: NicolasMitma17 ($1.10 in chips)
Seat 3: southalllegend ($2.08 in chips)
Seat 4: LeMiguelo ($2 in chips)
Seat 5: Numakin ($3.59 in chips)
Seat 6: rsxcd479 ($2 in chips)
Andy Oldani: posts small blind $0.01
NicolasMitma17: posts big blind $0.02
*** HOLE CARDS ***
southalllegend: calls $0.02
LeMiguelo: folds
Numakin: folds
rsxcd479: folds
Andy Oldani: folds
NicolasMitma17: checks
*** FLOP *** [7h 5d 2h]
NicolasMitma17: checks
southalllegend: checks
*** TURN *** [7h 5d 2h] [Ac]
NicolasMitma17: checks
southalllegend: checks
*** RIVER *** [7h 5d 2h Ac] [Kd]
NicolasMitma17: checks
southalllegend: checks
*** SHOW DOWN ***
NicolasMitma17: shows [6h 9c] (high card Ace)
southalllegend: mucks hand
NicolasMitma17 collected $0.05 from pot
*** SUMMARY ***
Total pot $0.05 | Rake $0
Board [7h 5d 2h Ac Kd]
Seat 1: Andy Oldani (small blind) folded before Flop
Seat 2: NicolasMitma17 (big blind) showed [6h 9c] and won ($0.05) with high card Ace
Seat 3: southalllegend mucked
Seat 4: LeMiguelo folded before Flop (didn't bet)
Seat 5: Numakin folded before Flop (didn't bet)
Seat 6: rsxcd479 (button) folded before Flop (didn't bet)


PokerStars Hand #238161515069:  Hold'em No Limit ($0.01/$0.02 USD) - 2022/08/23 0:40:04 ET
Table 'Achilles IV' 6-max Seat #1 is the button
Seat 1: Andy Oldani ($2.86 in chips)
Seat 2: NicolasMitma17 ($1.13 in chips)
Seat 3: southalllegend ($2.06 in chips)
Seat 4: LeMiguelo ($2 in chips)
Seat 5: Numakin ($3.59 in chips)
Seat 6: rsxcd479 ($2 in chips)
NicolasMitma17: posts small blind $0.01
southalllegend: posts big blind $0.02
*** HOLE CARDS ***
LeMiguelo: folds
Numakin: folds
rsxcd479: folds
Andy Oldani: folds
NicolasMitma17: folds
Uncalled bet ($0.01) returned to southalllegend
southalllegend collected $0.02 from pot
southalllegend: shows [Qd Qc] (a pair of Queens)
*** SUMMARY ***
Total pot $0.02 | Rake $0
Seat 1: Andy Oldani (button) folded before Flop (didn't bet)
Seat 2: NicolasMitma17 (small blind) folded before Flop
Seat 3: southalllegend (big blind) collected ($0.02)
Seat 4: LeMiguelo folded before Flop (didn't bet)
Seat 5: Numakin folded before Flop (didn't bet)
Seat 6: rsxcd479 folded before Flop (didn't bet)


PokerStars Hand #238161517585:  Hold'em No Limit ($0.01/$0.02 USD) - 2022/08/23 0:40:25 ET
Table 'Achilles IV' 6-max Seat #2 is the button
Seat 1: Andy Oldani ($2.86 in chips)
Seat 2: NicolasMitma17 ($1.12 in chips)
Seat 3: southalllegend ($2.07 in chips)
Seat 4: LeMiguelo ($2 in chips)
Seat 5: Numakin ($3.59 in chips)
Seat 6: rsxcd479 ($2 in chips)
southalllegend: posts small blind $0.01
LeMiguelo: posts big blind $0.02
*** HOLE CARDS ***
Numakin: folds
rsxcd479: folds
Andy Oldani: folds
NicolasMitma17: folds
southalllegend: calls $0.01
LeMiguelo: checks
*** FLOP *** [Jc Qd 2c]
southalllegend: checks
LeMiguelo: bets $0.04
southalllegend: calls $0.04
*** TURN *** [Jc Qd 2c] [8h]
southalllegend: checks
LeMiguelo: bets $0.09
southalllegend: calls $0.09
*** RIVER *** [Jc Qd 2c 8h] [9c]
southalllegend: checks
LeMiguelo: checks
*** SHOW DOWN ***
southalllegend: shows [2s 5d] (a pair of Deuces)
LeMiguelo: shows [Jh 2d] (two pair, Jacks and Deuces)
LeMiguelo collected $0.29 from pot
*** SUMMARY ***
Total pot $0.30 | Rake $0.01
Board [Jc Qd 2c 8h 9c]
Seat 1: Andy Oldani folded before Flop (didn't bet)
Seat 2: NicolasMitma17 (button) folded before Flop (didn't bet)
Seat 3: southalllegend (small blind) showed [2s 5d] and lost with a pair of Deuces
Seat 4: LeMiguelo (big blind) showed [Jh 2d] and won ($0.29) with two pair, Jacks and Deuces
Seat 5: Numakin folded before Flop (didn't bet)
Seat 6: rsxcd479 folded before Flop (didn't bet)


PokerStars Hand #238161522395:  Hold'em No Limit ($0.01/$0.02 USD) - 2022/08/23 0:41:06 ET
Table 'Achilles IV' 6-max Seat #3 is the button
Seat 1: Andy Oldani ($2.86 in chips)
Seat 2: NicolasMitma17 ($1.12 in chips)
Seat 3: southalllegend ($1.92 in chips)
Seat 4: LeMiguelo ($2.14 in chips)
Seat 5: Numakin ($3.59 in chips)
Seat 6: rsxcd479 ($2 in chips)
LeMiguelo: posts small blind $0.01
Numakin: posts big blind $0.02
*** HOLE CARDS ***
rsxcd479: folds
Andy Oldani: folds
NicolasMitma17: folds
southalllegend: calls $0.02
LeMiguelo: raises $0.06 to $0.08
Numakin: folds
southalllegend: calls $0.06
*** FLOP *** [5c Qs 9h]
LeMiguelo: checks
southalllegend: checks
*** TURN *** [5c Qs 9h] [Td]
LeMiguelo: checks
southalllegend: bets $0.17
LeMiguelo: folds
Uncalled bet ($0.17) returned to southalllegend
southalllegend collected $0.17 from pot
*** SUMMARY ***
Total pot $0.18 | Rake $0.01
Board [5c Qs 9h Td]
Seat 1: Andy Oldani folded before Flop (didn't bet)
Seat 2: NicolasMitma17 folded before Flop (didn't bet)
Seat 3: southalllegend (button) collected ($0.17)
Seat 4: LeMiguelo (small blind) folded on the Turn
Seat 5: Numakin (big blind) folded before Flop
Seat 6: rsxcd479 folded before Flop (didn't bet)


PokerStars Hand #238161528378:  Hold'em No Limit ($0.01/$0.02 USD) - 2022/08/23 0:41:56 ET
Table 'Achilles IV' 6-max Seat #4 is the button
Seat 1: Andy Oldani ($2.86 in chips)
Seat 2: NicolasMitma17 ($1.12 in chips)
Seat 3: southalllegend ($2.01 in chips)
Seat 4: LeMiguelo ($2.06 in chips)
Seat 5: Numakin ($3.57 in chips)
Seat 6: rsxcd479 ($2 in chips)
Numakin: posts small blind $0.01
rsxcd479: posts big blind $0.02
*** HOLE CARDS ***
Andy Oldani: folds
NicolasMitma17: folds
southalllegend: calls $0.02
LeMiguelo: folds
Numakin: raises $0.05 to $0.07
rsxcd479: folds
southalllegend: calls $0.05
*** FLOP *** [8h 3s 5c]
Numakin: bets $0.05
southalllegend: calls $0.05
*** TURN *** [8h 3s 5c] [6s]
Numakin: bets $0.08
southalllegend: calls $0.08
*** RIVER *** [8h 3s 5c 6s] [Ad]
Numakin: checks
southalllegend: checks
*** SHOW DOWN ***
Numakin: shows [Kh Kd] (a pair of Kings)
southalllegend: mucks hand
Numakin collected $0.41 from pot
*** SUMMARY ***
Total pot $0.42 | Rake $0.01
Board [8h 3s 5c 6s Ad]
Seat 1: Andy Oldani folded before Flop (didn't bet)
Seat 2: NicolasMitma17 folded before Flop (didn't bet)
Seat 3: southalllegend mucked
Seat 4: LeMiguelo (button) folded before Flop (didn't bet)
Seat 5: Numakin (small blind) showed [Kh Kd] and won ($0.41) with a pair of Kings
Seat 6: rsxcd479 (big blind) folded before Flop


PokerStars Hand #238161532330:  Hold'em No Limit ($0.01/$0.02 USD) - 2022/08/23 0:42:29 ET
Table 'Achilles IV' 6-max Seat #5 is the button
Seat 1: Andy Oldani ($2.86 in chips)
Seat 2: NicolasMitma17 ($1.12 in chips)
Seat 3: southalllegend ($1.81 in chips)
Seat 4: LeMiguelo ($2.06 in chips)
Seat 5: Numakin ($3.78 in chips)
Seat 6: rsxcd479 ($2 in chips)
rsxcd479: posts small blind $0.01
Andy Oldani: posts big blind $0.02
*** HOLE CARDS ***
NicolasMitma17: folds
southalllegend: calls $0.02
LeMiguelo: folds
Numakin: folds
rsxcd479: folds
Andy Oldani: raises $0.04 to $0.06
southalllegend: calls $0.04
*** FLOP *** [Jh Ac 8d]
Andy Oldani: checks
southalllegend: checks
*** TURN *** [Jh Ac 8d] [Qh]
Andy Oldani: bets $0.10
southalllegend: calls $0.10
*** RIVER *** [Jh Ac 8d Qh] [Qc]
Andy Oldani: bets $0.38
southalllegend: calls $0.38
*** SHOW DOWN ***
Andy Oldani: shows [8s 8c] (a full house, Eights full of Queens)
southalllegend: mucks hand
Andy Oldani collected $1.05 from pot
*** SUMMARY ***
Total pot $1.09 | Rake $0.04
Board [Jh Ac 8d Qh Qc]
Seat 1: Andy Oldani (big blind) showed [8s 8c] and won ($1.05) with a full house, Eights full of Queens
Seat 2: NicolasMitma17 folded before Flop (didn't bet)
Seat 3: southalllegend mucked
Seat 4: LeMiguelo folded before Flop (didn't bet)
Seat 5: Numakin (button) folded before Flop (didn't bet)
Seat 6: rsxcd479 (small blind) folded before Flop


PokerStars Hand #238161537792:  Hold'em No Limit ($0.01/$0.02 USD) - 2022/08/23 0:43:16 ET
Table 'Achilles IV' 6-max Seat #6 is the button
Seat 1: Andy Oldani ($3.37 in chips)
Seat 2: NicolasMitma17 ($1.12 in chips)
Seat 3: southalllegend ($1.27 in chips)
Seat 4: LeMiguelo ($2.06 in chips)
Seat 5: Numakin ($3.78 in chips)
Seat 6: rsxcd479 ($2 in chips)
Andy Oldani: posts small blind $0.01
NicolasMitma17: posts big blind $0.02
*** HOLE CARDS ***
southalllegend: calls $0.02
LeMiguelo: folds
LeMiguelo leaves the table
Numakin: folds
rsxcd479 has timed out
rsxcd479: folds
Andy Oldani: folds
NicolasMitma17: checks
*** FLOP *** [6c Kh 2c]
NicolasMitma17: checks
southalllegend: checks
*** TURN *** [6c Kh 2c] [7s]
NicolasMitma17: checks
southalllegend: checks
*** RIVER *** [6c Kh 2c 7s] [4d]
NicolasMitma17: checks
jeckarliyo joins the table at seat #4
southalllegend: checks
*** SHOW DOWN ***
NicolasMitma17: shows [8d 2s] (a pair of Deuces)
southalllegend: mucks hand
NicolasMitma17 collected $0.05 from pot
*** SUMMARY ***
Total pot $0.05 | Rake $0
Board [6c Kh 2c 7s 4d]
Seat 1: Andy Oldani (small blind) folded before Flop
Seat 2: NicolasMitma17 (big blind) showed [8d 2s] and won ($0.05) with a pair of Deuces
Seat 3: southalllegend mucked
Seat 4: LeMiguelo folded before Flop (didn't bet)
Seat 5: Numakin folded before Flop (didn't bet)
Seat 6: rsxcd479 (button) folded before Flop (didn't bet)


PokerStars Hand #238161543207:  Hold'em No Limit ($0.01/$0.02 USD) - 2022/08/23 0:44:03 ET
Table 'Achilles IV' 6-max Seat #1 is the button
Seat 1: Andy Oldani ($3.36 in chips)
Seat 2: NicolasMitma17 ($1.15 in chips)
Seat 3: southalllegend ($1.25 in chips)
Seat 4: jeckarliyo ($0.80 in chips)
Seat 5: Numakin ($3.78 in chips)
Seat 6: rsxcd479 ($2 in chips)
NicolasMitma17: posts small blind $0.01
southalllegend: posts big blind $0.02
jeckarliyo: posts big blind $0.02
*** HOLE CARDS ***
jeckarliyo: checks
Numakin: folds
rsxcd479: folds
Andy Oldani: folds
NicolasMitma17: folds
southalllegend: checks
*** FLOP *** [Qc Ah 8h]
southalllegend: checks
jeckarliyo: checks
*** TURN *** [Qc Ah 8h] [3c]
southalllegend: checks
jeckarliyo: bets $0.04
southalllegend: calls $0.04
*** RIVER *** [Qc Ah 8h 3c] [Jd]
southalllegend: checks
jeckarliyo: bets $0.04
southalllegend: calls $0.04
*** SHOW DOWN ***
jeckarliyo: shows [Jc Td] (a pair of Jacks)
southalllegend: mucks hand
jeckarliyo collected $0.20 from pot
*** SUMMARY ***
Total pot $0.21 | Rake $0.01
Board [Qc Ah 8h 3c Jd]
Seat 1: Andy Oldani (button) folded before Flop (didn't bet)
Seat 2: NicolasMitma17 (small blind) folded before Flop
Seat 3: southalllegend (big blind) mucked
Seat 4: jeckarliyo showed [Jc Td] and won ($0.20) with a pair of Jacks
Seat 5: Numakin folded before Flop (didn't bet)
Seat 6: rsxcd479 folded before Flop (didn't bet)


PokerStars Hand #238161547791:  Hold'em No Limit ($0.01/$0.02 USD) - 2022/08/23 0:44:42 ET
Table 'Achilles IV' 6-max Seat #2 is the button
Seat 1: Andy Oldani ($3.36 in chips)
Seat 2: NicolasMitma17 ($1.14 in chips)
Seat 3: southalllegend ($1.15 in chips)
Seat 4: jeckarliyo ($0.90 in chips)
Seat 5: Numakin ($3.78 in chips)
Seat 6: rsxcd479 ($2 in chips)
southalllegend: posts small blind $0.01
jeckarliyo: posts big blind $0.02
*** HOLE CARDS ***
Numakin: folds
rsxcd479 has timed out
rsxcd479: folds
Andy Oldani: folds
NicolasMitma17: calls $0.02
southalllegend: calls $0.01
jeckarliyo: checks
*** FLOP *** [2s As 2d]
southalllegend: checks
jeckarliyo: checks
NicolasMitma17: checks
*** TURN *** [2s As 2d] [8s]
southalllegend: bets $0.06
jeckarliyo: folds
NicolasMitma17: folds
Uncalled bet ($0.06) returned to southalllegend
southalllegend collected $0.06 from pot
southalllegend: shows [5h 2c] (three of a kind, Deuces)
*** SUMMARY ***
Total pot $0.06 | Rake $0
Board [2s As 2d 8s]
Seat 1: Andy Oldani folded before Flop (didn't bet)
Seat 2: NicolasMitma17 (button) folded on the Turn
Seat 3: southalllegend (small blind) collected ($0.06)
Seat 4: jeckarliyo (big blind) folded on the Turn
Seat 5: Numakin folded before Flop (didn't bet)
Seat 6: rsxcd479 folded before Flop (didn't bet)


PokerStars Hand #238161552231:  Hold'em No Limit ($0.01/$0.02 USD) - 2022/08/23 0:45:20 ET
Table 'Achilles IV' 6-max Seat #3 is the button
Seat 1: Andy Oldani ($3.36 in chips)
Seat 2: NicolasMitma17 ($1.12 in chips)
Seat 3: southalllegend ($1.19 in chips)
Seat 4: jeckarliyo ($0.88 in chips)
Seat 5: Numakin ($3.78 in chips)
Seat 6: rsxcd479 ($2 in chips)
jeckarliyo: posts small blind $0.01
Numakin: posts big blind $0.02
*** HOLE CARDS ***
rsxcd479: folds
Andy Oldani: folds
NicolasMitma17: folds
southalllegend: calls $0.02
jeckarliyo: calls $0.01
Numakin: checks
*** FLOP *** [Td Jh 6d]
jeckarliyo: checks
Numakin: checks
southalllegend: checks
*** TURN *** [Td Jh 6d] [3d]
jeckarliyo: checks
Numakin: checks
southalllegend: checks
*** RIVER *** [Td Jh 6d 3d] [2s]
jeckarliyo: checks
Numakin: checks
southalllegend: checks
*** SHOW DOWN ***
jeckarliyo: shows [Kc 9s] (high card King)
Numakin: shows [4c 6s] (a pair of Sixes)
southalllegend: shows [Ts 5c] (a pair of Tens)
southalllegend collected $0.06 from pot
*** SUMMARY ***
Total pot $0.06 | Rake $0
Board [Td Jh 6d 3d 2s]
Seat 1: Andy Oldani folded before Flop (didn't bet)
Seat 2: NicolasMitma17 folded before Flop (didn't bet)
Seat 3: southalllegend (button) showed [Ts 5c] and won ($0.06) with a pair of Tens
Seat 4: jeckarliyo (small blind) showed [Kc 9s] and lost with high card King
Seat 5: Numakin (big blind) showed [4c 6s] and lost with a pair of Sixes
Seat 6: rsxcd479 folded before Flop (didn't bet)


PokerStars Hand #238161557313:  Hold'em No Limit ($0.01/$0.02 USD) - 2022/08/23 0:46:03 ET
Table 'Achilles IV' 6-max Seat #4 is the button
Seat 1: Andy Oldani ($3.36 in chips)
Seat 2: NicolasMitma17 ($1.12 in chips)
Seat 3: southalllegend ($1.23 in chips)
Seat 4: jeckarliyo ($0.86 in chips)
Seat 5: Numakin ($3.76 in chips)
Seat 6: rsxcd479 ($2 in chips)
Numakin: posts small blind $0.01
rsxcd479: posts big blind $0.02
*** HOLE CARDS ***
Andy Oldani: folds
NicolasMitma17: folds
southalllegend: calls $0.02
jeckarliyo: raises $0.02 to $0.04
Numakin: folds
rsxcd479: calls $0.02
southalllegend: calls $0.02
*** FLOP *** [5d Jc Kd]
rsxcd479: checks
southalllegend: checks
jeckarliyo: bets $0.04
rsxcd479: folds
southalllegend: calls $0.04
*** TURN *** [5d Jc Kd] [4d]
southalllegend: checks
jeckarliyo: bets $0.04
southalllegend: calls $0.04
*** RIVER *** [5d Jc Kd 4d] [8d]
southalllegend: checks
jeckarliyo: bets $0.06
southalllegend: calls $0.06
*** SHOW DOWN ***
jeckarliyo: shows [Jd Ah] (a flush, King high)
southalllegend: mucks hand
jeckarliyo collected $0.40 from pot
*** SUMMARY ***
Total pot $0.41 | Rake $0.01
Board [5d Jc Kd 4d 8d]
Seat 1: Andy Oldani folded before Flop (didn't bet)
Seat 2: NicolasMitma17 folded before Flop (didn't bet)
Seat 3: southalllegend mucked
Seat 4: jeckarliyo (button) showed [Jd Ah] and won ($0.40) with a flush, King high
Seat 5: Numakin (small blind) folded before Flop
Seat 6: rsxcd479 (big blind) folded on the Flop


PokerStars Hand #238161562869:  Hold'em No Limit ($0.01/$0.02 USD) - 2022/08/23 0:46:50 ET
Table 'Achilles IV' 6-max Seat #5 is the button
Seat 1: Andy Oldani ($3.36 in chips)
Seat 2: NicolasMitma17 ($1.12 in chips)
Seat 3: southalllegend ($1.05 in chips)
Seat 4: jeckarliyo ($1.08 in chips)
Seat 5: Numakin ($3.75 in chips)
Seat 6: rsxcd479 ($2 in chips)
rsxcd479: posts small blind $0.01
Andy Oldani: posts big blind $0.02
*** HOLE CARDS ***
NicolasMitma17: folds
southalllegend: calls $0.02
jeckarliyo: folds
Numakin: folds
rsxcd479: raises $0.08 to $0.10
Andy Oldani: folds
southalllegend: calls $0.08
*** FLOP *** [5s 4s 2s]
rsxcd479: checks
southalllegend: checks
*** TURN *** [5s 4s 2s] [Ks]
rsxcd479: checks
southalllegend: checks
*** RIVER *** [5s 4s 2s Ks] [2h]
rsxcd479: checks
southalllegend: checks
*** SHOW DOWN ***
rsxcd479: shows [9c 8h] (a pair of Deuces)
southalllegend: shows [4h Qc] (two pair, Fours and Deuces)
southalllegend collected $0.21 from pot
*** SUMMARY ***
Total pot $0.22 | Rake $0.01
Board [5s 4s 2s Ks 2h]
Seat 1: Andy Oldani (big blind) folded before Flop
Seat 2: NicolasMitma17 folded before Flop (didn't bet)
Seat 3: southalllegend showed [4h Qc] and won ($0.21) with two pair, Fours and Deuces
Seat 4: jeckarliyo folded before Flop (didn't bet)
Seat 5: Numakin (button) folded before Flop (didn't bet)
Seat 6: rsxcd479 (small blind) showed [9c 8h] and lost with a pair of Deuces


PokerStars Hand #238161568901:  Hold'em No Limit ($0.01/$0.02 USD) - 2022/08/23 0:47:42 ET
Table 'Achilles IV' 6-max Seat #6 is the button
Seat 1: Andy Oldani ($3.34 in chips)
Seat 2: NicolasMitma17 ($1.12 in chips)
Seat 3: southalllegend ($1.16 in chips)
Seat 4: jeckarliyo ($1.08 in chips)
Seat 5: Numakin ($3.75 in chips)
Seat 6: rsxcd479 ($2 in chips)
Andy Oldani: posts small blind $0.01
NicolasMitma17: posts big blind $0.02
*** HOLE CARDS ***
southalllegend: calls $0.02
jeckarliyo: calls $0.02
Numakin: folds
rsxcd479: raises $0.11 to $0.13
Andy Oldani: folds
NicolasMitma17: calls $0.11
southalllegend: calls $0.11
jeckarliyo: folds
*** FLOP *** [9d Ad 2s]
NicolasMitma17: checks
southalllegend: checks
rsxcd479: checks
*** TURN *** [9d Ad 2s] [Kd]
NicolasMitma17: checks
southalllegend: checks
rsxcd479: checks
*** RIVER *** [9d Ad 2s Kd] [5h]
NicolasMitma17: checks
southalllegend: bets $0.41
rsxcd479: folds
NicolasMitma17: folds
Uncalled bet ($0.41) returned to southalllegend
southalllegend collected $0.41 from pot
*** SUMMARY ***
Total pot $0.42 | Rake $0.01
Board [9d Ad 2s Kd 5h]
Seat 1: Andy Oldani (small blind) folded before Flop
Seat 2: NicolasMitma17 (big blind) folded on the River
Seat 3: southalllegend collected ($0.41)
Seat 4: jeckarliyo folded before Flop
Seat 5: Numakin folded before Flop (didn't bet)
Seat 6: rsxcd479 (button) folded on the River


PokerStars Hand #238161578193:  Hold'em No Limit ($0.01/$0.02 USD) - 2022/08/23 0:49:00 ET
Table 'Achilles IV' 6-max Seat #1 is the button
Seat 1: Andy Oldani ($3.33 in chips)
Seat 2: NicolasMitma17 ($0.99 in chips)
Seat 3: southalllegend ($1.44 in chips)
Seat 4: jeckarliyo ($1.06 in chips)
Seat 5: Numakin ($3.75 in chips)
Seat 6: rsxcd479 ($2 in chips)
NicolasMitma17: posts small blind $0.01
southalllegend: posts big blind $0.02
*** HOLE CARDS ***
jeckarliyo: calls $0.02
Numakin: folds
rsxcd479 has timed out
rsxcd479: folds
Andy Oldani: folds
NicolasMitma17: folds
southalllegend: checks
*** FLOP *** [6s 6c 2s]
southalllegend: checks
jeckarliyo: checks
*** TURN *** [6s 6c 2s] [3s]
southalllegend: checks
jeckarliyo: checks
*** RIVER *** [6s 6c 2s 3s] [4s]
southalllegend: bets $1.42 and is all-in
jeckarliyo: folds
Uncalled bet ($1.42) returned to southalllegend
southalllegend collected $0.05 from pot
*** SUMMARY ***
Total pot $0.05 | Rake $0
Board [6s 6c 2s 3s 4s]
Seat 1: Andy Oldani (button) folded before Flop (didn't bet)
Seat 2: NicolasMitma17 (small blind) folded before Flop
Seat 3: southalllegend (big blind) collected ($0.05)
Seat 4: jeckarliyo folded on the River
Seat 5: Numakin folded before Flop (didn't bet)
Seat 6: rsxcd479 folded before Flop (didn't bet)


PokerStars Hand #238161582606:  Hold'em No Limit ($0.01/$0.02 USD) - 2022/08/23 0:49:38 ET
Table 'Achilles IV' 6-max Seat #2 is the button
Seat 1: Andy Oldani ($3.33 in chips)
Seat 2: NicolasMitma17 ($0.98 in chips)
Seat 3: southalllegend ($1.47 in chips)
Seat 4: jeckarliyo ($1.04 in chips)
Seat 5: Numakin ($3.75 in chips)
Seat 6: rsxcd479 ($2 in chips)
southalllegend: posts small blind $0.01
jeckarliyo: posts big blind $0.02
*** HOLE CARDS ***
Numakin: raises $0.03 to $0.05
rsxcd479 has timed out
rsxcd479: folds
Andy Oldani: folds
NicolasMitma17: folds
southalllegend: calls $0.04
jeckarliyo: calls $0.03
*** FLOP *** [5d 4s Ts]
southalllegend: checks
jeckarliyo: checks
Numakin: checks
*** TURN *** [5d 4s Ts] [As]
southalllegend: checks
jeckarliyo: bets $0.06
Numakin: folds
southalllegend: calls $0.06
*** RIVER *** [5d 4s Ts As] [9c]
southalllegend: checks
jeckarliyo: bets $0.12
southalllegend: folds
Uncalled bet ($0.12) returned to jeckarliyo
jeckarliyo collected $0.26 from pot
jeckarliyo: doesn't show hand
*** SUMMARY ***
Total pot $0.27 | Rake $0.01
Board [5d 4s Ts As 9c]
Seat 1: Andy Oldani folded before Flop (didn't bet)
Seat 2: NicolasMitma17 (button) folded before Flop (didn't bet)
Seat 3: southalllegend (small blind) folded on the River
Seat 4: jeckarliyo (big blind) collected ($0.26)
Seat 5: Numakin folded on the Turn
Seat 6: rsxcd479 folded before Flop (didn't bet)


PokerStars Hand #238161588900:  Hold'em No Limit ($0.01/$0.02 USD) - 2022/08/23 0:50:33 ET
Table 'Achilles IV' 6-max Seat #3 is the button
Seat 1: Andy Oldani ($3.33 in chips)
Seat 2: NicolasMitma17 ($0.98 in chips)
Seat 3: southalllegend ($1.36 in chips)
Seat 4: jeckarliyo ($1.19 in chips)
Seat 5: Numakin ($3.70 in chips)
Seat 6: rsxcd479 ($2 in chips)
jeckarliyo: posts small blind $0.01
Numakin: posts big blind $0.02
*** HOLE CARDS ***
rsxcd479: folds
Andy Oldani: folds
NicolasMitma17: folds
southalllegend: calls $0.02
jeckarliyo: calls $0.01
Numakin: checks
*** FLOP *** [Qd Jd 2c]
jeckarliyo: checks
Numakin: checks
southalllegend: checks
*** TURN *** [Qd Jd 2c] [7c]
jeckarliyo: checks
Numakin: checks
southalllegend: checks
*** RIVER *** [Qd Jd 2c 7c] [Ts]
jeckarliyo: bets $0.06
Numakin: folds
southalllegend: folds
Uncalled bet ($0.06) returned to jeckarliyo
jeckarliyo collected $0.06 from pot
jeckarliyo: doesn't show hand
*** SUMMARY ***
Total pot $0.06 | Rake $0
Board [Qd Jd 2c 7c Ts]
Seat 1: Andy Oldani folded before Flop (didn't bet)
Seat 2: NicolasMitma17 folded before Flop (didn't bet)
Seat 3: southalllegend (button) folded on the River
Seat 4: jeckarliyo (small blind) collected ($0.06)
Seat 5: Numakin (big blind) folded on the River
Seat 6: rsxcd479 folded before Flop (didn't bet)


PokerStars Hand #238161593069:  Hold'em No Limit ($0.01/$0.02 USD) - 2022/08/23 0:51:09 ET
Table 'Achilles IV' 6-max Seat #4 is the button
Seat 1: Andy Oldani ($3.33 in chips)
Seat 2: NicolasMitma17 ($0.98 in chips)
Seat 3: southalllegend ($1.34 in chips)
Seat 4: jeckarliyo ($1.23 in chips)
Seat 5: Numakin ($3.68 in chips)
Seat 6: rsxcd479 ($2 in chips)
Numakin: posts small blind $0.01
rsxcd479: posts big blind $0.02
*** HOLE CARDS ***
Andy Oldani: raises $0.04 to $0.06
NicolasMitma17: folds
southalllegend: calls $0.06
jeckarliyo: calls $0.06
Numakin: folds
rsxcd479: folds
*** FLOP *** [6s 2h Qd]
Andy Oldani: checks
southalllegend: checks
jeckarliyo: bets $0.08
Andy Oldani: calls $0.08
southalllegend: calls $0.08
*** TURN *** [6s 2h Qd] [8h]
Andy Oldani: checks
southalllegend: bets $0.43
jeckarliyo: calls $0.43
Andy Oldani: folds
*** RIVER *** [6s 2h Qd 8h] [Qs]
southalllegend: checks
jeckarliyo: bets $0.32
southalllegend: calls $0.32
*** SHOW DOWN ***
jeckarliyo: shows [Qc Kc] (three of a kind, Queens)
southalllegend: mucks hand
jeckarliyo collected $1.88 from pot
*** SUMMARY ***
Total pot $1.95 | Rake $0.07
Board [6s 2h Qd 8h Qs]
Seat 1: Andy Oldani folded on the Turn
Seat 2: NicolasMitma17 folded before Flop (didn't bet)
Seat 3: southalllegend mucked
Seat 4: jeckarliyo (button) showed [Qc Kc] and won ($1.88) with three of a kind, Queens
Seat 5: Numakin (small blind) folded before Flop
Seat 6: rsxcd479 (big blind) folded before Flop


PokerStars Hand #238161598103:  Hold'em No Limit ($0.01/$0.02 USD) - 2022/08/23 0:51:53 ET
Table 'Achilles IV' 6-max Seat #5 is the button
Seat 1: Andy Oldani ($3.19 in chips)
Seat 2: NicolasMitma17 ($0.98 in chips)
Seat 3: southalllegend ($0.45 in chips)
Seat 4: jeckarliyo ($2.22 in chips)
Seat 5: Numakin ($3.67 in chips)
Seat 6: rsxcd479 ($2 in chips)
rsxcd479: posts small blind $0.01
Andy Oldani: posts big blind $0.02
*** HOLE CARDS ***
NicolasMitma17: folds
southalllegend: calls $0.02
jeckarliyo: folds
Numakin: raises $0.06 to $0.08
rsxcd479: folds
Andy Oldani: calls $0.06
southalllegend: calls $0.06
*** FLOP *** [9s 2s 9h]
Andy Oldani: checks
southalllegend: checks
Numakin: checks
*** TURN *** [9s 2s 9h] [Qd]
Andy Oldani: bets $0.16
southalllegend: calls $0.16
Numakin: calls $0.16
*** RIVER *** [9s 2s 9h Qd] [5d]
Andy Oldani: checks
southalllegend: bets $0.21 and is all-in
Numakin: folds
Andy Oldani: calls $0.21
*** SHOW DOWN ***
southalllegend: shows [Kd 6d] (a pair of Nines)
Andy Oldani: shows [Qs Ks] (two pair, Queens and Nines)
Andy Oldani collected $1.11 from pot
*** SUMMARY ***
Total pot $1.15 | Rake $0.04
Board [9s 2s 9h Qd 5d]
Seat 1: Andy Oldani (big blind) showed [Qs Ks] and won ($1.11) with two pair, Queens and Nines
Seat 2: NicolasMitma17 folded before Flop (didn't bet)
Seat 3: southalllegend showed [Kd 6d] and lost with a pair of Nines
Seat 4: jeckarliyo folded before Flop (didn't bet)
Seat 5: Numakin (button) folded on the River
Seat 6: rsxcd479 (small blind) folded before Flop


PokerStars Hand #238161605230:  Hold'em No Limit ($0.01/$0.02 USD) - 2022/08/23 0:52:55 ET
Table 'Achilles IV' 6-max Seat #6 is the button
Seat 1: Andy Oldani ($3.85 in chips)
Seat 2: NicolasMitma17 ($0.98 in chips)
Seat 3: southalllegend ($1.05 in chips)
Seat 4: jeckarliyo ($2.22 in chips)
Seat 5: Numakin ($3.43 in chips)
Seat 6: rsxcd479 ($2 in chips)
Andy Oldani: posts small blind $0.01
NicolasMitma17: posts big blind $0.02
*** HOLE CARDS ***
southalllegend: calls $0.02
jeckarliyo: folds
Numakin: raises $0.06 to $0.08
rsxcd479: folds
Andy Oldani: folds
NicolasMitma17: folds
southalllegend: calls $0.06
*** FLOP *** [Ac 6h Kc]
southalllegend: checks
NicolasMitma17 leaves the table
Numakin: bets $0.12
southalllegend: calls $0.12
*** TURN *** [Ac 6h Kc] [8c]
southalllegend: bets $0.41
Numakin: raises $1.11 to $1.52
southalllegend: calls $0.44 and is all-in
Uncalled bet ($0.67) returned to Numakin
*** RIVER *** [Ac 6h Kc 8c] [6c]
*** SHOW DOWN ***
southalllegend: shows [5s 3d] (a pair of Sixes)
Numakin: shows [Qh As] (two pair, Aces and Sixes)
Numakin collected $2.06 from pot
*** SUMMARY ***
Total pot $2.13 | Rake $0.07
Board [Ac 6h Kc 8c 6c]
Seat 1: Andy Oldani (small blind) folded before Flop
Seat 2: NicolasMitma17 (big blind) folded before Flop
Seat 3: southalllegend showed [5s 3d] and lost with a pair of Sixes
Seat 4: jeckarliyo folded before Flop (didn't bet)
Seat 5: Numakin showed [Qh As] and won ($2.06) with two pair, Aces and Sixes
Seat 6: rsxcd479 (button) folded before Flop (didn't bet)


PokerStars Hand #238161610320:  Hold'em No Limit ($0.01/$0.02 USD) - 2022/08/23 0:53:39 ET
Table 'Achilles IV' 6-max Seat #1 is the button
Seat 1: Andy Oldani ($3.84 in chips)
Seat 3: southalllegend ($0.80 in chips)
Seat 4: jeckarliyo ($2.22 in chips)
Seat 5: Numakin ($4.44 in chips)
Seat 6: rsxcd479 ($2 in chips)
southalllegend: posts small blind $0.01
0.zika joins the table at seat #2
jeckarliyo: posts big blind $0.02
*** HOLE CARDS ***
Numakin: folds
rsxcd479: folds
Andy Oldani: folds
southalllegend: calls $0.01
jeckarliyo: checks
*** FLOP *** [Ad 4s 3d]
southalllegend: checks
jeckarliyo: checks
*** TURN *** [Ad 4s 3d] [Ac]
southalllegend: bets $0.04
jeckarliyo: calls $0.04
*** RIVER *** [Ad 4s 3d Ac] [3h]
Andy Oldani leaves the table
southalllegend: bets $0.74 and is all-in
jeckarliyo: folds
Uncalled bet ($0.74) returned to southalllegend
southalllegend collected $0.12 from pot
*** SUMMARY ***
Total pot $0.12 | Rake $0
Board [Ad 4s 3d Ac 3h]
Seat 1: Andy Oldani (button) folded before Flop (didn't bet)
Seat 3: southalllegend (small blind) collected ($0.12)
Seat 4: jeckarliyo (big blind) folded on the River
Seat 5: Numakin folded before Flop (didn't bet)
Seat 6: rsxcd479 folded before Flop (didn't bet)


PokerStars Hand #238161614987:  Hold'em No Limit ($0.01/$0.02 USD) - 2022/08/23 0:54:20 ET
Table 'Achilles IV' 6-max Seat #3 is the button
Seat 3: southalllegend ($0.86 in chips)
Seat 4: jeckarliyo ($2.16 in chips)
Seat 5: Numakin ($4.44 in chips)
Seat 6: rsxcd479 ($2 in chips)
jeckarliyo: posts small blind $0.01
Numakin: posts big blind $0.02
0.zika: sits out
*** HOLE CARDS ***
rsxcd479: folds
rsxcd479 leaves the table
southalllegend: folds
jeckarliyo: calls $0.01
Numakin: checks
*** FLOP *** [7c 3s 4c]
jeckarliyo: checks
Numakin: checks
*** TURN *** [7c 3s 4c] [Js]
jeckarliyo: checks
Numakin: checks
*** RIVER *** [7c 3s 4c Js] [4d]
jeckarliyo: checks
Numakin: checks
*** SHOW DOWN ***
jeckarliyo: shows [Kd 9s] (a pair of Fours)
Numakin: mucks hand
jeckarliyo collected $0.04 from pot
*** SUMMARY ***
Total pot $0.04 | Rake $0
Board [7c 3s 4c Js 4d]
Seat 3: southalllegend (button) folded before Flop (didn't bet)
Seat 4: jeckarliyo (small blind) showed [Kd 9s] and won ($0.04) with a pair of Fours
Seat 5: Numakin (big blind) mucked
Seat 6: rsxcd479 folded before Flop (didn't bet)


PokerStars Hand #238161618942:  Hold'em No Limit ($0.01/$0.02 USD) - 2022/08/23 0:54:54 ET
Table 'Achilles IV' 6-max Seat #4 is the button
Seat 2: 0.zika ($0.80 in chips)
Seat 3: southalllegend ($0.86 in chips)
Seat 4: jeckarliyo ($2.18 in chips)
Seat 5: Numakin ($4.42 in chips)
Numakin: posts small blind $0.01
0.zika: posts big blind $0.02
*** HOLE CARDS ***
southalllegend: calls $0.02
jeckarliyo: calls $0.02
Numakin: folds
0.zika: checks
*** FLOP *** [9d 4h 9s]
0.zika: checks
southalllegend: checks
jeckarliyo: checks
*** TURN *** [9d 4h 9s] [5h]
0.zika: checks
southalllegend: checks
jeckarliyo: checks
*** RIVER *** [9d 4h 9s 5h] [Qs]
0.zika: checks
southalllegend: checks
jeckarliyo: checks
*** SHOW DOWN ***
0.zika: shows [3s 8d] (a pair of Nines)
southalllegend: shows [Js 8c] (a pair of Nines - Queen+Jack kicker)
jeckarliyo: shows [Td Jc] (a pair of Nines - Queen+Jack+Ten kicker)
jeckarliyo collected $0.07 from pot
*** SUMMARY ***
Total pot $0.07 | Rake $0
Board [9d 4h 9s 5h Qs]
Seat 2: 0.zika (big blind) showed [3s 8d] and lost with a pair of Nines
Seat 3: southalllegend showed [Js 8c] and lost with a pair of Nines
Seat 4: jeckarliyo (button) showed [Td Jc] and won ($0.07) with a pair of Nines
Seat 5: Numakin (small blind) folded before Flop


PokerStars Hand #238161622973:  Hold'em No Limit ($0.01/$0.02 USD) - 2022/08/23 0:55:32 ET
Table 'Achilles IV' 6-max Seat #5 is the button
Seat 2: 0.zika ($0.78 in chips)
Seat 3: southalllegend ($0.84 in chips)
Seat 4: jeckarliyo ($2.23 in chips)
Seat 5: Numakin ($4.41 in chips)
0.zika: posts small blind $0.01
southalllegend: posts big blind $0.02
*** HOLE CARDS ***
jeckarliyo: raises $0.02 to $0.04
Numakin: folds
0.zika: calls $0.03
southalllegend: calls $0.02
*** FLOP *** [Kd 5s 6s]
0.zika: checks
southalllegend: checks
jeckarliyo: bets $0.06
0.zika: calls $0.06
southalllegend: calls $0.06
*** TURN *** [Kd 5s 6s] [8h]
0.zika: checks
southalllegend: checks
jeckarliyo: checks
*** RIVER *** [Kd 5s 6s 8h] [3c]
0.zika: checks
Koresh153 joins the table at seat #6
southalllegend: checks
jeckarliyo: bets $0.10
0.zika: folds
southalllegend: calls $0.10
*** SHOW DOWN ***
jeckarliyo: shows [Kc Js] (a pair of Kings)
southalllegend: shows [6c Ts] (a pair of Sixes)
jeckarliyo collected $0.48 from pot
*** SUMMARY ***
Total pot $0.50 | Rake $0.02
Board [Kd 5s 6s 8h 3c]
Seat 2: 0.zika (small blind) folded on the River
Seat 3: southalllegend (big blind) showed [6c Ts] and lost with a pair of Sixes
Seat 4: jeckarliyo showed [Kc Js] and won ($0.48) with a pair of Kings
Seat 5: Numakin (button) folded before Flop (didn't bet)


PokerStars Hand #238161629714:  Hold'em No Limit ($0.01/$0.02 USD) - 2022/08/23 0:56:37 ET
Table 'Achilles IV' 6-max Seat #2 is the button
Seat 2: 0.zika ($0.68 in chips)
Seat 3: southalllegend ($0.64 in chips)
Seat 4: jeckarliyo ($2.51 in chips)
Seat 5: Numakin ($4.41 in chips)
southalllegend: posts small blind $0.01
jeckarliyo: posts big blind $0.02
Koresh153: sits out
*** HOLE CARDS ***
Numakin: folds
0.zika: calls $0.02
southalllegend: calls $0.01
jeckarliyo: checks
*** FLOP *** [8c Tc As]
southalllegend: bets $0.62 and is all-in
jeckarliyo: folds
0.zika: folds
Uncalled bet ($0.62) returned to southalllegend
southalllegend collected $0.06 from pot
*** SUMMARY ***
Total pot $0.06 | Rake $0
Board [8c Tc As]
Seat 2: 0.zika (button) folded on the Flop
Seat 3: southalllegend (small blind) collected ($0.06)
Seat 4: jeckarliyo (big blind) folded on the Flop
Seat 5: Numakin folded before Flop (didn't bet)


PokerStars Hand #238161632860:  Hold'em No Limit ($0.01/$0.02 USD) - 2022/08/23 0:57:08 ET
Table 'Achilles IV' 6-max Seat #3 is the button
Seat 2: 0.zika ($0.66 in chips)
Seat 3: southalllegend ($0.68 in chips)
Seat 4: jeckarliyo ($2.49 in chips)
Seat 5: Numakin ($4.41 in chips)
jeckarliyo: posts small blind $0.01
Numakin: posts big blind $0.02
Koresh153: sits out
*** HOLE CARDS ***
0.zika: folds
southalllegend: calls $0.02
jeckarliyo: folds
Vlao joins the table at seat #1
Numakin: checks
*** FLOP *** [Jh Qd 6h]
Numakin: checks
southalllegend: checks
*** TURN *** [Jh Qd 6h] [Tc]
Numakin: checks
southalllegend: checks
*** RIVER *** [Jh Qd 6h Tc] [4h]
Numakin: checks
southalllegend: checks
*** SHOW DOWN ***
Numakin: shows [7c 8s] (high card Queen)
southalllegend: shows [Th 7d] (a pair of Tens)
southalllegend collected $0.05 from pot
*** SUMMARY ***
Total pot $0.05 | Rake $0
Board [Jh Qd 6h Tc 4h]
Seat 2: 0.zika folded before Flop (didn't bet)
Seat 3: southalllegend (button) showed [Th 7d] and won ($0.05) with a pair of Tens
Seat 4: jeckarliyo (small blind) folded before Flop
Seat 5: Numakin (big blind) showed [7c 8s] and lost with high card Queen


PokerStars Hand #238161641018:  Hold'em No Limit ($0.01/$0.02 USD) - 2022/08/23 0:57:29 ET
Table 'Achilles IV' 6-max Seat #4 is the button
Seat 2: 0.zika ($0.66 in chips)
Seat 3: southalllegend ($0.71 in chips)
Seat 4: jeckarliyo ($2.48 in chips)
Seat 5: Numakin ($4.39 in chips)
Seat 6: Koresh153 ($0.80 in chips)
Numakin: posts small blind $0.01
Koresh153: posts big blind $0.02
Vlao: sits out
*** HOLE CARDS ***
0.zika: calls $0.02
southalllegend: calls $0.02
jeckarliyo: calls $0.02
Numakin: folds
Koresh153: checks
*** FLOP *** [Jc 6d 8s]
Koresh153: checks
0.zika: checks
southalllegend: checks
jeckarliyo: bets $0.06
Koresh153: folds
0.zika: folds
southalllegend: calls $0.06
*** TURN *** [Jc 6d 8s] [3h]
southalllegend: checks
jeckarliyo: bets $0.06
southalllegend: calls $0.06
*** RIVER *** [Jc 6d 8s 3h] [9h]
southalllegend: checks
jeckarliyo: checks
*** SHOW DOWN ***
southalllegend: shows [Ks 8h] (a pair of Eights)
jeckarliyo: mucks hand
southalllegend collected $0.32 from pot
*** SUMMARY ***
Total pot $0.33 | Rake $0.01
Board [Jc 6d 8s 3h 9h]
Seat 2: 0.zika folded on the Flop
Seat 3: southalllegend showed [Ks 8h] and won ($0.32) with a pair of Eights
Seat 4: jeckarliyo (button) mucked
Seat 5: Numakin (small blind) folded before Flop
Seat 6: Koresh153 (big blind) folded on the Flop


PokerStars Hand #238161646759:  Hold'em No Limit ($0.01/$0.02 USD) - 2022/08/23 0:58:25 ET
Table 'Achilles IV' 6-max Seat #5 is the button
Seat 1: Vlao ($2 in chips)
Seat 2: 0.zika ($0.64 in chips)
Seat 3: southalllegend ($0.89 in chips)
Seat 4: jeckarliyo ($2.34 in chips)
Seat 5: Numakin ($4.38 in chips)
Seat 6: Koresh153 ($0.80 in chips)
Koresh153: posts small blind $0.01
Vlao: posts big blind $0.02
*** HOLE CARDS ***
0.zika: folds
southalllegend: calls $0.02
jeckarliyo: folds
Numakin: folds
Koresh153: folds
Vlao: checks
*** FLOP *** [2c 6h 4s]
Vlao: checks
southalllegend: checks
*** TURN *** [2c 6h 4s] [Th]
Vlao: checks
southalllegend: checks
*** RIVER *** [2c 6h 4s Th] [3d]
Vlao: bets $0.04
southalllegend: raises $0.83 to $0.87 and is all-in
Vlao: calls $0.83
*** SHOW DOWN ***
southalllegend: shows [Qd 5s] (a straight, Deuce to Six)
Vlao: shows [Kh 5h] (a straight, Deuce to Six)
Vlao collected $0.87 from pot
southalllegend collected $0.86 from pot
*** SUMMARY ***
Total pot $1.79 | Rake $0.06
Board [2c 6h 4s Th 3d]
Seat 1: Vlao (big blind) showed [Kh 5h] and won ($0.87) with a straight, Deuce to Six
Seat 2: 0.zika folded before Flop (didn't bet)
Seat 3: southalllegend showed [Qd 5s] and won ($0.86) with a straight, Deuce to Six
Seat 4: jeckarliyo folded before Flop (didn't bet)
Seat 5: Numakin (button) folded before Flop (didn't bet)
Seat 6: Koresh153 (small blind) folded before Flop


PokerStars Hand #238161650798:  Hold'em No Limit ($0.01/$0.02 USD) - 2022/08/23 0:59:04 ET
Table 'Achilles IV' 6-max Seat #6 is the button
Seat 1: Vlao ($2 in chips)
Seat 2: 0.zika ($0.64 in chips)
Seat 3: southalllegend ($0.86 in chips)
Seat 4: jeckarliyo ($2.34 in chips)
Seat 5: Numakin ($4.38 in chips)
Seat 6: Koresh153 ($0.80 in chips)
Vlao: posts small blind $0.01
0.zika: posts big blind $0.02
*** HOLE CARDS ***
southalllegend: calls $0.02
jeckarliyo: raises $0.02 to $0.04
Numakin: folds
Koresh153: folds
Vlao: folds
0.zika: folds
southalllegend: calls $0.02
*** FLOP *** [5h Jc Ah]
southalllegend: checks
jeckarliyo: checks
*** TURN *** [5h Jc Ah] [8s]
southalllegend: checks
jeckarliyo: bets $0.06
southalllegend: calls $0.06
*** RIVER *** [5h Jc Ah 8s] [7d]
southalllegend: checks
jeckarliyo: bets $0.06
southalllegend: calls $0.06
*** SHOW DOWN ***
jeckarliyo: shows [Kd Kh] (a pair of Kings)
southalllegend: mucks hand
jeckarliyo collected $0.34 from pot
*** SUMMARY ***
Total pot $0.35 | Rake $0.01
Board [5h Jc Ah 8s 7d]
Seat 1: Vlao (small blind) folded before Flop
Seat 2: 0.zika (big blind) folded before Flop
Seat 3: southalllegend mucked
Seat 4: jeckarliyo showed [Kd Kh] and won ($0.34) with a pair of Kings
Seat 5: Numakin folded before Flop (didn't bet)
Seat 6: Koresh153 (button) folded before Flop (didn't bet)


PokerStars Hand #238161654203:  Hold'em No Limit ($0.01/$0.02 USD) - 2022/08/23 0:59:38 ET
Table 'Achilles IV' 6-max Seat #1 is the button
Seat 1: Vlao ($2 in chips)
Seat 2: 0.zika ($0.62 in chips)
Seat 3: southalllegend ($0.70 in chips)
Seat 4: jeckarliyo ($2.52 in chips)
Seat 5: Numakin ($4.38 in chips)
Seat 6: Koresh153 ($2 in chips)
0.zika: posts small blind $0.01
southalllegend: posts big blind $0.02
*** HOLE CARDS ***
jeckarliyo: calls $0.02
Numakin: raises $0.06 to $0.08
Koresh153: folds
Vlao: raises $0.22 to $0.30
0.zika: folds
southalllegend: calls $0.28
jeckarliyo: folds
Numakin: calls $0.22
*** FLOP *** [Tc 3s 7d]
southalllegend: checks
Numakin: checks
Vlao: checks
*** TURN *** [Tc 3s 7d] [4s]
southalllegend: checks
Numakin: checks
Vlao: checks
*** RIVER *** [Tc 3s 7d 4s] [7s]
southalllegend: checks
Numakin: checks
Vlao: checks
*** SHOW DOWN ***
southalllegend: shows [Kc Qc] (a pair of Sevens)
Numakin: shows [Kh As] (a pair of Sevens - Ace kicker)
Vlao: shows [Ac Kd] (a pair of Sevens)
Numakin collected $0.45 from pot
Vlao collected $0.45 from pot
*** SUMMARY ***
Total pot $0.93 | Rake $0.03
Board [Tc 3s 7d 4s 7s]
Seat 1: Vlao (button) showed [Ac Kd] and won ($0.45) with a pair of Sevens
Seat 2: 0.zika (small blind) folded before Flop
Seat 3: southalllegend (big blind) showed [Kc Qc] and lost with a pair of Sevens
Seat 4: jeckarliyo folded before Flop
Seat 5: Numakin showed [Kh As] and won ($0.45) with a pair of Sevens
Seat 6: Koresh153 folded before Flop (didn't bet)


PokerStars Hand #238161661138:  Hold'em No Limit ($0.01/$0.02 USD) - 2022/08/23 1:00:44 ET
Table 'Achilles IV' 6-max Seat #2 is the button
Seat 1: Vlao ($2.15 in chips)
Seat 2: 0.zika ($0.61 in chips)
Seat 3: southalllegend ($0.40 in chips)
Seat 4: jeckarliyo ($2.50 in chips)
Seat 5: Numakin ($4.53 in chips)
Seat 6: Koresh153 ($2 in chips)
southalllegend: posts small blind $0.01
jeckarliyo: posts big blind $0.02
*** HOLE CARDS ***
Numakin: folds
Koresh153: folds
Vlao: folds
0.zika: folds
southalllegend: calls $0.01
jeckarliyo: checks
*** FLOP *** [Kd Js Qd]
southalllegend: bets $0.04
jeckarliyo: calls $0.04
*** TURN *** [Kd Js Qd] [9s]
southalllegend: checks
jeckarliyo: bets $0.06
southalllegend: raises $0.28 to $0.34 and is all-in
jeckarliyo: calls $0.28
*** RIVER *** [Kd Js Qd 9s] [5s]
*** SHOW DOWN ***
southalllegend: shows [9d Th] (a straight, Nine to King)
jeckarliyo: shows [7c Td] (a straight, Nine to King)
southalllegend collected $0.39 from pot
jeckarliyo collected $0.38 from pot
*** SUMMARY ***
Total pot $0.80 | Rake $0.03
Board [Kd Js Qd 9s 5s]
Seat 1: Vlao folded before Flop (didn't bet)
Seat 2: 0.zika (button) folded before Flop (didn't bet)
Seat 3: southalllegend (small blind) showed [9d Th] and won ($0.39) with a straight, Nine to King
Seat 4: jeckarliyo (big blind) showed [7c Td] and won ($0.38) with a straight, Nine to King
Seat 5: Numakin folded before Flop (didn't bet)
Seat 6: Koresh153 folded before Flop (didn't bet)


PokerStars Hand #238161664558:  Hold'em No Limit ($0.01/$0.02 USD) - 2022/08/23 1:01:16 ET
Table 'Achilles IV' 6-max Seat #3 is the button
Seat 1: Vlao ($2.15 in chips)
Seat 2: 0.zika ($0.61 in chips)
Seat 3: southalllegend ($0.39 in chips)
Seat 4: jeckarliyo ($2.48 in chips)
Seat 5: Numakin ($4.53 in chips)
Seat 6: Koresh153 ($2 in chips)
jeckarliyo: posts small blind $0.01
Numakin: posts big blind $0.02
*** HOLE CARDS ***
Koresh153: folds
Vlao: raises $0.03 to $0.05
0.zika: folds
southalllegend: calls $0.05
jeckarliyo: folds
Numakin: folds
*** FLOP *** [Qd Jh Kh]
Vlao: bets $0.38
southalllegend: folds
Uncalled bet ($0.38) returned to Vlao
Vlao collected $0.13 from pot
*** SUMMARY ***
Total pot $0.13 | Rake $0
Board [Qd Jh Kh]
Seat 1: Vlao collected ($0.13)
Seat 2: 0.zika folded before Flop (didn't bet)
Seat 3: southalllegend (button) folded on the Flop
Seat 4: jeckarliyo (small blind) folded before Flop
Seat 5: Numakin (big blind) folded before Flop
Seat 6: Koresh153 folded before Flop (didn't bet)


PokerStars Hand #238161668853:  Hold'em No Limit ($0.01/$0.02 USD) - 2022/08/23 1:01:54 ET
Table 'Achilles IV' 6-max Seat #4 is the button
Seat 1: Vlao ($2.23 in chips)
Seat 2: 0.zika ($0.61 in chips)
Seat 3: southalllegend ($0.34 in chips)
Seat 4: jeckarliyo ($2.47 in chips)
Seat 5: Numakin ($4.51 in chips)
Seat 6: Koresh153 ($2 in chips)
Numakin: posts small blind $0.01
Koresh153: posts big blind $0.02
*** HOLE CARDS ***
Vlao: folds
0.zika: folds
southalllegend: calls $0.02
jeckarliyo: calls $0.02
Numakin: folds
Koresh153: checks
*** FLOP *** [6c Qs As]
Koresh153: checks
southalllegend: checks
jeckarliyo: checks
*** TURN *** [6c Qs As] [9c]
Koresh153: checks
southalllegend: checks
jeckarliyo: bets $0.06
Koresh153: folds
southalllegend: calls $0.06
*** RIVER *** [6c Qs As 9c] [5d]
southalllegend: bets $0.18
jeckarliyo: calls $0.18
*** SHOW DOWN ***
southalllegend: shows [2h 7c] (high card Ace)
jeckarliyo: shows [Jc Qc] (a pair of Queens)
jeckarliyo collected $0.53 from pot
*** SUMMARY ***
Total pot $0.55 | Rake $0.02
Board [6c Qs As 9c 5d]
Seat 1: Vlao folded before Flop (didn't bet)
Seat 2: 0.zika folded before Flop (didn't bet)
Seat 3: southalllegend showed [2h 7c] and lost with high card Ace
Seat 4: jeckarliyo (button) showed [Jc Qc] and won ($0.53) with a pair of Queens
Seat 5: Numakin (small blind) folded before Flop
Seat 6: Koresh153 (big blind) folded on the Turn


PokerStars Hand #238161673416:  Hold'em No Limit ($0.01/$0.02 USD) - 2022/08/23 1:02:36 ET
Table 'Achilles IV' 6-max Seat #5 is the button
Seat 1: Vlao ($2.23 in chips)
Seat 2: 0.zika ($0.61 in chips)
Seat 3: southalllegend ($0.08 in chips)
Seat 4: jeckarliyo ($2.74 in chips)
Seat 5: Numakin ($4.50 in chips)
Seat 6: Koresh153 ($1.98 in chips)
Koresh153: posts small blind $0.01
Vlao: posts big blind $0.02
*** HOLE CARDS ***
0.zika: folds
southalllegend: calls $0.02
jeckarliyo: calls $0.02
Numakin: folds
Koresh153: folds
Vlao: checks
*** FLOP *** [Th 2d Tc]
Vlao: checks
southalllegend: bets $0.06 and is all-in
jeckarliyo: folds
Vlao: folds
Uncalled bet ($0.06) returned to southalllegend
southalllegend collected $0.07 from pot
*** SUMMARY ***
Total pot $0.07 | Rake $0
Board [Th 2d Tc]
Seat 1: Vlao (big blind) folded on the Flop
Seat 2: 0.zika folded before Flop (didn't bet)
Seat 3: southalllegend collected ($0.07)
Seat 4: jeckarliyo folded on the Flop
Seat 5: Numakin (button) folded before Flop (didn't bet)
Seat 6: Koresh153 (small blind) folded before Flop


PokerStars Hand #238161676850:  Hold'em No Limit ($0.01/$0.02 USD) - 2022/08/23 1:03:07 ET
Table 'Achilles IV' 6-max Seat #6 is the button
Seat 1: Vlao ($2.21 in chips)
Seat 2: 0.zika ($0.61 in chips)
Seat 3: southalllegend ($0.13 in chips)
Seat 4: jeckarliyo ($2.72 in chips)
Seat 5: Numakin ($4.50 in chips)
Seat 6: Koresh153 ($1.97 in chips)
Vlao: posts small blind $0.01
0.zika: posts big blind $0.02
*** HOLE CARDS ***
southalllegend: calls $0.02
jeckarliyo: calls $0.02
Numakin: folds
Koresh153: folds
Vlao: folds
0.zika: checks
*** FLOP *** [8d Jh Kh]
0.zika: checks
southalllegend: checks
jeckarliyo: checks
*** TURN *** [8d Jh Kh] [Th]
0.zika: checks
southalllegend: checks
jeckarliyo: checks
*** RIVER *** [8d Jh Kh Th] [Kd]
0.zika: checks
southalllegend: checks
jeckarliyo: checks
*** SHOW DOWN ***
0.zika: shows [Ks 9c] (three of a kind, Kings)
southalllegend: shows [8s 7d] (two pair, Kings and Eights)
jeckarliyo: mucks hand
0.zika collected $0.07 from pot
*** SUMMARY ***
Total pot $0.07 | Rake $0
Board [8d Jh Kh Th Kd]
Seat 1: Vlao (small blind) folded before Flop
Seat 2: 0.zika (big blind) showed [Ks 9c] and won ($0.07) with three of a kind, Kings
Seat 3: southalllegend showed [8s 7d] and lost with two pair, Kings and Eights
Seat 4: jeckarliyo mucked
Seat 5: Numakin folded before Flop (didn't bet)
Seat 6: Koresh153 (button) folded before Flop (didn't bet)


PokerStars Hand #238161681055:  Hold'em No Limit ($0.01/$0.02 USD) - 2022/08/23 1:03:46 ET
Table 'Achilles IV' 6-max Seat #1 is the button
Seat 1: Vlao ($2.20 in chips)
Seat 2: 0.zika ($0.66 in chips)
Seat 3: southalllegend ($0.11 in chips)
Seat 4: jeckarliyo ($2.70 in chips)
Seat 5: Numakin ($4.50 in chips)
Seat 6: Koresh153 ($1.97 in chips)
0.zika: posts small blind $0.01
southalllegend: posts big blind $0.02
*** HOLE CARDS ***
jeckarliyo: folds
Numakin: folds
Koresh153: folds
Vlao: folds
0.zika: calls $0.01
southalllegend: checks
*** FLOP *** [7d 8h 4c]
0.zika: checks
southalllegend: checks
*** TURN *** [7d 8h 4c] [3c]
0.zika: checks
southalllegend: bets $0.09 and is all-in
0.zika: folds
Uncalled bet ($0.09) returned to southalllegend
southalllegend collected $0.04 from pot
*** SUMMARY ***
Total pot $0.04 | Rake $0
Board [7d 8h 4c 3c]
Seat 1: Vlao (button) folded before Flop (didn't bet)
Seat 2: 0.zika (small blind) folded on the Turn
Seat 3: southalllegend (big blind) collected ($0.04)
Seat 4: jeckarliyo folded before Flop (didn't bet)
Seat 5: Numakin folded before Flop (didn't bet)
Seat 6: Koresh153 folded before Flop (didn't bet)


PokerStars Hand #238161683881:  Hold'em No Limit ($0.01/$0.02 USD) - 2022/08/23 1:04:11 ET
Table 'Achilles IV' 6-max Seat #2 is the button
Seat 1: Vlao ($2.20 in chips)
Seat 2: 0.zika ($0.64 in chips)
Seat 3: southalllegend ($0.13 in chips)
Seat 4: jeckarliyo ($2.70 in chips)
Seat 5: Numakin ($4.50 in chips)
Seat 6: Koresh153 ($1.97 in chips)
southalllegend: posts small blind $0.01
jeckarliyo: posts big blind $0.02
*** HOLE CARDS ***
Numakin: folds
Koresh153: folds
Vlao: folds
0.zika: calls $0.02
southalllegend: calls $0.01
jeckarliyo: checks
*** FLOP *** [2c 5d Qd]
southalllegend: checks
jeckarliyo: checks
0.zika: checks
*** TURN *** [2c 5d Qd] [3h]
southalllegend: checks
jeckarliyo: bets $0.04
0.zika: calls $0.04
southalllegend: calls $0.04
*** RIVER *** [2c 5d Qd 3h] [7h]
southalllegend: checks
jeckarliyo: bets $0.10
0.zika: folds
southalllegend: calls $0.07 and is all-in
Uncalled bet ($0.03) returned to jeckarliyo
*** SHOW DOWN ***
jeckarliyo: shows [3c Qc] (two pair, Queens and Threes)
southalllegend: shows [Jh Ac] (high card Ace)
jeckarliyo collected $0.31 from pot
*** SUMMARY ***
Total pot $0.32 | Rake $0.01
Board [2c 5d Qd 3h 7h]
Seat 1: Vlao folded before Flop (didn't bet)
Seat 2: 0.zika (button) folded on the River
Seat 3: southalllegend (small blind) showed [Jh Ac] and lost with high card Ace
Seat 4: jeckarliyo (big blind) showed [3c Qc] and won ($0.31) with two pair, Queens and Threes
Seat 5: Numakin folded before Flop (didn't bet)
Seat 6: Koresh153 folded before Flop (didn't bet)


PokerStars Hand #238161688521:  Hold'em No Limit ($0.01/$0.02 USD) - 2022/08/23 1:04:53 ET
Table 'Achilles IV' 6-max Seat #4 is the button
Seat 1: Vlao ($2.20 in chips)
Seat 2: 0.zika ($0.58 in chips)
Seat 4: jeckarliyo ($2.88 in chips)
Seat 5: Numakin ($4.50 in chips)
Seat 6: Koresh153 ($1.97 in chips)
Numakin: posts small blind $0.01
Koresh153: posts big blind $0.02
*** HOLE CARDS ***
southalllegend leaves the table
Vlao: folds
0.zika: calls $0.02
jeckarliyo: folds
Numakin: folds
killervzla28 joins the table at seat #3
Koresh153: checks
*** FLOP *** [Th 3s Ks]
Koresh153: checks
0.zika: checks
*** TURN *** [Th 3s Ks] [Qh]
Koresh153: checks
0.zika: checks
*** RIVER *** [Th 3s Ks Qh] [7s]
Koresh153: checks
0.zika: checks
*** SHOW DOWN ***
Koresh153: shows [5s 8d] (high card King)
0.zika: shows [Qd 2h] (a pair of Queens)
0.zika collected $0.05 from pot
*** SUMMARY ***
Total pot $0.05 | Rake $0
Board [Th 3s Ks Qh 7s]
Seat 1: Vlao folded before Flop (didn't bet)
Seat 2: 0.zika showed [Qd 2h] and won ($0.05) with a pair of Queens
Seat 4: jeckarliyo (button) folded before Flop (didn't bet)
Seat 5: Numakin (small blind) folded before Flop
Seat 6: Koresh153 (big blind) showed [5s 8d] and lost with high card King


PokerStars Hand #238161692260:  Hold'em No Limit ($0.01/$0.02 USD) - 2022/08/23 1:05:27 ET
Table 'Achilles IV' 6-max Seat #5 is the button
Seat 1: Vlao ($2.20 in chips)
Seat 2: 0.zika ($0.61 in chips)
Seat 4: jeckarliyo ($2.88 in chips)
Seat 5: Numakin ($4.49 in chips)
Seat 6: Koresh153 ($1.95 in chips)
Koresh153: posts small blind $0.01
Vlao: posts big blind $0.02
killervzla28: sits out
*** HOLE CARDS ***
0.zika: folds
jeckarliyo: raises $0.02 to $0.04
Numakin: folds
Koresh153: folds
Vlao: calls $0.02
*** FLOP *** [3c As 6h]
Vlao: checks
jeckarliyo: checks
*** TURN *** [3c As 6h] [Ks]
Vlao: checks
jeckarliyo: checks
*** RIVER *** [3c As 6h Ks] [4s]
Vlao: checks
jeckarliyo: checks
*** SHOW DOWN ***
Vlao: shows [Qh Tc] (high card Ace)
jeckarliyo: mucks hand
Vlao collected $0.09 from pot
*** SUMMARY ***
Total pot $0.09 | Rake $0
Board [3c As 6h Ks 4s]
Seat 1: Vlao (big blind) showed [Qh Tc] and won ($0.09) with high card Ace
Seat 2: 0.zika folded before Flop (didn't bet)
Seat 4: jeckarliyo mucked
Seat 5: Numakin (button) folded before Flop (didn't bet)
Seat 6: Koresh153 (small blind) folded before Flop


PokerStars Hand #238161695255:  Hold'em No Limit ($0.01/$0.02 USD) - 2022/08/23 1:05:56 ET
Table 'Achilles IV' 6-max Seat #6 is the button
Seat 1: Vlao ($2.25 in chips)
Seat 2: 0.zika ($0.61 in chips)
Seat 4: jeckarliyo ($2.84 in chips)
Seat 5: Numakin ($4.49 in chips)
Seat 6: Koresh153 ($1.94 in chips)
Vlao: posts small blind $0.01
0.zika: posts big blind $0.02
killervzla28: sits out
*** HOLE CARDS ***
jeckarliyo: folds
Numakin: folds
Koresh153: folds
Vlao: folds
Uncalled bet ($0.01) returned to 0.zika
0.zika collected $0.02 from pot
*** SUMMARY ***
Total pot $0.02 | Rake $0
Seat 1: Vlao (small blind) folded before Flop
Seat 2: 0.zika (big blind) collected ($0.02)
Seat 4: jeckarliyo folded before Flop (didn't bet)
Seat 5: Numakin folded before Flop (didn't bet)
Seat 6: Koresh153 (button) folded before Flop (didn't bet)


PokerStars Hand #238161696309:  Hold'em No Limit ($0.01/$0.02 USD) - 2022/08/23 1:06:05 ET
Table 'Achilles IV' 6-max Seat #1 is the button
Seat 1: Vlao ($2.24 in chips)
Seat 2: 0.zika ($0.62 in chips)
Seat 3: killervzla28 ($2 in chips)
Seat 4: jeckarliyo ($2.84 in chips)
Seat 5: Numakin ($4.49 in chips)
Seat 6: Koresh153 ($1.94 in chips)
0.zika: posts small blind $0.01
killervzla28: posts big blind $0.02
*** HOLE CARDS ***
jeckarliyo: calls $0.02
Numakin: calls $0.02
Koresh153: folds
Vlao: folds
0.zika: folds
killervzla28: checks
*** FLOP *** [4s 7s 9c]
killervzla28: checks
jeckarliyo: bets $0.04
Numakin: folds
killervzla28: folds
Uncalled bet ($0.04) returned to jeckarliyo
killervzla28 leaves the table
jeckarliyo collected $0.07 from pot
jeckarliyo: doesn't show hand
*** SUMMARY ***
Total pot $0.07 | Rake $0
Board [4s 7s 9c]
Seat 1: Vlao (button) folded before Flop (didn't bet)
Seat 2: 0.zika (small blind) folded before Flop
Seat 3: killervzla28 (big blind) folded on the Flop
Seat 4: jeckarliyo collected ($0.07)
Seat 5: Numakin folded on the Flop
Seat 6: Koresh153 folded before Flop (didn't bet)


PokerStars Hand #238161699795:  Hold'em No Limit ($0.01/$0.02 USD) - 2022/08/23 1:06:36 ET
Table 'Achilles IV' 6-max Seat #2 is the button
Seat 1: Vlao ($2.24 in chips)
Seat 2: 0.zika ($0.61 in chips)
Seat 4: jeckarliyo ($2.89 in chips)
Seat 5: Numakin ($4.47 in chips)
Seat 6: Koresh153 ($1.94 in chips)
jeckarliyo: posts small blind $0.01
Numakin: posts big blind $0.02
*** HOLE CARDS ***
Koresh153: folds
Vlao: folds
0.zika: calls $0.02
jeckarliyo: calls $0.01
ketomaldonado joins the table at seat #3
Numakin: checks
*** FLOP *** [As 9d 3d]
jeckarliyo: checks
Numakin: checks
0.zika: checks
*** TURN *** [As 9d 3d] [Kh]
jeckarliyo: checks
Numakin: checks
0.zika: bets $0.02
jeckarliyo: calls $0.02
Numakin: folds
*** RIVER *** [As 9d 3d Kh] [7h]
jeckarliyo: checks
0.zika: bets $0.10
jeckarliyo: folds
Uncalled bet ($0.10) returned to 0.zika
0.zika collected $0.10 from pot
0.zika: doesn't show hand
*** SUMMARY ***
Total pot $0.10 | Rake $0
Board [As 9d 3d Kh 7h]
Seat 1: Vlao folded before Flop (didn't bet)
Seat 2: 0.zika (button) collected ($0.10)
Seat 4: jeckarliyo (small blind) folded on the River
Seat 5: Numakin (big blind) folded on the Turn
Seat 6: Koresh153 folded before Flop (didn't bet)


PokerStars Hand #238161704277:  Hold'em No Limit ($0.01/$0.02 USD) - 2022/08/23 1:07:17 ET
Table 'Achilles IV' 6-max Seat #4 is the button
Seat 1: Vlao ($2.24 in chips)
Seat 2: 0.zika ($0.67 in chips)
Seat 3: ketomaldonado ($2 in chips)
Seat 4: jeckarliyo ($2.85 in chips)
Seat 5: Numakin ($4.45 in chips)
Seat 6: Koresh153 ($1.94 in chips)
Numakin: posts small blind $0.01
Koresh153: posts big blind $0.02
ketomaldonado: posts big blind $0.02
*** HOLE CARDS ***
Vlao: folds
0.zika: calls $0.02
ketomaldonado: checks
jeckarliyo: folds
Numakin: calls $0.01
Koresh153: checks
*** FLOP *** [Ah 5s 4c]
Numakin: checks
Koresh153: checks
0.zika: checks
ketomaldonado: bets $0.03
Numakin: folds
Koresh153: folds
0.zika: folds
Uncalled bet ($0.03) returned to ketomaldonado
ketomaldonado collected $0.08 from pot
*** SUMMARY ***
Total pot $0.08 | Rake $0
Board [Ah 5s 4c]
Seat 1: Vlao folded before Flop (didn't bet)
Seat 2: 0.zika folded on the Flop
Seat 3: ketomaldonado collected ($0.08)
Seat 4: jeckarliyo (button) folded before Flop (didn't bet)
Seat 5: Numakin (small blind) folded on the Flop
Seat 6: Koresh153 (big blind) folded on the Flop


PokerStars Hand #238161708839:  Hold'em No Limit ($0.01/$0.02 USD) - 2022/08/23 1:07:58 ET
Table 'Achilles IV' 6-max Seat #5 is the button
Seat 1: Vlao ($2.24 in chips)
Seat 2: 0.zika ($0.65 in chips)
Seat 3: ketomaldonado ($2.06 in chips)
Seat 4: jeckarliyo ($2.85 in chips)
Seat 5: Numakin ($4.43 in chips)
Seat 6: Koresh153 ($1.92 in chips)
Koresh153: posts small blind $0.01
Vlao: posts big blind $0.02
*** HOLE CARDS ***
0.zika: folds
ketomaldonado: raises $0.03 to $0.05
jeckarliyo: folds
Numakin: folds
Koresh153: folds
Vlao: folds
Uncalled bet ($0.03) returned to ketomaldonado
ketomaldonado collected $0.05 from pot
*** SUMMARY ***
Total pot $0.05 | Rake $0
Seat 1: Vlao (big blind) folded before Flop
Seat 2: 0.zika folded before Flop (didn't bet)
Seat 3: ketomaldonado collected ($0.05)
Seat 4: jeckarliyo folded before Flop (didn't bet)
Seat 5: Numakin (button) folded before Flop (didn't bet)
Seat 6: Koresh153 (small blind) folded before Flop


PokerStars Hand #238161711140:  Hold'em No Limit ($0.01/$0.02 USD) - 2022/08/23 1:08:19 ET
Table 'Achilles IV' 6-max Seat #6 is the button
Seat 1: Vlao ($2.22 in chips)
Seat 2: 0.zika ($0.65 in chips)
Seat 3: ketomaldonado ($2.09 in chips)
Seat 4: jeckarliyo ($2.85 in chips)
Seat 5: Numakin ($4.43 in chips)
Seat 6: Koresh153 ($1.91 in chips)
Vlao: posts small blind $0.01
0.zika: posts big blind $0.02
*** HOLE CARDS ***
ketomaldonado: folds
jeckarliyo: folds
Numakin: raises $0.03 to $0.05
Koresh153: folds
Vlao: folds
0.zika: folds
Uncalled bet ($0.03) returned to Numakin
Numakin collected $0.05 from pot
Numakin: doesn't show hand
*** SUMMARY ***
Total pot $0.05 | Rake $0
Seat 1: Vlao (small blind) folded before Flop
Seat 2: 0.zika (big blind) folded before Flop
Seat 3: ketomaldonado folded before Flop (didn't bet)
Seat 4: jeckarliyo folded before Flop (didn't bet)
Seat 5: Numakin collected ($0.05)
Seat 6: Koresh153 (button) folded before Flop (didn't bet)


PokerStars Hand #238161714102:  Hold'em No Limit ($0.01/$0.02 USD) - 2022/08/23 1:08:47 ET
Table 'Achilles IV' 6-max Seat #1 is the button
Seat 1: Vlao ($2.21 in chips)
Seat 2: 0.zika ($0.63 in chips)
Seat 3: ketomaldonado ($2.09 in chips)
Seat 4: jeckarliyo ($2.85 in chips)
Seat 5: Numakin ($4.46 in chips)
Seat 6: Koresh153 ($1.91 in chips)
0.zika: posts small blind $0.01
ketomaldonado: posts big blind $0.02
*** HOLE CARDS ***
jeckarliyo: folds
Numakin: folds
Koresh153: folds
Vlao: folds
0.zika: calls $0.01
ketomaldonado: checks
*** FLOP *** [9h Jd 7d]
0.zika: checks
ketomaldonado: bets $0.03
0.zika: calls $0.03
*** TURN *** [9h Jd 7d] [4c]
0.zika: checks
ketomaldonado: bets $0.03
0.zika: calls $0.03
*** RIVER *** [9h Jd 7d 4c] [8c]
0.zika: checks
ketomaldonado: bets $0.11
0.zika: folds
Uncalled bet ($0.11) returned to ketomaldonado
ketomaldonado collected $0.15 from pot
*** SUMMARY ***
Total pot $0.16 | Rake $0.01
Board [9h Jd 7d 4c 8c]
Seat 1: Vlao (button) folded before Flop (didn't bet)
Seat 2: 0.zika (small blind) folded on the River
Seat 3: ketomaldonado (big blind) collected ($0.15)
Seat 4: jeckarliyo folded before Flop (didn't bet)
Seat 5: Numakin folded before Flop (didn't bet)
Seat 6: Koresh153 folded before Flop (didn't bet)


PokerStars Hand #238161720532:  Hold'em No Limit ($0.01/$0.02 USD) - 2022/08/23 1:09:46 ET
Table 'Achilles IV' 6-max Seat #2 is the button
Seat 1: Vlao ($2.21 in chips)
Seat 2: 0.zika ($0.55 in chips)
Seat 3: ketomaldonado ($2.16 in chips)
Seat 4: jeckarliyo ($2.85 in chips)
Seat 5: Numakin ($4.46 in chips)
Seat 6: Koresh153 ($1.91 in chips)
ketomaldonado: posts small blind $0.01
jeckarliyo: posts big blind $0.02
*** HOLE CARDS ***
Numakin: folds
Koresh153: folds
Vlao: folds
0.zika: folds
ketomaldonado: raises $0.04 to $0.06
jeckarliyo: folds
Uncalled bet ($0.04) returned to ketomaldonado
ketomaldonado collected $0.04 from pot
*** SUMMARY ***
Total pot $0.04 | Rake $0
Seat 1: Vlao folded before Flop (didn't bet)
Seat 2: 0.zika (button) folded before Flop (didn't bet)
Seat 3: ketomaldonado (small blind) collected ($0.04)
Seat 4: jeckarliyo (big blind) folded before Flop
Seat 5: Numakin folded before Flop (didn't bet)
Seat 6: Koresh153 folded before Flop (didn't bet)


PokerStars Hand #238161726303:  Hold'em No Limit ($0.01/$0.02 USD) - 2022/08/23 1:10:37 ET
Table 'Achilles IV' 6-max Seat #4 is the button
Seat 1: Vlao ($2.21 in chips)
Seat 2: 0.zika ($0.49 in chips)
Seat 3: ketomaldonado ($2.18 in chips)
Seat 4: jeckarliyo ($2.77 in chips)
Seat 5: Numakin ($4.40 in chips)
Seat 6: Koresh153 ($2.08 in chips)
Numakin: posts small blind $0.01
Koresh153: posts big blind $0.02
*** HOLE CARDS ***
Vlao: folds
0.zika: folds
ketomaldonado: raises $0.03 to $0.05
jeckarliyo: folds
Numakin: folds
Koresh153: folds
Uncalled bet ($0.03) returned to ketomaldonado
ketomaldonado collected $0.05 from pot
*** SUMMARY ***
Total pot $0.05 | Rake $0
Seat 1: Vlao folded before Flop (didn't bet)
Seat 2: 0.zika folded before Flop (didn't bet)
Seat 3: ketomaldonado collected ($0.05)
Seat 4: jeckarliyo (button) folded before Flop (didn't bet)
Seat 5: Numakin (small blind) folded before Flop
Seat 6: Koresh153 (big blind) folded before Flop


PokerStars Hand #238161722476:  Hold'em No Limit ($0.01/$0.02 USD) - 2022/08/23 1:10:03 ET
Table 'Achilles IV' 6-max Seat #3 is the button
Seat 1: Vlao ($2.21 in chips)
Seat 2: 0.zika ($0.55 in chips)
Seat 3: ketomaldonado ($2.18 in chips)
Seat 4: jeckarliyo ($2.83 in chips)
Seat 5: Numakin ($4.46 in chips)
Seat 6: Koresh153 ($1.91 in chips)
jeckarliyo: posts small blind $0.01
Numakin: posts big blind $0.02
*** HOLE CARDS ***
Koresh153: raises $0.04 to $0.06
Vlao: folds
0.zika: calls $0.06
ketomaldonado: folds
jeckarliyo: calls $0.05
Numakin: calls $0.04
*** FLOP *** [2c 5s Ah]
jeckarliyo: checks
Numakin: checks
Koresh153: bets $0.15
0.zika: folds
jeckarliyo: folds
Numakin: folds
Uncalled bet ($0.15) returned to Koresh153
Koresh153 collected $0.23 from pot
Koresh153: doesn't show hand
*** SUMMARY ***
Total pot $0.24 | Rake $0.01
Board [2c 5s Ah]
Seat 1: Vlao folded before Flop (didn't bet)
Seat 2: 0.zika folded on the Flop
Seat 3: ketomaldonado (button) folded before Flop (didn't bet)
Seat 4: jeckarliyo (small blind) folded on the Flop
Seat 5: Numakin (big blind) folded on the Flop
Seat 6: Koresh153 collected ($0.23)


PokerStars Hand #238161732190:  Hold'em No Limit ($0.01/$0.02 USD) - 2022/08/23 1:11:30 ET
Table 'Achilles IV' 6-max Seat #6 is the button
Seat 1: Vlao ($2.11 in chips)
Seat 2: 0.zika ($0.49 in chips)
Seat 3: ketomaldonado ($2.21 in chips)
Seat 4: jeckarliyo ($2.87 in chips)
Seat 5: Numakin ($4.39 in chips)
Seat 6: Koresh153 ($2.05 in chips)
Vlao: posts small blind $0.01
0.zika: posts big blind $0.02
*** HOLE CARDS ***
ketomaldonado: folds
jeckarliyo: folds
Numakin: folds
Koresh153: folds
Vlao: folds
Uncalled bet ($0.01) returned to 0.zika
0.zika collected $0.02 from pot
*** SUMMARY ***
Total pot $0.02 | Rake $0
Seat 1: Vlao (small blind) folded before Flop
Seat 2: 0.zika (big blind) collected ($0.02)
Seat 3: ketomaldonado folded before Flop (didn't bet)
Seat 4: jeckarliyo folded before Flop (didn't bet)
Seat 5: Numakin folded before Flop (didn't bet)
Seat 6: Koresh153 (button) folded before Flop (didn't bet)


PokerStars Hand #238161728335:  Hold'em No Limit ($0.01/$0.02 USD) - 2022/08/23 1:10:55 ET
Table 'Achilles IV' 6-max Seat #5 is the button
Seat 1: Vlao ($2.21 in chips)
Seat 2: 0.zika ($0.49 in chips)
Seat 3: ketomaldonado ($2.21 in chips)
Seat 4: jeckarliyo ($2.77 in chips)
Seat 5: Numakin ($4.39 in chips)
Seat 6: Koresh153 ($2.06 in chips)
Koresh153: posts small blind $0.01
Vlao: posts big blind $0.02
*** HOLE CARDS ***
0.zika: folds
ketomaldonado: folds
jeckarliyo: raises $0.02 to $0.04
Numakin: folds
Koresh153: folds
Vlao: calls $0.02
*** FLOP *** [8c Td 8h]
Vlao: checks
jeckarliyo: bets $0.06
Vlao: calls $0.06
*** TURN *** [8c Td 8h] [4h]
Vlao: checks
jeckarliyo: bets $0.16
Vlao: folds
Uncalled bet ($0.16) returned to jeckarliyo
jeckarliyo collected $0.20 from pot
jeckarliyo: doesn't show hand
*** SUMMARY ***
Total pot $0.21 | Rake $0.01
Board [8c Td 8h 4h]
Seat 1: Vlao (big blind) folded on the Turn
Seat 2: 0.zika folded before Flop (didn't bet)
Seat 3: ketomaldonado folded before Flop (didn't bet)
Seat 4: jeckarliyo collected ($0.20)
Seat 5: Numakin (button) folded before Flop (didn't bet)
Seat 6: Koresh153 (small blind) folded before Flop


PokerStars Hand #238161733529:  Hold'em No Limit ($0.01/$0.02 USD) - 2022/08/23 1:11:42 ET
Table 'Achilles IV' 6-max Seat #1 is the button
Seat 1: Vlao ($2.10 in chips)
Seat 2: 0.zika ($0.50 in chips)
Seat 3: ketomaldonado ($2.21 in chips)
Seat 4: jeckarliyo ($2.87 in chips)
Seat 5: Numakin ($4.39 in chips)
Seat 6: Koresh153 ($2.05 in chips)
0.zika: posts small blind $0.01
ketomaldonado: posts big blind $0.02
*** HOLE CARDS ***
jeckarliyo: raises $0.04 to $0.06
Numakin: folds
Koresh153: folds
Vlao: folds
0.zika: folds
ketomaldonado: calls $0.04
*** FLOP *** [Qd 6d Qc]
ketomaldonado: checks
jeckarliyo: checks
*** TURN *** [Qd 6d Qc] [Js]
ketomaldonado: checks
jeckarliyo: checks
*** RIVER *** [Qd 6d Qc Js] [7d]
ketomaldonado: checks
jeckarliyo: checks
*** SHOW DOWN ***
ketomaldonado: shows [Jc 9c] (two pair, Queens and Jacks)
jeckarliyo: mucks hand
ketomaldonado collected $0.13 from pot
*** SUMMARY ***
Total pot $0.13 | Rake $0
Board [Qd 6d Qc Js 7d]
Seat 1: Vlao (button) folded before Flop (didn't bet)
Seat 2: 0.zika (small blind) folded before Flop
Seat 3: ketomaldonado (big blind) showed [Jc 9c] and won ($0.13) with two pair, Queens and Jacks
Seat 4: jeckarliyo mucked
Seat 5: Numakin folded before Flop (didn't bet)
Seat 6: Koresh153 folded before Flop (didn't bet)


PokerStars Hand #238161738339:  Hold'em No Limit ($0.01/$0.02 USD) - 2022/08/23 1:12:26 ET
Table 'Achilles IV' 6-max Seat #2 is the button
Seat 1: Vlao ($2.10 in chips)
Seat 2: 0.zika ($0.49 in chips)
Seat 3: ketomaldonado ($2.28 in chips)
Seat 4: jeckarliyo ($2.81 in chips)
Seat 5: Numakin ($4.39 in chips)
Seat 6: Koresh153 ($2.05 in chips)
ketomaldonado: posts small blind $0.01
jeckarliyo: posts big blind $0.02
*** HOLE CARDS ***
Numakin: folds
Koresh153: folds
Vlao: folds
0.zika: folds
ketomaldonado: raises $0.04 to $0.06
jeckarliyo: folds
Uncalled bet ($0.04) returned to ketomaldonado
ketomaldonado collected $0.04 from pot
*** SUMMARY ***
Total pot $0.04 | Rake $0
Seat 1: Vlao folded before Flop (didn't bet)
Seat 2: 0.zika (button) folded before Flop (didn't bet)
Seat 3: ketomaldonado (small blind) collected ($0.04)
Seat 4: jeckarliyo (big blind) folded before Flop
Seat 5: Numakin folded before Flop (didn't bet)
Seat 6: Koresh153 folded before Flop (didn't bet)


PokerStars Hand #238161740586:  Hold'em No Limit ($0.01/$0.02 USD) - 2022/08/23 1:12:46 ET
Table 'Achilles IV' 6-max Seat #3 is the button
Seat 1: Vlao ($2.10 in chips)
Seat 2: 0.zika ($0.49 in chips)
Seat 3: ketomaldonado ($2.30 in chips)
Seat 4: jeckarliyo ($2.79 in chips)
Seat 5: Numakin ($4.39 in chips)
Seat 6: Koresh153 ($2.05 in chips)
jeckarliyo: posts small blind $0.01
Numakin: posts big blind $0.02
*** HOLE CARDS ***
Koresh153: folds
Vlao: folds
0.zika: folds
ketomaldonado: folds
jeckarliyo: raises $0.02 to $0.04
Numakin: folds
Uncalled bet ($0.02) returned to jeckarliyo
jeckarliyo collected $0.04 from pot
jeckarliyo: doesn't show hand
*** SUMMARY ***
Total pot $0.04 | Rake $0
Seat 1: Vlao folded before Flop (didn't bet)
Seat 2: 0.zika folded before Flop (didn't bet)
Seat 3: ketomaldonado (button) folded before Flop (didn't bet)
Seat 4: jeckarliyo (small blind) collected ($0.04)
Seat 5: Numakin (big blind) folded before Flop
Seat 6: Koresh153 folded before Flop (didn't bet)


PokerStars Hand #238161742574:  Hold'em No Limit ($0.01/$0.02 USD) - 2022/08/23 1:13:05 ET
Table 'Achilles IV' 6-max Seat #4 is the button
Seat 1: Vlao ($2.10 in chips)
Seat 2: 0.zika ($0.49 in chips)
Seat 3: ketomaldonado ($2.30 in chips)
Seat 4: jeckarliyo ($2.81 in chips)
Seat 5: Numakin ($4.37 in chips)
Seat 6: Koresh153 ($2.05 in chips)
Numakin: posts small blind $0.01
Koresh153: posts big blind $0.02
*** HOLE CARDS ***
Vlao: folds
0.zika: calls $0.02
ketomaldonado: folds
jeckarliyo: calls $0.02
Numakin: folds
Koresh153: raises $0.10 to $0.12
0.zika: calls $0.10
jeckarliyo: folds
*** FLOP *** [7s As 6s]
Koresh153: bets $1.93 and is all-in
0.zika: calls $0.37 and is all-in
Uncalled bet ($1.56) returned to Koresh153
*** TURN *** [7s As 6s] [8d]
*** RIVER *** [7s As 6s 8d] [6h]
*** SHOW DOWN ***
Koresh153: shows [Js Jh] (two pair, Jacks and Sixes)
0.zika: shows [4d Ad] (two pair, Aces and Sixes)
0.zika collected $0.97 from pot
Koresh153 cashed out the hand for $0.42
*** SUMMARY ***
Total pot $1.01 | Rake $0.04
Board [7s As 6s 8d 6h]
Seat 1: Vlao folded before Flop (didn't bet)
Seat 2: 0.zika showed [4d Ad] and won ($0.97) with two pair, Aces and Sixes
Seat 3: ketomaldonado folded before Flop (didn't bet)
Seat 4: jeckarliyo (button) folded before Flop
Seat 5: Numakin (small blind) folded before Flop
Seat 6: Koresh153 (big blind) showed [Js Jh] and lost with two pair, Jacks and Sixes (cashed out).


PokerStars Hand #238161749121:  Hold'em No Limit ($0.01/$0.02 USD) - 2022/08/23 1:14:05 ET
Table 'Achilles IV' 6-max Seat #5 is the button
Seat 1: Vlao ($2.10 in chips)
Seat 2: 0.zika ($0.97 in chips)
Seat 3: ketomaldonado ($2.30 in chips)
Seat 4: jeckarliyo ($2.79 in chips)
Seat 5: Numakin ($4.36 in chips)
Seat 6: Koresh153 ($1.98 in chips)
Koresh153: posts small blind $0.01
Vlao: posts big blind $0.02
*** HOLE CARDS ***
0.zika: folds
ketomaldonado: folds
jeckarliyo: calls $0.02
Numakin: folds
Koresh153: folds
Vlao: checks
*** FLOP *** [5s 5c 3s]
Vlao: checks
jeckarliyo: checks
*** TURN *** [5s 5c 3s] [8h]
Vlao: checks
jeckarliyo: checks
*** RIVER *** [5s 5c 3s 8h] [4h]
Vlao: checks
jeckarliyo: checks
*** SHOW DOWN ***
Vlao: shows [6s Ts] (a pair of Fives)
jeckarliyo: shows [Kh 6d] (a pair of Fives - King kicker)
jeckarliyo collected $0.05 from pot
*** SUMMARY ***
Total pot $0.05 | Rake $0
Board [5s 5c 3s 8h 4h]
Seat 1: Vlao (big blind) showed [6s Ts] and lost with a pair of Fives
Seat 2: 0.zika folded before Flop (didn't bet)
Seat 3: ketomaldonado folded before Flop (didn't bet)
Seat 4: jeckarliyo showed [Kh 6d] and won ($0.05) with a pair of Fives
Seat 5: Numakin (button) folded before Flop (didn't bet)
Seat 6: Koresh153 (small blind) folded before Flop


PokerStars Hand #238161753532:  Hold'em No Limit ($0.01/$0.02 USD) - 2022/08/23 1:14:46 ET
Table 'Achilles IV' 6-max Seat #6 is the button
Seat 1: Vlao ($2.08 in chips)
Seat 2: 0.zika ($0.97 in chips)
Seat 3: ketomaldonado ($2.30 in chips)
Seat 4: jeckarliyo ($2.82 in chips)
Seat 5: Numakin ($4.36 in chips)
Seat 6: Koresh153 ($1.97 in chips)
Vlao: posts small blind $0.01
0.zika: posts big blind $0.02
*** HOLE CARDS ***
ketomaldonado: folds
jeckarliyo: folds
Numakin: folds
Koresh153: raises $0.04 to $0.06
Vlao: folds
0.zika: folds
Uncalled bet ($0.04) returned to Koresh153
Koresh153 collected $0.05 from pot
Koresh153: doesn't show hand
*** SUMMARY ***
Total pot $0.05 | Rake $0
Seat 1: Vlao (small blind) folded before Flop
Seat 2: 0.zika (big blind) folded before Flop
Seat 3: ketomaldonado folded before Flop (didn't bet)
Seat 4: jeckarliyo folded before Flop (didn't bet)
Seat 5: Numakin folded before Flop (didn't bet)
Seat 6: Koresh153 (button) collected ($0.05)


PokerStars Hand #238161756143:  Hold'em No Limit ($0.01/$0.02 USD) - 2022/08/23 1:15:10 ET
Table 'Achilles IV' 6-max Seat #1 is the button
Seat 1: Vlao ($2.07 in chips)
Seat 2: 0.zika ($0.95 in chips)
Seat 3: ketomaldonado ($2.30 in chips)
Seat 4: jeckarliyo ($2.82 in chips)
Seat 5: Numakin ($4.36 in chips)
Seat 6: Koresh153 ($2 in chips)
0.zika: posts small blind $0.01
ketomaldonado: posts big blind $0.02
*** HOLE CARDS ***
jeckarliyo: calls $0.02
Numakin: folds
Koresh153: folds
Vlao: folds
0.zika: folds
ketomaldonado: checks
*** FLOP *** [7h 8c 3s]
ketomaldonado: checks
jeckarliyo: checks
*** TURN *** [7h 8c 3s] [Qc]
ketomaldonado: checks
jeckarliyo: checks
*** RIVER *** [7h 8c 3s Qc] [7s]
ketomaldonado: checks
jeckarliyo: checks
*** SHOW DOWN ***
ketomaldonado: shows [4d Kh] (a pair of Sevens)
jeckarliyo: mucks hand
ketomaldonado collected $0.05 from pot
*** SUMMARY ***
Total pot $0.05 | Rake $0
Board [7h 8c 3s Qc 7s]
Seat 1: Vlao (button) folded before Flop (didn't bet)
Seat 2: 0.zika (small blind) folded before Flop
Seat 3: ketomaldonado (big blind) showed [4d Kh] and won ($0.05) with a pair of Sevens
Seat 4: jeckarliyo mucked
Seat 5: Numakin folded before Flop (didn't bet)
Seat 6: Koresh153 folded before Flop (didn't bet)


PokerStars Hand #238161759802:  Hold'em No Limit ($0.01/$0.02 USD) - 2022/08/23 1:15:45 ET
Table 'Achilles IV' 6-max Seat #2 is the button
Seat 1: Vlao ($2.07 in chips)
Seat 2: 0.zika ($0.94 in chips)
Seat 3: ketomaldonado ($2.33 in chips)
Seat 4: jeckarliyo ($2.80 in chips)
Seat 5: Numakin ($4.36 in chips)
Seat 6: Koresh153 ($2 in chips)
ketomaldonado: posts small blind $0.01
jeckarliyo: posts big blind $0.02
*** HOLE CARDS ***
Numakin: folds
Koresh153 has timed out
Koresh153: folds
Vlao: folds
0.zika: calls $0.02
ketomaldonado: folds
jeckarliyo: checks
*** FLOP *** [Tc 9h 5d]
jeckarliyo: bets $0.04
0.zika: calls $0.04
*** TURN *** [Tc 9h 5d] [Qd]
jeckarliyo: checks
0.zika: checks
*** RIVER *** [Tc 9h 5d Qd] [4c]
jeckarliyo: bets $0.06
0.zika: calls $0.06
*** SHOW DOWN ***
jeckarliyo: shows [Td 3h] (a pair of Tens)
0.zika: mucks hand
jeckarliyo collected $0.24 from pot
*** SUMMARY ***
Total pot $0.25 | Rake $0.01
Board [Tc 9h 5d Qd 4c]
Seat 1: Vlao folded before Flop (didn't bet)
Seat 2: 0.zika (button) mucked
Seat 3: ketomaldonado (small blind) folded before Flop
Seat 4: jeckarliyo (big blind) showed [Td 3h] and won ($0.24) with a pair of Tens
Seat 5: Numakin folded before Flop (didn't bet)
Seat 6: Koresh153 folded before Flop (didn't bet)


PokerStars Hand #238161765751:  Hold'em No Limit ($0.01/$0.02 USD) - 2022/08/23 1:16:40 ET
Table 'Achilles IV' 6-max Seat #3 is the button
Seat 1: Vlao ($2.07 in chips)
Seat 2: 0.zika ($0.82 in chips)
Seat 3: ketomaldonado ($2.32 in chips)
Seat 4: jeckarliyo ($2.92 in chips)
Seat 5: Numakin ($4.36 in chips)
Seat 6: Koresh153 ($2 in chips)
jeckarliyo: posts small blind $0.01
Numakin: posts big blind $0.02
*** HOLE CARDS ***
Koresh153: raises $0.04 to $0.06
Vlao: folds
0.zika: folds
ketomaldonado: folds
jeckarliyo: folds
Numakin: folds
Uncalled bet ($0.04) returned to Koresh153
Koresh153 collected $0.05 from pot
Koresh153: doesn't show hand
*** SUMMARY ***
Total pot $0.05 | Rake $0
Seat 1: Vlao folded before Flop (didn't bet)
Seat 2: 0.zika folded before Flop (didn't bet)
Seat 3: ketomaldonado (button) folded before Flop (didn't bet)
Seat 4: jeckarliyo (small blind) folded before Flop
Seat 5: Numakin (big blind) folded before Flop
Seat 6: Koresh153 collected ($0.05)


PokerStars Hand #238161767552:  Hold'em No Limit ($0.01/$0.02 USD) - 2022/08/23 1:16:57 ET
Table 'Achilles IV' 6-max Seat #4 is the button
Seat 1: Vlao ($2.07 in chips)
Seat 2: 0.zika ($0.82 in chips)
Seat 3: ketomaldonado ($2.32 in chips)
Seat 4: jeckarliyo ($2.91 in chips)
Seat 5: Numakin ($4.34 in chips)
Seat 6: Koresh153 ($2.03 in chips)
Numakin: posts small blind $0.01
Koresh153: posts big blind $0.02
*** HOLE CARDS ***
Vlao: folds
0.zika: folds
ketomaldonado: folds
jeckarliyo: calls $0.02
Numakin: folds
Koresh153: checks
*** FLOP *** [5h Tc 5d]
Koresh153: checks
jeckarliyo: checks
*** TURN *** [5h Tc 5d] [Qd]
Koresh153: checks
jeckarliyo: bets $0.04
Koresh153: folds
Uncalled bet ($0.04) returned to jeckarliyo
Koresh153 leaves the table
jeckarliyo collected $0.05 from pot
jeckarliyo: doesn't show hand
*** SUMMARY ***
Total pot $0.05 | Rake $0
Board [5h Tc 5d Qd]
Seat 1: Vlao folded before Flop (didn't bet)
Seat 2: 0.zika folded before Flop (didn't bet)
Seat 3: ketomaldonado folded before Flop (didn't bet)
Seat 4: jeckarliyo (button) collected ($0.05)
Seat 5: Numakin (small blind) folded before Flop
Seat 6: Koresh153 (big blind) folded on the Turn


PokerStars Hand #238161771746:  Hold'em No Limit ($0.01/$0.02 USD) - 2022/08/23 1:17:36 ET
Table 'Achilles IV' 6-max Seat #5 is the button
Seat 1: Vlao ($2.07 in chips)
Seat 2: 0.zika ($0.82 in chips)
Seat 4: jeckarliyo ($2.94 in chips)
Seat 5: Numakin ($4.33 in chips)
Vlao: posts small blind $0.01
0.zika: posts big blind $0.02
*** HOLE CARDS ***
jeckarliyo: calls $0.02
Numakin: folds
Vlao: raises $0.06 to $0.08
0.zika: folds
jeckarliyo: folds
Uncalled bet ($0.06) returned to Vlao
Vlao collected $0.06 from pot
*** SUMMARY ***
Total pot $0.06 | Rake $0
Seat 1: Vlao (small blind) collected ($0.06)
Seat 2: 0.zika (big blind) folded before Flop
Seat 4: jeckarliyo folded before Flop
Seat 5: Numakin (button) folded before Flop (didn't bet)


PokerStars Hand #238161773371:  Hold'em No Limit ($0.01/$0.02 USD) - 2022/08/23 1:17:51 ET
Table 'Achilles IV' 6-max Seat #1 is the button
Seat 1: Vlao ($2.11 in chips)
Seat 2: 0.zika ($0.80 in chips)
Seat 4: jeckarliyo ($2.92 in chips)
Seat 5: Numakin ($4.33 in chips)
0.zika: posts small blind $0.01
jeckarliyo: posts big blind $0.02
*** HOLE CARDS ***
Numakin: folds
Vlao: folds
0.zika: calls $0.01
jeckarliyo: checks
*** FLOP *** [Ad Jh 4c]
0.zika: checks
jeckarliyo: checks
*** TURN *** [Ad Jh 4c] [4d]
0.zika: checks
jeckarliyo: checks
*** RIVER *** [Ad Jh 4c 4d] [Qs]
0.zika: bets $0.04
jeckarliyo: raises $0.08 to $0.12
0.zika: folds
Uncalled bet ($0.08) returned to jeckarliyo
jeckarliyo collected $0.12 from pot
jeckarliyo: doesn't show hand
*** SUMMARY ***
Total pot $0.12 | Rake $0
Board [Ad Jh 4c 4d Qs]
Seat 1: Vlao (button) folded before Flop (didn't bet)
Seat 2: 0.zika (small blind) folded on the River
Seat 4: jeckarliyo (big blind) collected ($0.12)
Seat 5: Numakin folded before Flop (didn't bet)


PokerStars Hand #238161777897:  Hold'em No Limit ($0.01/$0.02 USD) - 2022/08/23 1:18:33 ET
Table 'Achilles IV' 6-max Seat #2 is the button
Seat 1: Vlao ($2.11 in chips)
Seat 2: 0.zika ($0.74 in chips)
Seat 4: jeckarliyo ($2.98 in chips)
Seat 5: Numakin ($4.33 in chips)
jeckarliyo: posts small blind $0.01
Numakin: posts big blind $0.02
*** HOLE CARDS ***
Vlao: folds
0.zika: folds
jeckarliyo: raises $0.02 to $0.04
Numakin: calls $0.02
*** FLOP *** [Qs 8d Ah]
jeckarliyo: bets $0.04
Numakin: folds
Uncalled bet ($0.04) returned to jeckarliyo
jeckarliyo collected $0.08 from pot
jeckarliyo: doesn't show hand
*** SUMMARY ***
Total pot $0.08 | Rake $0
Board [Qs 8d Ah]
Seat 1: Vlao folded before Flop (didn't bet)
Seat 2: 0.zika (button) folded before Flop (didn't bet)
Seat 4: jeckarliyo (small blind) collected ($0.08)
Seat 5: Numakin (big blind) folded on the Flop


PokerStars Hand #238161779827:  Hold'em No Limit ($0.01/$0.02 USD) - 2022/08/23 1:18:52 ET
Table 'Achilles IV' 6-max Seat #4 is the button
Seat 1: Vlao ($2.11 in chips)
Seat 2: 0.zika ($0.74 in chips)
Seat 4: jeckarliyo ($3.02 in chips)
Seat 5: Numakin ($4.29 in chips)
Numakin: posts small blind $0.01
Vlao: posts big blind $0.02
*** HOLE CARDS ***
azall joins the table at seat #6
0.zika: calls $0.02
jeckarliyo: folds
Numakin: folds
Vlao: checks
*** FLOP *** [Ks 8h Kh]
Vlao: checks
0.zika: checks
*** TURN *** [Ks 8h Kh] [Ac]
Vlao: checks
0.zika: checks
*** RIVER *** [Ks 8h Kh Ac] [Ts]
Vlao: checks
0.zika: checks
*** SHOW DOWN ***
Vlao: shows [9c 4c] (a pair of Kings)
0.zika: shows [Qs 2s] (a pair of Kings - Ace+Queen kicker)
0.zika collected $0.05 from pot
*** SUMMARY ***
Total pot $0.05 | Rake $0
Board [Ks 8h Kh Ac Ts]
Seat 1: Vlao (big blind) showed [9c 4c] and lost with a pair of Kings
Seat 2: 0.zika showed [Qs 2s] and won ($0.05) with a pair of Kings
Seat 4: jeckarliyo (button) folded before Flop (didn't bet)
Seat 5: Numakin (small blind) folded before Flop


PokerStars Hand #238161783078:  Hold'em No Limit ($0.01/$0.02 USD) - 2022/08/23 1:19:23 ET
Table 'Achilles IV' 6-max Seat #5 is the button
Seat 1: Vlao ($2.09 in chips)
Seat 2: 0.zika ($0.77 in chips)
Seat 3: ketomaldonado ($2.32 in chips)
Seat 4: jeckarliyo ($3.02 in chips)
Seat 5: Numakin ($4.28 in chips)
Vlao: posts small blind $0.01
0.zika: posts big blind $0.02
ketomaldonado: posts small & big blinds $0.03
*** HOLE CARDS ***
ketomaldonado: checks
jeckarliyo: folds
Numakin: folds
Vlao: folds
0.zika: checks
*** FLOP *** [Qs Ad 4s]
0.zika: checks
ketomaldonado: checks
*** TURN *** [Qs Ad 4s] [Ks]
0.zika: checks
ketomaldonado: bets $0.08
0.zika: raises $0.08 to $0.16
ketomaldonado: calls $0.08
*** RIVER *** [Qs Ad 4s Ks] [Qd]
0.zika: bets $0.18
ketomaldonado: calls $0.18
*** SHOW DOWN ***
0.zika: shows [Kd 8s] (two pair, Kings and Queens)
ketomaldonado: shows [As 4d] (two pair, Aces and Queens)
ketomaldonado collected $0.71 from pot
*** SUMMARY ***
Total pot $0.74 | Rake $0.03
Board [Qs Ad 4s Ks Qd]
Seat 1: Vlao (small blind) folded before Flop
Seat 2: 0.zika (big blind) showed [Kd 8s] and lost with two pair, Kings and Queens
Seat 3: ketomaldonado showed [As 4d] and won ($0.71) with two pair, Aces and Queens
Seat 4: jeckarliyo folded before Flop (didn't bet)
Seat 5: Numakin (button) folded before Flop (didn't bet)


PokerStars Hand #238161786582:  Hold'em No Limit ($0.01/$0.02 USD) - 2022/08/23 1:19:55 ET
Table 'Achilles IV' 6-max Seat #1 is the button
Seat 1: Vlao ($2.08 in chips)
Seat 2: 0.zika ($0.41 in chips)
Seat 3: ketomaldonado ($2.66 in chips)
Seat 4: jeckarliyo ($3.02 in chips)
Seat 5: Numakin ($4.28 in chips)
0.zika: posts small blind $0.01
ketomaldonado: posts big blind $0.02
azall: sits out
*** HOLE CARDS ***
jeckarliyo: folds
Numakin: folds
Vlao: folds
0.zika: raises $0.04 to $0.06
ketomaldonado: raises $0.15 to $0.21
0.zika: raises $0.20 to $0.41 and is all-in
ketomaldonado: calls $0.20
*** FLOP *** [4c Ks 3c]
*** TURN *** [4c Ks 3c] [7c]
*** RIVER *** [4c Ks 3c 7c] [9c]
*** SHOW DOWN ***
0.zika: shows [8d 8c] (a flush, Nine high)
ketomaldonado: shows [Ac Ah] (a flush, Ace high)
ketomaldonado collected $0.79 from pot
*** SUMMARY ***
Total pot $0.82 | Rake $0.03
Board [4c Ks 3c 7c 9c]
Seat 1: Vlao (button) folded before Flop (didn't bet)
Seat 2: 0.zika (small blind) showed [8d 8c] and lost with a flush, Nine high
Seat 3: ketomaldonado (big blind) showed [Ac Ah] and won ($0.79) with a flush, Ace high
Seat 4: jeckarliyo folded before Flop (didn't bet)
Seat 5: Numakin folded before Flop (didn't bet)


PokerStars Hand #238161789995:  Hold'em No Limit ($0.01/$0.02 USD) - 2022/08/23 1:20:27 ET
Table 'Achilles IV' 6-max Seat #3 is the button
Seat 1: Vlao ($2.08 in chips)
Seat 3: ketomaldonado ($3.04 in chips)
Seat 4: jeckarliyo ($3.02 in chips)
Seat 5: Numakin ($4.28 in chips)
jeckarliyo: posts small blind $0.01
Numakin: posts big blind $0.02
azall: sits out
*** HOLE CARDS ***
Vlao: folds
ketomaldonado: folds
0.zika leaves the table
jeckarliyo: calls $0.01
Numakin: checks
*** FLOP *** [4s 7d 7c]
jeckarliyo: checks
Numakin: checks
*** TURN *** [4s 7d 7c] [Kh]
jeckarliyo: checks
Numakin: checks
*** RIVER *** [4s 7d 7c Kh] [5h]
jeckarliyo: bets $0.04
Numakin: folds
Uncalled bet ($0.04) returned to jeckarliyo
jeckarliyo collected $0.04 from pot
jeckarliyo: doesn't show hand
*** SUMMARY ***
Total pot $0.04 | Rake $0
Board [4s 7d 7c Kh 5h]
Seat 1: Vlao folded before Flop (didn't bet)
Seat 3: ketomaldonado (button) folded before Flop (didn't bet)
Seat 4: jeckarliyo (small blind) collected ($0.04)
Seat 5: Numakin (big blind) folded on the River


PokerStars Hand #238161793990:  Hold'em No Limit ($0.01/$0.02 USD) - 2022/08/23 1:21:04 ET
Table 'Achilles IV' 6-max Seat #4 is the button
Seat 1: Vlao ($2.08 in chips)
Seat 3: ketomaldonado ($3.04 in chips)
Seat 4: jeckarliyo ($3.04 in chips)
Seat 5: Numakin ($4.26 in chips)
Seat 6: azall ($2 in chips)
Numakin: posts small blind $0.01
azall: posts big blind $0.02
*** HOLE CARDS ***
Vlao: folds
ketomaldonado: folds
jeckarliyo: folds
Numakin: raises $0.04 to $0.06
azall: folds
Uncalled bet ($0.04) returned to Numakin
Numakin collected $0.04 from pot
Numakin: doesn't show hand
*** SUMMARY ***
Total pot $0.04 | Rake $0
Seat 1: Vlao folded before Flop (didn't bet)
Seat 3: ketomaldonado folded before Flop (didn't bet)
Seat 4: jeckarliyo (button) folded before Flop (didn't bet)
Seat 5: Numakin (small blind) collected ($0.04)
Seat 6: azall (big blind) folded before Flop


PokerStars Hand #238161795265:  Hold'em No Limit ($0.01/$0.02 USD) - 2022/08/23 1:21:17 ET
Table 'Achilles IV' 6-max Seat #5 is the button
Seat 1: Vlao ($2.08 in chips)
Seat 3: ketomaldonado ($3.04 in chips)
Seat 4: jeckarliyo ($3.04 in chips)
Seat 5: Numakin ($4.28 in chips)
Seat 6: azall ($2 in chips)
azall: posts small blind $0.01
Vlao: posts big blind $0.02
*** HOLE CARDS ***
ketomaldonado: folds
jeckarliyo: calls $0.02
Numakin: folds
azall: folds
Vlao: checks
*** FLOP *** [Kc 6s 8c]
SnahGod joins the table at seat #2
Vlao: checks
jeckarliyo: checks
*** TURN *** [Kc 6s 8c] [As]
Vlao: checks
jeckarliyo: checks
*** RIVER *** [Kc 6s 8c As] [2h]
Vlao: checks
jeckarliyo: checks
*** SHOW DOWN ***
Vlao: shows [4s 7c] (high card Ace)
jeckarliyo: shows [Tc Js] (high card Ace - King+Jack kicker)
jeckarliyo collected $0.05 from pot
*** SUMMARY ***
Total pot $0.05 | Rake $0
Board [Kc 6s 8c As 2h]
Seat 1: Vlao (big blind) showed [4s 7c] and lost with high card Ace
Seat 3: ketomaldonado folded before Flop (didn't bet)
Seat 4: jeckarliyo showed [Tc Js] and won ($0.05) with high card Ace
Seat 5: Numakin (button) folded before Flop (didn't bet)
Seat 6: azall (small blind) folded before Flop


PokerStars Hand #238161799419:  Hold'em No Limit ($0.01/$0.02 USD) - 2022/08/23 1:21:56 ET
Table 'Achilles IV' 6-max Seat #6 is the button
Seat 1: Vlao ($2.06 in chips)
Seat 2: SnahGod ($1.60 in chips)
Seat 3: ketomaldonado ($3.04 in chips)
Seat 4: jeckarliyo ($3.07 in chips)
Seat 5: Numakin ($4.28 in chips)
Seat 6: azall ($2 in chips)
Vlao: posts small blind $0.01
SnahGod: posts big blind $0.02
*** HOLE CARDS ***
ketomaldonado: folds
jeckarliyo: folds
Numakin: raises $0.03 to $0.05
azall: folds
Vlao: raises $0.17 to $0.22
SnahGod: folds
Numakin: raises $0.28 to $0.50
Vlao: calls $0.28
*** FLOP *** [Ks Qs Jh]
Vlao: checks
Numakin: checks
*** TURN *** [Ks Qs Jh] [9h]
Vlao: bets $1.56 and is all-in
Numakin: folds
Uncalled bet ($1.56) returned to Vlao
Vlao collected $0.98 from pot
*** SUMMARY ***
Total pot $1.02 | Rake $0.04
Board [Ks Qs Jh 9h]
Seat 1: Vlao (small blind) collected ($0.98)
Seat 2: SnahGod (big blind) folded before Flop
Seat 3: ketomaldonado folded before Flop (didn't bet)
Seat 4: jeckarliyo folded before Flop (didn't bet)
Seat 5: Numakin folded on the Turn
Seat 6: azall (button) folded before Flop (didn't bet)


PokerStars Hand #238161804858:  Hold'em No Limit ($0.01/$0.02 USD) - 2022/08/23 1:22:47 ET
Table 'Achilles IV' 6-max Seat #1 is the button
Seat 1: Vlao ($2.54 in chips)
Seat 2: SnahGod ($1.58 in chips)
Seat 3: ketomaldonado ($3.04 in chips)
Seat 4: jeckarliyo ($3.07 in chips)
Seat 5: Numakin ($3.78 in chips)
Seat 6: azall ($2 in chips)
SnahGod: posts small blind $0.01
ketomaldonado: posts big blind $0.02
*** HOLE CARDS ***
jeckarliyo: calls $0.02
Numakin: raises $0.06 to $0.08
azall: folds
Vlao: folds
SnahGod: calls $0.07
ketomaldonado: folds
jeckarliyo: folds
*** FLOP *** [Td 5c 2c]
SnahGod: bets $0.10
Numakin: raises $0.26 to $0.36
SnahGod: raises $1.14 to $1.50 and is all-in
Numakin: folds
Uncalled bet ($1.14) returned to SnahGod
SnahGod collected $0.89 from pot
SnahGod: doesn't show hand
*** SUMMARY ***
Total pot $0.92 | Rake $0.03
Board [Td 5c 2c]
Seat 1: Vlao (button) folded before Flop (didn't bet)
Seat 2: SnahGod (small blind) collected ($0.89)
Seat 3: ketomaldonado (big blind) folded before Flop
Seat 4: jeckarliyo folded before Flop
Seat 5: Numakin folded on the Flop
Seat 6: azall folded before Flop (didn't bet)


PokerStars Hand #238161809756:  Hold'em No Limit ($0.01/$0.02 USD) - 2022/08/23 1:23:32 ET
Table 'Achilles IV' 6-max Seat #2 is the button
Seat 1: Vlao ($2.54 in chips)
Seat 2: SnahGod ($2.03 in chips)
Seat 3: ketomaldonado ($3.02 in chips)
Seat 4: jeckarliyo ($3.05 in chips)
Seat 5: Numakin ($3.34 in chips)
Seat 6: azall ($2 in chips)
ketomaldonado: posts small blind $0.01
jeckarliyo: posts big blind $0.02
*** HOLE CARDS ***
Numakin: folds
azall: folds
Vlao: folds
SnahGod: calls $0.02
ketomaldonado: folds
jeckarliyo: checks
*** FLOP *** [5d 8d Ah]
jeckarliyo: checks
SnahGod: checks
*** TURN *** [5d 8d Ah] [Kh]
jeckarliyo: checks
SnahGod: checks
*** RIVER *** [5d 8d Ah Kh] [7c]
jeckarliyo: checks
SnahGod: bets $0.04
jeckarliyo: folds
Uncalled bet ($0.04) returned to SnahGod
SnahGod collected $0.05 from pot
SnahGod: doesn't show hand
*** SUMMARY ***
Total pot $0.05 | Rake $0
Board [5d 8d Ah Kh 7c]
Seat 1: Vlao folded before Flop (didn't bet)
Seat 2: SnahGod (button) collected ($0.05)
Seat 3: ketomaldonado (small blind) folded before Flop
Seat 4: jeckarliyo (big blind) folded on the River
Seat 5: Numakin folded before Flop (didn't bet)
Seat 6: azall folded before Flop (didn't bet)


PokerStars Hand #238161813397:  Hold'em No Limit ($0.01/$0.02 USD) - 2022/08/23 1:24:07 ET
Table 'Achilles IV' 6-max Seat #3 is the button
Seat 1: Vlao ($2.54 in chips)
Seat 2: SnahGod ($2.06 in chips)
Seat 3: ketomaldonado ($3.01 in chips)
Seat 4: jeckarliyo ($3.03 in chips)
Seat 5: Numakin ($3.34 in chips)
Seat 6: azall ($2 in chips)
jeckarliyo: posts small blind $0.01
Numakin: posts big blind $0.02
*** HOLE CARDS ***
azall: folds
Vlao: raises $0.03 to $0.05
SnahGod: calls $0.05
ketomaldonado: folds
jeckarliyo: calls $0.04
Numakin: folds
*** FLOP *** [2h 5c Qc]
jeckarliyo: checks
Vlao: checks
SnahGod: bets $0.12
jeckarliyo: folds
Vlao: calls $0.12
*** TURN *** [2h 5c Qc] [As]
Vlao: bets $0.27
SnahGod: folds
Uncalled bet ($0.27) returned to Vlao
Vlao collected $0.40 from pot
*** SUMMARY ***
Total pot $0.41 | Rake $0.01
Board [2h 5c Qc As]
Seat 1: Vlao collected ($0.40)
Seat 2: SnahGod folded on the Turn
Seat 3: ketomaldonado (button) folded before Flop (didn't bet)
Seat 4: jeckarliyo (small blind) folded on the Flop
Seat 5: Numakin (big blind) folded before Flop
Seat 6: azall folded before Flop (didn't bet)


PokerStars Hand #238161823950:  Hold'em No Limit ($0.01/$0.02 USD) - 2022/08/23 1:24:57 ET
Table 'Achilles IV' 6-max Seat #4 is the button
Seat 1: Vlao ($2.77 in chips)
Seat 2: SnahGod ($1.89 in chips)
Seat 3: ketomaldonado ($3.01 in chips)
Seat 4: jeckarliyo ($2.98 in chips)
Seat 5: Numakin ($3.32 in chips)
Seat 6: azall ($2 in chips)
Numakin: posts small blind $0.01
azall: posts big blind $0.02
*** HOLE CARDS ***
Vlao: folds
SnahGod: calls $0.02
ketomaldonado: folds
jeckarliyo: folds
Numakin: raises $0.05 to $0.07
azall: raises $0.19 to $0.26
SnahGod: folds
Numakin: folds
Uncalled bet ($0.19) returned to azall
azall collected $0.16 from pot
*** SUMMARY ***
Total pot $0.16 | Rake $0
Seat 1: Vlao folded before Flop (didn't bet)
Seat 2: SnahGod folded before Flop
Seat 3: ketomaldonado folded before Flop (didn't bet)
Seat 4: jeckarliyo (button) folded before Flop (didn't bet)
Seat 5: Numakin (small blind) folded before Flop
Seat 6: azall (big blind) collected ($0.16)


PokerStars Hand #238161826978:  Hold'em No Limit ($0.01/$0.02 USD) - 2022/08/23 1:25:26 ET
Table 'Achilles IV' 6-max Seat #5 is the button
Seat 1: Vlao ($2.77 in chips)
Seat 2: SnahGod ($1.87 in chips)
Seat 3: ketomaldonado ($3.01 in chips)
Seat 4: jeckarliyo ($2.98 in chips)
Seat 5: Numakin ($3.25 in chips)
Seat 6: azall ($2.09 in chips)
azall: posts small blind $0.01
Vlao: posts big blind $0.02
*** HOLE CARDS ***
SnahGod: calls $0.02
ketomaldonado: raises $0.08 to $0.10
jeckarliyo: calls $0.10
Numakin: folds
azall: folds
Vlao: folds
SnahGod: calls $0.08
*** FLOP *** [8s 8d Jh]
SnahGod: checks
ketomaldonado: bets $0.11
jeckarliyo: folds
SnahGod: folds
Uncalled bet ($0.11) returned to ketomaldonado
ketomaldonado collected $0.32 from pot
*** SUMMARY ***
Total pot $0.33 | Rake $0.01
Board [8s 8d Jh]
Seat 1: Vlao (big blind) folded before Flop
Seat 2: SnahGod folded on the Flop
Seat 3: ketomaldonado collected ($0.32)
Seat 4: jeckarliyo folded on the Flop
Seat 5: Numakin (button) folded before Flop (didn't bet)
Seat 6: azall (small blind) folded before Flop


PokerStars Hand #238161833632:  Hold'em No Limit ($0.01/$0.02 USD) - 2022/08/23 1:26:29 ET
Table 'Achilles IV' 6-max Seat #6 is the button
Seat 1: Vlao ($2.75 in chips)
Seat 2: SnahGod ($1.77 in chips)
Seat 3: ketomaldonado ($3.23 in chips)
Seat 4: jeckarliyo ($2.88 in chips)
Seat 5: Numakin ($3.25 in chips)
Seat 6: azall ($2.08 in chips)
Vlao: posts small blind $0.01
SnahGod: posts big blind $0.02
*** HOLE CARDS ***
ketomaldonado: raises $0.03 to $0.05
jeckarliyo: folds
Numakin: folds
azall: folds
Vlao: folds
SnahGod: calls $0.03
*** FLOP *** [Jc 8h 6d]
SnahGod: checks
ketomaldonado: bets $0.04
SnahGod: calls $0.04
*** TURN *** [Jc 8h 6d] [Kc]
SnahGod: checks
ketomaldonado: checks
*** RIVER *** [Jc 8h 6d Kc] [3h]
SnahGod: bets $0.20
ketomaldonado: folds
Uncalled bet ($0.20) returned to SnahGod
SnahGod collected $0.18 from pot
SnahGod: doesn't show hand
*** SUMMARY ***
Total pot $0.19 | Rake $0.01
Board [Jc 8h 6d Kc 3h]
Seat 1: Vlao (small blind) folded before Flop
Seat 2: SnahGod (big blind) collected ($0.18)
Seat 3: ketomaldonado folded on the River
Seat 4: jeckarliyo folded before Flop (didn't bet)
Seat 5: Numakin folded before Flop (didn't bet)
Seat 6: azall (button) folded before Flop (didn't bet)


PokerStars Hand #238161839618:  Hold'em No Limit ($0.01/$0.02 USD) - 2022/08/23 1:27:26 ET
Table 'Achilles IV' 6-max Seat #1 is the button
Seat 1: Vlao ($2.74 in chips)
Seat 2: SnahGod ($1.86 in chips)
Seat 3: ketomaldonado ($3.14 in chips)
Seat 4: jeckarliyo ($2.88 in chips)
Seat 5: Numakin ($3.25 in chips)
Seat 6: azall ($2.08 in chips)
SnahGod: posts small blind $0.01
ketomaldonado: posts big blind $0.02
*** HOLE CARDS ***
jeckarliyo: calls $0.02
Numakin: folds
azall: folds
Vlao: folds
SnahGod: calls $0.01
ketomaldonado: checks
*** FLOP *** [5c 5h 2c]
SnahGod: checks
ketomaldonado: checks
jeckarliyo: checks
*** TURN *** [5c 5h 2c] [Jh]
SnahGod: checks
ketomaldonado: checks
jeckarliyo: checks
*** RIVER *** [5c 5h 2c Jh] [2d]
SnahGod: bets $0.06
ketomaldonado: raises $0.26 to $0.32
jeckarliyo: folds
SnahGod: raises $0.26 to $0.58
ketomaldonado: raises $2.54 to $3.12 and is all-in
SnahGod: calls $1.26 and is all-in
Uncalled bet ($1.28) returned to ketomaldonado
*** SHOW DOWN ***
ketomaldonado: shows [5d As] (a full house, Fives full of Deuces)
SnahGod: shows [5s 8h] (a full house, Fives full of Deuces)
SnahGod collected $1.81 from pot
ketomaldonado collected $1.80 from pot
*** SUMMARY ***
Total pot $3.74 | Rake $0.13
Board [5c 5h 2c Jh 2d]
Seat 1: Vlao (button) folded before Flop (didn't bet)
Seat 2: SnahGod (small blind) showed [5s 8h] and won ($1.81) with a full house, Fives full of Deuces
Seat 3: ketomaldonado (big blind) showed [5d As] and won ($1.80) with a full house, Fives full of Deuces
Seat 4: jeckarliyo folded on the River
Seat 5: Numakin folded before Flop (didn't bet)
Seat 6: azall folded before Flop (didn't bet)


PokerStars Hand #238161851830:  Hold'em No Limit ($0.01/$0.02 USD) - 2022/08/23 1:28:30 ET
Table 'Achilles IV' 6-max Seat #2 is the button
Seat 1: Vlao ($2.74 in chips)
Seat 2: SnahGod ($1.81 in chips)
Seat 3: ketomaldonado ($3.08 in chips)
Seat 4: jeckarliyo ($2.86 in chips)
Seat 5: Numakin ($3.25 in chips)
Seat 6: azall ($2.08 in chips)
ketomaldonado: posts small blind $0.01
jeckarliyo: posts big blind $0.02
*** HOLE CARDS ***
Numakin: raises $0.03 to $0.05
azall: folds
Vlao: folds
SnahGod: calls $0.05
ketomaldonado: folds
jeckarliyo: calls $0.03
*** FLOP *** [8c 4d Tc]
jeckarliyo: bets $0.06
Numakin: folds
SnahGod: folds
Uncalled bet ($0.06) returned to jeckarliyo
jeckarliyo collected $0.15 from pot
jeckarliyo: doesn't show hand
*** SUMMARY ***
Total pot $0.16 | Rake $0.01
Board [8c 4d Tc]
Seat 1: Vlao folded before Flop (didn't bet)
Seat 2: SnahGod (button) folded on the Flop
Seat 3: ketomaldonado (small blind) folded before Flop
Seat 4: jeckarliyo (big blind) collected ($0.15)
Seat 5: Numakin folded on the Flop
Seat 6: azall folded before Flop (didn't bet)


PokerStars Hand #238161857090:  Hold'em No Limit ($0.01/$0.02 USD) - 2022/08/23 1:29:21 ET
Table 'Achilles IV' 6-max Seat #3 is the button
Seat 1: Vlao ($2.74 in chips)
Seat 2: SnahGod ($1.76 in chips)
Seat 3: ketomaldonado ($3.07 in chips)
Seat 4: jeckarliyo ($2.96 in chips)
Seat 5: Numakin ($3.20 in chips)
Seat 6: azall ($2.08 in chips)
jeckarliyo: posts small blind $0.01
Numakin: posts big blind $0.02
*** HOLE CARDS ***
azall: folds
Vlao: folds
SnahGod: calls $0.02
ketomaldonado: folds
jeckarliyo: folds
Numakin: checks
*** FLOP *** [Ac Ks 5s]
Numakin: checks
SnahGod: bets $0.02
Numakin: calls $0.02
*** TURN *** [Ac Ks 5s] [9s]
Numakin: checks
SnahGod: bets $0.10
Numakin: folds
Uncalled bet ($0.10) returned to SnahGod
SnahGod collected $0.09 from pot
SnahGod: doesn't show hand
*** SUMMARY ***
Total pot $0.09 | Rake $0
Board [Ac Ks 5s 9s]
Seat 1: Vlao folded before Flop (didn't bet)
Seat 2: SnahGod collected ($0.09)
Seat 3: ketomaldonado (button) folded before Flop (didn't bet)
Seat 4: jeckarliyo (small blind) folded before Flop
Seat 5: Numakin (big blind) folded on the Turn
Seat 6: azall folded before Flop (didn't bet)


PokerStars Hand #238161861187:  Hold'em No Limit ($0.01/$0.02 USD) - 2022/08/23 1:30:01 ET
Table 'Achilles IV' 6-max Seat #4 is the button
Seat 1: Vlao ($2.74 in chips)
Seat 2: SnahGod ($1.81 in chips)
Seat 3: ketomaldonado ($3.07 in chips)
Seat 4: jeckarliyo ($2.95 in chips)
Seat 5: Numakin ($3.16 in chips)
Seat 6: azall ($2.08 in chips)
Numakin: posts small blind $0.01
azall: posts big blind $0.02
*** HOLE CARDS ***
Vlao: folds
SnahGod: calls $0.02
ketomaldonado: raises $0.08 to $0.10
jeckarliyo: calls $0.10
Numakin: folds
azall: folds
SnahGod: calls $0.08
*** FLOP *** [5d Kd Jd]
SnahGod: checks
ketomaldonado: checks
jeckarliyo: checks
*** TURN *** [5d Kd Jd] [4h]
SnahGod: checks
ketomaldonado: bets $0.16
jeckarliyo: calls $0.16
SnahGod: folds
*** RIVER *** [5d Kd Jd 4h] [4d]
ketomaldonado: checks
jeckarliyo: bets $0.22
ketomaldonado: folds
Uncalled bet ($0.22) returned to jeckarliyo
jeckarliyo collected $0.63 from pot
jeckarliyo: doesn't show hand
*** SUMMARY ***
Total pot $0.65 | Rake $0.02
Board [5d Kd Jd 4h 4d]
Seat 1: Vlao folded before Flop (didn't bet)
Seat 2: SnahGod folded on the Turn
Seat 3: ketomaldonado folded on the River
Seat 4: jeckarliyo (button) collected ($0.63)
Seat 5: Numakin (small blind) folded before Flop
Seat 6: azall (big blind) folded before Flop


PokerStars Hand #238161867489:  Hold'em No Limit ($0.01/$0.02 USD) - 2022/08/23 1:31:02 ET
Table 'Achilles IV' 6-max Seat #5 is the button
Seat 1: Vlao ($2.74 in chips)
Seat 2: SnahGod ($1.71 in chips)
Seat 3: ketomaldonado ($2.81 in chips)
Seat 4: jeckarliyo ($3.32 in chips)
Seat 5: Numakin ($3.15 in chips)
Seat 6: azall ($2.06 in chips)
azall: posts small blind $0.01
Vlao: posts big blind $0.02
*** HOLE CARDS ***
SnahGod: calls $0.02
ketomaldonado: folds
jeckarliyo: calls $0.02
Numakin: folds
azall: folds
Vlao: checks
*** FLOP *** [5s 5d 6s]
Vlao: checks
SnahGod: checks
jeckarliyo: checks
*** TURN *** [5s 5d 6s] [Jd]
Vlao: checks
SnahGod: checks
jeckarliyo: checks
*** RIVER *** [5s 5d 6s Jd] [6h]
Vlao: checks
SnahGod: checks
jeckarliyo: checks
*** SHOW DOWN ***
Vlao: shows [2c 4c] (two pair, Sixes and Fives)
SnahGod: shows [9h 8d] (two pair, Sixes and Fives)
jeckarliyo: shows [Kh 9c] (two pair, Sixes and Fives - King kicker)
jeckarliyo collected $0.07 from pot
*** SUMMARY ***
Total pot $0.07 | Rake $0
Board [5s 5d 6s Jd 6h]
Seat 1: Vlao (big blind) showed [2c 4c] and lost with two pair, Sixes and Fives
Seat 2: SnahGod showed [9h 8d] and lost with two pair, Sixes and Fives
Seat 3: ketomaldonado folded before Flop (didn't bet)
Seat 4: jeckarliyo showed [Kh 9c] and won ($0.07) with two pair, Sixes and Fives
Seat 5: Numakin (button) folded before Flop (didn't bet)
Seat 6: azall (small blind) folded before Flop


PokerStars Hand #238161873766:  Hold'em No Limit ($0.01/$0.02 USD) - 2022/08/23 1:32:03 ET
Table 'Achilles IV' 6-max Seat #6 is the button
Seat 1: Vlao ($2.72 in chips)
Seat 2: SnahGod ($1.69 in chips)
Seat 3: ketomaldonado ($2.81 in chips)
Seat 4: jeckarliyo ($3.37 in chips)
Seat 5: Numakin ($3.15 in chips)
Seat 6: azall ($2.05 in chips)
Vlao: posts small blind $0.01
SnahGod: posts big blind $0.02
*** HOLE CARDS ***
ketomaldonado: folds
jeckarliyo: folds
Numakin: folds
azall: raises $0.04 to $0.06
Vlao: folds
SnahGod: calls $0.04
*** FLOP *** [5s Ks Jh]
SnahGod: bets $0.10
azall: calls $0.10
*** TURN *** [5s Ks Jh] [Kd]
SnahGod: checks
azall: checks
*** RIVER *** [5s Ks Jh Kd] [4h]
SnahGod: bets $0.02
azall: folds
Uncalled bet ($0.02) returned to SnahGod
SnahGod collected $0.32 from pot
SnahGod: doesn't show hand
*** SUMMARY ***
Total pot $0.33 | Rake $0.01
Board [5s Ks Jh Kd 4h]
Seat 1: Vlao (small blind) folded before Flop
Seat 2: SnahGod (big blind) collected ($0.32)
Seat 3: ketomaldonado folded before Flop (didn't bet)
Seat 4: jeckarliyo folded before Flop (didn't bet)
Seat 5: Numakin folded before Flop (didn't bet)
Seat 6: azall (button) folded on the River


PokerStars Hand #238161879036:  Hold'em No Limit ($0.01/$0.02 USD) - 2022/08/23 1:32:53 ET
Table 'Achilles IV' 6-max Seat #1 is the button
Seat 1: Vlao ($2.71 in chips)
Seat 2: SnahGod ($1.85 in chips)
Seat 3: ketomaldonado ($2.81 in chips)
Seat 4: jeckarliyo ($3.37 in chips)
Seat 5: Numakin ($3.15 in chips)
Seat 6: azall ($2 in chips)
SnahGod: posts small blind $0.01
ketomaldonado: posts big blind $0.02
*** HOLE CARDS ***
jeckarliyo: calls $0.02
Numakin: folds
azall: folds
Vlao: folds
SnahGod: calls $0.01
ketomaldonado: checks
*** FLOP *** [7d 2c 2h]
SnahGod: checks
ketomaldonado: checks
jeckarliyo: checks
*** TURN *** [7d 2c 2h] [7c]
SnahGod: checks
ketomaldonado: checks
jeckarliyo: checks
*** RIVER *** [7d 2c 2h 7c] [Kc]
SnahGod: checks
ketomaldonado: checks
jeckarliyo: checks
*** SHOW DOWN ***
SnahGod: shows [Tc Jd] (two pair, Sevens and Deuces)
ketomaldonado: shows [9d 6d] (two pair, Sevens and Deuces)
jeckarliyo: shows [4d 3d] (two pair, Sevens and Deuces)
SnahGod collected $0.02 from pot
ketomaldonado collected $0.02 from pot
jeckarliyo collected $0.02 from pot
*** SUMMARY ***
Total pot $0.06 | Rake $0
Board [7d 2c 2h 7c Kc]
Seat 1: Vlao (button) folded before Flop (didn't bet)
Seat 2: SnahGod (small blind) showed [Tc Jd] and won ($0.02) with two pair, Sevens and Deuces
Seat 3: ketomaldonado (big blind) showed [9d 6d] and won ($0.02) with two pair, Sevens and Deuces
Seat 4: jeckarliyo showed [4d 3d] and won ($0.02) with two pair, Sevens and Deuces
Seat 5: Numakin folded before Flop (didn't bet)
Seat 6: azall folded before Flop (didn't bet)


PokerStars Hand #238161883872:  Hold'em No Limit ($0.01/$0.02 USD) - 2022/08/23 1:33:38 ET
Table 'Achilles IV' 6-max Seat #2 is the button
Seat 1: Vlao ($2.71 in chips)
Seat 2: SnahGod ($1.85 in chips)
Seat 3: ketomaldonado ($2.81 in chips)
Seat 4: jeckarliyo ($3.37 in chips)
Seat 5: Numakin ($3.15 in chips)
Seat 6: azall ($2 in chips)
ketomaldonado: posts small blind $0.01
jeckarliyo: posts big blind $0.02
*** HOLE CARDS ***
Numakin: folds
azall: folds
Vlao: raises $0.03 to $0.05
SnahGod: calls $0.05
ketomaldonado: calls $0.04
jeckarliyo: folds
*** FLOP *** [8d 5d 4c]
ketomaldonado: checks
Vlao: checks
SnahGod: bets $0.10
ketomaldonado: calls $0.10
Vlao: folds
*** TURN *** [8d 5d 4c] [3c]
ketomaldonado: checks
SnahGod: bets $1.70 and is all-in
ketomaldonado: folds
Uncalled bet ($1.70) returned to SnahGod
SnahGod collected $0.36 from pot
SnahGod: doesn't show hand
*** SUMMARY ***
Total pot $0.37 | Rake $0.01
Board [8d 5d 4c 3c]
Seat 1: Vlao folded on the Flop
Seat 2: SnahGod (button) collected ($0.36)
Seat 3: ketomaldonado (small blind) folded on the Turn
Seat 4: jeckarliyo (big blind) folded before Flop
Seat 5: Numakin folded before Flop (didn't bet)
Seat 6: azall folded before Flop (didn't bet)


PokerStars Hand #238161890334:  Hold'em No Limit ($0.01/$0.02 USD) - 2022/08/23 1:34:40 ET
Table 'Achilles IV' 6-max Seat #3 is the button
Seat 1: Vlao ($2.66 in chips)
Seat 2: SnahGod ($2.06 in chips)
Seat 3: ketomaldonado ($2.66 in chips)
Seat 4: jeckarliyo ($3.35 in chips)
Seat 5: Numakin ($3.15 in chips)
Seat 6: azall ($2 in chips)
jeckarliyo: posts small blind $0.01
Numakin: posts big blind $0.02
*** HOLE CARDS ***
azall: folds
Vlao: folds
SnahGod: calls $0.02
ketomaldonado: folds
jeckarliyo: folds
Numakin: checks
*** FLOP *** [3s As 5s]
Numakin: checks
SnahGod: bets $0.08
Numakin: folds
Uncalled bet ($0.08) returned to SnahGod
SnahGod collected $0.05 from pot
SnahGod: doesn't show hand
*** SUMMARY ***
Total pot $0.05 | Rake $0
Board [3s As 5s]
Seat 1: Vlao folded before Flop (didn't bet)
Seat 2: SnahGod collected ($0.05)
Seat 3: ketomaldonado (button) folded before Flop (didn't bet)
Seat 4: jeckarliyo (small blind) folded before Flop
Seat 5: Numakin (big blind) folded on the Flop
Seat 6: azall folded before Flop (didn't bet)


PokerStars Hand #238161893002:  Hold'em No Limit ($0.01/$0.02 USD) - 2022/08/23 1:35:05 ET
Table 'Achilles IV' 6-max Seat #4 is the button
Seat 1: Vlao ($2.66 in chips)
Seat 2: SnahGod ($2.09 in chips)
Seat 3: ketomaldonado ($2.66 in chips)
Seat 4: jeckarliyo ($3.34 in chips)
Seat 5: Numakin ($3.13 in chips)
Seat 6: azall ($2 in chips)
Numakin: posts small blind $0.01
azall: posts big blind $0.02
*** HOLE CARDS ***
Vlao: raises $0.03 to $0.05
SnahGod: calls $0.05
ketomaldonado: folds
jeckarliyo: folds
Numakin: folds
azall: calls $0.03
*** FLOP *** [3s 3h 7c]
azall: checks
Vlao: checks
SnahGod: checks
*** TURN *** [3s 3h 7c] [7d]
azall: bets $0.07
Vlao: calls $0.07
SnahGod: folds
*** RIVER *** [3s 3h 7c 7d] [7s]
azall: bets $0.14
Vlao: calls $0.14
*** SHOW DOWN ***
azall: shows [7h 9h] (four of a kind, Sevens)
Vlao: mucks hand
azall collected $0.56 from pot
*** SUMMARY ***
Total pot $0.58 | Rake $0.02
Board [3s 3h 7c 7d 7s]
Seat 1: Vlao mucked
Seat 2: SnahGod folded on the Turn
Seat 3: ketomaldonado folded before Flop (didn't bet)
Seat 4: jeckarliyo (button) folded before Flop (didn't bet)
Seat 5: Numakin (small blind) folded before Flop
Seat 6: azall (big blind) showed [7h 9h] and won ($0.56) with four of a kind, Sevens


PokerStars Hand #238161898615:  Hold'em No Limit ($0.01/$0.02 USD) - 2022/08/23 1:35:59 ET
Table 'Achilles IV' 6-max Seat #5 is the button
Seat 1: Vlao ($2.40 in chips)
Seat 2: SnahGod ($2.04 in chips)
Seat 3: ketomaldonado ($2.66 in chips)
Seat 4: jeckarliyo ($3.34 in chips)
Seat 5: Numakin ($3.12 in chips)
Seat 6: azall ($2.30 in chips)
azall: posts small blind $0.01
Vlao: posts big blind $0.02
*** HOLE CARDS ***
SnahGod: calls $0.02
ketomaldonado: folds
jeckarliyo: folds
Numakin: folds
azall: folds
Vlao: checks
*** FLOP *** [6h 8s 2h]
Vlao: checks
SnahGod: checks
*** TURN *** [6h 8s 2h] [Jd]
Vlao: checks
SnahGod: checks
*** RIVER *** [6h 8s 2h Jd] [Ad]
Vlao: checks
SnahGod: bets $0.04
Vlao: folds
Uncalled bet ($0.04) returned to SnahGod
SnahGod collected $0.05 from pot
SnahGod: doesn't show hand
*** SUMMARY ***
Total pot $0.05 | Rake $0
Board [6h 8s 2h Jd Ad]
Seat 1: Vlao (big blind) folded on the River
Seat 2: SnahGod collected ($0.05)
Seat 3: ketomaldonado folded before Flop (didn't bet)
Seat 4: jeckarliyo folded before Flop (didn't bet)
Seat 5: Numakin (button) folded before Flop (didn't bet)
Seat 6: azall (small blind) folded before Flop


PokerStars Hand #238161902057:  Hold'em No Limit ($0.01/$0.02 USD) - 2022/08/23 1:36:32 ET
Table 'Achilles IV' 6-max Seat #6 is the button
Seat 1: Vlao ($2.38 in chips)
Seat 2: SnahGod ($2.07 in chips)
Seat 3: ketomaldonado ($2.66 in chips)
Seat 4: jeckarliyo ($3.34 in chips)
Seat 5: Numakin ($3.12 in chips)
Seat 6: azall ($2.29 in chips)
Vlao: posts small blind $0.01
SnahGod: posts big blind $0.02
*** HOLE CARDS ***
ketomaldonado: raises $0.03 to $0.05
jeckarliyo: calls $0.05
Numakin: raises $0.16 to $0.21
azall: folds
Vlao: folds
SnahGod: folds
ketomaldonado: folds
jeckarliyo: folds
Uncalled bet ($0.16) returned to Numakin
Numakin collected $0.18 from pot
Numakin: doesn't show hand
*** SUMMARY ***
Total pot $0.18 | Rake $0
Seat 1: Vlao (small blind) folded before Flop
Seat 2: SnahGod (big blind) folded before Flop
Seat 3: ketomaldonado folded before Flop
Seat 4: jeckarliyo folded before Flop
Seat 5: Numakin collected ($0.18)
Seat 6: azall (button) folded before Flop (didn't bet)


PokerStars Hand #238161904754:  Hold'em No Limit ($0.01/$0.02 USD) - 2022/08/23 1:36:58 ET
Table 'Achilles IV' 6-max Seat #1 is the button
Seat 1: Vlao ($2.37 in chips)
Seat 2: SnahGod ($2.05 in chips)
Seat 3: ketomaldonado ($2.61 in chips)
Seat 4: jeckarliyo ($3.29 in chips)
Seat 5: Numakin ($3.25 in chips)
Seat 6: azall ($2.29 in chips)
SnahGod: posts small blind $0.01
ketomaldonado: posts big blind $0.02
*** HOLE CARDS ***
jeckarliyo: calls $0.02
Numakin: folds
azall: folds
Vlao: folds
SnahGod: calls $0.01
ketomaldonado: checks
*** FLOP *** [9c 6s 7c]
SnahGod: checks
ketomaldonado: bets $0.04
jeckarliyo: calls $0.04
SnahGod: folds
*** TURN *** [9c 6s 7c] [5c]
ketomaldonado: checks
jeckarliyo: checks
*** RIVER *** [9c 6s 7c 5c] [9s]
ketomaldonado: checks
jeckarliyo: checks
*** SHOW DOWN ***
ketomaldonado: shows [3s 5d] (two pair, Nines and Fives)
jeckarliyo: shows [7h 8d] (a straight, Five to Nine)
jeckarliyo collected $0.14 from pot
*** SUMMARY ***
Total pot $0.14 | Rake $0
Board [9c 6s 7c 5c 9s]
Seat 1: Vlao (button) folded before Flop (didn't bet)
Seat 2: SnahGod (small blind) folded on the Flop
Seat 3: ketomaldonado (big blind) showed [3s 5d] and lost with two pair, Nines and Fives
Seat 4: jeckarliyo showed [7h 8d] and won ($0.14) with a straight, Five to Nine
Seat 5: Numakin folded before Flop (didn't bet)
Seat 6: azall folded before Flop (didn't bet)


PokerStars Hand #238161914024:  Hold'em No Limit ($0.01/$0.02 USD) - 2022/08/23 1:37:54 ET
Table 'Achilles IV' 6-max Seat #2 is the button
Seat 1: Vlao ($2.37 in chips)
Seat 2: SnahGod ($2.03 in chips)
Seat 3: ketomaldonado ($2.55 in chips)
Seat 6: azall ($2.29 in chips)
ketomaldonado: posts small blind $0.01
Numakin: is sitting out
azall: posts big blind $0.02
*** HOLE CARDS ***
Vlao: folds
jeckarliyo leaves the table
SnahGod: calls $0.02
ketomaldonado: folds
killervzla28 joins the table at seat #4
Numakin leaves the table
azall: raises $0.08 to $0.10
SnahGod: calls $0.08
*** FLOP *** [Td 4d Qc]
azall: checks
SnahGod: bets $0.10
azall: folds
Uncalled bet ($0.10) returned to SnahGod
SnahGod collected $0.20 from pot
SnahGod: doesn't show hand
*** SUMMARY ***
Total pot $0.21 | Rake $0.01
Board [Td 4d Qc]
Seat 1: Vlao folded before Flop (didn't bet)
Seat 2: SnahGod (button) collected ($0.20)
Seat 3: ketomaldonado (small blind) folded before Flop
Seat 6: azall (big blind) folded on the Flop


PokerStars Hand #238161918087:  Hold'em No Limit ($0.01/$0.02 USD) - 2022/08/23 1:38:32 ET
Table 'Achilles IV' 6-max Seat #3 is the button
Seat 1: Vlao ($2.37 in chips)
Seat 2: SnahGod ($2.13 in chips)
Seat 3: ketomaldonado ($2.54 in chips)
Seat 6: azall ($2.19 in chips)
azall: posts small blind $0.01
Vlao: posts big blind $0.02
*** HOLE CARDS ***
SnahGod: calls $0.02
ketomaldonado: folds
azall: folds
Vlao: checks
*** FLOP *** [Tc 6s 8d]
Vlao: checks
SnahGod: checks
*** TURN *** [Tc 6s 8d] [6d]
Vlao: checks
SnahGod: checks
*** RIVER *** [Tc 6s 8d 6d] [Jc]
Vlao: checks
SnahGod: bets $0.06
Vlao: folds
Uncalled bet ($0.06) returned to SnahGod
SnahGod collected $0.05 from pot
SnahGod: doesn't show hand
*** SUMMARY ***
Total pot $0.05 | Rake $0
Board [Tc 6s 8d 6d Jc]
Seat 1: Vlao (big blind) folded on the River
Seat 2: SnahGod collected ($0.05)
Seat 3: ketomaldonado (button) folded before Flop (didn't bet)
Seat 6: azall (small blind) folded before Flop


PokerStars Hand #238161920697:  Hold'em No Limit ($0.01/$0.02 USD) - 2022/08/23 1:38:58 ET
Table 'Achilles IV' 6-max Seat #6 is the button
Seat 1: Vlao ($2.35 in chips)
Seat 2: SnahGod ($2.16 in chips)
Seat 3: ketomaldonado ($2.54 in chips)
Seat 6: azall ($2.18 in chips)
Vlao: posts small blind $0.01
SnahGod: posts big blind $0.02
killervzla28: sits out
*** HOLE CARDS ***
ketomaldonado: folds
azall: folds
Vlao: folds
Uncalled bet ($0.01) returned to SnahGod
SnahGod collected $0.02 from pot
SnahGod: doesn't show hand
*** SUMMARY ***
Total pot $0.02 | Rake $0
Seat 1: Vlao (small blind) folded before Flop
Seat 2: SnahGod (big blind) collected ($0.02)
Seat 3: ketomaldonado folded before Flop (didn't bet)
Seat 6: azall (button) folded before Flop (didn't bet)


PokerStars Hand #238161921971:  Hold'em No Limit ($0.01/$0.02 USD) - 2022/08/23 1:39:10 ET
Table 'Achilles IV' 6-max Seat #1 is the button
Seat 1: Vlao ($2.34 in chips)
Seat 2: SnahGod ($2.17 in chips)
Seat 3: ketomaldonado ($2.54 in chips)
Seat 6: azall ($2.18 in chips)
SnahGod: posts small blind $0.01
ketomaldonado: posts big blind $0.02
killervzla28: sits out
*** HOLE CARDS ***
azall: folds
Vlao: folds
SnahGod: calls $0.01
ketomaldonado: checks
*** FLOP *** [Kd 7h 6d]
falcao25 joins the table at seat #5
SnahGod: bets $0.06
ketomaldonado: folds
Uncalled bet ($0.06) returned to SnahGod
SnahGod collected $0.04 from pot
SnahGod: doesn't show hand
*** SUMMARY ***
Total pot $0.04 | Rake $0
Board [Kd 7h 6d]
Seat 1: Vlao (button) folded before Flop (didn't bet)
Seat 2: SnahGod (small blind) collected ($0.04)
Seat 3: ketomaldonado (big blind) folded on the Flop
Seat 6: azall folded before Flop (didn't bet)


PokerStars Hand #238161924313:  Hold'em No Limit ($0.01/$0.02 USD) - 2022/08/23 1:39:32 ET
Table 'Achilles IV' 6-max Seat #2 is the button
Seat 1: Vlao ($2.34 in chips)
Seat 2: SnahGod ($2.19 in chips)
Seat 3: ketomaldonado ($2.52 in chips)
Seat 4: killervzla28 ($2 in chips)
Seat 6: azall ($2.18 in chips)
ketomaldonado: posts small blind $0.01
killervzla28: posts big blind $0.02
falcao25: sits out
*** HOLE CARDS ***
azall: folds
Vlao: folds
SnahGod: calls $0.02
ketomaldonado: folds
killervzla28: checks
*** FLOP *** [Td Ac 9d]
killervzla28: checks
SnahGod: bets $0.10
killervzla28: folds
Uncalled bet ($0.10) returned to SnahGod
SnahGod collected $0.05 from pot
SnahGod: doesn't show hand
*** SUMMARY ***
Total pot $0.05 | Rake $0
Board [Td Ac 9d]
Seat 1: Vlao folded before Flop (didn't bet)
Seat 2: SnahGod (button) collected ($0.05)
Seat 3: ketomaldonado (small blind) folded before Flop
Seat 4: killervzla28 (big blind) folded on the Flop
Seat 6: azall folded before Flop (didn't bet)


PokerStars Hand #238161926270:  Hold'em No Limit ($0.01/$0.02 USD) - 2022/08/23 1:39:50 ET
Table 'Achilles IV' 6-max Seat #3 is the button
Seat 1: Vlao ($2.34 in chips)
Seat 2: SnahGod ($2.22 in chips)
Seat 3: ketomaldonado ($2.51 in chips)
Seat 4: killervzla28 ($2 in chips)
Seat 5: falcao25 ($2 in chips)
Seat 6: azall ($2.18 in chips)
killervzla28: posts small blind $0.01
falcao25: posts big blind $0.02
*** HOLE CARDS ***
azall: folds
Vlao: folds
SnahGod: calls $0.02
ketomaldonado: folds
killervzla28: folds
falcao25: checks
*** FLOP *** [6h 5c 5h]
falcao25: checks
SnahGod: checks
*** TURN *** [6h 5c 5h] [4s]
falcao25: checks
SnahGod: checks
*** RIVER *** [6h 5c 5h 4s] [4d]
falcao25: checks
SnahGod: bets $0.10
falcao25: calls $0.10
*** SHOW DOWN ***
SnahGod: shows [Jd Jc] (two pair, Jacks and Fives)
falcao25: mucks hand
SnahGod collected $0.24 from pot
*** SUMMARY ***
Total pot $0.25 | Rake $0.01
Board [6h 5c 5h 4s 4d]
Seat 1: Vlao folded before Flop (didn't bet)
Seat 2: SnahGod showed [Jd Jc] and won ($0.24) with two pair, Jacks and Fives
Seat 3: ketomaldonado (button) folded before Flop (didn't bet)
Seat 4: killervzla28 (small blind) folded before Flop
Seat 5: falcao25 (big blind) mucked
Seat 6: azall folded before Flop (didn't bet)


PokerStars Hand #238161931033:  Hold'em No Limit ($0.01/$0.02 USD) - 2022/08/23 1:40:35 ET
Table 'Achilles IV' 6-max Seat #4 is the button
Seat 1: Vlao ($2.34 in chips)
Seat 2: SnahGod ($2.34 in chips)
Seat 3: ketomaldonado ($2.51 in chips)
Seat 4: killervzla28 ($2 in chips)
Seat 5: falcao25 ($2 in chips)
Seat 6: azall ($2.18 in chips)
falcao25: posts small blind $0.01
azall: posts big blind $0.02
*** HOLE CARDS ***
Vlao: folds
SnahGod: calls $0.02
ketomaldonado: folds
killervzla28: raises $0.06 to $0.08
falcao25: folds
azall: folds
SnahGod: folds
Uncalled bet ($0.06) returned to killervzla28
killervzla28 collected $0.07 from pot
killervzla28: doesn't show hand
*** SUMMARY ***
Total pot $0.07 | Rake $0
Seat 1: Vlao folded before Flop (didn't bet)
Seat 2: SnahGod folded before Flop
Seat 3: ketomaldonado folded before Flop (didn't bet)
Seat 4: killervzla28 (button) collected ($0.07)
Seat 5: falcao25 (small blind) folded before Flop
Seat 6: azall (big blind) folded before Flop


PokerStars Hand #238161934771:  Hold'em No Limit ($0.01/$0.02 USD) - 2022/08/23 1:41:12 ET
Table 'Achilles IV' 6-max Seat #5 is the button
Seat 1: Vlao ($2.34 in chips)
Seat 2: SnahGod ($2.32 in chips)
Seat 3: ketomaldonado ($2.51 in chips)
Seat 4: killervzla28 ($2.05 in chips)
Seat 5: falcao25 ($2 in chips)
Seat 6: azall ($2.16 in chips)
azall: posts small blind $0.01
Vlao: posts big blind $0.02
*** HOLE CARDS ***
SnahGod: calls $0.02
ketomaldonado: folds
killervzla28: folds
falcao25: raises $0.04 to $0.06
azall: folds
Vlao: calls $0.04
SnahGod: calls $0.04
*** FLOP *** [As 5c 5h]
Vlao: checks
SnahGod: bets $0.10
falcao25: calls $0.10
Vlao: folds
*** TURN *** [As 5c 5h] [Js]
SnahGod: checks
falcao25: bets $0.19
SnahGod: folds
Uncalled bet ($0.19) returned to falcao25
falcao25 collected $0.38 from pot
*** SUMMARY ***
Total pot $0.39 | Rake $0.01
Board [As 5c 5h Js]
Seat 1: Vlao (big blind) folded on the Flop
Seat 2: SnahGod folded on the Turn
Seat 3: ketomaldonado folded before Flop (didn't bet)
Seat 4: killervzla28 folded before Flop (didn't bet)
Seat 5: falcao25 (button) collected ($0.38)
Seat 6: azall (small blind) folded before Flop


PokerStars Hand #238161940247:  Hold'em No Limit ($0.01/$0.02 USD) - 2022/08/23 1:42:04 ET
Table 'Achilles IV' 6-max Seat #6 is the button
Seat 1: Vlao ($2.28 in chips)
Seat 2: SnahGod ($2.16 in chips)
Seat 3: ketomaldonado ($2.51 in chips)
Seat 4: killervzla28 ($2.05 in chips)
Seat 5: falcao25 ($2.22 in chips)
Seat 6: azall ($2.15 in chips)
Vlao: posts small blind $0.01
SnahGod: posts big blind $0.02
*** HOLE CARDS ***
ketomaldonado: folds
killervzla28: folds
falcao25: folds
azall: raises $0.04 to $0.06
Vlao: folds
SnahGod: calls $0.04
*** FLOP *** [5s 9s 3c]
SnahGod: bets $0.06
azall: raises $0.12 to $0.18
SnahGod: folds
Uncalled bet ($0.12) returned to azall
azall collected $0.24 from pot
*** SUMMARY ***
Total pot $0.25 | Rake $0.01
Board [5s 9s 3c]
Seat 1: Vlao (small blind) folded before Flop
Seat 2: SnahGod (big blind) folded on the Flop
Seat 3: ketomaldonado folded before Flop (didn't bet)
Seat 4: killervzla28 folded before Flop (didn't bet)
Seat 5: falcao25 folded before Flop (didn't bet)
Seat 6: azall (button) collected ($0.24)


PokerStars Hand #238161944608:  Hold'em No Limit ($0.01/$0.02 USD) - 2022/08/23 1:42:46 ET
Table 'Achilles IV' 6-max Seat #1 is the button
Seat 1: Vlao ($2.27 in chips)
Seat 2: SnahGod ($2.04 in chips)
Seat 3: ketomaldonado ($2.51 in chips)
Seat 4: killervzla28 ($2.05 in chips)
Seat 5: falcao25 ($2.22 in chips)
Seat 6: azall ($2.27 in chips)
SnahGod: posts small blind $0.01
ketomaldonado: posts big blind $0.02
*** HOLE CARDS ***
killervzla28: folds
falcao25: folds
azall: raises $0.04 to $0.06
Vlao: folds
SnahGod: calls $0.05
ketomaldonado: folds
*** FLOP *** [5c 9c Qs]
SnahGod: checks
azall: checks
*** TURN *** [5c 9c Qs] [2d]
SnahGod: bets $0.06
azall: calls $0.06
*** RIVER *** [5c 9c Qs 2d] [Ks]
SnahGod: bets $0.02
azall: calls $0.02
*** SHOW DOWN ***
SnahGod: shows [Js 2s] (a pair of Deuces)
azall: shows [Ad 5d] (a pair of Fives)
azall collected $0.29 from pot
*** SUMMARY ***
Total pot $0.30 | Rake $0.01
Board [5c 9c Qs 2d Ks]
Seat 1: Vlao (button) folded before Flop (didn't bet)
Seat 2: SnahGod (small blind) showed [Js 2s] and lost with a pair of Deuces
Seat 3: ketomaldonado (big blind) folded before Flop
Seat 4: killervzla28 folded before Flop (didn't bet)
Seat 5: falcao25 folded before Flop (didn't bet)
Seat 6: azall showed [Ad 5d] and won ($0.29) with a pair of Fives


PokerStars Hand #238161950064:  Hold'em No Limit ($0.01/$0.02 USD) - 2022/08/23 1:43:37 ET
Table 'Achilles IV' 6-max Seat #2 is the button
Seat 1: Vlao ($2.27 in chips)
Seat 2: SnahGod ($1.90 in chips)
Seat 3: ketomaldonado ($2.49 in chips)
Seat 4: killervzla28 ($2.05 in chips)
Seat 5: falcao25 ($2.22 in chips)
Seat 6: azall ($2.42 in chips)
ketomaldonado: posts small blind $0.01
killervzla28: posts big blind $0.02
*** HOLE CARDS ***
falcao25: folds
azall: folds
Vlao: folds
SnahGod: calls $0.02
ketomaldonado: calls $0.01
killervzla28: checks
*** FLOP *** [8d Qd Jh]
ketomaldonado: checks
killervzla28: checks
SnahGod: checks
*** TURN *** [8d Qd Jh] [Tc]
ketomaldonado: checks
killervzla28: bets $0.06
SnahGod: folds
ketomaldonado: calls $0.06
*** RIVER *** [8d Qd Jh Tc] [Kh]
ketomaldonado: bets $2.41 and is all-in
killervzla28: folds
Uncalled bet ($2.41) returned to ketomaldonado
ketomaldonado collected $0.17 from pot
*** SUMMARY ***
Total pot $0.18 | Rake $0.01
Board [8d Qd Jh Tc Kh]
Seat 1: Vlao folded before Flop (didn't bet)
Seat 2: SnahGod (button) folded on the Turn
Seat 3: ketomaldonado (small blind) collected ($0.17)
Seat 4: killervzla28 (big blind) folded on the River
Seat 5: falcao25 folded before Flop (didn't bet)
Seat 6: azall folded before Flop (didn't bet)


PokerStars Hand #238161957161:  Hold'em No Limit ($0.01/$0.02 USD) - 2022/08/23 1:44:44 ET
Table 'Achilles IV' 6-max Seat #3 is the button
Seat 1: Vlao ($2.27 in chips)
Seat 2: SnahGod ($1.88 in chips)
Seat 3: ketomaldonado ($2.58 in chips)
Seat 4: killervzla28 ($2 in chips)
Seat 5: falcao25 ($2.22 in chips)
Seat 6: azall ($2.42 in chips)
killervzla28: posts small blind $0.01
falcao25: posts big blind $0.02
*** HOLE CARDS ***
azall: folds
Vlao: folds
SnahGod: calls $0.02
ketomaldonado: folds
killervzla28: folds
falcao25: checks
*** FLOP *** [Ah 2c Qs]
falcao25: checks
SnahGod: checks
*** TURN *** [Ah 2c Qs] [6d]
falcao25: checks
SnahGod: bets $0.08
falcao25: folds
Uncalled bet ($0.08) returned to SnahGod
SnahGod collected $0.05 from pot
SnahGod: doesn't show hand
*** SUMMARY ***
Total pot $0.05 | Rake $0
Board [Ah 2c Qs 6d]
Seat 1: Vlao folded before Flop (didn't bet)
Seat 2: SnahGod collected ($0.05)
Seat 3: ketomaldonado (button) folded before Flop (didn't bet)
Seat 4: killervzla28 (small blind) folded before Flop
Seat 5: falcao25 (big blind) folded on the Turn
Seat 6: azall folded before Flop (didn't bet)


PokerStars Hand #238161960322:  Hold'em No Limit ($0.01/$0.02 USD) - 2022/08/23 1:45:15 ET
Table 'Achilles IV' 6-max Seat #4 is the button
Seat 1: Vlao ($2.27 in chips)
Seat 2: SnahGod ($1.91 in chips)
Seat 3: ketomaldonado ($2.58 in chips)
Seat 4: killervzla28 ($2 in chips)
Seat 5: falcao25 ($2.20 in chips)
Seat 6: azall ($2.42 in chips)
falcao25: posts small blind $0.01
azall: posts big blind $0.02
*** HOLE CARDS ***
Vlao: folds
SnahGod: folds
ketomaldonado: folds
killervzla28: folds
falcao25: folds
Uncalled bet ($0.01) returned to azall
azall collected $0.02 from pot
*** SUMMARY ***
Total pot $0.02 | Rake $0
Seat 1: Vlao folded before Flop (didn't bet)
Seat 2: SnahGod folded before Flop (didn't bet)
Seat 3: ketomaldonado folded before Flop (didn't bet)
Seat 4: killervzla28 (button) folded before Flop (didn't bet)
Seat 5: falcao25 (small blind) folded before Flop
Seat 6: azall (big blind) collected ($0.02)


PokerStars Hand #238161962418:  Hold'em No Limit ($0.01/$0.02 USD) - 2022/08/23 1:45:35 ET
Table 'Achilles IV' 6-max Seat #5 is the button
Seat 1: Vlao ($2.27 in chips)
Seat 2: SnahGod ($1.91 in chips)
Seat 3: ketomaldonado ($2.58 in chips)
Seat 4: killervzla28 ($2 in chips)
Seat 5: falcao25 ($2.19 in chips)
Seat 6: azall ($2.43 in chips)
azall: posts small blind $0.01
Vlao: posts big blind $0.02
*** HOLE CARDS ***
SnahGod: folds
ketomaldonado: folds
killervzla28: folds
SnahGod leaves the table
falcao25: folds
azall: raises $0.04 to $0.06
Vlao: folds
Uncalled bet ($0.04) returned to azall
azall collected $0.04 from pot
*** SUMMARY ***
Total pot $0.04 | Rake $0
Seat 1: Vlao (big blind) folded before Flop
Seat 2: SnahGod folded before Flop (didn't bet)
Seat 3: ketomaldonado folded before Flop (didn't bet)
Seat 4: killervzla28 folded before Flop (didn't bet)
Seat 5: falcao25 (button) folded before Flop (didn't bet)
Seat 6: azall (small blind) collected ($0.04)


PokerStars Hand #238161964114:  Hold'em No Limit ($0.01/$0.02 USD) - 2022/08/23 1:45:51 ET
Table 'Achilles IV' 6-max Seat #6 is the button
Seat 1: Vlao ($2.25 in chips)
Seat 3: ketomaldonado ($2.58 in chips)
Seat 4: killervzla28 ($2 in chips)
Seat 5: falcao25 ($2.19 in chips)
Seat 6: azall ($2.45 in chips)
Vlao: posts small blind $0.01
ketomaldonado: posts big blind $0.02
*** HOLE CARDS ***
killervzla28: raises $0.04 to $0.06
falcao25: calls $0.06
azall: folds
Vlao: calls $0.05
ketomaldonado: folds
*** FLOP *** [Ts 7c 3s]
Vlao: checks
killervzla28: bets $0.13
falcao25: folds
Vlao: calls $0.13
*** TURN *** [Ts 7c 3s] [Qc]
msmbenz9900 joins the table at seat #2
Vlao: checks
killervzla28: checks
*** RIVER *** [Ts 7c 3s Qc] [Kh]
Vlao: checks
killervzla28: checks
*** SHOW DOWN ***
Vlao: shows [As 5s] (high card Ace)
killervzla28: shows [9c 9h] (a pair of Nines)
killervzla28 collected $0.44 from pot
*** SUMMARY ***
Total pot $0.46 | Rake $0.02
Board [Ts 7c 3s Qc Kh]
Seat 1: Vlao (small blind) showed [As 5s] and lost with high card Ace
Seat 3: ketomaldonado (big blind) folded before Flop
Seat 4: killervzla28 showed [9c 9h] and won ($0.44) with a pair of Nines
Seat 5: falcao25 folded on the Flop
Seat 6: azall (button) folded before Flop (didn't bet)


PokerStars Hand #238161969806:  Hold'em No Limit ($0.01/$0.02 USD) - 2022/08/23 1:46:47 ET
Table 'Achilles IV' 6-max Seat #1 is the button
Seat 1: Vlao ($2.06 in chips)
Seat 3: ketomaldonado ($2.56 in chips)
Seat 4: killervzla28 ($2.25 in chips)
Seat 5: falcao25 ($2.13 in chips)
Seat 6: azall ($2.45 in chips)
ketomaldonado: posts small blind $0.01
killervzla28: posts big blind $0.02
*** HOLE CARDS ***
falcao25: folds
azall: folds
Vlao: folds
ketomaldonado: folds
Uncalled bet ($0.01) returned to killervzla28
killervzla28 collected $0.02 from pot
killervzla28: doesn't show hand
*** SUMMARY ***
Total pot $0.02 | Rake $0
Seat 1: Vlao (button) folded before Flop (didn't bet)
Seat 3: ketomaldonado (small blind) folded before Flop
Seat 4: killervzla28 (big blind) collected ($0.02)
Seat 5: falcao25 folded before Flop (didn't bet)
Seat 6: azall folded before Flop (didn't bet)


PokerStars Hand #238161971070:  Hold'em No Limit ($0.01/$0.02 USD) - 2022/08/23 1:46:59 ET
Table 'Achilles IV' 6-max Seat #3 is the button
Seat 1: Vlao ($2.06 in chips)
Seat 2: msmbenz9900 ($1.51 in chips)
Seat 3: ketomaldonado ($2.55 in chips)
Seat 4: killervzla28 ($2.26 in chips)
Seat 5: falcao25 ($2.13 in chips)
Seat 6: azall ($2.45 in chips)
killervzla28: posts small blind $0.01
falcao25: posts big blind $0.02
msmbenz9900: posts big blind $0.02
*** HOLE CARDS ***
azall: folds
Vlao: folds
msmbenz9900: checks
ketomaldonado: raises $0.08 to $0.10
killervzla28: folds
falcao25: folds
msmbenz9900: folds
Uncalled bet ($0.08) returned to ketomaldonado
ketomaldonado collected $0.07 from pot
*** SUMMARY ***
Total pot $0.07 | Rake $0
Seat 1: Vlao folded before Flop (didn't bet)
Seat 2: msmbenz9900 folded before Flop (didn't bet)
Seat 3: ketomaldonado (button) collected ($0.07)
Seat 4: killervzla28 (small blind) folded before Flop
Seat 5: falcao25 (big blind) folded before Flop
Seat 6: azall folded before Flop (didn't bet)


PokerStars Hand #238161974749:  Hold'em No Limit ($0.01/$0.02 USD) - 2022/08/23 1:47:34 ET
Table 'Achilles IV' 6-max Seat #4 is the button
Seat 1: Vlao ($2.06 in chips)
Seat 2: msmbenz9900 ($1.49 in chips)
Seat 3: ketomaldonado ($2.60 in chips)
Seat 4: killervzla28 ($2.25 in chips)
Seat 5: falcao25 ($2.11 in chips)
Seat 6: azall ($2.45 in chips)
falcao25: posts small blind $0.01
azall: posts big blind $0.02
*** HOLE CARDS ***
Vlao: folds
msmbenz9900: calls $0.02
ketomaldonado: folds
killervzla28: folds
killervzla28 was removed from the table for failing to post
killervzla28 leaves the table
Overdiewings joins the table at seat #4
falcao25: folds
Overdiewings leaves the table
azall: checks
*** FLOP *** [7c Js Jd]
azall: checks
msmbenz9900: checks
*** TURN *** [7c Js Jd] [2s]
azall: checks
msmbenz9900: checks
*** RIVER *** [7c Js Jd 2s] [9c]
azall: checks
msmbenz9900: checks
*** SHOW DOWN ***
azall: shows [5c Qc] (a pair of Jacks)
msmbenz9900: mucks hand
azall collected $0.05 from pot
*** SUMMARY ***
Total pot $0.05 | Rake $0
Board [7c Js Jd 2s 9c]
Seat 1: Vlao folded before Flop (didn't bet)
Seat 2: msmbenz9900 mucked
Seat 3: ketomaldonado folded before Flop (didn't bet)
Seat 4: killervzla28 (button) folded before Flop (didn't bet)
Seat 5: falcao25 (small blind) folded before Flop
Seat 6: azall (big blind) showed [5c Qc] and won ($0.05) with a pair of Jacks


PokerStars Hand #238161978426:  Hold'em No Limit ($0.01/$0.02 USD) - 2022/08/23 1:48:10 ET
Table 'Achilles IV' 6-max Seat #5 is the button
Seat 1: Vlao ($2.06 in chips)
Seat 2: msmbenz9900 ($1.47 in chips)
Seat 3: ketomaldonado ($2.60 in chips)
Seat 5: falcao25 ($2.10 in chips)
Seat 6: azall ($2.48 in chips)
azall: posts small blind $0.01
Vlao: posts big blind $0.02
*** HOLE CARDS ***
msmbenz9900: folds
ketomaldonado: folds
falcao25: folds
azall: folds
Uncalled bet ($0.01) returned to Vlao
Vlao collected $0.02 from pot
*** SUMMARY ***
Total pot $0.02 | Rake $0
Seat 1: Vlao (big blind) collected ($0.02)
Seat 2: msmbenz9900 folded before Flop (didn't bet)
Seat 3: ketomaldonado folded before Flop (didn't bet)
Seat 5: falcao25 (button) folded before Flop (didn't bet)
Seat 6: azall (small blind) folded before Flop


PokerStars Hand #238161979988:  Hold'em No Limit ($0.01/$0.02 USD) - 2022/08/23 1:48:25 ET
Table 'Achilles IV' 6-max Seat #6 is the button
Seat 1: Vlao ($2.07 in chips)
Seat 2: msmbenz9900 ($1.47 in chips)
Seat 3: ketomaldonado ($2.60 in chips)
Seat 5: falcao25 ($2.10 in chips)
Seat 6: azall ($2.47 in chips)
Vlao: posts small blind $0.01
msmbenz9900: posts big blind $0.02
*** HOLE CARDS ***
ketomaldonado: folds
falcao25: folds
azall: folds
Vlao: raises $0.03 to $0.05
msmbenz9900: calls $0.03
*** FLOP *** [Kh 7c 2s]
Vlao: bets $0.07
msmbenz9900: calls $0.07
*** TURN *** [Kh 7c 2s] [Qh]
Vlao: bets $0.15
msmbenz9900: calls $0.15
*** RIVER *** [Kh 7c 2s Qh] [6s]
Vlao: checks
msmbenz9900: checks
*** SHOW DOWN ***
Vlao: shows [Ah Kc] (a pair of Kings)
msmbenz9900: mucks hand
Vlao collected $0.52 from pot
*** SUMMARY ***
Total pot $0.54 | Rake $0.02
Board [Kh 7c 2s Qh 6s]
Seat 1: Vlao (small blind) showed [Ah Kc] and won ($0.52) with a pair of Kings
Seat 2: msmbenz9900 (big blind) mucked
Seat 3: ketomaldonado folded before Flop (didn't bet)
Seat 5: falcao25 folded before Flop (didn't bet)
Seat 6: azall (button) folded before Flop (didn't bet)


PokerStars Hand #238161983494:  Hold'em No Limit ($0.01/$0.02 USD) - 2022/08/23 1:49:00 ET
Table 'Achilles IV' 6-max Seat #1 is the button
Seat 1: Vlao ($2.32 in chips)
Seat 2: msmbenz9900 ($1.20 in chips)
Seat 3: ketomaldonado ($2.60 in chips)
Seat 5: falcao25 ($2.10 in chips)
Seat 6: azall ($2.47 in chips)
msmbenz9900: posts small blind $0.01
ketomaldonado: posts big blind $0.02
*** HOLE CARDS ***
falcao25: folds
azall: folds
Vlao: raises $0.03 to $0.05
msmbenz9900: folds
ketomaldonado: folds
Uncalled bet ($0.03) returned to Vlao
Vlao collected $0.05 from pot
*** SUMMARY ***
Total pot $0.05 | Rake $0
Seat 1: Vlao (button) collected ($0.05)
Seat 2: msmbenz9900 (small blind) folded before Flop
Seat 3: ketomaldonado (big blind) folded before Flop
Seat 5: falcao25 folded before Flop (didn't bet)
Seat 6: azall folded before Flop (didn't bet)


PokerStars Hand #238161985728:  Hold'em No Limit ($0.01/$0.02 USD) - 2022/08/23 1:49:21 ET
Table 'Achilles IV' 6-max Seat #2 is the button
Seat 1: Vlao ($2.35 in chips)
Seat 2: msmbenz9900 ($1.19 in chips)
Seat 3: ketomaldonado ($2.58 in chips)
Seat 5: falcao25 ($2.10 in chips)
Seat 6: azall ($2.47 in chips)
ketomaldonado: posts small blind $0.01
falcao25: posts big blind $0.02
*** HOLE CARDS ***
azall: folds
Sabaka777 joins the table at seat #4
Vlao: raises $0.03 to $0.05
msmbenz9900: calls $0.05
ketomaldonado: folds
falcao25: folds
*** FLOP *** [9s Qh 6c]
Vlao: bets $0.10
msmbenz9900: folds
Uncalled bet ($0.10) returned to Vlao
Vlao collected $0.13 from pot
*** SUMMARY ***
Total pot $0.13 | Rake $0
Board [9s Qh 6c]
Seat 1: Vlao collected ($0.13)
Seat 2: msmbenz9900 (button) folded on the Flop
Seat 3: ketomaldonado (small blind) folded before Flop
Seat 5: falcao25 (big blind) folded before Flop
Seat 6: azall folded before Flop (didn't bet)


PokerStars Hand #238161990710:  Hold'em No Limit ($0.01/$0.02 USD) - 2022/08/23 1:50:10 ET
Table 'Achilles IV' 6-max Seat #5 is the button
Seat 2: msmbenz9900 ($1.14 in chips)
Seat 3: ketomaldonado ($2.60 in chips)
Seat 5: falcao25 ($2.07 in chips)
Seat 6: azall ($2.45 in chips)
azall: posts small blind $0.01
msmbenz9900: posts big blind $0.02
Sabaka777: sits out
*** HOLE CARDS ***
ketomaldonado: folds
falcao25: folds
ketomaldonado leaves the table
azall: raises $0.04 to $0.06
msmbenz9900: folds
Uncalled bet ($0.04) returned to azall
azall collected $0.04 from pot
*** SUMMARY ***
Total pot $0.04 | Rake $0
Seat 2: msmbenz9900 (big blind) folded before Flop
Seat 3: ketomaldonado folded before Flop (didn't bet)
Seat 5: falcao25 (button) folded before Flop (didn't bet)
Seat 6: azall (small blind) collected ($0.04)


PokerStars Hand #238161988522:  Hold'em No Limit ($0.01/$0.02 USD) - 2022/08/23 1:49:48 ET
Table 'Achilles IV' 6-max Seat #3 is the button
Seat 1: Vlao ($2.43 in chips)
Seat 2: msmbenz9900 ($1.14 in chips)
Seat 3: ketomaldonado ($2.57 in chips)
Seat 5: falcao25 ($2.08 in chips)
Seat 6: azall ($2.47 in chips)
falcao25: posts small blind $0.01
azall: posts big blind $0.02
*** HOLE CARDS ***
Vlao: folds
msmbenz9900: folds
ketomaldonado: raises $0.03 to $0.05
falcao25: folds
azall: folds
Uncalled bet ($0.03) returned to ketomaldonado
ketomaldonado collected $0.05 from pot
*** SUMMARY ***
Total pot $0.05 | Rake $0
Seat 1: Vlao folded before Flop (didn't bet)
Seat 2: msmbenz9900 folded before Flop (didn't bet)
Seat 3: ketomaldonado (button) collected ($0.05)
Seat 5: falcao25 (small blind) folded before Flop
Seat 6: azall (big blind) folded before Flop


PokerStars Hand #238161992403:  Hold'em No Limit ($0.01/$0.02 USD) - 2022/08/23 1:50:26 ET
Table 'Achilles IV' 6-max Seat #6 is the button
Seat 2: msmbenz9900 ($1.12 in chips)
Seat 4: Sabaka777 ($2 in chips)
Seat 5: falcao25 ($2.07 in chips)
Seat 6: azall ($2.47 in chips)
msmbenz9900: posts small blind $0.01
Sabaka777: posts big blind $0.02
*** HOLE CARDS ***
falcao25: folds
d1ablo84 joins the table at seat #3
azall: raises $0.04 to $0.06
msmbenz9900: folds
Sabaka777: folds
Uncalled bet ($0.04) returned to azall
azall collected $0.05 from pot
*** SUMMARY ***
Total pot $0.05 | Rake $0
Seat 2: msmbenz9900 (small blind) folded before Flop
Seat 4: Sabaka777 (big blind) folded before Flop
Seat 5: falcao25 folded before Flop (didn't bet)
Seat 6: azall (button) collected ($0.05)


PokerStars Hand #238162000995:  Hold'em No Limit ($0.01/$0.02 USD) - 2022/08/23 1:50:40 ET
Table 'Achilles IV' 6-max Seat #2 is the button
Seat 2: msmbenz9900 ($1.11 in chips)
Seat 4: Sabaka777 ($1.98 in chips)
Seat 5: falcao25 ($2.07 in chips)
Seat 6: azall ($2.50 in chips)
Sabaka777: posts small blind $0.01
falcao25: posts big blind $0.02
*** HOLE CARDS ***
azall: folds
msmbenz9900: raises $0.02 to $0.04
Sabaka777: folds
falcao25: folds
Uncalled bet ($0.02) returned to msmbenz9900
msmbenz9900 collected $0.05 from pot
*** SUMMARY ***
Total pot $0.05 | Rake $0
Seat 2: msmbenz9900 (button) collected ($0.05)
Seat 4: Sabaka777 (small blind) folded before Flop
Seat 5: falcao25 (big blind) folded before Flop
Seat 6: azall folded before Flop (didn't bet)


PokerStars Hand #238162002517:  Hold'em No Limit ($0.01/$0.02 USD) - 2022/08/23 1:50:54 ET
Table 'Achilles IV' 6-max Seat #4 is the button
Seat 2: msmbenz9900 ($1.14 in chips)
Seat 4: Sabaka777 ($1.97 in chips)
Seat 5: falcao25 ($2.05 in chips)
Seat 6: azall ($2.50 in chips)
falcao25: posts small blind $0.01
azall: posts big blind $0.02
d1ablo84: sits out
*** HOLE CARDS ***
msmbenz9900: calls $0.02
Sabaka777: raises $0.02 to $0.04
falcao25: folds
azall: folds
msmbenz9900: calls $0.02
*** FLOP *** [2h Js 5s]
msmbenz9900: bets $0.02
Sabaka777: calls $0.02
*** TURN *** [2h Js 5s] [6s]
msmbenz9900: bets $0.02
Sabaka777: raises $0.04 to $0.06
msmbenz9900: calls $0.04
*** RIVER *** [2h Js 5s 6s] [9h]
msmbenz9900: checks
Sabaka777: bets $0.08
msmbenz9900: calls $0.08
*** SHOW DOWN ***
Sabaka777: shows [As 2s] (a flush, Ace high)
msmbenz9900: mucks hand
Sabaka777 collected $0.41 from pot
*** SUMMARY ***
Total pot $0.43 | Rake $0.02
Board [2h Js 5s 6s 9h]
Seat 2: msmbenz9900 mucked
Seat 4: Sabaka777 (button) showed [As 2s] and won ($0.41) with a flush, Ace high
Seat 5: falcao25 (small blind) folded before Flop
Seat 6: azall (big blind) folded before Flop


PokerStars Hand #238162007102:  Hold'em No Limit ($0.01/$0.02 USD) - 2022/08/23 1:51:39 ET
Table 'Achilles IV' 6-max Seat #5 is the button
Seat 2: msmbenz9900 ($0.94 in chips)
Seat 4: Sabaka777 ($2.18 in chips)
Seat 5: falcao25 ($2.04 in chips)
Seat 6: azall ($2.48 in chips)
azall: posts small blind $0.01
msmbenz9900: posts big blind $0.02
d1ablo84: sits out
*** HOLE CARDS ***
Sabaka777: folds
falcao25: folds
azall: raises $0.04 to $0.06
msmbenz9900: raises $0.04 to $0.10
azall: folds
Uncalled bet ($0.04) returned to msmbenz9900
msmbenz9900 collected $0.12 from pot
*** SUMMARY ***
Total pot $0.12 | Rake $0
Seat 2: msmbenz9900 (big blind) collected ($0.12)
Seat 4: Sabaka777 folded before Flop (didn't bet)
Seat 5: falcao25 (button) folded before Flop (didn't bet)
Seat 6: azall (small blind) folded before Flop


PokerStars Hand #238162008891:  Hold'em No Limit ($0.01/$0.02 USD) - 2022/08/23 1:51:56 ET
Table 'Achilles IV' 6-max Seat #6 is the button
Seat 2: msmbenz9900 ($1 in chips)
Seat 3: d1ablo84 ($2 in chips)
Seat 4: Sabaka777 ($2.18 in chips)
Seat 5: falcao25 ($2.04 in chips)
Seat 6: azall ($2.42 in chips)
msmbenz9900: posts small blind $0.01
d1ablo84: posts big blind $0.02
*** HOLE CARDS ***
Sabaka777: folds
falcao25: folds
azall: folds
msmbenz9900: folds
Uncalled bet ($0.01) returned to d1ablo84
d1ablo84 collected $0.02 from pot
d1ablo84: doesn't show hand
*** SUMMARY ***
Total pot $0.02 | Rake $0
Seat 2: msmbenz9900 (small blind) folded before Flop
Seat 3: d1ablo84 (big blind) collected ($0.02)
Seat 4: Sabaka777 folded before Flop (didn't bet)
Seat 5: falcao25 folded before Flop (didn't bet)
Seat 6: azall (button) folded before Flop (didn't bet)


PokerStars Hand #238162009920:  Hold'em No Limit ($0.01/$0.02 USD) - 2022/08/23 1:52:05 ET
Table 'Achilles IV' 6-max Seat #2 is the button
Seat 2: msmbenz9900 ($0.99 in chips)
Seat 3: d1ablo84 ($2.01 in chips)
Seat 4: Sabaka777 ($2.18 in chips)
Seat 5: falcao25 ($2.04 in chips)
Seat 6: azall ($2.42 in chips)
d1ablo84: posts small blind $0.01
Sabaka777: posts big blind $0.02
*** HOLE CARDS ***
falcao25: raises $0.04 to $0.06
azall: folds
msmbenz9900: folds
d1ablo84: folds
Sabaka777: folds
Uncalled bet ($0.04) returned to falcao25
falcao25 collected $0.05 from pot
*** SUMMARY ***
Total pot $0.05 | Rake $0
Seat 2: msmbenz9900 (button) folded before Flop (didn't bet)
Seat 3: d1ablo84 (small blind) folded before Flop
Seat 4: Sabaka777 (big blind) folded before Flop
Seat 5: falcao25 collected ($0.05)
Seat 6: azall folded before Flop (didn't bet)


PokerStars Hand #238162011495:  Hold'em No Limit ($0.01/$0.02 USD) - 2022/08/23 1:52:20 ET
Table 'Achilles IV' 6-max Seat #3 is the button
Seat 2: msmbenz9900 ($0.99 in chips)
Seat 3: d1ablo84 ($2 in chips)
Seat 4: Sabaka777 ($2.16 in chips)
Seat 5: falcao25 ($2.07 in chips)
Seat 6: azall ($2.42 in chips)
Sabaka777: posts small blind $0.01
falcao25: posts big blind $0.02
*** HOLE CARDS ***
azall: folds
msmbenz9900: calls $0.02
d1ablo84: folds
Sabaka777: folds
falcao25: checks
*** FLOP *** [As Ks 6h]
falcao25: checks
msmbenz9900: bets $0.02
falcao25: folds
Uncalled bet ($0.02) returned to msmbenz9900
msmbenz9900 collected $0.05 from pot
*** SUMMARY ***
Total pot $0.05 | Rake $0
Board [As Ks 6h]
Seat 2: msmbenz9900 collected ($0.05)
Seat 3: d1ablo84 (button) folded before Flop (didn't bet)
Seat 4: Sabaka777 (small blind) folded before Flop
Seat 5: falcao25 (big blind) folded on the Flop
Seat 6: azall folded before Flop (didn't bet)


PokerStars Hand #238162013669:  Hold'em No Limit ($0.01/$0.02 USD) - 2022/08/23 1:52:41 ET
Table 'Achilles IV' 6-max Seat #4 is the button
Seat 2: msmbenz9900 ($1.02 in chips)
Seat 3: d1ablo84 ($2 in chips)
Seat 4: Sabaka777 ($2.15 in chips)
Seat 5: falcao25 ($2.05 in chips)
Seat 6: azall ($2.42 in chips)
falcao25: posts small blind $0.01
azall: posts big blind $0.02
*** HOLE CARDS ***
msmbenz9900: folds
d1ablo84: folds
Sabaka777: folds
falcao25: raises $0.04 to $0.06
azall: folds
Uncalled bet ($0.04) returned to falcao25
falcao25 collected $0.04 from pot
*** SUMMARY ***
Total pot $0.04 | Rake $0
Seat 2: msmbenz9900 folded before Flop (didn't bet)
Seat 3: d1ablo84 folded before Flop (didn't bet)
Seat 4: Sabaka777 (button) folded before Flop (didn't bet)
Seat 5: falcao25 (small blind) collected ($0.04)
Seat 6: azall (big blind) folded before Flop


PokerStars Hand #238162018335:  Hold'em No Limit ($0.01/$0.02 USD) - 2022/08/23 1:53:26 ET
Table 'Achilles IV' 6-max Seat #6 is the button
Seat 2: msmbenz9900 ($1 in chips)
Seat 3: d1ablo84 ($2 in chips)
Seat 4: Sabaka777 ($2.18 in chips)
Seat 5: falcao25 ($2.07 in chips)
Seat 6: azall ($2.39 in chips)
msmbenz9900: posts small blind $0.01
d1ablo84: posts big blind $0.02
*** HOLE CARDS ***
Sabaka777: folds
falcao25: folds
azall: folds
msmbenz9900: folds
Uncalled bet ($0.01) returned to d1ablo84
d1ablo84 collected $0.02 from pot
d1ablo84: doesn't show hand
*** SUMMARY ***
Total pot $0.02 | Rake $0
Seat 2: msmbenz9900 (small blind) folded before Flop
Seat 3: d1ablo84 (big blind) collected ($0.02)
Seat 4: Sabaka777 folded before Flop (didn't bet)
Seat 5: falcao25 folded before Flop (didn't bet)
Seat 6: azall (button) folded before Flop (didn't bet)


PokerStars Hand #238162017097:  Hold'em No Limit ($0.01/$0.02 USD) - 2022/08/23 1:53:14 ET
Table 'Achilles IV' 6-max Seat #5 is the button
Seat 2: msmbenz9900 ($1.02 in chips)
Seat 3: d1ablo84 ($2 in chips)
Seat 4: Sabaka777 ($2.15 in chips)
Seat 5: falcao25 ($2.07 in chips)
Seat 6: azall ($2.40 in chips)
azall: posts small blind $0.01
msmbenz9900: posts big blind $0.02
*** HOLE CARDS ***
d1ablo84: folds
Sabaka777: raises $0.02 to $0.04
falcao25: folds
azall: folds
msmbenz9900: folds
Uncalled bet ($0.02) returned to Sabaka777
Sabaka777 collected $0.05 from pot
Sabaka777: doesn't show hand
*** SUMMARY ***
Total pot $0.05 | Rake $0
Seat 2: msmbenz9900 (big blind) folded before Flop
Seat 3: d1ablo84 folded before Flop (didn't bet)
Seat 4: Sabaka777 collected ($0.05)
Seat 5: falcao25 (button) folded before Flop (didn't bet)
Seat 6: azall (small blind) folded before Flop


PokerStars Hand #238162019354:  Hold'em No Limit ($0.01/$0.02 USD) - 2022/08/23 1:53:36 ET
Table 'Achilles IV' 6-max Seat #2 is the button
Seat 2: msmbenz9900 ($0.99 in chips)
Seat 3: d1ablo84 ($2.01 in chips)
Seat 4: Sabaka777 ($2.18 in chips)
Seat 5: falcao25 ($2.07 in chips)
Seat 6: azall ($2.39 in chips)
d1ablo84: posts small blind $0.01
Sabaka777: posts big blind $0.02
Vlao: sits out
*** HOLE CARDS ***
falcao25: folds
azall: folds
msmbenz9900: calls $0.02
d1ablo84: folds
Sabaka777: checks
*** FLOP *** [As Qs 7d]
Sabaka777: checks
msmbenz9900: bets $0.02
Sabaka777: folds
Uncalled bet ($0.02) returned to msmbenz9900
msmbenz9900 collected $0.05 from pot
*** SUMMARY ***
Total pot $0.05 | Rake $0
Board [As Qs 7d]
Seat 2: msmbenz9900 (button) collected ($0.05)
Seat 3: d1ablo84 (small blind) folded before Flop
Seat 4: Sabaka777 (big blind) folded on the Flop
Seat 5: falcao25 folded before Flop (didn't bet)
Seat 6: azall folded before Flop (didn't bet)


PokerStars Hand #238162022093:  Hold'em No Limit ($0.01/$0.02 USD) - 2022/08/23 1:54:02 ET
Table 'Achilles IV' 6-max Seat #3 is the button
Seat 2: msmbenz9900 ($1.02 in chips)
Seat 3: d1ablo84 ($2 in chips)
Seat 4: Sabaka777 ($2.16 in chips)
Seat 5: falcao25 ($2.07 in chips)
Seat 6: azall ($2.39 in chips)
Sabaka777: posts small blind $0.01
falcao25: posts big blind $0.02
Vlao: sits out
*** HOLE CARDS ***
azall: folds
msmbenz9900: folds
d1ablo84: raises $0.03 to $0.05
Sabaka777: folds
falcao25: folds
Uncalled bet ($0.03) returned to d1ablo84
d1ablo84 collected $0.05 from pot
d1ablo84: doesn't show hand
*** SUMMARY ***
Total pot $0.05 | Rake $0
Seat 2: msmbenz9900 folded before Flop (didn't bet)
Seat 3: d1ablo84 (button) collected ($0.05)
Seat 4: Sabaka777 (small blind) folded before Flop
Seat 5: falcao25 (big blind) folded before Flop
Seat 6: azall folded before Flop (didn't bet)


PokerStars Hand #238162023350:  Hold'em No Limit ($0.01/$0.02 USD) - 2022/08/23 1:54:14 ET
Table 'Achilles IV' 6-max Seat #4 is the button
Seat 1: Vlao ($2.43 in chips)
Seat 2: msmbenz9900 ($1.02 in chips)
Seat 3: d1ablo84 ($2.03 in chips)
Seat 4: Sabaka777 ($2.15 in chips)
Seat 5: falcao25 ($2.05 in chips)
falcao25: posts small blind $0.01
azall: is sitting out
Vlao: posts big blind $0.02
*** HOLE CARDS ***
msmbenz9900: folds
d1ablo84: raises $0.04 to $0.06
Sabaka777: folds
falcao25: folds
Vlao: folds
Uncalled bet ($0.04) returned to d1ablo84
d1ablo84 collected $0.05 from pot
d1ablo84: doesn't show hand
*** SUMMARY ***
Total pot $0.05 | Rake $0
Seat 1: Vlao (big blind) folded before Flop
Seat 2: msmbenz9900 folded before Flop (didn't bet)
Seat 3: d1ablo84 collected ($0.05)
Seat 4: Sabaka777 (button) folded before Flop (didn't bet)
Seat 5: falcao25 (small blind) folded before Flop


PokerStars Hand #238162025467:  Hold'em No Limit ($0.01/$0.02 USD) - 2022/08/23 1:54:35 ET
Table 'Achilles IV' 6-max Seat #5 is the button
Seat 1: Vlao ($2.41 in chips)
Seat 2: msmbenz9900 ($1.02 in chips)
Seat 3: d1ablo84 ($2.06 in chips)
Seat 4: Sabaka777 ($2.15 in chips)
Seat 5: falcao25 ($2.04 in chips)
Vlao: posts small blind $0.01
msmbenz9900: posts big blind $0.02
*** HOLE CARDS ***
d1ablo84: folds
Sabaka777: folds
falcao25: folds
Vlao: folds
Uncalled bet ($0.01) returned to msmbenz9900
msmbenz9900 collected $0.02 from pot
*** SUMMARY ***
Total pot $0.02 | Rake $0
Seat 1: Vlao (small blind) folded before Flop
Seat 2: msmbenz9900 (big blind) collected ($0.02)
Seat 3: d1ablo84 folded before Flop (didn't bet)
Seat 4: Sabaka777 folded before Flop (didn't bet)
Seat 5: falcao25 (button) folded before Flop (didn't bet)


PokerStars Hand #238162027132:  Hold'em No Limit ($0.01/$0.02 USD) - 2022/08/23 1:54:51 ET
Table 'Achilles IV' 6-max Seat #1 is the button
Seat 1: Vlao ($2.40 in chips)
Seat 2: msmbenz9900 ($1.03 in chips)
Seat 3: d1ablo84 ($2.06 in chips)
Seat 4: Sabaka777 ($2.15 in chips)
Seat 5: falcao25 ($2.04 in chips)
msmbenz9900: posts small blind $0.01
d1ablo84: posts big blind $0.02
*** HOLE CARDS ***
Sabaka777: folds
azall leaves the table
falcao25: folds
Vlao: folds
msmbenz9900: calls $0.01
d1ablo84: checks
*** FLOP *** [3d 6c 4c]
msmbenz9900: checks
d1ablo84: checks
*** TURN *** [3d 6c 4c] [Js]
msmbenz9900: checks
d1ablo84: checks
*** RIVER *** [3d 6c 4c Js] [Jc]
msmbenz9900: checks
d1ablo84: checks
*** SHOW DOWN ***
msmbenz9900: shows [4d 5h] (two pair, Jacks and Fours)
d1ablo84: mucks hand
msmbenz9900 collected $0.04 from pot
*** SUMMARY ***
Total pot $0.04 | Rake $0
Board [3d 6c 4c Js Jc]
Seat 1: Vlao (button) folded before Flop (didn't bet)
Seat 2: msmbenz9900 (small blind) showed [4d 5h] and won ($0.04) with two pair, Jacks and Fours
Seat 3: d1ablo84 (big blind) mucked
Seat 4: Sabaka777 folded before Flop (didn't bet)
Seat 5: falcao25 folded before Flop (didn't bet)


PokerStars Hand #238162030423:  Hold'em No Limit ($0.01/$0.02 USD) - 2022/08/23 1:55:24 ET
Table 'Achilles IV' 6-max Seat #2 is the button
Seat 1: Vlao ($2.40 in chips)
Seat 2: msmbenz9900 ($1.05 in chips)
Seat 3: d1ablo84 ($2.04 in chips)
Seat 4: Sabaka777 ($2.15 in chips)
Seat 5: falcao25 ($2.04 in chips)
d1ablo84: posts small blind $0.01
Sabaka777: posts big blind $0.02
*** HOLE CARDS ***
falcao25: folds
Vlao: folds
msmbenz9900: folds
d1ablo84: folds
Uncalled bet ($0.01) returned to Sabaka777
Sabaka777 collected $0.02 from pot
Sabaka777: doesn't show hand
*** SUMMARY ***
Total pot $0.02 | Rake $0
Seat 1: Vlao folded before Flop (didn't bet)
Seat 2: msmbenz9900 (button) folded before Flop (didn't bet)
Seat 3: d1ablo84 (small blind) folded before Flop
Seat 4: Sabaka777 (big blind) collected ($0.02)
Seat 5: falcao25 folded before Flop (didn't bet)


PokerStars Hand #238162031395:  Hold'em No Limit ($0.01/$0.02 USD) - 2022/08/23 1:55:35 ET
Table 'Achilles IV' 6-max Seat #3 is the button
Seat 1: Vlao ($2.40 in chips)
Seat 2: msmbenz9900 ($1.05 in chips)
Seat 3: d1ablo84 ($2.03 in chips)
Seat 4: Sabaka777 ($2.16 in chips)
Seat 5: falcao25 ($2.04 in chips)
Sabaka777: posts small blind $0.01
falcao25: posts big blind $0.02
*** HOLE CARDS ***
Vlao: folds
msmbenz9900: calls $0.02
d1ablo84: folds
Sabaka777: raises $0.04 to $0.06
falcao25: folds
msmbenz9900: calls $0.04
*** FLOP *** [9c 8s Jd]
Sabaka777: bets $0.04
msmbenz9900: calls $0.04
*** TURN *** [9c 8s Jd] [7h]
florin.cbtr joins the table at seat #6
Sabaka777: bets $0.12
msmbenz9900: calls $0.12
*** RIVER *** [9c 8s Jd 7h] [Qh]
Sabaka777: checks
msmbenz9900: checks
*** SHOW DOWN ***
Sabaka777: shows [Js Ad] (a pair of Jacks)
msmbenz9900: mucks hand
Sabaka777 collected $0.44 from pot
*** SUMMARY ***
Total pot $0.46 | Rake $0.02
Board [9c 8s Jd 7h Qh]
Seat 1: Vlao folded before Flop (didn't bet)
Seat 2: msmbenz9900 mucked
Seat 3: d1ablo84 (button) folded before Flop (didn't bet)
Seat 4: Sabaka777 (small blind) showed [Js Ad] and won ($0.44) with a pair of Jacks
Seat 5: falcao25 (big blind) folded before Flop


PokerStars Hand #238162036093:  Hold'em No Limit ($0.01/$0.02 USD) - 2022/08/23 1:56:26 ET
Table 'Achilles IV' 6-max Seat #4 is the button
Seat 1: Vlao ($2.40 in chips)
Seat 2: msmbenz9900 ($0.83 in chips)
Seat 3: d1ablo84 ($2.03 in chips)
Seat 4: Sabaka777 ($2.38 in chips)
Seat 5: falcao25 ($2.02 in chips)
Seat 6: florin.cbtr ($2 in chips)
falcao25: posts small blind $0.01
florin.cbtr: posts big blind $0.02
*** HOLE CARDS ***
Vlao: folds
msmbenz9900: folds
d1ablo84: raises $0.04 to $0.06
Sabaka777: folds
falcao25: folds
florin.cbtr: calls $0.04
*** FLOP *** [Qs 6d Jc]
florin.cbtr: checks
d1ablo84: bets $0.04
florin.cbtr: calls $0.04
*** TURN *** [Qs 6d Jc] [Qh]
florin.cbtr: checks
d1ablo84: checks
*** RIVER *** [Qs 6d Jc Qh] [2d]
florin.cbtr: bets $0.14
d1ablo84: calls $0.14
*** SHOW DOWN ***
florin.cbtr: shows [9d Ac] (a pair of Queens)
d1ablo84: shows [7d 7s] (two pair, Queens and Sevens)
d1ablo84 collected $0.47 from pot
*** SUMMARY ***
Total pot $0.49 | Rake $0.02
Board [Qs 6d Jc Qh 2d]
Seat 1: Vlao folded before Flop (didn't bet)
Seat 2: msmbenz9900 folded before Flop (didn't bet)
Seat 3: d1ablo84 showed [7d 7s] and won ($0.47) with two pair, Queens and Sevens
Seat 4: Sabaka777 (button) folded before Flop (didn't bet)
Seat 5: falcao25 (small blind) folded before Flop
Seat 6: florin.cbtr (big blind) showed [9d Ac] and lost with a pair of Queens


PokerStars Hand #238162040058:  Hold'em No Limit ($0.01/$0.02 USD) - 2022/08/23 1:57:09 ET
Table 'Achilles IV' 6-max Seat #5 is the button
Seat 1: Vlao ($2.40 in chips)
Seat 2: msmbenz9900 ($0.83 in chips)
Seat 3: d1ablo84 ($2.26 in chips)
Seat 4: Sabaka777 ($2.38 in chips)
Seat 5: falcao25 ($2.01 in chips)
Seat 6: florin.cbtr ($1.76 in chips)
florin.cbtr: posts small blind $0.01
Vlao: posts big blind $0.02
*** HOLE CARDS ***
msmbenz9900: folds
d1ablo84: raises $0.04 to $0.06
Sabaka777: folds
falcao25: folds
florin.cbtr: calls $0.05
Vlao: folds
*** FLOP *** [3s 6s 4h]
florin.cbtr: bets $0.04
d1ablo84: calls $0.04
*** TURN *** [3s 6s 4h] [Kd]
florin.cbtr: bets $0.08
d1ablo84: raises $0.22 to $0.30
florin.cbtr: folds
Uncalled bet ($0.22) returned to d1ablo84
d1ablo84 collected $0.37 from pot
d1ablo84: doesn't show hand
*** SUMMARY ***
Total pot $0.38 | Rake $0.01
Board [3s 6s 4h Kd]
Seat 1: Vlao (big blind) folded before Flop
Seat 2: msmbenz9900 folded before Flop (didn't bet)
Seat 3: d1ablo84 collected ($0.37)
Seat 4: Sabaka777 folded before Flop (didn't bet)
Seat 5: falcao25 (button) folded before Flop (didn't bet)
Seat 6: florin.cbtr (small blind) folded on the Turn


PokerStars Hand #238162045234:  Hold'em No Limit ($0.01/$0.02 USD) - 2022/08/23 1:58:05 ET
Table 'Achilles IV' 6-max Seat #6 is the button
Seat 1: Vlao ($2.38 in chips)
Seat 2: msmbenz9900 ($0.83 in chips)
Seat 3: d1ablo84 ($2.45 in chips)
Seat 4: Sabaka777 ($2.38 in chips)
Seat 5: falcao25 ($2.01 in chips)
Seat 6: florin.cbtr ($1.58 in chips)
Vlao: posts small blind $0.01
msmbenz9900: posts big blind $0.02
*** HOLE CARDS ***
d1ablo84: folds
Sabaka777: folds
falcao25: folds
florin.cbtr: raises $0.04 to $0.06
Vlao: folds
msmbenz9900: calls $0.04
*** FLOP *** [As 2c 7s]
msmbenz9900: checks
florin.cbtr: bets $0.04
msmbenz9900: folds
Uncalled bet ($0.04) returned to florin.cbtr
florin.cbtr collected $0.13 from pot
florin.cbtr: doesn't show hand
*** SUMMARY ***
Total pot $0.13 | Rake $0
Board [As 2c 7s]
Seat 1: Vlao (small blind) folded before Flop
Seat 2: msmbenz9900 (big blind) folded on the Flop
Seat 3: d1ablo84 folded before Flop (didn't bet)
Seat 4: Sabaka777 folded before Flop (didn't bet)
Seat 5: falcao25 folded before Flop (didn't bet)
Seat 6: florin.cbtr (button) collected ($0.13)


PokerStars Hand #238162047915:  Hold'em No Limit ($0.01/$0.02 USD) - 2022/08/23 1:58:34 ET
Table 'Achilles IV' 6-max Seat #1 is the button
Seat 1: Vlao ($2.37 in chips)
Seat 2: msmbenz9900 ($0.77 in chips)
Seat 3: d1ablo84 ($2.45 in chips)
Seat 4: Sabaka777 ($2.38 in chips)
Seat 5: falcao25 ($2.01 in chips)
Seat 6: florin.cbtr ($1.65 in chips)
msmbenz9900: posts small blind $0.01
d1ablo84: posts big blind $0.02
*** HOLE CARDS ***
Sabaka777: raises $0.04 to $0.06
falcao25: folds
florin.cbtr: folds
Vlao: folds
msmbenz9900: raises $0.71 to $0.77 and is all-in
d1ablo84: folds
Sabaka777: calls $0.71
*** FLOP *** [4s Td 6c]
*** TURN *** [4s Td 6c] [8c]
*** RIVER *** [4s Td 6c 8c] [4h]
*** SHOW DOWN ***
msmbenz9900: shows [5c As] (a pair of Fours)
Sabaka777: shows [Tc 9c] (two pair, Tens and Fours)
Sabaka777 collected $1.51 from pot
*** SUMMARY ***
Total pot $1.56 | Rake $0.05
Board [4s Td 6c 8c 4h]
Seat 1: Vlao (button) folded before Flop (didn't bet)
Seat 2: msmbenz9900 (small blind) showed [5c As] and lost with a pair of Fours
Seat 3: d1ablo84 (big blind) folded before Flop
Seat 4: Sabaka777 showed [Tc 9c] and won ($1.51) with two pair, Tens and Fours
Seat 5: falcao25 folded before Flop (didn't bet)
Seat 6: florin.cbtr folded before Flop (didn't bet)


PokerStars Hand #238162050973:  Hold'em No Limit ($0.01/$0.02 USD) - 2022/08/23 1:59:07 ET
Table 'Achilles IV' 6-max Seat #3 is the button
Seat 1: Vlao ($2.37 in chips)
Seat 3: d1ablo84 ($2.43 in chips)
Seat 4: Sabaka777 ($3.12 in chips)
Seat 5: falcao25 ($2.01 in chips)
Seat 6: florin.cbtr ($1.65 in chips)
Sabaka777: posts small blind $0.01
falcao25: posts big blind $0.02
*** HOLE CARDS ***
florin.cbtr: folds
msmbenz9900 is disconnected
Vlao: folds
d1ablo84: folds
Sabaka777: folds
Uncalled bet ($0.01) returned to falcao25
falcao25 collected $0.02 from pot
*** SUMMARY ***
Total pot $0.02 | Rake $0
Seat 1: Vlao folded before Flop (didn't bet)
Seat 3: d1ablo84 (button) folded before Flop (didn't bet)
Seat 4: Sabaka777 (small blind) folded before Flop
Seat 5: falcao25 (big blind) collected ($0.02)
Seat 6: florin.cbtr folded before Flop (didn't bet)


PokerStars Hand #238162052333:  Hold'em No Limit ($0.01/$0.02 USD) - 2022/08/23 1:59:21 ET
Table 'Achilles IV' 6-max Seat #4 is the button
Seat 1: Vlao ($2.37 in chips)
Seat 3: d1ablo84 ($2.43 in chips)
Seat 4: Sabaka777 ($3.11 in chips)
Seat 5: falcao25 ($2.02 in chips)
Seat 6: florin.cbtr ($1.65 in chips)
falcao25: posts small blind $0.01
florin.cbtr: posts big blind $0.02
*** HOLE CARDS ***
Vlao: folds
d1ablo84: raises $0.04 to $0.06
Sabaka777: folds
falcao25: folds
florin.cbtr: calls $0.04
*** FLOP *** [4h 6h Qc]
florin.cbtr: checks
d1ablo84: checks
*** TURN *** [4h 6h Qc] [9h]
florin.cbtr: bets $0.04
d1ablo84: calls $0.04
*** RIVER *** [4h 6h Qc 9h] [2d]
florin.cbtr: bets $0.10
d1ablo84: calls $0.10
*** SHOW DOWN ***
florin.cbtr: shows [Ts 5s] (high card Queen)
d1ablo84: shows [8c 8h] (a pair of Eights)
d1ablo84 collected $0.40 from pot
*** SUMMARY ***
Total pot $0.41 | Rake $0.01
Board [4h 6h Qc 9h 2d]
Seat 1: Vlao folded before Flop (didn't bet)
Seat 3: d1ablo84 showed [8c 8h] and won ($0.40) with a pair of Eights
Seat 4: Sabaka777 (button) folded before Flop (didn't bet)
Seat 5: falcao25 (small blind) folded before Flop
Seat 6: florin.cbtr (big blind) showed [Ts 5s] and lost with high card Queen


PokerStars Hand #238162060505:  Hold'em No Limit ($0.01/$0.02 USD) - 2022/08/23 2:00:46 ET
Table 'Achilles IV' 6-max Seat #5 is the button
Seat 1: Vlao ($2.37 in chips)
Seat 3: d1ablo84 ($2.63 in chips)
Seat 4: Sabaka777 ($3.11 in chips)
Seat 5: falcao25 ($2.01 in chips)
Seat 6: florin.cbtr ($1.45 in chips)
florin.cbtr: posts small blind $0.01
Vlao: posts big blind $0.02
*** HOLE CARDS ***
d1ablo84: folds
Sabaka777: raises $0.04 to $0.06
falcao25: folds
florin.cbtr: folds
Vlao: folds
Uncalled bet ($0.04) returned to Sabaka777
Sabaka777 collected $0.05 from pot
Sabaka777: doesn't show hand
*** SUMMARY ***
Total pot $0.05 | Rake $0
Seat 1: Vlao (big blind) folded before Flop
Seat 3: d1ablo84 folded before Flop (didn't bet)
Seat 4: Sabaka777 collected ($0.05)
Seat 5: falcao25 (button) folded before Flop (didn't bet)
Seat 6: florin.cbtr (small blind) folded before Flop


PokerStars Hand #238162061880:  Hold'em No Limit ($0.01/$0.02 USD) - 2022/08/23 2:01:00 ET
Table 'Achilles IV' 6-max Seat #6 is the button
Seat 1: Vlao ($2.35 in chips)
Seat 3: d1ablo84 ($2.63 in chips)
Seat 4: Sabaka777 ($3.14 in chips)
Seat 5: falcao25 ($2.01 in chips)
Seat 6: florin.cbtr ($1.44 in chips)
Vlao: posts small blind $0.01
d1ablo84: posts big blind $0.02
*** HOLE CARDS ***
Sabaka777: raises $0.02 to $0.04
falcao25: folds
florin.cbtr: raises $0.02 to $0.06
Vlao: folds
d1ablo84: folds
Sabaka777: calls $0.02
*** FLOP *** [Ad 2c 7s]
Sabaka777: checks
florin.cbtr: bets $0.07
Sabaka777: calls $0.07
*** TURN *** [Ad 2c 7s] [6d]
Sabaka777: bets $0.14
florin.cbtr: folds
Uncalled bet ($0.14) returned to Sabaka777
Sabaka777 collected $0.28 from pot
Sabaka777: doesn't show hand
*** SUMMARY ***
Total pot $0.29 | Rake $0.01
Board [Ad 2c 7s 6d]
Seat 1: Vlao (small blind) folded before Flop
Seat 3: d1ablo84 (big blind) folded before Flop
Seat 4: Sabaka777 collected ($0.28)
Seat 5: falcao25 folded before Flop (didn't bet)
Seat 6: florin.cbtr (button) folded on the Turn


PokerStars Hand #238162065364:  Hold'em No Limit ($0.01/$0.02 USD) - 2022/08/23 2:01:33 ET
Table 'Achilles IV' 6-max Seat #1 is the button
Seat 1: Vlao ($2.34 in chips)
Seat 3: d1ablo84 ($2.61 in chips)
Seat 4: Sabaka777 ($3.29 in chips)
Seat 5: falcao25 ($2.01 in chips)
Seat 6: florin.cbtr ($1.31 in chips)
d1ablo84: posts small blind $0.01
Sabaka777: posts big blind $0.02
*** HOLE CARDS ***
falcao25: raises $0.04 to $0.06
florin.cbtr: raises $0.12 to $0.18
Vlao: folds
d1ablo84: folds
Sabaka777: folds
falcao25: folds
Uncalled bet ($0.12) returned to florin.cbtr
florin.cbtr collected $0.15 from pot
florin.cbtr: doesn't show hand
*** SUMMARY ***
Total pot $0.15 | Rake $0
Seat 1: Vlao (button) folded before Flop (didn't bet)
Seat 3: d1ablo84 (small blind) folded before Flop
Seat 4: Sabaka777 (big blind) folded before Flop
Seat 5: falcao25 folded before Flop
Seat 6: florin.cbtr collected ($0.15)


PokerStars Hand #238162067352:  Hold'em No Limit ($0.01/$0.02 USD) - 2022/08/23 2:01:52 ET
Table 'Achilles IV' 6-max Seat #3 is the button
Seat 1: Vlao ($2.34 in chips)
Seat 3: d1ablo84 ($2.60 in chips)
Seat 4: Sabaka777 ($3.27 in chips)
Seat 5: falcao25 ($2 in chips)
Seat 6: florin.cbtr ($1.40 in chips)
Sabaka777: posts small blind $0.01
falcao25: posts big blind $0.02
*** HOLE CARDS ***
florin.cbtr: folds
Vlao: folds
d1ablo84: raises $0.03 to $0.05
Sabaka777: folds
falcao25: folds
Uncalled bet ($0.03) returned to d1ablo84
d1ablo84 collected $0.05 from pot
d1ablo84: doesn't show hand
*** SUMMARY ***
Total pot $0.05 | Rake $0
Seat 1: Vlao folded before Flop (didn't bet)
Seat 3: d1ablo84 (button) collected ($0.05)
Seat 4: Sabaka777 (small blind) folded before Flop
Seat 5: falcao25 (big blind) folded before Flop
Seat 6: florin.cbtr folded before Flop (didn't bet)


PokerStars Hand #238162069579:  Hold'em No Limit ($0.01/$0.02 USD) - 2022/08/23 2:02:13 ET
Table 'Achilles IV' 6-max Seat #4 is the button
Seat 1: Vlao ($2.34 in chips)
Seat 3: d1ablo84 ($2.63 in chips)
Seat 4: Sabaka777 ($3.26 in chips)
Seat 5: falcao25 ($2 in chips)
Seat 6: florin.cbtr ($1.40 in chips)
falcao25: posts small blind $0.01
florin.cbtr: posts big blind $0.02
*** HOLE CARDS ***
Vlao: folds
d1ablo84: folds
Sabaka777: folds
falcao25: folds
Uncalled bet ($0.01) returned to florin.cbtr
florin.cbtr collected $0.02 from pot
florin.cbtr: doesn't show hand
*** SUMMARY ***
Total pot $0.02 | Rake $0
Seat 1: Vlao folded before Flop (didn't bet)
Seat 3: d1ablo84 folded before Flop (didn't bet)
Seat 4: Sabaka777 (button) folded before Flop (didn't bet)
Seat 5: falcao25 (small blind) folded before Flop
Seat 6: florin.cbtr (big blind) collected ($0.02)


PokerStars Hand #238162071269:  Hold'em No Limit ($0.01/$0.02 USD) - 2022/08/23 2:02:30 ET
Table 'Achilles IV' 6-max Seat #5 is the button
Seat 1: Vlao ($2.34 in chips)
Seat 3: d1ablo84 ($2.63 in chips)
Seat 4: Sabaka777 ($3.26 in chips)
Seat 5: falcao25 ($2 in chips)
Seat 6: florin.cbtr ($1.41 in chips)
florin.cbtr: posts small blind $0.01
Vlao: posts big blind $0.02
*** HOLE CARDS ***
d1ablo84: folds
Sabaka777: raises $0.04 to $0.06
falcao25: folds
florin.cbtr: folds
Vlao: calls $0.04
*** FLOP *** [5h 2d 7h]
Vlao: checks
Sabaka777: bets $0.06
Vlao: raises $0.17 to $0.23
Sabaka777: calls $0.17
*** TURN *** [5h 2d 7h] [3s]
Vlao: bets $0.38
Sabaka777: calls $0.38
*** RIVER *** [5h 2d 7h 3s] [Qs]
Vlao: checks
Sabaka777: checks
*** SHOW DOWN ***
Vlao: shows [8h Kh] (high card King)
Sabaka777: shows [9s 9c] (a pair of Nines)
Sabaka777 collected $1.30 from pot
*** SUMMARY ***
Total pot $1.35 | Rake $0.05
Board [5h 2d 7h 3s Qs]
Seat 1: Vlao (big blind) showed [8h Kh] and lost with high card King
Seat 3: d1ablo84 folded before Flop (didn't bet)
Seat 4: Sabaka777 showed [9s 9c] and won ($1.30) with a pair of Nines
Seat 5: falcao25 (button) folded before Flop (didn't bet)
Seat 6: florin.cbtr (small blind) folded before Flop


PokerStars Hand #238162076516:  Hold'em No Limit ($0.01/$0.02 USD) - 2022/08/23 2:03:21 ET
Table 'Achilles IV' 6-max Seat #6 is the button
Seat 1: Vlao ($2 in chips)
Seat 3: d1ablo84 ($2.63 in chips)
Seat 4: Sabaka777 ($3.89 in chips)
Seat 5: falcao25 ($2 in chips)
Seat 6: florin.cbtr ($1.40 in chips)
Vlao: posts small blind $0.01
d1ablo84: posts big blind $0.02
*** HOLE CARDS ***
Sabaka777: raises $0.02 to $0.04
falcao25: folds
florin.cbtr: calls $0.04
Vlao: calls $0.03
d1ablo84: raises $0.22 to $0.26
Sabaka777: folds
florin.cbtr: folds
Vlao: calls $0.22
*** FLOP *** [7c Ks 4d]
Vlao: checks
d1ablo84: bets $0.18
Vlao: calls $0.18
*** TURN *** [7c Ks 4d] [Qh]
Vlao: checks
d1ablo84: bets $0.40
Vlao: folds
Uncalled bet ($0.40) returned to d1ablo84
d1ablo84 collected $0.93 from pot
d1ablo84: doesn't show hand
*** SUMMARY ***
Total pot $0.96 | Rake $0.03
Board [7c Ks 4d Qh]
Seat 1: Vlao (small blind) folded on the Turn
Seat 3: d1ablo84 (big blind) collected ($0.93)
Seat 4: Sabaka777 folded before Flop
Seat 5: falcao25 folded before Flop (didn't bet)
Seat 6: florin.cbtr (button) folded before Flop


PokerStars Hand #238162087026:  Hold'em No Limit ($0.01/$0.02 USD) - 2022/08/23 2:05:03 ET
Table 'Achilles IV' 6-max Seat #3 is the button
Seat 1: Vlao ($2 in chips)
Seat 3: d1ablo84 ($3.11 in chips)
Seat 4: Sabaka777 ($3.83 in chips)
Seat 5: falcao25 ($2 in chips)
Seat 6: florin.cbtr ($1.39 in chips)
Sabaka777: posts small blind $0.01
falcao25: posts big blind $0.02
*** HOLE CARDS ***
florin.cbtr: raises $0.04 to $0.06
Vlao: folds
d1ablo84: folds
Sabaka777: folds
falcao25: folds
Uncalled bet ($0.04) returned to florin.cbtr
florin.cbtr collected $0.05 from pot
florin.cbtr: doesn't show hand
*** SUMMARY ***
Total pot $0.05 | Rake $0
Seat 1: Vlao folded before Flop (didn't bet)
Seat 3: d1ablo84 (button) folded before Flop (didn't bet)
Seat 4: Sabaka777 (small blind) folded before Flop
Seat 5: falcao25 (big blind) folded before Flop
Seat 6: florin.cbtr collected ($0.05)


PokerStars Hand #238162084799:  Hold'em No Limit ($0.01/$0.02 USD) - 2022/08/23 2:04:41 ET
Table 'Achilles IV' 6-max Seat #1 is the button
Seat 1: Vlao ($2 in chips)
Seat 3: d1ablo84 ($3.12 in chips)
Seat 4: Sabaka777 ($3.85 in chips)
Seat 5: falcao25 ($2 in chips)
Seat 6: florin.cbtr ($1.36 in chips)
d1ablo84: posts small blind $0.01
Sabaka777: posts big blind $0.02
*** HOLE CARDS ***
falcao25: folds
florin.cbtr: raises $0.04 to $0.06
Vlao: folds
d1ablo84: folds
Sabaka777: folds
Uncalled bet ($0.04) returned to florin.cbtr
florin.cbtr collected $0.05 from pot
florin.cbtr: doesn't show hand
*** SUMMARY ***
Total pot $0.05 | Rake $0
Seat 1: Vlao (button) folded before Flop (didn't bet)
Seat 3: d1ablo84 (small blind) folded before Flop
Seat 4: Sabaka777 (big blind) folded before Flop
Seat 5: falcao25 folded before Flop (didn't bet)
Seat 6: florin.cbtr collected ($0.05)


PokerStars Hand #238162088254:  Hold'em No Limit ($0.01/$0.02 USD) - 2022/08/23 2:05:15 ET
Table 'Achilles IV' 6-max Seat #4 is the button
Seat 1: Vlao ($2 in chips)
Seat 3: d1ablo84 ($3.11 in chips)
Seat 4: Sabaka777 ($3.82 in chips)
Seat 5: falcao25 ($2 in chips)
Seat 6: florin.cbtr ($1.42 in chips)
falcao25: posts small blind $0.01
florin.cbtr: posts big blind $0.02
*** HOLE CARDS ***
Vlao: folds
d1ablo84: folds
Sabaka777: folds
falcao25: folds
Uncalled bet ($0.01) returned to florin.cbtr
florin.cbtr collected $0.02 from pot
florin.cbtr: doesn't show hand
*** SUMMARY ***
Total pot $0.02 | Rake $0
Seat 1: Vlao folded before Flop (didn't bet)
Seat 3: d1ablo84 folded before Flop (didn't bet)
Seat 4: Sabaka777 (button) folded before Flop (didn't bet)
Seat 5: falcao25 (small blind) folded before Flop
Seat 6: florin.cbtr (big blind) collected ($0.02)


PokerStars Hand #238162089500:  Hold'em No Limit ($0.01/$0.02 USD) - 2022/08/23 2:05:28 ET
Table 'Achilles IV' 6-max Seat #5 is the button
Seat 1: Vlao ($2 in chips)
Seat 3: d1ablo84 ($3.11 in chips)
Seat 4: Sabaka777 ($3.82 in chips)
Seat 5: falcao25 ($2 in chips)
Seat 6: florin.cbtr ($1.43 in chips)
florin.cbtr: posts small blind $0.01
Vlao: posts big blind $0.02
*** HOLE CARDS ***
d1ablo84: folds
Sabaka777: folds
falcao25: raises $0.04 to $0.06
florin.cbtr: folds
Vlao: folds
Uncalled bet ($0.04) returned to falcao25
falcao25 collected $0.05 from pot
*** SUMMARY ***
Total pot $0.05 | Rake $0
Seat 1: Vlao (big blind) folded before Flop
Seat 3: d1ablo84 folded before Flop (didn't bet)
Seat 4: Sabaka777 folded before Flop (didn't bet)
Seat 5: falcao25 (button) collected ($0.05)
Seat 6: florin.cbtr (small blind) folded before Flop


PokerStars Hand #238162091775:  Hold'em No Limit ($0.01/$0.02 USD) - 2022/08/23 2:05:49 ET
Table 'Achilles IV' 6-max Seat #6 is the button
Seat 1: Vlao ($2 in chips)
Seat 3: d1ablo84 ($3.11 in chips)
Seat 4: Sabaka777 ($3.82 in chips)
Seat 5: falcao25 ($2.03 in chips)
Seat 6: florin.cbtr ($1.42 in chips)
Vlao: posts small blind $0.01
d1ablo84: posts big blind $0.02
*** HOLE CARDS ***
Sabaka777: folds
falcao25: folds
florin.cbtr: calls $0.02
Vlao: calls $0.01
d1ablo84: raises $0.10 to $0.12
florin.cbtr: folds
Vlao: folds
Uncalled bet ($0.10) returned to d1ablo84
d1ablo84 collected $0.06 from pot
d1ablo84: doesn't show hand
*** SUMMARY ***
Total pot $0.06 | Rake $0
Seat 1: Vlao (small blind) folded before Flop
Seat 3: d1ablo84 (big blind) collected ($0.06)
Seat 4: Sabaka777 folded before Flop (didn't bet)
Seat 5: falcao25 folded before Flop (didn't bet)
Seat 6: florin.cbtr (button) folded before Flop


PokerStars Hand #238162094742:  Hold'em No Limit ($0.01/$0.02 USD) - 2022/08/23 2:06:18 ET
Table 'Achilles IV' 6-max Seat #1 is the button
Seat 1: Vlao ($2 in chips)
Seat 3: d1ablo84 ($3.15 in chips)
Seat 5: falcao25 ($2.03 in chips)
Seat 6: florin.cbtr ($1.40 in chips)
d1ablo84: posts small blind $0.01
Sabaka777: is sitting out
falcao25: posts big blind $0.02
*** HOLE CARDS ***
florin.cbtr: calls $0.02
Sabaka777 leaves the table
Vlao: folds
d1ablo84: folds
falcao25: checks
*** FLOP *** [Kd Qc Jh]
falcao25: checks
florin.cbtr: checks
*** TURN *** [Kd Qc Jh] [Ts]
falcao25: checks
florin.cbtr: bets $0.04
falcao25: folds
Uncalled bet ($0.04) returned to florin.cbtr
florin.cbtr collected $0.05 from pot
florin.cbtr: doesn't show hand
*** SUMMARY ***
Total pot $0.05 | Rake $0
Board [Kd Qc Jh Ts]
Seat 1: Vlao (button) folded before Flop (didn't bet)
Seat 3: d1ablo84 (small blind) folded before Flop
Seat 5: falcao25 (big blind) folded on the Turn
Seat 6: florin.cbtr collected ($0.05)


PokerStars Hand #238162097102:  Hold'em No Limit ($0.01/$0.02 USD) - 2022/08/23 2:06:41 ET
Table 'Achilles IV' 6-max Seat #3 is the button
Seat 1: Vlao ($2 in chips)
Seat 3: d1ablo84 ($3.14 in chips)
Seat 5: falcao25 ($2.01 in chips)
Seat 6: florin.cbtr ($1.43 in chips)
falcao25: posts small blind $0.01
florin.cbtr: posts big blind $0.02
*** HOLE CARDS ***
Vlao: folds
d1ablo84: folds
falcao25: calls $0.01
florin.cbtr: checks
*** FLOP *** [3d 5d 2d]
falcao25: checks
florin.cbtr: bets $0.04
falcao25: folds
Uncalled bet ($0.04) returned to florin.cbtr
florin.cbtr collected $0.04 from pot
florin.cbtr: doesn't show hand
*** SUMMARY ***
Total pot $0.04 | Rake $0
Board [3d 5d 2d]
Seat 1: Vlao folded before Flop (didn't bet)
Seat 3: d1ablo84 (button) folded before Flop (didn't bet)
Seat 5: falcao25 (small blind) folded on the Flop
Seat 6: florin.cbtr (big blind) collected ($0.04)


PokerStars Hand #238162100205:  Hold'em No Limit ($0.01/$0.02 USD) - 2022/08/23 2:07:11 ET
Table 'Achilles IV' 6-max Seat #5 is the button
Seat 1: Vlao ($2 in chips)
Seat 3: d1ablo84 ($3.14 in chips)
Seat 5: falcao25 ($2 in chips)
Seat 6: florin.cbtr ($1.45 in chips)
florin.cbtr: posts small blind $0.01
Vlao: posts big blind $0.02
*** HOLE CARDS ***
d1ablo84: raises $0.04 to $0.06
kizzle72 joins the table at seat #4
falcao25: raises $0.09 to $0.15
florin.cbtr: folds
Vlao: folds
d1ablo84: raises $0.27 to $0.42
falcao25: folds
Uncalled bet ($0.27) returned to d1ablo84
d1ablo84 collected $0.33 from pot
d1ablo84: doesn't show hand
*** SUMMARY ***
Total pot $0.33 | Rake $0
Seat 1: Vlao (big blind) folded before Flop
Seat 3: d1ablo84 collected ($0.33)
Seat 5: falcao25 (button) folded before Flop
Seat 6: florin.cbtr (small blind) folded before Flop


PokerStars Hand #238162104842:  Hold'em No Limit ($0.01/$0.02 USD) - 2022/08/23 2:07:55 ET
Table 'Achilles IV' 6-max Seat #1 is the button
Seat 1: Vlao ($2 in chips)
Seat 3: d1ablo84 ($3.33 in chips)
Seat 4: kizzle72 ($1.29 in chips)
Seat 5: falcao25 ($2 in chips)
Seat 6: florin.cbtr ($1.44 in chips)
d1ablo84: posts small blind $0.01
kizzle72: posts big blind $0.02
*** HOLE CARDS ***
falcao25: folds
florin.cbtr: folds
Vlao: folds
d1ablo84: folds
Uncalled bet ($0.01) returned to kizzle72
kizzle72 collected $0.02 from pot
*** SUMMARY ***
Total pot $0.02 | Rake $0
Seat 1: Vlao (button) folded before Flop (didn't bet)
Seat 3: d1ablo84 (small blind) folded before Flop
Seat 4: kizzle72 (big blind) collected ($0.02)
Seat 5: falcao25 folded before Flop (didn't bet)
Seat 6: florin.cbtr folded before Flop (didn't bet)


PokerStars Hand #238162103804:  Hold'em No Limit ($0.01/$0.02 USD) - 2022/08/23 2:07:45 ET
Table 'Achilles IV' 6-max Seat #6 is the button
Seat 1: Vlao ($2 in chips)
Seat 3: d1ablo84 ($3.32 in chips)
Seat 5: falcao25 ($2 in chips)
Seat 6: florin.cbtr ($1.44 in chips)
Vlao: posts small blind $0.01
d1ablo84: posts big blind $0.02
kizzle72: sits out
*** HOLE CARDS ***
falcao25: folds
florin.cbtr: folds
Vlao: folds
Uncalled bet ($0.01) returned to d1ablo84
d1ablo84 collected $0.02 from pot
msmbenz9900 was removed from the table for failing to post
msmbenz9900 leaves the table
d1ablo84: doesn't show hand
*** SUMMARY ***
Total pot $0.02 | Rake $0
Seat 1: Vlao (small blind) folded before Flop
Seat 3: d1ablo84 (big blind) collected ($0.02)
Seat 5: falcao25 folded before Flop (didn't bet)
Seat 6: florin.cbtr (button) folded before Flop (didn't bet)


PokerStars Hand #238162106304:  Hold'em No Limit ($0.01/$0.02 USD) - 2022/08/23 2:08:09 ET
Table 'Achilles IV' 6-max Seat #3 is the button
Seat 1: Vlao ($2 in chips)
Seat 3: d1ablo84 ($3.32 in chips)
Seat 4: kizzle72 ($1.30 in chips)
Seat 5: falcao25 ($2 in chips)
Seat 6: florin.cbtr ($1.44 in chips)
kizzle72: posts small blind $0.01
falcao25: posts big blind $0.02
*** HOLE CARDS ***
spider568 joins the table at seat #2
florin.cbtr: calls $0.02
Vlao: folds
d1ablo84: folds
kizzle72: folds
falcao25: checks
*** FLOP *** [Tc 2h 2d]
falcao25: checks
florin.cbtr: bets $0.04
falcao25: folds
Uncalled bet ($0.04) returned to florin.cbtr
florin.cbtr collected $0.05 from pot
florin.cbtr: doesn't show hand
*** SUMMARY ***
Total pot $0.05 | Rake $0
Board [Tc 2h 2d]
Seat 1: Vlao folded before Flop (didn't bet)
Seat 3: d1ablo84 (button) folded before Flop (didn't bet)
Seat 4: kizzle72 (small blind) folded before Flop
Seat 5: falcao25 (big blind) folded on the Flop
Seat 6: florin.cbtr collected ($0.05)


PokerStars Hand #238162109812:  Hold'em No Limit ($0.01/$0.02 USD) - 2022/08/23 2:08:43 ET
Table 'Achilles IV' 6-max Seat #4 is the button
Seat 1: Vlao ($2 in chips)
Seat 2: spider568 ($2 in chips)
Seat 3: d1ablo84 ($3.32 in chips)
Seat 4: kizzle72 ($1.29 in chips)
Seat 5: falcao25 ($2 in chips)
Seat 6: florin.cbtr ($1.47 in chips)
falcao25: posts small blind $0.01
florin.cbtr: posts big blind $0.02
spider568: posts big blind $0.02
*** HOLE CARDS ***
Vlao: folds
spider568: checks
d1ablo84: raises $0.06 to $0.08
kizzle72: folds
falcao25: folds
florin.cbtr: folds
spider568: folds
Uncalled bet ($0.06) returned to d1ablo84
d1ablo84 collected $0.07 from pot
d1ablo84: doesn't show hand
*** SUMMARY ***
Total pot $0.07 | Rake $0
Seat 1: Vlao folded before Flop (didn't bet)
Seat 2: spider568 folded before Flop (didn't bet)
Seat 3: d1ablo84 collected ($0.07)
Seat 4: kizzle72 (button) folded before Flop (didn't bet)
Seat 5: falcao25 (small blind) folded before Flop
Seat 6: florin.cbtr (big blind) folded before Flop


PokerStars Hand #238162111626:  Hold'em No Limit ($0.01/$0.02 USD) - 2022/08/23 2:09:01 ET
Table 'Achilles IV' 6-max Seat #5 is the button
Seat 1: Vlao ($2 in chips)
Seat 2: spider568 ($2 in chips)
Seat 3: d1ablo84 ($3.37 in chips)
Seat 4: kizzle72 ($1.29 in chips)
Seat 5: falcao25 ($2 in chips)
Seat 6: florin.cbtr ($1.45 in chips)
florin.cbtr: posts small blind $0.01
Vlao: posts big blind $0.02
*** HOLE CARDS ***
spider568: calls $0.02
d1ablo84: folds
kizzle72: raises $0.07 to $0.09
falcao25: folds
florin.cbtr: folds
Vlao: folds
spider568: folds
Uncalled bet ($0.07) returned to kizzle72
kizzle72 collected $0.07 from pot
*** SUMMARY ***
Total pot $0.07 | Rake $0
Seat 1: Vlao (big blind) folded before Flop
Seat 2: spider568 folded before Flop
Seat 3: d1ablo84 folded before Flop (didn't bet)
Seat 4: kizzle72 collected ($0.07)
Seat 5: falcao25 (button) folded before Flop (didn't bet)
Seat 6: florin.cbtr (small blind) folded before Flop


PokerStars Hand #238162113679:  Hold'em No Limit ($0.01/$0.02 USD) - 2022/08/23 2:09:21 ET
Table 'Achilles IV' 6-max Seat #6 is the button
Seat 1: Vlao ($2 in chips)
Seat 2: spider568 ($2 in chips)
Seat 3: d1ablo84 ($3.37 in chips)
Seat 4: kizzle72 ($1.34 in chips)
Seat 5: falcao25 ($2 in chips)
Seat 6: florin.cbtr ($1.44 in chips)
Vlao: posts small blind $0.01
spider568: posts big blind $0.02
*** HOLE CARDS ***
d1ablo84: folds
kizzle72: folds
falcao25: folds
florin.cbtr: raises $0.04 to $0.06
Vlao: folds
spider568: raises $0.08 to $0.14
florin.cbtr: calls $0.08
*** FLOP *** [Ac Td 7d]
spider568: bets $0.30
florin.cbtr: folds
Uncalled bet ($0.30) returned to spider568
spider568 collected $0.28 from pot
*** SUMMARY ***
Total pot $0.29 | Rake $0.01
Board [Ac Td 7d]
Seat 1: Vlao (small blind) folded before Flop
Seat 2: spider568 (big blind) collected ($0.28)
Seat 3: d1ablo84 folded before Flop (didn't bet)
Seat 4: kizzle72 folded before Flop (didn't bet)
Seat 5: falcao25 folded before Flop (didn't bet)
Seat 6: florin.cbtr (button) folded on the Flop


PokerStars Hand #238162116359:  Hold'em No Limit ($0.01/$0.02 USD) - 2022/08/23 2:09:47 ET
Table 'Achilles IV' 6-max Seat #1 is the button
Seat 1: Vlao ($2 in chips)
Seat 2: spider568 ($2.14 in chips)
Seat 3: d1ablo84 ($3.37 in chips)
Seat 4: kizzle72 ($1.34 in chips)
Seat 5: falcao25 ($2 in chips)
Seat 6: florin.cbtr ($1.30 in chips)
spider568: posts small blind $0.01
d1ablo84: posts big blind $0.02
*** HOLE CARDS ***
kizzle72: folds
falcao25: folds
florin.cbtr: calls $0.02
Vlao: folds
spider568: calls $0.01
d1ablo84: checks
*** FLOP *** [4s 2d Qh]
spider568: checks
d1ablo84: checks
florin.cbtr: checks
*** TURN *** [4s 2d Qh] [As]
spider568: bets $0.06
d1ablo84: folds
florin.cbtr: folds
Uncalled bet ($0.06) returned to spider568
spider568 collected $0.06 from pot
*** SUMMARY ***
Total pot $0.06 | Rake $0
Board [4s 2d Qh As]
Seat 1: Vlao (button) folded before Flop (didn't bet)
Seat 2: spider568 (small blind) collected ($0.06)
Seat 3: d1ablo84 (big blind) folded on the Turn
Seat 4: kizzle72 folded before Flop (didn't bet)
Seat 5: falcao25 folded before Flop (didn't bet)
Seat 6: florin.cbtr folded on the Turn


PokerStars Hand #238162122428:  Hold'em No Limit ($0.01/$0.02 USD) - 2022/08/23 2:10:48 ET
Table 'Achilles IV' 6-max Seat #2 is the button
Seat 1: Vlao ($2 in chips)
Seat 2: spider568 ($2.18 in chips)
Seat 3: d1ablo84 ($3.35 in chips)
Seat 4: kizzle72 ($1.34 in chips)
Seat 5: falcao25 ($2 in chips)
Seat 6: florin.cbtr ($1.28 in chips)
d1ablo84: posts small blind $0.01
kizzle72: posts big blind $0.02
*** HOLE CARDS ***
falcao25: folds
florin.cbtr: calls $0.02
Vlao: folds
spider568: folds
d1ablo84: folds
kizzle72: checks
*** FLOP *** [7d 4s Js]
kizzle72: checks
florin.cbtr: bets $0.04
kizzle72: calls $0.04
*** TURN *** [7d 4s Js] [9c]
kizzle72: checks
florin.cbtr: bets $0.08
kizzle72: calls $0.08
*** RIVER *** [7d 4s Js 9c] [Kc]
kizzle72: checks
florin.cbtr: bets $0.14
kizzle72: folds
Uncalled bet ($0.14) returned to florin.cbtr
florin.cbtr collected $0.28 from pot
florin.cbtr: doesn't show hand
*** SUMMARY ***
Total pot $0.29 | Rake $0.01
Board [7d 4s Js 9c Kc]
Seat 1: Vlao folded before Flop (didn't bet)
Seat 2: spider568 (button) folded before Flop (didn't bet)
Seat 3: d1ablo84 (small blind) folded before Flop
Seat 4: kizzle72 (big blind) folded on the River
Seat 5: falcao25 folded before Flop (didn't bet)
Seat 6: florin.cbtr collected ($0.28)


PokerStars Hand #238162127280:  Hold'em No Limit ($0.01/$0.02 USD) - 2022/08/23 2:11:36 ET
Table 'Achilles IV' 6-max Seat #3 is the button
Seat 1: Vlao ($2 in chips)
Seat 2: spider568 ($2.18 in chips)
Seat 3: d1ablo84 ($3.34 in chips)
Seat 4: kizzle72 ($1.20 in chips)
Seat 5: falcao25 ($2 in chips)
Seat 6: florin.cbtr ($1.42 in chips)
kizzle72: posts small blind $0.01
falcao25: posts big blind $0.02
*** HOLE CARDS ***
florin.cbtr: folds
Vlao: folds
spider568: calls $0.02
d1ablo84: folds
kizzle72: folds
falcao25: checks
*** FLOP *** [Kd Qs 9s]
falcao25: checks
spider568: bets $0.05
falcao25: folds
Uncalled bet ($0.05) returned to spider568
spider568 collected $0.05 from pot
*** SUMMARY ***
Total pot $0.05 | Rake $0
Board [Kd Qs 9s]
Seat 1: Vlao folded before Flop (didn't bet)
Seat 2: spider568 collected ($0.05)
Seat 3: d1ablo84 (button) folded before Flop (didn't bet)
Seat 4: kizzle72 (small blind) folded before Flop
Seat 5: falcao25 (big blind) folded on the Flop
Seat 6: florin.cbtr folded before Flop (didn't bet)


PokerStars Hand #238162129863:  Hold'em No Limit ($0.01/$0.02 USD) - 2022/08/23 2:12:02 ET
Table 'Achilles IV' 6-max Seat #4 is the button
Seat 1: Vlao ($2 in chips)
Seat 2: spider568 ($2.21 in chips)
Seat 3: d1ablo84 ($3.34 in chips)
Seat 4: kizzle72 ($1.19 in chips)
Seat 5: falcao25 ($2 in chips)
Seat 6: florin.cbtr ($1.42 in chips)
falcao25: posts small blind $0.01
florin.cbtr: posts big blind $0.02
*** HOLE CARDS ***
Vlao: folds
spider568: calls $0.02
d1ablo84: folds
kizzle72: folds
falcao25: folds
florin.cbtr: raises $0.04 to $0.06
spider568: folds
Uncalled bet ($0.04) returned to florin.cbtr
florin.cbtr collected $0.05 from pot
florin.cbtr: doesn't show hand
*** SUMMARY ***
Total pot $0.05 | Rake $0
Seat 1: Vlao folded before Flop (didn't bet)
Seat 2: spider568 folded before Flop
Seat 3: d1ablo84 folded before Flop (didn't bet)
Seat 4: kizzle72 (button) folded before Flop (didn't bet)
Seat 5: falcao25 (small blind) folded before Flop
Seat 6: florin.cbtr (big blind) collected ($0.05)


PokerStars Hand #238162132139:  Hold'em No Limit ($0.01/$0.02 USD) - 2022/08/23 2:12:24 ET
Table 'Achilles IV' 6-max Seat #5 is the button
Seat 1: Vlao ($2 in chips)
Seat 2: spider568 ($2.19 in chips)
Seat 3: d1ablo84 ($3.34 in chips)
Seat 4: kizzle72 ($1.19 in chips)
Seat 5: falcao25 ($2 in chips)
Seat 6: florin.cbtr ($1.45 in chips)
florin.cbtr: posts small blind $0.01
Vlao: posts big blind $0.02
*** HOLE CARDS ***
spider568: calls $0.02
d1ablo84: folds
kizzle72: calls $0.02
falcao25: folds
florin.cbtr: calls $0.01
Vlao: checks
*** FLOP *** [2s Qs 3h]
florin.cbtr: checks
Vlao: checks
spider568: bets $0.04
kizzle72: calls $0.04
florin.cbtr: calls $0.04
Vlao: calls $0.04
*** TURN *** [2s Qs 3h] [Jh]
florin.cbtr: checks
Vlao: checks
spider568: checks
kizzle72: bets $0.23
florin.cbtr: folds
Vlao: folds
spider568: calls $0.23
*** RIVER *** [2s Qs 3h Jh] [Qd]
spider568: bets $0.10
kizzle72: calls $0.10
*** SHOW DOWN ***
spider568: shows [4s Ts] (a pair of Queens)
kizzle72: shows [3s Js] (two pair, Queens and Jacks)
kizzle72 collected $0.87 from pot
*** SUMMARY ***
Total pot $0.90 | Rake $0.03
Board [2s Qs 3h Jh Qd]
Seat 1: Vlao (big blind) folded on the Turn
Seat 2: spider568 showed [4s Ts] and lost with a pair of Queens
Seat 3: d1ablo84 folded before Flop (didn't bet)
Seat 4: kizzle72 showed [3s Js] and won ($0.87) with two pair, Queens and Jacks
Seat 5: falcao25 (button) folded before Flop (didn't bet)
Seat 6: florin.cbtr (small blind) folded on the Turn


PokerStars Hand #238162140955:  Hold'em No Limit ($0.01/$0.02 USD) - 2022/08/23 2:13:51 ET
Table 'Achilles IV' 6-max Seat #6 is the button
Seat 1: Vlao ($2 in chips)
Seat 2: spider568 ($2 in chips)
Seat 3: d1ablo84 ($3.34 in chips)
Seat 4: kizzle72 ($1.67 in chips)
Seat 5: falcao25 ($2 in chips)
Seat 6: florin.cbtr ($1.39 in chips)
Vlao: posts small blind $0.01
spider568: posts big blind $0.02
*** HOLE CARDS ***
d1ablo84: folds
kizzle72: calls $0.02
falcao25: folds
florin.cbtr: calls $0.02
Vlao: calls $0.01
spider568: checks
*** FLOP *** [3h Kd 2h]
Vlao: checks
spider568: checks
kizzle72: checks
florin.cbtr: checks
*** TURN *** [3h Kd 2h] [Js]
Vlao: checks
spider568: bets $0.04
kizzle72: folds
florin.cbtr: folds
Vlao: folds
Uncalled bet ($0.04) returned to spider568
spider568 collected $0.08 from pot
*** SUMMARY ***
Total pot $0.08 | Rake $0
Board [3h Kd 2h Js]
Seat 1: Vlao (small blind) folded on the Turn
Seat 2: spider568 (big blind) collected ($0.08)
Seat 3: d1ablo84 folded before Flop (didn't bet)
Seat 4: kizzle72 folded on the Turn
Seat 5: falcao25 folded before Flop (didn't bet)
Seat 6: florin.cbtr (button) folded on the Turn


PokerStars Hand #238162146676:  Hold'em No Limit ($0.01/$0.02 USD) - 2022/08/23 2:14:46 ET
Table 'Achilles IV' 6-max Seat #1 is the button
Seat 1: Vlao ($2 in chips)
Seat 2: spider568 ($2.06 in chips)
Seat 3: d1ablo84 ($3.34 in chips)
Seat 4: kizzle72 ($1.65 in chips)
Seat 5: falcao25 ($2 in chips)
Seat 6: florin.cbtr ($1.37 in chips)
spider568: posts small blind $0.01
d1ablo84: posts big blind $0.02
*** HOLE CARDS ***
kizzle72: calls $0.02
falcao25: folds
florin.cbtr: calls $0.02
Vlao: folds
spider568: calls $0.01
d1ablo84: checks
*** FLOP *** [2c 4s Js]
spider568: bets $0.08
d1ablo84: folds
kizzle72: calls $0.08
florin.cbtr: folds
*** TURN *** [2c 4s Js] [Ac]
spider568: checks
kizzle72: checks
*** RIVER *** [2c 4s Js Ac] [Qd]
spider568: bets $0.11
kizzle72: folds
Uncalled bet ($0.11) returned to spider568
spider568 collected $0.23 from pot
*** SUMMARY ***
Total pot $0.24 | Rake $0.01
Board [2c 4s Js Ac Qd]
Seat 1: Vlao (button) folded before Flop (didn't bet)
Seat 2: spider568 (small blind) collected ($0.23)
Seat 3: d1ablo84 (big blind) folded on the Flop
Seat 4: kizzle72 folded on the River
Seat 5: falcao25 folded before Flop (didn't bet)
Seat 6: florin.cbtr folded on the Flop


PokerStars Hand #238162152461:  Hold'em No Limit ($0.01/$0.02 USD) - 2022/08/23 2:15:42 ET
Table 'Achilles IV' 6-max Seat #2 is the button
Seat 1: Vlao ($2 in chips)
Seat 2: spider568 ($2.19 in chips)
Seat 3: d1ablo84 ($3.32 in chips)
Seat 5: falcao25 ($2 in chips)
Seat 6: florin.cbtr ($1.35 in chips)
d1ablo84: posts small blind $0.01
falcao25: posts big blind $0.02
*** HOLE CARDS ***
florin.cbtr: calls $0.02
Vlao: folds
spider568: calls $0.02
d1ablo84: folds
falcao25: raises $0.04 to $0.06
florin.cbtr: calls $0.04
spider568: calls $0.04
*** FLOP *** [7h Ts 8c]
falcao25: bets $0.09
florin.cbtr: calls $0.09
spider568: folds
*** TURN *** [7h Ts 8c] [Js]
falcao25: checks
florin.cbtr: bets $0.18
falcao25: calls $0.18
*** RIVER *** [7h Ts 8c Js] [Ah]
falcao25: bets $0.02
florin.cbtr: raises $1 to $1.02 and is all-in
falcao25: folds
Uncalled bet ($1) returned to florin.cbtr
florin.cbtr collected $0.74 from pot
florin.cbtr: doesn't show hand
*** SUMMARY ***
Total pot $0.77 | Rake $0.03
Board [7h Ts 8c Js Ah]
Seat 1: Vlao folded before Flop (didn't bet)
Seat 2: spider568 (button) folded on the Flop
Seat 3: d1ablo84 (small blind) folded before Flop
Seat 5: falcao25 (big blind) folded on the River
Seat 6: florin.cbtr collected ($0.74)


PokerStars Hand #238162160513:  Hold'em No Limit ($0.01/$0.02 USD) - 2022/08/23 2:17:00 ET
Table 'Achilles IV' 6-max Seat #3 is the button
Seat 1: Vlao ($2 in chips)
Seat 2: spider568 ($2.13 in chips)
Seat 3: d1ablo84 ($3.31 in chips)
Seat 5: falcao25 ($2 in chips)
Seat 6: florin.cbtr ($1.74 in chips)
falcao25: posts small blind $0.01
florin.cbtr: posts big blind $0.02
*** HOLE CARDS ***
Vlao: raises $0.03 to $0.05
spider568: folds
d1ablo84: folds
falcao25: folds
florin.cbtr: calls $0.03
*** FLOP *** [3c 6d 5d]
florin.cbtr: checks
Vlao: checks
*** TURN *** [3c 6d 5d] [Jd]
florin.cbtr: checks
Vlao: checks
*** RIVER *** [3c 6d 5d Jd] [4s]
florin.cbtr: bets $0.05
Vlao: folds
Uncalled bet ($0.05) returned to florin.cbtr
florin.cbtr collected $0.11 from pot
florin.cbtr: doesn't show hand
*** SUMMARY ***
Total pot $0.11 | Rake $0
Board [3c 6d 5d Jd 4s]
Seat 1: Vlao folded on the River
Seat 2: spider568 folded before Flop (didn't bet)
Seat 3: d1ablo84 (button) folded before Flop (didn't bet)
Seat 5: falcao25 (small blind) folded before Flop
Seat 6: florin.cbtr (big blind) collected ($0.11)


PokerStars Hand #238162163925:  Hold'em No Limit ($0.01/$0.02 USD) - 2022/08/23 2:17:32 ET
Table 'Achilles IV' 6-max Seat #5 is the button
Seat 1: Vlao ($2 in chips)
Seat 2: spider568 ($2.13 in chips)
Seat 3: d1ablo84 ($3.31 in chips)
Seat 5: falcao25 ($2 in chips)
Seat 6: florin.cbtr ($1.80 in chips)
florin.cbtr: posts small blind $0.01
Vlao: posts big blind $0.02
*** HOLE CARDS ***
spider568: folds
d1ablo84: raises $0.04 to $0.06
falcao25: raises $0.09 to $0.15
florin.cbtr: folds
Vlao: folds
d1ablo84: raises $0.25 to $0.40
falcao25: raises $1.60 to $2 and is all-in
d1ablo84: folds
Uncalled bet ($1.60) returned to falcao25
falcao25 collected $0.83 from pot
*** SUMMARY ***
Total pot $0.83 | Rake $0
Seat 1: Vlao (big blind) folded before Flop
Seat 2: spider568 folded before Flop (didn't bet)
Seat 3: d1ablo84 folded before Flop
Seat 5: falcao25 (button) collected ($0.83)
Seat 6: florin.cbtr (small blind) folded before Flop


PokerStars Hand #238162169367:  Hold'em No Limit ($0.01/$0.02 USD) - 2022/08/23 2:18:25 ET
Table 'Achilles IV' 6-max Seat #6 is the button
Seat 1: Vlao ($2 in chips)
Seat 2: spider568 ($2.13 in chips)
Seat 3: d1ablo84 ($2.91 in chips)
Seat 5: falcao25 ($2.43 in chips)
Seat 6: florin.cbtr ($1.79 in chips)
Vlao: posts small blind $0.01
spider568: posts big blind $0.02
*** HOLE CARDS ***
d1ablo84: folds
falcao25: folds
kizzle72 is disconnected
florin.cbtr: raises $0.04 to $0.06
Vlao: folds
spider568: folds
Uncalled bet ($0.04) returned to florin.cbtr
florin.cbtr collected $0.05 from pot
florin.cbtr: doesn't show hand
*** SUMMARY ***
Total pot $0.05 | Rake $0
Seat 1: Vlao (small blind) folded before Flop
Seat 2: spider568 (big blind) folded before Flop
Seat 3: d1ablo84 folded before Flop (didn't bet)
Seat 5: falcao25 folded before Flop (didn't bet)
Seat 6: florin.cbtr (button) collected ($0.05)


PokerStars Hand #238162171555:  Hold'em No Limit ($0.01/$0.02 USD) - 2022/08/23 2:18:47 ET
Table 'Achilles IV' 6-max Seat #1 is the button
Seat 1: Vlao ($2 in chips)
Seat 2: spider568 ($2.11 in chips)
Seat 3: d1ablo84 ($2.91 in chips)
Seat 5: falcao25 ($2.43 in chips)
Seat 6: florin.cbtr ($1.82 in chips)
spider568: posts small blind $0.01
d1ablo84: posts big blind $0.02
*** HOLE CARDS ***
falcao25: folds
florin.cbtr: calls $0.02
Vlao: folds
spider568: calls $0.01
d1ablo84: checks
*** FLOP *** [3h 9s 3c]
spider568: bets $0.03
d1ablo84: folds
florin.cbtr: calls $0.03
*** TURN *** [3h 9s 3c] [Kd]
spider568: checks
florin.cbtr: bets $0.06
spider568: calls $0.06
*** RIVER *** [3h 9s 3c Kd] [As]
spider568: bets $0.62
florin.cbtr: folds
Uncalled bet ($0.62) returned to spider568
spider568 collected $0.23 from pot
*** SUMMARY ***
Total pot $0.24 | Rake $0.01
Board [3h 9s 3c Kd As]
Seat 1: Vlao (button) folded before Flop (didn't bet)
Seat 2: spider568 (small blind) collected ($0.23)
Seat 3: d1ablo84 (big blind) folded on the Flop
Seat 5: falcao25 folded before Flop (didn't bet)
Seat 6: florin.cbtr folded on the River


PokerStars Hand #238162175365:  Hold'em No Limit ($0.01/$0.02 USD) - 2022/08/23 2:19:25 ET
Table 'Achilles IV' 6-max Seat #2 is the button
Seat 1: Vlao ($2 in chips)
Seat 2: spider568 ($2.23 in chips)
Seat 3: d1ablo84 ($2.89 in chips)
Seat 6: florin.cbtr ($1.71 in chips)
d1ablo84: posts small blind $0.01
falcao25: is sitting out
florin.cbtr: posts big blind $0.02
*** HOLE CARDS ***
Vlao: folds
spider568: calls $0.02
d1ablo84: folds
florin.cbtr: checks
*** FLOP *** [Ac Jh 9d]
florin.cbtr: checks
spider568: bets $0.05
florin.cbtr: raises $0.11 to $0.16
spider568: calls $0.11
*** TURN *** [Ac Jh 9d] [Ks]
florin.cbtr: bets $0.20
falcao25 leaves the table
spider568: calls $0.20
*** RIVER *** [Ac Jh 9d Ks] [2d]
florin.cbtr: bets $1.33 and is all-in
spider568: folds
Uncalled bet ($1.33) returned to florin.cbtr
florin.cbtr collected $0.74 from pot
florin.cbtr: doesn't show hand
*** SUMMARY ***
Total pot $0.77 | Rake $0.03
Board [Ac Jh 9d Ks 2d]
Seat 1: Vlao folded before Flop (didn't bet)
Seat 2: spider568 (button) folded on the River
Seat 3: d1ablo84 (small blind) folded before Flop
Seat 6: florin.cbtr (big blind) collected ($0.74)


PokerStars Hand #238162179984:  Hold'em No Limit ($0.01/$0.02 USD) - 2022/08/23 2:20:10 ET
Table 'Achilles IV' 6-max Seat #3 is the button
Seat 1: Vlao ($2 in chips)
Seat 2: spider568 ($2 in chips)
Seat 3: d1ablo84 ($2.88 in chips)
Seat 6: florin.cbtr ($2.07 in chips)
florin.cbtr: posts small blind $0.01
Vlao: posts big blind $0.02
*** HOLE CARDS ***
spider568: calls $0.02
d1ablo84: folds
florin.cbtr: raises $0.04 to $0.06
Vlao: folds
spider568: calls $0.04
*** FLOP *** [Qh Td Ts]
florin.cbtr: bets $0.07
spider568: calls $0.07
*** TURN *** [Qh Td Ts] [Ah]
florin.cbtr: checks
spider568: bets $0.13
Noah_D@vid joins the table at seat #5
florin.cbtr: raises $0.27 to $0.40
spider568: folds
Uncalled bet ($0.27) returned to florin.cbtr
florin.cbtr collected $0.52 from pot
florin.cbtr: doesn't show hand
*** SUMMARY ***
Total pot $0.54 | Rake $0.02
Board [Qh Td Ts Ah]
Seat 1: Vlao (big blind) folded before Flop
Seat 2: spider568 folded on the Turn
Seat 3: d1ablo84 (button) folded before Flop (didn't bet)
Seat 6: florin.cbtr (small blind) collected ($0.52)


PokerStars Hand #238162185895:  Hold'em No Limit ($0.01/$0.02 USD) - 2022/08/23 2:21:08 ET
Table 'Achilles IV' 6-max Seat #6 is the button
Seat 1: Vlao ($2 in chips)
Seat 2: spider568 ($2 in chips)
Seat 3: d1ablo84 ($2.88 in chips)
Seat 5: Noah_D@vid ($0.80 in chips)
Seat 6: florin.cbtr ($2.33 in chips)
Vlao: posts small blind $0.01
spider568: posts big blind $0.02
Noah_D@vid: posts big blind $0.02
*** HOLE CARDS ***
d1ablo84: folds
Noah_D@vid: checks
florin.cbtr: calls $0.02
Vlao: calls $0.01
spider568: checks
*** FLOP *** [8d 4h Ad]
Vlao: checks
spider568: checks
Noah_D@vid: checks
florin.cbtr: checks
*** TURN *** [8d 4h Ad] [Ah]
Vlao: checks
spider568: checks
Noah_D@vid: checks
florin.cbtr: checks
*** RIVER *** [8d 4h Ad Ah] [Td]
Vlao: checks
spider568: checks
Noah_D@vid: checks
florin.cbtr: checks
*** SHOW DOWN ***
Vlao: shows [2s 5c] (a pair of Aces)
spider568: shows [Th 5s] (two pair, Aces and Tens)
Noah_D@vid: mucks hand
florin.cbtr: mucks hand
spider568 collected $0.08 from pot
*** SUMMARY ***
Total pot $0.08 | Rake $0
Board [8d 4h Ad Ah Td]
Seat 1: Vlao (small blind) showed [2s 5c] and lost with a pair of Aces
Seat 2: spider568 (big blind) showed [Th 5s] and won ($0.08) with two pair, Aces and Tens
Seat 3: d1ablo84 folded before Flop (didn't bet)
Seat 5: Noah_D@vid mucked
Seat 6: florin.cbtr (button) mucked


PokerStars Hand #238162191172:  Hold'em No Limit ($0.01/$0.02 USD) - 2022/08/23 2:21:58 ET
Table 'Achilles IV' 6-max Seat #1 is the button
Seat 1: Vlao ($2 in chips)
Seat 2: spider568 ($2.06 in chips)
Seat 3: d1ablo84 ($2.88 in chips)
Seat 5: Noah_D@vid ($0.78 in chips)
Seat 6: florin.cbtr ($2.31 in chips)
spider568: posts small blind $0.01
d1ablo84: posts big blind $0.02
*** HOLE CARDS ***
Noah_D@vid: folds
florin.cbtr: raises $0.04 to $0.06
Vlao: folds
spider568: folds
d1ablo84: folds
Uncalled bet ($0.04) returned to florin.cbtr
florin.cbtr collected $0.05 from pot
florin.cbtr: doesn't show hand
*** SUMMARY ***
Total pot $0.05 | Rake $0
Seat 1: Vlao (button) folded before Flop (didn't bet)
Seat 2: spider568 (small blind) folded before Flop
Seat 3: d1ablo84 (big blind) folded before Flop
Seat 5: Noah_D@vid folded before Flop (didn't bet)
Seat 6: florin.cbtr collected ($0.05)


PokerStars Hand #238162193476:  Hold'em No Limit ($0.01/$0.02 USD) - 2022/08/23 2:22:21 ET
Table 'Achilles IV' 6-max Seat #2 is the button
Seat 1: Vlao ($2 in chips)
Seat 2: spider568 ($2.05 in chips)
Seat 3: d1ablo84 ($2.86 in chips)
Seat 5: Noah_D@vid ($0.78 in chips)
Seat 6: florin.cbtr ($2.34 in chips)
d1ablo84: posts small blind $0.01
Noah_D@vid: posts big blind $0.02
*** HOLE CARDS ***
florin.cbtr: raises $0.06 to $0.08
Vlao: folds
spider568: calls $0.08
d1ablo84: folds
Noah_D@vid: folds
*** FLOP *** [Qs Ad 3d]
florin.cbtr: checks
spider568: checks
*** TURN *** [Qs Ad 3d] [8h]
florin.cbtr: bets $0.09
spider568: calls $0.09
*** RIVER *** [Qs Ad 3d 8h] [6s]
florin.cbtr: bets $0.36
spider568: folds
Uncalled bet ($0.36) returned to florin.cbtr
florin.cbtr collected $0.36 from pot
florin.cbtr: doesn't show hand
*** SUMMARY ***
Total pot $0.37 | Rake $0.01
Board [Qs Ad 3d 8h 6s]
Seat 1: Vlao folded before Flop (didn't bet)
Seat 2: spider568 (button) folded on the River
Seat 3: d1ablo84 (small blind) folded before Flop
Seat 5: Noah_D@vid (big blind) folded before Flop
Seat 6: florin.cbtr collected ($0.36)


PokerStars Hand #238162196921:  Hold'em No Limit ($0.01/$0.02 USD) - 2022/08/23 2:22:55 ET
Table 'Achilles IV' 6-max Seat #3 is the button
Seat 1: Vlao ($2 in chips)
Seat 2: spider568 ($2 in chips)
Seat 3: d1ablo84 ($2.85 in chips)
Seat 5: Noah_D@vid ($0.76 in chips)
Seat 6: florin.cbtr ($2.53 in chips)
Noah_D@vid: posts small blind $0.01
florin.cbtr: posts big blind $0.02
*** HOLE CARDS ***
Vlao: folds
spider568: calls $0.02
d1ablo84: folds
Noah_D@vid: folds
florin.cbtr: checks
*** FLOP *** [7s 8s Ad]
florin.cbtr: checks
spider568: checks
*** TURN *** [7s 8s Ad] [6s]
florin.cbtr: checks
spider568: checks
*** RIVER *** [7s 8s Ad 6s] [4s]
florin.cbtr: checks
spider568: checks
*** SHOW DOWN ***
florin.cbtr: shows [3s 2c] (a flush, Eight high)
spider568: mucks hand
florin.cbtr collected $0.05 from pot
*** SUMMARY ***
Total pot $0.05 | Rake $0
Board [7s 8s Ad 6s 4s]
Seat 1: Vlao folded before Flop (didn't bet)
Seat 2: spider568 mucked
Seat 3: d1ablo84 (button) folded before Flop (didn't bet)
Seat 5: Noah_D@vid (small blind) folded before Flop
Seat 6: florin.cbtr (big blind) showed [3s 2c] and won ($0.05) with a flush, Eight high


PokerStars Hand #238162200021:  Hold'em No Limit ($0.01/$0.02 USD) - 2022/08/23 2:23:25 ET
Table 'Achilles IV' 6-max Seat #5 is the button
Seat 1: Vlao ($2 in chips)
Seat 2: spider568 ($2 in chips)
Seat 3: d1ablo84 ($2.85 in chips)
Seat 5: Noah_D@vid ($0.75 in chips)
Seat 6: florin.cbtr ($2.56 in chips)
florin.cbtr: posts small blind $0.01
Vlao: posts big blind $0.02
*** HOLE CARDS ***
spider568: calls $0.02
d1ablo84: folds
Noah_D@vid: folds
florin.cbtr: calls $0.01
Vlao: checks
*** FLOP *** [5c Qd 3c]
florin.cbtr: checks
Vlao: checks
spider568: checks
*** TURN *** [5c Qd 3c] [Ac]
florin.cbtr: checks
Vlao: checks
spider568: checks
*** RIVER *** [5c Qd 3c Ac] [Ts]
florin.cbtr: checks
Vlao: checks
spider568: checks
*** SHOW DOWN ***
florin.cbtr: shows [4s 6s] (high card Ace)
Vlao: shows [9s 5d] (a pair of Fives)
spider568: shows [Jd Qs] (a pair of Queens)
spider568 collected $0.06 from pot
*** SUMMARY ***
Total pot $0.06 | Rake $0
Board [5c Qd 3c Ac Ts]
Seat 1: Vlao (big blind) showed [9s 5d] and lost with a pair of Fives
Seat 2: spider568 showed [Jd Qs] and won ($0.06) with a pair of Queens
Seat 3: d1ablo84 folded before Flop (didn't bet)
Seat 5: Noah_D@vid (button) folded before Flop (didn't bet)
Seat 6: florin.cbtr (small blind) showed [4s 6s] and lost with high card Ace


PokerStars Hand #238162203086:  Hold'em No Limit ($0.01/$0.02 USD) - 2022/08/23 2:23:55 ET
Table 'Achilles IV' 6-max Seat #6 is the button
Seat 1: Vlao ($2 in chips)
Seat 2: spider568 ($2.04 in chips)
Seat 3: d1ablo84 ($2.85 in chips)
Seat 5: Noah_D@vid ($0.75 in chips)
Seat 6: florin.cbtr ($2.54 in chips)
Vlao: posts small blind $0.01
spider568: posts big blind $0.02
*** HOLE CARDS ***
d1ablo84: folds
Noah_D@vid: folds
florin.cbtr: calls $0.02
Vlao: raises $0.06 to $0.08
spider568: folds
florin.cbtr: calls $0.06
*** FLOP *** [3d Jh Ah]
Vlao: bets $0.11
florin.cbtr: folds
Uncalled bet ($0.11) returned to Vlao
Vlao collected $0.17 from pot
*** SUMMARY ***
Total pot $0.18 | Rake $0.01
Board [3d Jh Ah]
Seat 1: Vlao (small blind) collected ($0.17)
Seat 2: spider568 (big blind) folded before Flop
Seat 3: d1ablo84 folded before Flop (didn't bet)
Seat 5: Noah_D@vid folded before Flop (didn't bet)
Seat 6: florin.cbtr (button) folded on the Flop


PokerStars Hand #238162205791:  Hold'em No Limit ($0.01/$0.02 USD) - 2022/08/23 2:24:22 ET
Table 'Achilles IV' 6-max Seat #1 is the button
Seat 1: Vlao ($2.09 in chips)
Seat 2: spider568 ($2.02 in chips)
Seat 3: d1ablo84 ($2.85 in chips)
Seat 5: Noah_D@vid ($0.75 in chips)
Seat 6: florin.cbtr ($2.46 in chips)
spider568: posts small blind $0.01
d1ablo84: posts big blind $0.02
*** HOLE CARDS ***
Noah_D@vid: folds
florin.cbtr: folds
Vlao: folds
spider568: folds
Uncalled bet ($0.01) returned to d1ablo84
d1ablo84 collected $0.02 from pot
d1ablo84: doesn't show hand
*** SUMMARY ***
Total pot $0.02 | Rake $0
Seat 1: Vlao (button) folded before Flop (didn't bet)
Seat 2: spider568 (small blind) folded before Flop
Seat 3: d1ablo84 (big blind) collected ($0.02)
Seat 5: Noah_D@vid folded before Flop (didn't bet)
Seat 6: florin.cbtr folded before Flop (didn't bet)


PokerStars Hand #238162206968:  Hold'em No Limit ($0.01/$0.02 USD) - 2022/08/23 2:24:33 ET
Table 'Achilles IV' 6-max Seat #2 is the button
Seat 1: Vlao ($2.09 in chips)
Seat 2: spider568 ($2.01 in chips)
Seat 3: d1ablo84 ($2.86 in chips)
Seat 5: Noah_D@vid ($0.75 in chips)
Seat 6: florin.cbtr ($2.46 in chips)
d1ablo84: posts small blind $0.01
Noah_D@vid: posts big blind $0.02
*** HOLE CARDS ***
florin.cbtr: calls $0.02
Vlao: folds
spider568: calls $0.02
d1ablo84: folds
Noah_D@vid: checks
*** FLOP *** [5c Jd Qh]
Noah_D@vid: checks
florin.cbtr: checks
spider568: bets $0.07
Noah_D@vid: folds
florin.cbtr: folds
Uncalled bet ($0.07) returned to spider568
spider568 collected $0.07 from pot
kizzle72 was removed from the table for failing to post
kizzle72 leaves the table
*** SUMMARY ***
Total pot $0.07 | Rake $0
Board [5c Jd Qh]
Seat 1: Vlao folded before Flop (didn't bet)
Seat 2: spider568 (button) collected ($0.07)
Seat 3: d1ablo84 (small blind) folded before Flop
Seat 5: Noah_D@vid (big blind) folded on the Flop
Seat 6: florin.cbtr folded on the Flop


PokerStars Hand #238162208992:  Hold'em No Limit ($0.01/$0.02 USD) - 2022/08/23 2:24:53 ET
Table 'Achilles IV' 6-max Seat #3 is the button
Seat 1: Vlao ($2.09 in chips)
Seat 2: spider568 ($2.06 in chips)
Seat 3: d1ablo84 ($2.85 in chips)
Seat 5: Noah_D@vid ($0.73 in chips)
Seat 6: florin.cbtr ($2.44 in chips)
Noah_D@vid: posts small blind $0.01
florin.cbtr: posts big blind $0.02
*** HOLE CARDS ***
Vlao: folds
spider568: calls $0.02
d1ablo84: folds
Noah_D@vid: folds
florin.cbtr: checks
*** FLOP *** [Ks 7d 8s]
BluffJobbbz joins the table at seat #4
florin.cbtr: checks
spider568: checks
*** TURN *** [Ks 7d 8s] [5s]
florin.cbtr: checks
spider568: checks
*** RIVER *** [Ks 7d 8s 5s] [Qh]
florin.cbtr: bets $0.02
spider568: calls $0.02
*** SHOW DOWN ***
florin.cbtr: shows [6c Ad] (high card Ace)
spider568: shows [Ah 6h] (high card Ace)
florin.cbtr collected $0.05 from pot
spider568 collected $0.04 from pot
*** SUMMARY ***
Total pot $0.09 | Rake $0
Board [Ks 7d 8s 5s Qh]
Seat 1: Vlao folded before Flop (didn't bet)
Seat 2: spider568 showed [Ah 6h] and won ($0.04) with high card Ace
Seat 3: d1ablo84 (button) folded before Flop (didn't bet)
Seat 5: Noah_D@vid (small blind) folded before Flop
Seat 6: florin.cbtr (big blind) showed [6c Ad] and won ($0.05) with high card Ace


PokerStars Hand #238162212114:  Hold'em No Limit ($0.01/$0.02 USD) - 2022/08/23 2:25:24 ET
Table 'Achilles IV' 6-max Seat #5 is the button
Seat 2: spider568 ($2.06 in chips)
Seat 3: d1ablo84 ($2.85 in chips)
Seat 5: Noah_D@vid ($0.72 in chips)
Seat 6: florin.cbtr ($2.45 in chips)
florin.cbtr: posts small blind $0.01
Vlao: is sitting out
spider568: posts big blind $0.02
BluffJobbbz: sits out
*** HOLE CARDS ***
d1ablo84: folds
Noah_D@vid: calls $0.02
florin.cbtr: calls $0.01
spider568: checks
*** FLOP *** [7h Jc 3s]
florin.cbtr: checks
spider568: bets $0.06
Noah_D@vid: calls $0.06
florin.cbtr: folds
*** TURN *** [7h Jc 3s] [As]
spider568: checks
Noah_D@vid: checks
*** RIVER *** [7h Jc 3s As] [4s]
spider568: bets $0.10
Noah_D@vid: calls $0.10
*** SHOW DOWN ***
spider568: shows [Tc 8c] (high card Ace)
Noah_D@vid: shows [8d 8s] (a pair of Eights)
Noah_D@vid collected $0.37 from pot
*** SUMMARY ***
Total pot $0.38 | Rake $0.01
Board [7h Jc 3s As 4s]
Seat 2: spider568 (big blind) showed [Tc 8c] and lost with high card Ace
Seat 3: d1ablo84 folded before Flop (didn't bet)
Seat 5: Noah_D@vid (button) showed [8d 8s] and won ($0.37) with a pair of Eights
Seat 6: florin.cbtr (small blind) folded on the Flop


PokerStars Hand #238162216439:  Hold'em No Limit ($0.01/$0.02 USD) - 2022/08/23 2:26:07 ET
Table 'Achilles IV' 6-max Seat #6 is the button
Seat 2: spider568 ($2 in chips)
Seat 3: d1ablo84 ($2.85 in chips)
Seat 5: Noah_D@vid ($0.91 in chips)
Seat 6: florin.cbtr ($2.43 in chips)
spider568: posts small blind $0.01
d1ablo84: posts big blind $0.02
BluffJobbbz: sits out
*** HOLE CARDS ***
Noah_D@vid: folds
florin.cbtr: folds
spider568: calls $0.01
d1ablo84: checks
*** FLOP *** [4s 8d Td]
spider568: checks
d1ablo84: checks
*** TURN *** [4s 8d Td] [4d]
spider568: checks
d1ablo84: checks
*** RIVER *** [4s 8d Td 4d] [6c]
spider568: bets $0.04
d1ablo84: folds
Uncalled bet ($0.04) returned to spider568
spider568 collected $0.04 from pot
*** SUMMARY ***
Total pot $0.04 | Rake $0
Board [4s 8d Td 4d 6c]
Seat 2: spider568 (small blind) collected ($0.04)
Seat 3: d1ablo84 (big blind) folded on the River
Seat 5: Noah_D@vid folded before Flop (didn't bet)
Seat 6: florin.cbtr (button) folded before Flop (didn't bet)


PokerStars Hand #238162220785:  Hold'em No Limit ($0.01/$0.02 USD) - 2022/08/23 2:26:51 ET
Table 'Achilles IV' 6-max Seat #2 is the button
Seat 2: spider568 ($2.02 in chips)
Seat 3: d1ablo84 ($2.83 in chips)
Seat 4: BluffJobbbz ($2 in chips)
Seat 5: Noah_D@vid ($0.91 in chips)
Seat 6: florin.cbtr ($2.43 in chips)
d1ablo84: posts small blind $0.01
BluffJobbbz: posts big blind $0.02
*** HOLE CARDS ***
Noah_D@vid: calls $0.02
florin.cbtr: raises $0.04 to $0.06
spider568: folds
d1ablo84: folds
BluffJobbbz: folds
Noah_D@vid: calls $0.04
*** FLOP *** [8d 2d 8h]
Noah_D@vid: checks
florin.cbtr: bets $0.07
Noah_D@vid: folds
Uncalled bet ($0.07) returned to florin.cbtr
florin.cbtr collected $0.14 from pot
florin.cbtr: doesn't show hand
*** SUMMARY ***
Total pot $0.15 | Rake $0.01
Board [8d 2d 8h]
Seat 2: spider568 (button) folded before Flop (didn't bet)
Seat 3: d1ablo84 (small blind) folded before Flop
Seat 4: BluffJobbbz (big blind) folded before Flop
Seat 5: Noah_D@vid folded on the Flop
Seat 6: florin.cbtr collected ($0.14)


PokerStars Hand #238162223715:  Hold'em No Limit ($0.01/$0.02 USD) - 2022/08/23 2:27:19 ET
Table 'Achilles IV' 6-max Seat #3 is the button
Seat 2: spider568 ($2.02 in chips)
Seat 3: d1ablo84 ($2.82 in chips)
Seat 4: BluffJobbbz ($2 in chips)
Seat 5: Noah_D@vid ($0.85 in chips)
Seat 6: florin.cbtr ($2.51 in chips)
BluffJobbbz: posts small blind $0.01
Noah_D@vid: posts big blind $0.02
*** HOLE CARDS ***
florin.cbtr: raises $0.06 to $0.08
spider568: calls $0.08
d1ablo84: folds
BluffJobbbz: folds
Noah_D@vid: folds
*** FLOP *** [4c 5s 5h]
florin.cbtr: bets $0.10
spider568: calls $0.10
*** TURN *** [4c 5s 5h] [8c]
florin.cbtr: bets $0.38
spider568: calls $0.38
*** RIVER *** [4c 5s 5h 8c] [Ts]
florin.cbtr: bets $1.95 and is all-in
spider568: folds
Uncalled bet ($1.95) returned to florin.cbtr
florin.cbtr collected $1.11 from pot
florin.cbtr: doesn't show hand
*** SUMMARY ***
Total pot $1.15 | Rake $0.04
Board [4c 5s 5h 8c Ts]
Seat 2: spider568 folded on the River
Seat 3: d1ablo84 (button) folded before Flop (didn't bet)
Seat 4: BluffJobbbz (small blind) folded before Flop
Seat 5: Noah_D@vid (big blind) folded before Flop
Seat 6: florin.cbtr collected ($1.11)


PokerStars Hand #238162226833:  Hold'em No Limit ($0.01/$0.02 USD) - 2022/08/23 2:27:49 ET
Table 'Achilles IV' 6-max Seat #4 is the button
Seat 2: spider568 ($2 in chips)
Seat 3: d1ablo84 ($2.82 in chips)
Seat 4: BluffJobbbz ($2 in chips)
Seat 5: Noah_D@vid ($0.83 in chips)
Seat 6: florin.cbtr ($3.06 in chips)
Noah_D@vid: posts small blind $0.01
florin.cbtr: posts big blind $0.02
*** HOLE CARDS ***
spider568: calls $0.02
d1ablo84: folds
BluffJobbbz: folds
Noah_D@vid: folds
florin.cbtr: checks
*** FLOP *** [2c Qs 4h]
florin.cbtr: checks
spider568: checks
*** TURN *** [2c Qs 4h] [5c]
florin.cbtr: bets $0.04
spider568: calls $0.04
*** RIVER *** [2c Qs 4h 5c] [Td]
florin.cbtr: bets $0.06
spider568: calls $0.06
*** SHOW DOWN ***
florin.cbtr: shows [4s 8d] (a pair of Fours)
spider568: shows [9c 5d] (a pair of Fives)
spider568 collected $0.24 from pot
*** SUMMARY ***
Total pot $0.25 | Rake $0.01
Board [2c Qs 4h 5c Td]
Seat 2: spider568 showed [9c 5d] and won ($0.24) with a pair of Fives
Seat 3: d1ablo84 folded before Flop (didn't bet)
Seat 4: BluffJobbbz (button) folded before Flop (didn't bet)
Seat 5: Noah_D@vid (small blind) folded before Flop
Seat 6: florin.cbtr (big blind) showed [4s 8d] and lost with a pair of Fours


PokerStars Hand #238162230573:  Hold'em No Limit ($0.01/$0.02 USD) - 2022/08/23 2:28:26 ET
Table 'Achilles IV' 6-max Seat #5 is the button
Seat 2: spider568 ($2.12 in chips)
Seat 3: d1ablo84 ($2.82 in chips)
Seat 4: BluffJobbbz ($2 in chips)
Seat 5: Noah_D@vid ($0.82 in chips)
Seat 6: florin.cbtr ($2.94 in chips)
florin.cbtr: posts small blind $0.01
spider568: posts big blind $0.02
*** HOLE CARDS ***
d1ablo84: raises $0.04 to $0.06
BluffJobbbz: folds
Noah_D@vid: folds
florin.cbtr: calls $0.05
spider568: calls $0.04
*** FLOP *** [8c 9d 7c]
florin.cbtr: bets $0.08
spider568: calls $0.08
d1ablo84: calls $0.08
*** TURN *** [8c 9d 7c] [8d]
florin.cbtr: bets $0.20
spider568: raises $0.20 to $0.40
d1ablo84: folds
florin.cbtr: calls $0.20
*** RIVER *** [8c 9d 7c 8d] [Ks]
florin.cbtr: checks
spider568: bets $1.18
florin.cbtr: folds
Uncalled bet ($1.18) returned to spider568
spider568 collected $1.18 from pot
*** SUMMARY ***
Total pot $1.22 | Rake $0.04
Board [8c 9d 7c 8d Ks]
Seat 2: spider568 (big blind) collected ($1.18)
Seat 3: d1ablo84 folded on the Turn
Seat 4: BluffJobbbz folded before Flop (didn't bet)
Seat 5: Noah_D@vid (button) folded before Flop (didn't bet)
Seat 6: florin.cbtr (small blind) folded on the River


PokerStars Hand #238162248152:  Hold'em No Limit ($0.01/$0.02 USD) - 2022/08/23 2:29:47 ET
Table 'Achilles IV' 6-max Seat #2 is the button
Seat 2: spider568 ($2.74 in chips)
Seat 3: d1ablo84 ($2.70 in chips)
Seat 4: BluffJobbbz ($2 in chips)
Seat 5: Noah_D@vid ($0.82 in chips)
Seat 6: florin.cbtr ($2.40 in chips)
d1ablo84: posts small blind $0.01
BluffJobbbz: posts big blind $0.02
Vlao: sits out
*** HOLE CARDS ***
Noah_D@vid: folds
florin.cbtr: folds
spider568: calls $0.02
d1ablo84: folds
BluffJobbbz: raises $0.08 to $0.10
spider568: folds
Uncalled bet ($0.08) returned to BluffJobbbz
BluffJobbbz collected $0.05 from pot
BluffJobbbz: doesn't show hand
*** SUMMARY ***
Total pot $0.05 | Rake $0
Seat 2: spider568 (button) folded before Flop
Seat 3: d1ablo84 (small blind) folded before Flop
Seat 4: BluffJobbbz (big blind) collected ($0.05)
Seat 5: Noah_D@vid folded before Flop (didn't bet)
Seat 6: florin.cbtr folded before Flop (didn't bet)


PokerStars Hand #238162245192:  Hold'em No Limit ($0.01/$0.02 USD) - 2022/08/23 2:29:18 ET
Table 'Achilles IV' 6-max Seat #6 is the button
Seat 2: spider568 ($2.76 in chips)
Seat 3: d1ablo84 ($2.68 in chips)
Seat 4: BluffJobbbz ($2 in chips)
Seat 5: Noah_D@vid ($0.82 in chips)
Seat 6: florin.cbtr ($2.40 in chips)
spider568: posts small blind $0.01
d1ablo84: posts big blind $0.02
*** HOLE CARDS ***
BluffJobbbz: folds
Noah_D@vid: folds
florin.cbtr: folds
spider568: calls $0.01
d1ablo84: checks
*** FLOP *** [4h 6c Jh]
spider568: checks
d1ablo84: checks
*** TURN *** [4h 6c Jh] [Js]
spider568: checks
d1ablo84: bets $0.02
spider568: folds
Uncalled bet ($0.02) returned to d1ablo84
d1ablo84 collected $0.04 from pot
d1ablo84: doesn't show hand
*** SUMMARY ***
Total pot $0.04 | Rake $0
Board [4h 6c Jh Js]
Seat 2: spider568 (small blind) folded on the Turn
Seat 3: d1ablo84 (big blind) collected ($0.04)
Seat 4: BluffJobbbz folded before Flop (didn't bet)
Seat 5: Noah_D@vid folded before Flop (didn't bet)
Seat 6: florin.cbtr (button) folded before Flop (didn't bet)


PokerStars Hand #238162249916:  Hold'em No Limit ($0.01/$0.02 USD) - 2022/08/23 2:30:05 ET
Table 'Achilles IV' 6-max Seat #3 is the button
Seat 2: spider568 ($2.72 in chips)
Seat 3: d1ablo84 ($2.69 in chips)
Seat 4: BluffJobbbz ($2.03 in chips)
Seat 5: Noah_D@vid ($0.82 in chips)
Seat 6: florin.cbtr ($2.40 in chips)
BluffJobbbz: posts small blind $0.01
Noah_D@vid: posts big blind $0.02
Vlao: sits out
*** HOLE CARDS ***
florin.cbtr: calls $0.02
spider568: calls $0.02
d1ablo84: folds
BluffJobbbz: folds
Noah_D@vid: checks
*** FLOP *** [8h 6d Qd]
Noah_D@vid: checks
florin.cbtr: checks
spider568: bets $0.07
Noah_D@vid: folds
florin.cbtr: calls $0.07
*** TURN *** [8h 6d Qd] [6s]
florin.cbtr: checks
spider568: bets $0.10
florin.cbtr: calls $0.10
*** RIVER *** [8h 6d Qd 6s] [3h]
florin.cbtr: checks
spider568: checks
*** SHOW DOWN ***
florin.cbtr: shows [9h 8c] (two pair, Eights and Sixes)
spider568: shows [Jd Qs] (two pair, Queens and Sixes)
spider568 collected $0.40 from pot
*** SUMMARY ***
Total pot $0.41 | Rake $0.01
Board [8h 6d Qd 6s 3h]
Seat 2: spider568 showed [Jd Qs] and won ($0.40) with two pair, Queens and Sixes
Seat 3: d1ablo84 (button) folded before Flop (didn't bet)
Seat 4: BluffJobbbz (small blind) folded before Flop
Seat 5: Noah_D@vid (big blind) folded on the Flop
Seat 6: florin.cbtr showed [9h 8c] and lost with two pair, Eights and Sixes


PokerStars Hand #238162260317:  Hold'em No Limit ($0.01/$0.02 USD) - 2022/08/23 2:30:45 ET
Table 'Achilles IV' 6-max Seat #4 is the button
Seat 2: spider568 ($2.93 in chips)
Seat 3: d1ablo84 ($2.69 in chips)
Seat 4: BluffJobbbz ($2.02 in chips)
Seat 5: Noah_D@vid ($0.80 in chips)
Seat 6: florin.cbtr ($2.21 in chips)
Noah_D@vid: posts small blind $0.01
florin.cbtr: posts big blind $0.02
Vlao: sits out
*** HOLE CARDS ***
spider568: calls $0.02
d1ablo84: folds
BluffJobbbz: calls $0.02
Noah_D@vid: calls $0.01
florin.cbtr: checks
*** FLOP *** [8s 4c 6d]
Noah_D@vid: bets $0.08
florin.cbtr: folds
spider568: calls $0.08
BluffJobbbz: folds
*** TURN *** [8s 4c 6d] [7h]
Noah_D@vid: checks
spider568: bets $0.10
Noah_D@vid: calls $0.10
*** RIVER *** [8s 4c 6d 7h] [3h]
Noah_D@vid: checks
spider568: checks
*** SHOW DOWN ***
Noah_D@vid: shows [Qh Qd] (a pair of Queens)
spider568: mucks hand
Noah_D@vid collected $0.42 from pot
*** SUMMARY ***
Total pot $0.44 | Rake $0.02
Board [8s 4c 6d 7h 3h]
Seat 2: spider568 mucked
Seat 3: d1ablo84 folded before Flop (didn't bet)
Seat 4: BluffJobbbz (button) folded on the Flop
Seat 5: Noah_D@vid (small blind) showed [Qh Qd] and won ($0.42) with a pair of Queens
Seat 6: florin.cbtr (big blind) folded on the Flop


PokerStars Hand #238162263983:  Hold'em No Limit ($0.01/$0.02 USD) - 2022/08/23 2:31:22 ET
Table 'Achilles IV' 6-max Seat #5 is the button
Seat 1: Vlao ($2.09 in chips)
Seat 2: spider568 ($2.73 in chips)
Seat 3: d1ablo84 ($2.69 in chips)
Seat 4: BluffJobbbz ($2 in chips)
Seat 5: Noah_D@vid ($1.02 in chips)
Seat 6: florin.cbtr ($2.19 in chips)
florin.cbtr: posts small blind $0.01
Vlao: posts big blind $0.02
*** HOLE CARDS ***
spider568: calls $0.02
d1ablo84 has timed out
d1ablo84: folds
BluffJobbbz: folds
Noah_D@vid: calls $0.02
florin.cbtr: raises $0.04 to $0.06
Vlao: folds
spider568: calls $0.04
Noah_D@vid: calls $0.04
*** FLOP *** [8d 4h 3s]
florin.cbtr: bets $0.10
spider568: calls $0.10
Noah_D@vid: folds
*** TURN *** [8d 4h 3s] [2c]
florin.cbtr: bets $0.30
spider568: folds
Uncalled bet ($0.30) returned to florin.cbtr
florin.cbtr collected $0.39 from pot
florin.cbtr: doesn't show hand
*** SUMMARY ***
Total pot $0.40 | Rake $0.01
Board [8d 4h 3s 2c]
Seat 1: Vlao (big blind) folded before Flop
Seat 2: spider568 folded on the Turn
Seat 3: d1ablo84 folded before Flop (didn't bet)
Seat 4: BluffJobbbz folded before Flop (didn't bet)
Seat 5: Noah_D@vid (button) folded on the Flop
Seat 6: florin.cbtr (small blind) collected ($0.39)


PokerStars Hand #238162269733:  Hold'em No Limit ($0.01/$0.02 USD) - 2022/08/23 2:32:18 ET
Table 'Achilles IV' 6-max Seat #6 is the button
Seat 1: Vlao ($2.07 in chips)
Seat 2: spider568 ($2.57 in chips)
Seat 3: d1ablo84 ($2.69 in chips)
Seat 4: BluffJobbbz ($2 in chips)
Seat 5: Noah_D@vid ($0.96 in chips)
Seat 6: florin.cbtr ($2.42 in chips)
Vlao: posts small blind $0.01
spider568: posts big blind $0.02
*** HOLE CARDS ***
d1ablo84: folds
BluffJobbbz: folds
Noah_D@vid: calls $0.02
florin.cbtr: calls $0.02
Vlao: calls $0.01
spider568: checks
*** FLOP *** [Jd 3c Ac]
Vlao: checks
spider568: checks
Noah_D@vid: checks
florin.cbtr: checks
*** TURN *** [Jd 3c Ac] [7h]
Vlao: checks
spider568: bets $0.04
Noah_D@vid: calls $0.04
florin.cbtr: calls $0.04
Vlao: folds
*** RIVER *** [Jd 3c Ac 7h] [4h]
spider568: checks
Noah_D@vid: checks
florin.cbtr: checks
*** SHOW DOWN ***
spider568: shows [8d 8h] (a pair of Eights)
Noah_D@vid: shows [Th Js] (a pair of Jacks)
florin.cbtr: mucks hand
Noah_D@vid collected $0.19 from pot
*** SUMMARY ***
Total pot $0.20 | Rake $0.01
Board [Jd 3c Ac 7h 4h]
Seat 1: Vlao (small blind) folded on the Turn
Seat 2: spider568 (big blind) showed [8d 8h] and lost with a pair of Eights
Seat 3: d1ablo84 folded before Flop (didn't bet)
Seat 4: BluffJobbbz folded before Flop (didn't bet)
Seat 5: Noah_D@vid showed [Th Js] and won ($0.19) with a pair of Jacks
Seat 6: florin.cbtr (button) mucked


PokerStars Hand #238162286309:  Hold'em No Limit ($0.01/$0.02 USD) - 2022/08/23 2:33:42 ET
Table 'Achilles IV' 6-max Seat #2 is the button
Seat 1: Vlao ($2.05 in chips)
Seat 2: spider568 ($2.50 in chips)
Seat 3: d1ablo84 ($2.63 in chips)
Seat 4: BluffJobbbz ($2 in chips)
Seat 5: Noah_D@vid ($1.16 in chips)
Seat 6: florin.cbtr ($2.36 in chips)
d1ablo84: posts small blind $0.01
BluffJobbbz: posts big blind $0.02
*** HOLE CARDS ***
Noah_D@vid: calls $0.02
florin.cbtr: calls $0.02
Vlao: folds
spider568: calls $0.02
d1ablo84: folds
BluffJobbbz: checks
*** FLOP *** [Ks 9c Th]
BluffJobbbz: checks
Noah_D@vid: checks
florin.cbtr: checks
spider568: bets $0.04
BluffJobbbz: folds
Noah_D@vid: calls $0.04
florin.cbtr: folds
*** TURN *** [Ks 9c Th] [3d]
Noah_D@vid: checks
spider568: checks
*** RIVER *** [Ks 9c Th 3d] [9h]
Noah_D@vid: bets $0.02
spider568: calls $0.02
*** SHOW DOWN ***
Noah_D@vid: shows [Ts Ad] (two pair, Tens and Nines)
spider568: mucks hand
Noah_D@vid collected $0.20 from pot
*** SUMMARY ***
Total pot $0.21 | Rake $0.01
Board [Ks 9c Th 3d 9h]
Seat 1: Vlao folded before Flop (didn't bet)
Seat 2: spider568 (button) mucked
Seat 3: d1ablo84 (small blind) folded before Flop
Seat 4: BluffJobbbz (big blind) folded on the Flop
Seat 5: Noah_D@vid showed [Ts Ad] and won ($0.20) with two pair, Tens and Nines
Seat 6: florin.cbtr folded on the Flop


PokerStars Hand #238162293139:  Hold'em No Limit ($0.01/$0.02 USD) - 2022/08/23 2:34:50 ET
Table 'Achilles IV' 6-max Seat #3 is the button
Seat 1: Vlao ($2.05 in chips)
Seat 2: spider568 ($2.42 in chips)
Seat 3: d1ablo84 ($2.62 in chips)
Seat 4: BluffJobbbz ($2 in chips)
Seat 5: Noah_D@vid ($1.28 in chips)
Seat 6: florin.cbtr ($2.34 in chips)
BluffJobbbz: posts small blind $0.01
Noah_D@vid: posts big blind $0.02
*** HOLE CARDS ***
florin.cbtr: raises $0.04 to $0.06
Vlao: folds
spider568: folds
d1ablo84: raises $0.12 to $0.18
BluffJobbbz: folds
Noah_D@vid: folds
florin.cbtr: calls $0.12
*** FLOP *** [5d Js 6c]
florin.cbtr: checks
d1ablo84: bets $0.20
florin.cbtr: calls $0.20
*** TURN *** [5d Js 6c] [6d]
florin.cbtr: checks
d1ablo84: checks
*** RIVER *** [5d Js 6c 6d] [6h]
florin.cbtr: bets $0.50
d1ablo84: raises $1.74 to $2.24 and is all-in
florin.cbtr: calls $1.46 and is all-in
Uncalled bet ($0.28) returned to d1ablo84
*** SHOW DOWN ***
d1ablo84: shows [Kd Kc] (a full house, Sixes full of Kings)
florin.cbtr: shows [6s Ad] (four of a kind, Sixes)
florin.cbtr collected $4.55 from pot
*** SUMMARY ***
Total pot $4.71 | Rake $0.16
Board [5d Js 6c 6d 6h]
Seat 1: Vlao folded before Flop (didn't bet)
Seat 2: spider568 folded before Flop (didn't bet)
Seat 3: d1ablo84 (button) showed [Kd Kc] and lost with a full house, Sixes full of Kings
Seat 4: BluffJobbbz (small blind) folded before Flop
Seat 5: Noah_D@vid (big blind) folded before Flop
Seat 6: florin.cbtr showed [6s Ad] and won ($4.55) with four of a kind, Sixes


PokerStars Hand #238162301635:  Hold'em No Limit ($0.01/$0.02 USD) - 2022/08/23 2:36:14 ET
Table 'Achilles IV' 6-max Seat #4 is the button
Seat 1: Vlao ($2.05 in chips)
Seat 2: spider568 ($2.42 in chips)
Seat 3: d1ablo84 ($2 in chips)
Seat 4: BluffJobbbz ($2 in chips)
Seat 5: Noah_D@vid ($1.26 in chips)
Seat 6: florin.cbtr ($4.55 in chips)
Noah_D@vid: posts small blind $0.01
florin.cbtr: posts big blind $0.02
*** HOLE CARDS ***
Vlao: raises $0.03 to $0.05
spider568: calls $0.05
d1ablo84: folds
BluffJobbbz: folds
Noah_D@vid: calls $0.04
florin.cbtr: calls $0.03
*** FLOP *** [5c 9h Qs]
Noah_D@vid: checks
florin.cbtr: checks
Vlao: bets $0.15
spider568: folds
Noah_D@vid: folds
florin.cbtr: folds
Uncalled bet ($0.15) returned to Vlao
Vlao collected $0.19 from pot
*** SUMMARY ***
Total pot $0.20 | Rake $0.01
Board [5c 9h Qs]
Seat 1: Vlao collected ($0.19)
Seat 2: spider568 folded on the Flop
Seat 3: d1ablo84 folded before Flop (didn't bet)
Seat 4: BluffJobbbz (button) folded before Flop (didn't bet)
Seat 5: Noah_D@vid (small blind) folded on the Flop
Seat 6: florin.cbtr (big blind) folded on the Flop


PokerStars Hand #238162305449:  Hold'em No Limit ($0.01/$0.02 USD) - 2022/08/23 2:36:51 ET
Table 'Achilles IV' 6-max Seat #5 is the button
Seat 1: Vlao ($2.19 in chips)
Seat 2: spider568 ($2.37 in chips)
Seat 3: d1ablo84 ($2 in chips)
Seat 4: BluffJobbbz ($2 in chips)
Seat 5: Noah_D@vid ($1.21 in chips)
Seat 6: florin.cbtr ($4.50 in chips)
florin.cbtr: posts small blind $0.01
Vlao: posts big blind $0.02
*** HOLE CARDS ***
spider568: calls $0.02
d1ablo84: folds
BluffJobbbz: folds
Noah_D@vid: folds
florin.cbtr: folds
Vlao: checks
*** FLOP *** [6s 8s 4s]
Vlao: checks
spider568: checks
*** TURN *** [6s 8s 4s] [As]
Vlao: checks
spider568: bets $0.05
Vlao: folds
Uncalled bet ($0.05) returned to spider568
spider568 collected $0.05 from pot
*** SUMMARY ***
Total pot $0.05 | Rake $0
Board [6s 8s 4s As]
Seat 1: Vlao (big blind) folded on the Turn
Seat 2: spider568 collected ($0.05)
Seat 3: d1ablo84 folded before Flop (didn't bet)
Seat 4: BluffJobbbz folded before Flop (didn't bet)
Seat 5: Noah_D@vid (button) folded before Flop (didn't bet)
Seat 6: florin.cbtr (small blind) folded before Flop


PokerStars Hand #238162308054:  Hold'em No Limit ($0.01/$0.02 USD) - 2022/08/23 2:37:16 ET
Table 'Achilles IV' 6-max Seat #6 is the button
Seat 1: Vlao ($2.17 in chips)
Seat 2: spider568 ($2.40 in chips)
Seat 3: d1ablo84 ($2 in chips)
Seat 4: BluffJobbbz ($2 in chips)
Seat 5: Noah_D@vid ($1.21 in chips)
Seat 6: florin.cbtr ($4.49 in chips)
Vlao: posts small blind $0.01
spider568: posts big blind $0.02
*** HOLE CARDS ***
d1ablo84: folds
BluffJobbbz: raises $0.04 to $0.06
Noah_D@vid: folds
florin.cbtr: calls $0.06
Vlao: folds
spider568: folds
*** FLOP *** [8s 7c 8h]
BluffJobbbz: bets $0.04
florin.cbtr: folds
Uncalled bet ($0.04) returned to BluffJobbbz
BluffJobbbz collected $0.14 from pot
BluffJobbbz: doesn't show hand
*** SUMMARY ***
Total pot $0.15 | Rake $0.01
Board [8s 7c 8h]
Seat 1: Vlao (small blind) folded before Flop
Seat 2: spider568 (big blind) folded before Flop
Seat 3: d1ablo84 folded before Flop (didn't bet)
Seat 4: BluffJobbbz collected ($0.14)
Seat 5: Noah_D@vid folded before Flop (didn't bet)
Seat 6: florin.cbtr (button) folded on the Flop


PokerStars Hand #238162310908:  Hold'em No Limit ($0.01/$0.02 USD) - 2022/08/23 2:37:44 ET
Table 'Achilles IV' 6-max Seat #1 is the button
Seat 1: Vlao ($2.16 in chips)
Seat 2: spider568 ($2.38 in chips)
Seat 3: d1ablo84 ($2 in chips)
Seat 4: BluffJobbbz ($2.08 in chips)
Seat 5: Noah_D@vid ($1.21 in chips)
Seat 6: florin.cbtr ($4.43 in chips)
spider568: posts small blind $0.01
d1ablo84: posts big blind $0.02
*** HOLE CARDS ***
BluffJobbbz: folds
Noah_D@vid: folds
florin.cbtr: raises $0.04 to $0.06
Vlao: folds
spider568: folds
d1ablo84: folds
Uncalled bet ($0.04) returned to florin.cbtr
florin.cbtr collected $0.05 from pot
florin.cbtr: doesn't show hand
*** SUMMARY ***
Total pot $0.05 | Rake $0
Seat 1: Vlao (button) folded before Flop (didn't bet)
Seat 2: spider568 (small blind) folded before Flop
Seat 3: d1ablo84 (big blind) folded before Flop
Seat 4: BluffJobbbz folded before Flop (didn't bet)
Seat 5: Noah_D@vid folded before Flop (didn't bet)
Seat 6: florin.cbtr collected ($0.05)


PokerStars Hand #238162312171:  Hold'em No Limit ($0.01/$0.02 USD) - 2022/08/23 2:37:55 ET
Table 'Achilles IV' 6-max Seat #2 is the button
Seat 1: Vlao ($2.16 in chips)
Seat 2: spider568 ($2.37 in chips)
Seat 3: d1ablo84 ($2 in chips)
Seat 4: BluffJobbbz ($2.08 in chips)
Seat 5: Noah_D@vid ($1.21 in chips)
Seat 6: florin.cbtr ($4.46 in chips)
d1ablo84: posts small blind $0.01
BluffJobbbz: posts big blind $0.02
*** HOLE CARDS ***
Noah_D@vid: folds
florin.cbtr: raises $0.04 to $0.06
Vlao: calls $0.06
spider568: calls $0.06
d1ablo84: folds
BluffJobbbz: folds
*** FLOP *** [Qs 5h 3h]
florin.cbtr: checks
Vlao: checks
spider568: bets $0.10
florin.cbtr: folds
Vlao: calls $0.10
*** TURN *** [Qs 5h 3h] [2d]
Vlao: checks
spider568: bets $0.12
Vlao: calls $0.12
*** RIVER *** [Qs 5h 3h 2d] [8c]
Vlao: checks
spider568: checks
*** SHOW DOWN ***
Vlao: shows [4d 3d] (a pair of Threes)
spider568: shows [Qd Ks] (a pair of Queens)
spider568 collected $0.63 from pot
*** SUMMARY ***
Total pot $0.65 | Rake $0.02
Board [Qs 5h 3h 2d 8c]
Seat 1: Vlao showed [4d 3d] and lost with a pair of Threes
Seat 2: spider568 (button) showed [Qd Ks] and won ($0.63) with a pair of Queens
Seat 3: d1ablo84 (small blind) folded before Flop
Seat 4: BluffJobbbz (big blind) folded before Flop
Seat 5: Noah_D@vid folded before Flop (didn't bet)
Seat 6: florin.cbtr folded on the Flop


PokerStars Hand #238162318114:  Hold'em No Limit ($0.01/$0.02 USD) - 2022/08/23 2:38:53 ET
Table 'Achilles IV' 6-max Seat #3 is the button
Seat 1: Vlao ($2 in chips)
Seat 2: spider568 ($2.72 in chips)
Seat 3: d1ablo84 ($2 in chips)
Seat 4: BluffJobbbz ($2.06 in chips)
Seat 5: Noah_D@vid ($1.21 in chips)
Seat 6: florin.cbtr ($4.40 in chips)
BluffJobbbz: posts small blind $0.01
Noah_D@vid: posts big blind $0.02
*** HOLE CARDS ***
florin.cbtr: folds
florin.cbtr leaves the table
Vlao: raises $0.03 to $0.05
spider568: calls $0.05
Koresh153 joins the table at seat #6
d1ablo84: folds
BluffJobbbz: folds
Noah_D@vid: calls $0.03
*** FLOP *** [Tc Qh 7h]
Noah_D@vid: checks
Vlao: bets $0.10
spider568: calls $0.10
Noah_D@vid: folds
*** TURN *** [Tc Qh 7h] [5s]
Vlao: bets $0.28
spider568: folds
Uncalled bet ($0.28) returned to Vlao
Vlao collected $0.35 from pot
*** SUMMARY ***
Total pot $0.36 | Rake $0.01
Board [Tc Qh 7h 5s]
Seat 1: Vlao collected ($0.35)
Seat 2: spider568 folded on the Turn
Seat 3: d1ablo84 (button) folded before Flop (didn't bet)
Seat 4: BluffJobbbz (small blind) folded before Flop
Seat 5: Noah_D@vid (big blind) folded on the Flop
Seat 6: florin.cbtr folded before Flop (didn't bet)


PokerStars Hand #238162323856:  Hold'em No Limit ($0.01/$0.02 USD) - 2022/08/23 2:39:48 ET
Table 'Achilles IV' 6-max Seat #4 is the button
Seat 1: Vlao ($2.20 in chips)
Seat 2: spider568 ($2.57 in chips)
Seat 3: d1ablo84 ($2 in chips)
Seat 4: BluffJobbbz ($2.05 in chips)
Seat 5: Noah_D@vid ($1.16 in chips)
Seat 6: Koresh153 ($2.01 in chips)
Noah_D@vid: posts small blind $0.01
Koresh153: posts big blind $0.02
*** HOLE CARDS ***
Vlao: folds
spider568: calls $0.02
d1ablo84: folds
BluffJobbbz: folds
Noah_D@vid: folds
Koresh153: checks
*** FLOP *** [2s 8h Qd]
Koresh153: checks
spider568: bets $0.05
Koresh153: folds
Uncalled bet ($0.05) returned to spider568
spider568 collected $0.05 from pot
*** SUMMARY ***
Total pot $0.05 | Rake $0
Board [2s 8h Qd]
Seat 1: Vlao folded before Flop (didn't bet)
Seat 2: spider568 collected ($0.05)
Seat 3: d1ablo84 folded before Flop (didn't bet)
Seat 4: BluffJobbbz (button) folded before Flop (didn't bet)
Seat 5: Noah_D@vid (small blind) folded before Flop
Seat 6: Koresh153 (big blind) folded on the Flop


PokerStars Hand #238162328112:  Hold'em No Limit ($0.01/$0.02 USD) - 2022/08/23 2:40:30 ET
Table 'Achilles IV' 6-max Seat #5 is the button
Seat 1: Vlao ($2.20 in chips)
Seat 2: spider568 ($2.60 in chips)
Seat 3: d1ablo84 ($2 in chips)
Seat 4: BluffJobbbz ($2.05 in chips)
Seat 5: Noah_D@vid ($1.15 in chips)
Seat 6: Koresh153 ($1.99 in chips)
Koresh153: posts small blind $0.01
Vlao: posts big blind $0.02
*** HOLE CARDS ***
spider568: folds
d1ablo84: folds
BluffJobbbz: folds
Noah_D@vid: calls $0.02
Koresh153: folds
Vlao: checks
*** FLOP *** [Th 5c 7s]
Vlao: checks
Noah_D@vid: checks
*** TURN *** [Th 5c 7s] [3h]
Vlao: checks
Noah_D@vid: checks
*** RIVER *** [Th 5c 7s 3h] [4s]
Vlao: checks
Noah_D@vid: checks
*** SHOW DOWN ***
Vlao: shows [Kh 2s] (high card King)
Noah_D@vid: shows [Jd Kd] (high card King - Jack kicker)
Noah_D@vid collected $0.05 from pot
*** SUMMARY ***
Total pot $0.05 | Rake $0
Board [Th 5c 7s 3h 4s]
Seat 1: Vlao (big blind) showed [Kh 2s] and lost with high card King
Seat 2: spider568 folded before Flop (didn't bet)
Seat 3: d1ablo84 folded before Flop (didn't bet)
Seat 4: BluffJobbbz folded before Flop (didn't bet)
Seat 5: Noah_D@vid (button) showed [Jd Kd] and won ($0.05) with high card King
Seat 6: Koresh153 (small blind) folded before Flop


PokerStars Hand #238162331020:  Hold'em No Limit ($0.01/$0.02 USD) - 2022/08/23 2:40:58 ET
Table 'Achilles IV' 6-max Seat #6 is the button
Seat 1: Vlao ($2.18 in chips)
Seat 2: spider568 ($2.60 in chips)
Seat 3: d1ablo84 ($2 in chips)
Seat 4: BluffJobbbz ($2.05 in chips)
Seat 5: Noah_D@vid ($1.18 in chips)
Seat 6: Koresh153 ($1.98 in chips)
Vlao: posts small blind $0.01
spider568: posts big blind $0.02
*** HOLE CARDS ***
d1ablo84: folds
BluffJobbbz: folds
Noah_D@vid: folds
d1ablo84 leaves the table
Koresh153: folds
DobermanBY joins the table at seat #3
Vlao: folds
Uncalled bet ($0.01) returned to spider568
spider568 collected $0.02 from pot
*** SUMMARY ***
Total pot $0.02 | Rake $0
Seat 1: Vlao (small blind) folded before Flop
Seat 2: spider568 (big blind) collected ($0.02)
Seat 3: d1ablo84 folded before Flop (didn't bet)
Seat 4: BluffJobbbz folded before Flop (didn't bet)
Seat 5: Noah_D@vid folded before Flop (didn't bet)
Seat 6: Koresh153 (button) folded before Flop (didn't bet)


PokerStars Hand #238162332264:  Hold'em No Limit ($0.01/$0.02 USD) - 2022/08/23 2:41:11 ET
Table 'Achilles IV' 6-max Seat #1 is the button
Seat 1: Vlao ($2.17 in chips)
Seat 2: spider568 ($2.61 in chips)
Seat 3: DobermanBY ($2 in chips)
Seat 4: BluffJobbbz ($2.05 in chips)
Seat 5: Noah_D@vid ($1.18 in chips)
Seat 6: Koresh153 ($1.98 in chips)
spider568: posts small blind $0.01
DobermanBY: posts big blind $0.02
*** HOLE CARDS ***
BluffJobbbz: folds
Noah_D@vid: folds
Koresh153 has timed out
Koresh153: folds
Vlao: folds
spider568: calls $0.01
DobermanBY: raises $0.04 to $0.06
spider568: calls $0.04
*** FLOP *** [Th Jh 4h]
spider568: checks
DobermanBY: checks
*** TURN *** [Th Jh 4h] [5s]
spider568: bets $0.06
DobermanBY: folds
Uncalled bet ($0.06) returned to spider568
spider568 collected $0.12 from pot
*** SUMMARY ***
Total pot $0.12 | Rake $0
Board [Th Jh 4h 5s]
Seat 1: Vlao (button) folded before Flop (didn't bet)
Seat 2: spider568 (small blind) collected ($0.12)
Seat 3: DobermanBY (big blind) folded on the Turn
Seat 4: BluffJobbbz folded before Flop (didn't bet)
Seat 5: Noah_D@vid folded before Flop (didn't bet)
Seat 6: Koresh153 folded before Flop (didn't bet)


PokerStars Hand #238162338515:  Hold'em No Limit ($0.01/$0.02 USD) - 2022/08/23 2:42:12 ET
Table 'Achilles IV' 6-max Seat #2 is the button
Seat 1: Vlao ($2.17 in chips)
Seat 2: spider568 ($2.67 in chips)
Seat 3: DobermanBY ($2 in chips)
Seat 4: BluffJobbbz ($2.05 in chips)
Seat 5: Noah_D@vid ($1.18 in chips)
Seat 6: Koresh153 ($1.98 in chips)
DobermanBY: posts small blind $0.01
BluffJobbbz: posts big blind $0.02
*** HOLE CARDS ***
Noah_D@vid: folds
Koresh153: folds
Vlao: folds
spider568: calls $0.02
DobermanBY: folds
BluffJobbbz: checks
*** FLOP *** [Tc Qh Th]
BluffJobbbz: checks
spider568: checks
*** TURN *** [Tc Qh Th] [Qd]
BluffJobbbz: bets $0.02
spider568: folds
Uncalled bet ($0.02) returned to BluffJobbbz
BluffJobbbz collected $0.05 from pot
BluffJobbbz: doesn't show hand
*** SUMMARY ***
Total pot $0.05 | Rake $0
Board [Tc Qh Th Qd]
Seat 1: Vlao folded before Flop (didn't bet)
Seat 2: spider568 (button) folded on the Turn
Seat 3: DobermanBY (small blind) folded before Flop
Seat 4: BluffJobbbz (big blind) collected ($0.05)
Seat 5: Noah_D@vid folded before Flop (didn't bet)
Seat 6: Koresh153 folded before Flop (didn't bet)


PokerStars Hand #238162341546:  Hold'em No Limit ($0.01/$0.02 USD) - 2022/08/23 2:42:41 ET
Table 'Achilles IV' 6-max Seat #3 is the button
Seat 1: Vlao ($2.17 in chips)
Seat 2: spider568 ($2.65 in chips)
Seat 3: DobermanBY ($2 in chips)
Seat 4: BluffJobbbz ($2.08 in chips)
Seat 5: Noah_D@vid ($1.18 in chips)
Seat 6: Koresh153 ($1.98 in chips)
BluffJobbbz: posts small blind $0.01
Noah_D@vid: posts big blind $0.02
*** HOLE CARDS ***
Koresh153: folds
Vlao: folds
spider568: calls $0.02
DobermanBY: folds
BluffJobbbz: raises $0.08 to $0.10
Noah_D@vid: folds
spider568: folds
Uncalled bet ($0.08) returned to BluffJobbbz
BluffJobbbz collected $0.06 from pot
BluffJobbbz: doesn't show hand
*** SUMMARY ***
Total pot $0.06 | Rake $0
Seat 1: Vlao folded before Flop (didn't bet)
Seat 2: spider568 folded before Flop
Seat 3: DobermanBY (button) folded before Flop (didn't bet)
Seat 4: BluffJobbbz (small blind) collected ($0.06)
Seat 5: Noah_D@vid (big blind) folded before Flop
Seat 6: Koresh153 folded before Flop (didn't bet)


PokerStars Hand #238162344231:  Hold'em No Limit ($0.01/$0.02 USD) - 2022/08/23 2:43:07 ET
Table 'Achilles IV' 6-max Seat #4 is the button
Seat 1: Vlao ($2.17 in chips)
Seat 2: spider568 ($2.63 in chips)
Seat 3: DobermanBY ($2 in chips)
Seat 4: BluffJobbbz ($2.12 in chips)
Seat 5: Noah_D@vid ($1.16 in chips)
Seat 6: Koresh153 ($1.98 in chips)
Noah_D@vid: posts small blind $0.01
Koresh153: posts big blind $0.02
*** HOLE CARDS ***
Vlao: folds
spider568: calls $0.02
DobermanBY: raises $0.04 to $0.06
BluffJobbbz: folds
Noah_D@vid: folds
Koresh153: folds
spider568: calls $0.04
*** FLOP *** [5s Kh 2h]
spider568: checks
DobermanBY: checks
*** TURN *** [5s Kh 2h] [3h]
spider568: bets $0.07
DobermanBY: calls $0.07
*** RIVER *** [5s Kh 2h 3h] [8d]
spider568: checks
DobermanBY: checks
*** SHOW DOWN ***
spider568: shows [Th Kd] (a pair of Kings)
DobermanBY: mucks hand
spider568 collected $0.28 from pot
*** SUMMARY ***
Total pot $0.29 | Rake $0.01
Board [5s Kh 2h 3h 8d]
Seat 1: Vlao folded before Flop (didn't bet)
Seat 2: spider568 showed [Th Kd] and won ($0.28) with a pair of Kings
Seat 3: DobermanBY mucked
Seat 4: BluffJobbbz (button) folded before Flop (didn't bet)
Seat 5: Noah_D@vid (small blind) folded before Flop
Seat 6: Koresh153 (big blind) folded before Flop


PokerStars Hand #238162347789:  Hold'em No Limit ($0.01/$0.02 USD) - 2022/08/23 2:43:42 ET
Table 'Achilles IV' 6-max Seat #5 is the button
Seat 1: Vlao ($2.17 in chips)
Seat 2: spider568 ($2.78 in chips)
Seat 3: DobermanBY ($2 in chips)
Seat 4: BluffJobbbz ($2.12 in chips)
Seat 5: Noah_D@vid ($1.15 in chips)
Seat 6: Koresh153 ($1.96 in chips)
Koresh153: posts small blind $0.01
Vlao: posts big blind $0.02
*** HOLE CARDS ***
spider568: calls $0.02
DobermanBY: folds
BluffJobbbz: raises $0.07 to $0.09
Noah_D@vid: folds
Koresh153: folds
Vlao: folds
spider568: folds
Uncalled bet ($0.07) returned to BluffJobbbz
BluffJobbbz collected $0.07 from pot
BluffJobbbz: doesn't show hand
*** SUMMARY ***
Total pot $0.07 | Rake $0
Seat 1: Vlao (big blind) folded before Flop
Seat 2: spider568 folded before Flop
Seat 3: DobermanBY folded before Flop (didn't bet)
Seat 4: BluffJobbbz collected ($0.07)
Seat 5: Noah_D@vid (button) folded before Flop (didn't bet)
Seat 6: Koresh153 (small blind) folded before Flop


PokerStars Hand #238162350392:  Hold'em No Limit ($0.01/$0.02 USD) - 2022/08/23 2:44:07 ET
Table 'Achilles IV' 6-max Seat #6 is the button
Seat 1: Vlao ($2.15 in chips)
Seat 2: spider568 ($2.76 in chips)
Seat 3: DobermanBY ($2 in chips)
Seat 4: BluffJobbbz ($2.17 in chips)
Seat 5: Noah_D@vid ($1.15 in chips)
Seat 6: Koresh153 ($1.95 in chips)
Vlao: posts small blind $0.01
spider568: posts big blind $0.02
*** HOLE CARDS ***
DobermanBY: folds
BluffJobbbz: raises $0.04 to $0.06
Noah_D@vid: folds
Koresh153: calls $0.06
Vlao: folds
spider568: calls $0.04
*** FLOP *** [2s Tc 7d]
spider568: checks
BluffJobbbz: bets $0.06
Koresh153: folds
spider568: calls $0.06
*** TURN *** [2s Tc 7d] [9d]
spider568: bets $0.10
BluffJobbbz: calls $0.10
*** RIVER *** [2s Tc 7d 9d] [Ah]
spider568: bets $0.10
BluffJobbbz: folds
Uncalled bet ($0.10) returned to spider568
spider568 collected $0.49 from pot
*** SUMMARY ***
Total pot $0.51 | Rake $0.02
Board [2s Tc 7d 9d Ah]
Seat 1: Vlao (small blind) folded before Flop
Seat 2: spider568 (big blind) collected ($0.49)
Seat 3: DobermanBY folded before Flop (didn't bet)
Seat 4: BluffJobbbz folded on the River
Seat 5: Noah_D@vid folded before Flop (didn't bet)
Seat 6: Koresh153 (button) folded on the Flop


PokerStars Hand #238162366575:  Hold'em No Limit ($0.01/$0.02 USD) - 2022/08/23 2:46:44 ET
Table 'Achilles IV' 6-max Seat #3 is the button
Seat 1: Vlao ($2.14 in chips)
Seat 3: DobermanBY ($2.01 in chips)
Seat 4: BluffJobbbz ($2 in chips)
Seat 5: Noah_D@vid ($1.15 in chips)
Seat 6: Koresh153 ($1.89 in chips)
BluffJobbbz: posts small blind $0.01
Noah_D@vid: posts big blind $0.02
*** HOLE CARDS ***
Koresh153: folds
Vlao: folds
DobermanBY: folds
BluffJobbbz: folds
Uncalled bet ($0.01) returned to Noah_D@vid
Noah_D@vid collected $0.02 from pot
*** SUMMARY ***
Total pot $0.02 | Rake $0
Seat 1: Vlao folded before Flop (didn't bet)
Seat 3: DobermanBY (button) folded before Flop (didn't bet)
Seat 4: BluffJobbbz (small blind) folded before Flop
Seat 5: Noah_D@vid (big blind) collected ($0.02)
Seat 6: Koresh153 folded before Flop (didn't bet)


PokerStars Hand #238162360623:  Hold'em No Limit ($0.01/$0.02 USD) - 2022/08/23 2:45:46 ET
Table 'Achilles IV' 6-max Seat #1 is the button
Seat 1: Vlao ($2.14 in chips)
Seat 2: spider568 ($3.03 in chips)
Seat 3: DobermanBY ($2 in chips)
Seat 4: BluffJobbbz ($2 in chips)
Seat 5: Noah_D@vid ($1.15 in chips)
Seat 6: Koresh153 ($1.89 in chips)
spider568: posts small blind $0.01
DobermanBY: posts big blind $0.02
*** HOLE CARDS ***
BluffJobbbz: folds
Noah_D@vid: folds
Koresh153: folds
Vlao: folds
spider568 has timed out
spider568: folds
Uncalled bet ($0.01) returned to DobermanBY
DobermanBY collected $0.02 from pot
DobermanBY: doesn't show hand
*** SUMMARY ***
Total pot $0.02 | Rake $0
Seat 1: Vlao (button) folded before Flop (didn't bet)
Seat 2: spider568 (small blind) folded before Flop
Seat 3: DobermanBY (big blind) collected ($0.02)
Seat 4: BluffJobbbz folded before Flop (didn't bet)
Seat 5: Noah_D@vid folded before Flop (didn't bet)
Seat 6: Koresh153 folded before Flop (didn't bet)


PokerStars Hand #238162367908:  Hold'em No Limit ($0.01/$0.02 USD) - 2022/08/23 2:46:56 ET
Table 'Achilles IV' 6-max Seat #4 is the button
Seat 1: Vlao ($2.14 in chips)
Seat 3: DobermanBY ($2.01 in chips)
Seat 4: BluffJobbbz ($2 in chips)
Seat 5: Noah_D@vid ($1.16 in chips)
Seat 6: Koresh153 ($1.89 in chips)
Noah_D@vid: posts small blind $0.01
Koresh153: posts big blind $0.02
*** HOLE CARDS ***
Vlao: folds
DobermanBY: folds
BluffJobbbz: raises $0.04 to $0.06
Noah_D@vid: folds
Koresh153: folds
Uncalled bet ($0.04) returned to BluffJobbbz
BluffJobbbz collected $0.05 from pot
BluffJobbbz: doesn't show hand
*** SUMMARY ***
Total pot $0.05 | Rake $0
Seat 1: Vlao folded before Flop (didn't bet)
Seat 3: DobermanBY folded before Flop (didn't bet)
Seat 4: BluffJobbbz (button) collected ($0.05)
Seat 5: Noah_D@vid (small blind) folded before Flop
Seat 6: Koresh153 (big blind) folded before Flop


PokerStars Hand #238162369183:  Hold'em No Limit ($0.01/$0.02 USD) - 2022/08/23 2:47:08 ET
Table 'Achilles IV' 6-max Seat #5 is the button
Seat 1: Vlao ($2.14 in chips)
Seat 3: DobermanBY ($2.01 in chips)
Seat 4: BluffJobbbz ($2.03 in chips)
Seat 5: Noah_D@vid ($1.15 in chips)
Seat 6: Koresh153 ($1.87 in chips)
Koresh153: posts small blind $0.01
Vlao: posts big blind $0.02
*** HOLE CARDS ***
DobermanBY: folds
BluffJobbbz: raises $0.04 to $0.06
Noah_D@vid: folds
Koresh153: calls $0.05
Vlao: folds
*** FLOP *** [2c 4c 8h]
Koresh153: bets $0.09
spider568 is disconnected
BluffJobbbz: raises $0.19 to $0.28
Koresh153: calls $0.19
*** TURN *** [2c 4c 8h] [Qd]
Koresh153: checks
BluffJobbbz: bets $0.34
Koresh153: folds
Uncalled bet ($0.34) returned to BluffJobbbz
BluffJobbbz collected $0.68 from pot
BluffJobbbz: doesn't show hand
*** SUMMARY ***
Total pot $0.70 | Rake $0.02
Board [2c 4c 8h Qd]
Seat 1: Vlao (big blind) folded before Flop
Seat 3: DobermanBY folded before Flop (didn't bet)
Seat 4: BluffJobbbz collected ($0.68)
Seat 5: Noah_D@vid (button) folded before Flop (didn't bet)
Seat 6: Koresh153 (small blind) folded on the Turn


PokerStars Hand #238162375280:  Hold'em No Limit ($0.01/$0.02 USD) - 2022/08/23 2:48:06 ET
Table 'Achilles IV' 6-max Seat #6 is the button
Seat 1: Vlao ($2.12 in chips)
Seat 4: BluffJobbbz ($2.37 in chips)
Seat 5: Noah_D@vid ($1.15 in chips)
Seat 6: Koresh153 ($1.53 in chips)
Vlao: posts small blind $0.01
DobermanBY: is sitting out
BluffJobbbz: posts big blind $0.02
*** HOLE CARDS ***
Noah_D@vid: calls $0.02
Koresh153: folds
Vlao: folds
BluffJobbbz: raises $0.06 to $0.08
Noah_D@vid: calls $0.06
*** FLOP *** [4s 8d 6c]
BluffJobbbz: bets $0.04
Noah_D@vid: calls $0.04
*** TURN *** [4s 8d 6c] [Tc]
BluffJobbbz: checks
Noah_D@vid: bets $0.10
BluffJobbbz: folds
Uncalled bet ($0.10) returned to Noah_D@vid
Noah_D@vid collected $0.24 from pot
*** SUMMARY ***
Total pot $0.25 | Rake $0.01
Board [4s 8d 6c Tc]
Seat 1: Vlao (small blind) folded before Flop
Seat 4: BluffJobbbz (big blind) folded on the Turn
Seat 5: Noah_D@vid collected ($0.24)
Seat 6: Koresh153 (button) folded before Flop (didn't bet)


PokerStars Hand #238162381053:  Hold'em No Limit ($0.01/$0.02 USD) - 2022/08/23 2:49:01 ET
Table 'Achilles IV' 6-max Seat #1 is the button
Seat 1: Vlao ($2.11 in chips)
Seat 4: BluffJobbbz ($2.25 in chips)
Seat 5: Noah_D@vid ($1.27 in chips)
Seat 6: Koresh153 ($2 in chips)
BluffJobbbz: posts small blind $0.01
Noah_D@vid: posts big blind $0.02
*** HOLE CARDS ***
Koresh153: folds
Vlao: raises $0.03 to $0.05
BluffJobbbz: folds
Noah_D@vid: folds
Uncalled bet ($0.03) returned to Vlao
Koresh153 was removed from the table for failing to post
Koresh153 leaves the table
Vlao collected $0.05 from pot
*** SUMMARY ***
Total pot $0.05 | Rake $0
Seat 1: Vlao (button) collected ($0.05)
Seat 4: BluffJobbbz (small blind) folded before Flop
Seat 5: Noah_D@vid (big blind) folded before Flop
Seat 6: Koresh153 folded before Flop (didn't bet)


PokerStars Hand #238162385128:  Hold'em No Limit ($0.01/$0.02 USD) - 2022/08/23 2:49:40 ET
Table 'Achilles IV' 6-max Seat #5 is the button
Seat 1: Vlao ($2.12 in chips)
Seat 4: BluffJobbbz ($2.31 in chips)
Seat 5: Noah_D@vid ($1.20 in chips)
Vlao: posts small blind $0.01
BluffJobbbz: posts big blind $0.02
*** HOLE CARDS ***
Noah_D@vid: folds
Vlao: folds
Uncalled bet ($0.01) returned to BluffJobbbz
BluffJobbbz collected $0.02 from pot
BluffJobbbz: doesn't show hand
*** SUMMARY ***
Total pot $0.02 | Rake $0
Seat 1: Vlao (small blind) folded before Flop
Seat 4: BluffJobbbz (big blind) collected ($0.02)
Seat 5: Noah_D@vid (button) folded before Flop (didn't bet)


PokerStars Hand #238162382502:  Hold'em No Limit ($0.01/$0.02 USD) - 2022/08/23 2:49:14 ET
Table 'Achilles IV' 6-max Seat #4 is the button
Seat 1: Vlao ($2.14 in chips)
Seat 4: BluffJobbbz ($2.24 in chips)
Seat 5: Noah_D@vid ($1.25 in chips)
Noah_D@vid: posts small blind $0.01
Vlao: posts big blind $0.02
*** HOLE CARDS ***
BluffJobbbz: raises $0.03 to $0.05
DobermanBY leaves the table
Noah_D@vid: calls $0.04
Vlao: folds
*** FLOP *** [6s 5h 9h]
Noah_D@vid: checks
BluffJobbbz: bets $0.08
Noah_D@vid: folds
Uncalled bet ($0.08) returned to BluffJobbbz
BluffJobbbz collected $0.12 from pot
BluffJobbbz: doesn't show hand
*** SUMMARY ***
Total pot $0.12 | Rake $0
Board [6s 5h 9h]
Seat 1: Vlao (big blind) folded before Flop
Seat 4: BluffJobbbz (button) collected ($0.12)
Seat 5: Noah_D@vid (small blind) folded on the Flop


PokerStars Hand #238162385862:  Hold'em No Limit ($0.01/$0.02 USD) - 2022/08/23 2:49:46 ET
Table 'Achilles IV' 6-max Seat #1 is the button
Seat 1: Vlao ($2.11 in chips)
Seat 4: BluffJobbbz ($2.32 in chips)
Seat 5: Noah_D@vid ($1.20 in chips)
BluffJobbbz: posts small blind $0.01
Noah_D@vid: posts big blind $0.02
*** HOLE CARDS ***
Vlao: raises $0.03 to $0.05
BluffJobbbz: folds
Noah_D@vid: folds
Uncalled bet ($0.03) returned to Vlao
Vlao collected $0.05 from pot
*** SUMMARY ***
Total pot $0.05 | Rake $0
Seat 1: Vlao (button) collected ($0.05)
Seat 4: BluffJobbbz (small blind) folded before Flop
Seat 5: Noah_D@vid (big blind) folded before Flop


PokerStars Hand #238162387495:  Hold'em No Limit ($0.01/$0.02 USD) - 2022/08/23 2:50:02 ET
Table 'Achilles IV' 6-max Seat #4 is the button
Seat 1: Vlao ($2.14 in chips)
Seat 4: BluffJobbbz ($2.31 in chips)
Seat 5: Noah_D@vid ($1.18 in chips)
Noah_D@vid: posts small blind $0.01
Vlao: posts big blind $0.02
*** HOLE CARDS ***
BluffJobbbz: folds
Noah_D@vid: calls $0.01
Vlao: checks
*** FLOP *** [7h 4d 5s]
Noah_D@vid: checks
Vlao: checks
*** TURN *** [7h 4d 5s] [Qd]
Noah_D@vid: checks
RodriguezDB joins the table at seat #3
Vlao: checks
*** RIVER *** [7h 4d 5s Qd] [8c]
Noah_D@vid: checks
Vlao: checks
*** SHOW DOWN ***
Noah_D@vid: shows [Ah 9c] (high card Ace)
Vlao: mucks hand
Noah_D@vid collected $0.04 from pot
*** SUMMARY ***
Total pot $0.04 | Rake $0
Board [7h 4d 5s Qd 8c]
Seat 1: Vlao (big blind) mucked
Seat 4: BluffJobbbz (button) folded before Flop (didn't bet)
Seat 5: Noah_D@vid (small blind) showed [Ah 9c] and won ($0.04) with high card Ace


PokerStars Hand #238162390171:  Hold'em No Limit ($0.01/$0.02 USD) - 2022/08/23 2:50:27 ET
Table 'Achilles IV' 6-max Seat #5 is the button
Seat 1: Vlao ($2.12 in chips)
Seat 3: RodriguezDB ($2 in chips)
Seat 4: BluffJobbbz ($2.31 in chips)
Seat 5: Noah_D@vid ($1.20 in chips)
Vlao: posts small blind $0.01
RodriguezDB: posts big blind $0.02
*** HOLE CARDS ***
BluffJobbbz: raises $0.04 to $0.06
Noah_D@vid: folds
Vlao: folds
RodriguezDB: calls $0.04
*** FLOP *** [Qd Qh Js]
RodriguezDB: checks
BluffJobbbz: bets $0.08
RodriguezDB: calls $0.08
*** TURN *** [Qd Qh Js] [7d]
RodriguezDB: checks
BluffJobbbz: bets $0.22
RodriguezDB: raises $0.72 to $0.94
BluffJobbbz: folds
Uncalled bet ($0.72) returned to RodriguezDB
RodriguezDB collected $0.70 from pot
*** SUMMARY ***
Total pot $0.73 | Rake $0.03
Board [Qd Qh Js 7d]
Seat 1: Vlao (small blind) folded before Flop
Seat 3: RodriguezDB (big blind) collected ($0.70)
Seat 4: BluffJobbbz folded on the Turn
Seat 5: Noah_D@vid (button) folded before Flop (didn't bet)


PokerStars Hand #238162398781:  Hold'em No Limit ($0.01/$0.02 USD) - 2022/08/23 2:51:49 ET
Table 'Achilles IV' 6-max Seat #1 is the button
Seat 1: Vlao ($2.11 in chips)
Seat 3: RodriguezDB ($2.34 in chips)
Seat 4: BluffJobbbz ($2 in chips)
Seat 5: Noah_D@vid ($1.20 in chips)
RodriguezDB: posts small blind $0.01
BluffJobbbz: posts big blind $0.02
*** HOLE CARDS ***
freedomcrank joins the table at seat #6
Noah_D@vid: folds
Vlao: folds
RodriguezDB: folds
Uncalled bet ($0.01) returned to BluffJobbbz
BluffJobbbz collected $0.02 from pot
BluffJobbbz: doesn't show hand
*** SUMMARY ***
Total pot $0.02 | Rake $0
Seat 1: Vlao (button) folded before Flop (didn't bet)
Seat 3: RodriguezDB (small blind) folded before Flop
Seat 4: BluffJobbbz (big blind) collected ($0.02)
Seat 5: Noah_D@vid folded before Flop (didn't bet)


PokerStars Hand #238162400137:  Hold'em No Limit ($0.01/$0.02 USD) - 2022/08/23 2:52:02 ET
Table 'Achilles IV' 6-max Seat #3 is the button
Seat 1: Vlao ($2.11 in chips)
Seat 3: RodriguezDB ($2.33 in chips)
Seat 4: BluffJobbbz ($2.01 in chips)
Seat 5: Noah_D@vid ($1.20 in chips)
BluffJobbbz: posts small blind $0.01
Noah_D@vid: posts big blind $0.02
freedomcrank: sits out
*** HOLE CARDS ***
Vlao: folds
RodriguezDB has timed out
RodriguezDB: folds
BluffJobbbz: raises $0.04 to $0.06
Noah_D@vid: calls $0.04
*** FLOP *** [Kh 9s 7s]
BluffJobbbz: checks
Noah_D@vid: checks
*** TURN *** [Kh 9s 7s] [5s]
BluffJobbbz: checks
Noah_D@vid: checks
*** RIVER *** [Kh 9s 7s 5s] [Kc]
BluffJobbbz: checks
Noah_D@vid: checks
*** SHOW DOWN ***
BluffJobbbz: shows [4d Ah] (a pair of Kings)
Noah_D@vid: shows [8d 8c] (two pair, Kings and Eights)
Noah_D@vid collected $0.12 from pot
*** SUMMARY ***
Total pot $0.12 | Rake $0
Board [Kh 9s 7s 5s Kc]
Seat 1: Vlao folded before Flop (didn't bet)
Seat 3: RodriguezDB (button) folded before Flop (didn't bet)
Seat 4: BluffJobbbz (small blind) showed [4d Ah] and lost with a pair of Kings
Seat 5: Noah_D@vid (big blind) showed [8d 8c] and won ($0.12) with two pair, Kings and Eights


PokerStars Hand #238162403572:  Hold'em No Limit ($0.01/$0.02 USD) - 2022/08/23 2:52:34 ET
Table 'Achilles IV' 6-max Seat #4 is the button
Seat 1: Vlao ($2.11 in chips)
Seat 3: RodriguezDB ($2.33 in chips)
Seat 4: BluffJobbbz ($2 in chips)
Seat 5: Noah_D@vid ($1.26 in chips)
Seat 6: freedomcrank ($2 in chips)
Noah_D@vid: posts small blind $0.01
freedomcrank: posts big blind $0.02
*** HOLE CARDS ***
Vlao: folds
RodriguezDB: raises $0.04 to $0.06
BluffJobbbz: folds
Noah_D@vid: folds
freedomcrank: folds
Uncalled bet ($0.04) returned to RodriguezDB
RodriguezDB collected $0.05 from pot
*** SUMMARY ***
Total pot $0.05 | Rake $0
Seat 1: Vlao folded before Flop (didn't bet)
Seat 3: RodriguezDB collected ($0.05)
Seat 4: BluffJobbbz (button) folded before Flop (didn't bet)
Seat 5: Noah_D@vid (small blind) folded before Flop
Seat 6: freedomcrank (big blind) folded before Flop


PokerStars Hand #238162405782:  Hold'em No Limit ($0.01/$0.02 USD) - 2022/08/23 2:52:55 ET
Table 'Achilles IV' 6-max Seat #5 is the button
Seat 1: Vlao ($2.11 in chips)
Seat 3: RodriguezDB ($2.36 in chips)
Seat 4: BluffJobbbz ($2 in chips)
Seat 5: Noah_D@vid ($1.25 in chips)
Seat 6: freedomcrank ($1.98 in chips)
freedomcrank: posts small blind $0.01
Vlao: posts big blind $0.02
*** HOLE CARDS ***
RodriguezDB: folds
BluffJobbbz: folds
Noah_D@vid: folds
freedomcrank: calls $0.01
Vlao: raises $0.06 to $0.08
freedomcrank: folds
Uncalled bet ($0.06) returned to Vlao
Vlao collected $0.04 from pot
*** SUMMARY ***
Total pot $0.04 | Rake $0
Seat 1: Vlao (big blind) collected ($0.04)
Seat 3: RodriguezDB folded before Flop (didn't bet)
Seat 4: BluffJobbbz folded before Flop (didn't bet)
Seat 5: Noah_D@vid (button) folded before Flop (didn't bet)
Seat 6: freedomcrank (small blind) folded before Flop


PokerStars Hand #238162407772:  Hold'em No Limit ($0.01/$0.02 USD) - 2022/08/23 2:53:15 ET
Table 'Achilles IV' 6-max Seat #6 is the button
Seat 1: Vlao ($2.13 in chips)
Seat 3: RodriguezDB ($2.36 in chips)
Seat 4: BluffJobbbz ($2 in chips)
Seat 5: Noah_D@vid ($1.25 in chips)
Seat 6: freedomcrank ($1.96 in chips)
Vlao: posts small blind $0.01
RodriguezDB: posts big blind $0.02
*** HOLE CARDS ***
BluffJobbbz: folds
Noah_D@vid: folds
freedomcrank: raises $0.04 to $0.06
Vlao: folds
RodriguezDB: folds
Uncalled bet ($0.04) returned to freedomcrank
freedomcrank collected $0.05 from pot
spider568 was removed from the table for failing to post
spider568 leaves the table
freedomcrank: doesn't show hand
*** SUMMARY ***
Total pot $0.05 | Rake $0
Seat 1: Vlao (small blind) folded before Flop
Seat 3: RodriguezDB (big blind) folded before Flop
Seat 4: BluffJobbbz folded before Flop (didn't bet)
Seat 5: Noah_D@vid folded before Flop (didn't bet)
Seat 6: freedomcrank (button) collected ($0.05)


PokerStars Hand #238162409016:  Hold'em No Limit ($0.01/$0.02 USD) - 2022/08/23 2:53:26 ET
Table 'Achilles IV' 6-max Seat #1 is the button
Seat 1: Vlao ($2.12 in chips)
Seat 3: RodriguezDB ($2.34 in chips)
Seat 4: BluffJobbbz ($2 in chips)
Seat 5: Noah_D@vid ($1.25 in chips)
Seat 6: freedomcrank ($1.99 in chips)
RodriguezDB: posts small blind $0.01
BluffJobbbz: posts big blind $0.02
*** HOLE CARDS ***
Noah_D@vid: calls $0.02
freedomcrank: raises $0.04 to $0.06
Vlao: folds
Rutzy259 joins the table at seat #2
RodriguezDB: folds
BluffJobbbz: folds
Noah_D@vid: calls $0.04
*** FLOP *** [7s Kd 8h]
Noah_D@vid: checks
freedomcrank: bets $0.04
Noah_D@vid: calls $0.04
*** TURN *** [7s Kd 8h] [6s]
Noah_D@vid: checks
freedomcrank: bets $0.06
Noah_D@vid: folds
Uncalled bet ($0.06) returned to freedomcrank
freedomcrank collected $0.22 from pot
freedomcrank: doesn't show hand
*** SUMMARY ***
Total pot $0.23 | Rake $0.01
Board [7s Kd 8h 6s]
Seat 1: Vlao (button) folded before Flop (didn't bet)
Seat 3: RodriguezDB (small blind) folded before Flop
Seat 4: BluffJobbbz (big blind) folded before Flop
Seat 5: Noah_D@vid folded on the Turn
Seat 6: freedomcrank collected ($0.22)


PokerStars Hand #238162413228:  Hold'em No Limit ($0.01/$0.02 USD) - 2022/08/23 2:54:06 ET
Table 'Achilles IV' 6-max Seat #3 is the button
Seat 1: Vlao ($2.12 in chips)
Seat 2: Rutzy259 ($2 in chips)
Seat 3: RodriguezDB ($2.33 in chips)
Seat 4: BluffJobbbz ($2 in chips)
Seat 5: Noah_D@vid ($1.15 in chips)
Seat 6: freedomcrank ($2.11 in chips)
BluffJobbbz: posts small blind $0.01
Noah_D@vid: posts big blind $0.02
Rutzy259: posts big blind $0.02
*** HOLE CARDS ***
freedomcrank: folds
Vlao: folds
Rutzy259: checks
RodriguezDB: folds
BluffJobbbz: folds
Noah_D@vid: checks
*** FLOP *** [Kd 9s 6c]
Noah_D@vid: checks
Rutzy259: checks
*** TURN *** [Kd 9s 6c] [Ad]
Noah_D@vid: checks
Rutzy259: checks
*** RIVER *** [Kd 9s 6c Ad] [Kc]
Noah_D@vid: checks
Rutzy259: checks
*** SHOW DOWN ***
Noah_D@vid: shows [4c Jd] (a pair of Kings)
Rutzy259: shows [Qc 8h] (a pair of Kings - Ace+Queen kicker)
Rutzy259 collected $0.05 from pot
*** SUMMARY ***
Total pot $0.05 | Rake $0
Board [Kd 9s 6c Ad Kc]
Seat 1: Vlao folded before Flop (didn't bet)
Seat 2: Rutzy259 showed [Qc 8h] and won ($0.05) with a pair of Kings
Seat 3: RodriguezDB (button) folded before Flop (didn't bet)
Seat 4: BluffJobbbz (small blind) folded before Flop
Seat 5: Noah_D@vid (big blind) showed [4c Jd] and lost with a pair of Kings
Seat 6: freedomcrank folded before Flop (didn't bet)


PokerStars Hand #238162415810:  Hold'em No Limit ($0.01/$0.02 USD) - 2022/08/23 2:54:29 ET
Table 'Achilles IV' 6-max Seat #4 is the button
Seat 1: Vlao ($2.12 in chips)
Seat 2: Rutzy259 ($2.03 in chips)
Seat 3: RodriguezDB ($2.33 in chips)
Seat 4: BluffJobbbz ($2 in chips)
Seat 5: Noah_D@vid ($1.13 in chips)
Seat 6: freedomcrank ($2.11 in chips)
Noah_D@vid: posts small blind $0.01
freedomcrank: posts big blind $0.02
*** HOLE CARDS ***
Vlao: folds
Rutzy259: calls $0.02
RodriguezDB: folds
BluffJobbbz: calls $0.02
Noah_D@vid: calls $0.01
freedomcrank: checks
*** FLOP *** [Jc 6h 2c]
Noah_D@vid: checks
freedomcrank: checks
Rutzy259: checks
BluffJobbbz: checks
*** TURN *** [Jc 6h 2c] [2h]
Noah_D@vid: bets $0.02
freedomcrank: folds
Rutzy259: folds
BluffJobbbz: calls $0.02
*** RIVER *** [Jc 6h 2c 2h] [Ah]
Noah_D@vid: bets $0.02
BluffJobbbz: folds
Uncalled bet ($0.02) returned to Noah_D@vid
Noah_D@vid collected $0.12 from pot
*** SUMMARY ***
Total pot $0.12 | Rake $0
Board [Jc 6h 2c 2h Ah]
Seat 1: Vlao folded before Flop (didn't bet)
Seat 2: Rutzy259 folded on the Turn
Seat 3: RodriguezDB folded before Flop (didn't bet)
Seat 4: BluffJobbbz (button) folded on the River
Seat 5: Noah_D@vid (small blind) collected ($0.12)
Seat 6: freedomcrank (big blind) folded on the Turn


PokerStars Hand #238162420231:  Hold'em No Limit ($0.01/$0.02 USD) - 2022/08/23 2:55:11 ET
Table 'Achilles IV' 6-max Seat #5 is the button
Seat 1: Vlao ($2.12 in chips)
Seat 2: Rutzy259 ($2.01 in chips)
Seat 3: RodriguezDB ($2.33 in chips)
Seat 4: BluffJobbbz ($2 in chips)
Seat 5: Noah_D@vid ($1.21 in chips)
Seat 6: freedomcrank ($2.09 in chips)
freedomcrank: posts small blind $0.01
Vlao: posts big blind $0.02
*** HOLE CARDS ***
Rutzy259: calls $0.02
RodriguezDB: raises $0.08 to $0.10
BluffJobbbz: folds
Noah_D@vid: folds
freedomcrank: folds
Vlao: folds
Rutzy259: calls $0.08
*** FLOP *** [4h Kh Ac]
Rutzy259: checks
RodriguezDB: bets $0.07
Rutzy259: folds
Uncalled bet ($0.07) returned to RodriguezDB
RodriguezDB collected $0.22 from pot
*** SUMMARY ***
Total pot $0.23 | Rake $0.01
Board [4h Kh Ac]
Seat 1: Vlao (big blind) folded before Flop
Seat 2: Rutzy259 folded on the Flop
Seat 3: RodriguezDB collected ($0.22)
Seat 4: BluffJobbbz folded before Flop (didn't bet)
Seat 5: Noah_D@vid (button) folded before Flop (didn't bet)
Seat 6: freedomcrank (small blind) folded before Flop


PokerStars Hand #238162424298:  Hold'em No Limit ($0.01/$0.02 USD) - 2022/08/23 2:55:52 ET
Table 'Achilles IV' 6-max Seat #6 is the button
Seat 1: Vlao ($2.10 in chips)
Seat 2: Rutzy259 ($1.91 in chips)
Seat 3: RodriguezDB ($2.45 in chips)
Seat 4: BluffJobbbz ($2 in chips)
Seat 5: Noah_D@vid ($1.21 in chips)
Seat 6: freedomcrank ($2.08 in chips)
Vlao: posts small blind $0.01
Rutzy259: posts big blind $0.02
*** HOLE CARDS ***
RodriguezDB: folds
BluffJobbbz: folds
Noah_D@vid: folds
freedomcrank: folds
Vlao: folds
Uncalled bet ($0.01) returned to Rutzy259
Rutzy259 collected $0.02 from pot
*** SUMMARY ***
Total pot $0.02 | Rake $0
Seat 1: Vlao (small blind) folded before Flop
Seat 2: Rutzy259 (big blind) collected ($0.02)
Seat 3: RodriguezDB folded before Flop (didn't bet)
Seat 4: BluffJobbbz folded before Flop (didn't bet)
Seat 5: Noah_D@vid folded before Flop (didn't bet)
Seat 6: freedomcrank (button) folded before Flop (didn't bet)


PokerStars Hand #238162426007:  Hold'em No Limit ($0.01/$0.02 USD) - 2022/08/23 2:56:10 ET
Table 'Achilles IV' 6-max Seat #1 is the button
Seat 1: Vlao ($2.09 in chips)
Seat 2: Rutzy259 ($1.92 in chips)
Seat 3: RodriguezDB ($2.45 in chips)
Seat 4: BluffJobbbz ($2 in chips)
Seat 5: Noah_D@vid ($1.21 in chips)
Seat 6: freedomcrank ($2.08 in chips)
Rutzy259: posts small blind $0.01
RodriguezDB: posts big blind $0.02
*** HOLE CARDS ***
BluffJobbbz: folds
Noah_D@vid: calls $0.02
freedomcrank: folds
Vlao: raises $0.06 to $0.08
Rutzy259: folds
RodriguezDB: raises $0.14 to $0.22
Noah_D@vid: folds
Vlao: folds
Uncalled bet ($0.14) returned to RodriguezDB
RodriguezDB collected $0.19 from pot
*** SUMMARY ***
Total pot $0.19 | Rake $0
Seat 1: Vlao (button) folded before Flop
Seat 2: Rutzy259 (small blind) folded before Flop
Seat 3: RodriguezDB (big blind) collected ($0.19)
Seat 4: BluffJobbbz folded before Flop (didn't bet)
Seat 5: Noah_D@vid folded before Flop
Seat 6: freedomcrank folded before Flop (didn't bet)


PokerStars Hand #238162428896:  Hold'em No Limit ($0.01/$0.02 USD) - 2022/08/23 2:56:39 ET
Table 'Achilles IV' 6-max Seat #2 is the button
Seat 1: Vlao ($2.01 in chips)
Seat 2: Rutzy259 ($1.91 in chips)
Seat 3: RodriguezDB ($2.56 in chips)
Seat 4: BluffJobbbz ($2 in chips)
Seat 5: Noah_D@vid ($1.19 in chips)
Seat 6: freedomcrank ($2.08 in chips)
RodriguezDB: posts small blind $0.01
BluffJobbbz: posts big blind $0.02
*** HOLE CARDS ***
Noah_D@vid: folds
freedomcrank: raises $0.04 to $0.06
Vlao: folds
Rutzy259: calls $0.06
RodriguezDB: calls $0.05
BluffJobbbz: folds
*** FLOP *** [7d 4d 5d]
RodriguezDB: checks
freedomcrank: checks
Rutzy259: checks
*** TURN *** [7d 4d 5d] [Kd]
RodriguezDB: checks
freedomcrank: bets $0.04
Rutzy259: folds
RodriguezDB: calls $0.04
*** RIVER *** [7d 4d 5d Kd] [Jh]
RodriguezDB: checks
freedomcrank: bets $0.06
RodriguezDB: calls $0.06
*** SHOW DOWN ***
freedomcrank: shows [6d Qd] (a flush, King high)
RodriguezDB: mucks hand
freedomcrank collected $0.39 from pot
*** SUMMARY ***
Total pot $0.40 | Rake $0.01
Board [7d 4d 5d Kd Jh]
Seat 1: Vlao folded before Flop (didn't bet)
Seat 2: Rutzy259 (button) folded on the Turn
Seat 3: RodriguezDB (small blind) mucked
Seat 4: BluffJobbbz (big blind) folded before Flop
Seat 5: Noah_D@vid folded before Flop (didn't bet)
Seat 6: freedomcrank showed [6d Qd] and won ($0.39) with a flush, King high


PokerStars Hand #238162437121:  Hold'em No Limit ($0.01/$0.02 USD) - 2022/08/23 2:58:03 ET
Table 'Achilles IV' 6-max Seat #3 is the button
Seat 1: Vlao ($2.01 in chips)
Seat 2: Rutzy259 ($1.85 in chips)
Seat 3: RodriguezDB ($2.40 in chips)
Seat 4: BluffJobbbz ($2 in chips)
Seat 5: Noah_D@vid ($1.19 in chips)
Seat 6: freedomcrank ($2.31 in chips)
BluffJobbbz: posts small blind $0.01
Noah_D@vid: posts big blind $0.02
*** HOLE CARDS ***
freedomcrank: raises $0.04 to $0.06
Vlao: folds
Rutzy259: calls $0.06
RodriguezDB: folds
BluffJobbbz: folds
Noah_D@vid: folds
*** FLOP *** [8c As 6s]
freedomcrank: checks
Rutzy259: checks
*** TURN *** [8c As 6s] [8d]
freedomcrank: bets $0.04
Rutzy259: folds
Uncalled bet ($0.04) returned to freedomcrank
freedomcrank collected $0.14 from pot
freedomcrank: doesn't show hand
*** SUMMARY ***
Total pot $0.15 | Rake $0.01
Board [8c As 6s 8d]
Seat 1: Vlao folded before Flop (didn't bet)
Seat 2: Rutzy259 folded on the Turn
Seat 3: RodriguezDB (button) folded before Flop (didn't bet)
Seat 4: BluffJobbbz (small blind) folded before Flop
Seat 5: Noah_D@vid (big blind) folded before Flop
Seat 6: freedomcrank collected ($0.14)


PokerStars Hand #238162440135:  Hold'em No Limit ($0.01/$0.02 USD) - 2022/08/23 2:58:34 ET
Table 'Achilles IV' 6-max Seat #4 is the button
Seat 1: Vlao ($2.01 in chips)
Seat 2: Rutzy259 ($1.79 in chips)
Seat 3: RodriguezDB ($2.40 in chips)
Seat 4: BluffJobbbz ($2 in chips)
Seat 5: Noah_D@vid ($1.17 in chips)
Seat 6: freedomcrank ($2.39 in chips)
Noah_D@vid: posts small blind $0.01
freedomcrank: posts big blind $0.02
*** HOLE CARDS ***
Vlao: folds
Rutzy259: calls $0.02
RodriguezDB: folds
BluffJobbbz: folds
Noah_D@vid: folds
freedomcrank: checks
*** FLOP *** [8h 7c Ac]
freedomcrank: checks
Rutzy259: bets $0.08
freedomcrank: folds
Uncalled bet ($0.08) returned to Rutzy259
Rutzy259 collected $0.05 from pot
*** SUMMARY ***
Total pot $0.05 | Rake $0
Board [8h 7c Ac]
Seat 1: Vlao folded before Flop (didn't bet)
Seat 2: Rutzy259 collected ($0.05)
Seat 3: RodriguezDB folded before Flop (didn't bet)
Seat 4: BluffJobbbz (button) folded before Flop (didn't bet)
Seat 5: Noah_D@vid (small blind) folded before Flop
Seat 6: freedomcrank (big blind) folded on the Flop


PokerStars Hand #238162443165:  Hold'em No Limit ($0.01/$0.02 USD) - 2022/08/23 2:59:05 ET
Table 'Achilles IV' 6-max Seat #5 is the button
Seat 1: Vlao ($2.01 in chips)
Seat 2: Rutzy259 ($1.82 in chips)
Seat 3: RodriguezDB ($2.40 in chips)
Seat 4: BluffJobbbz ($2 in chips)
Seat 5: Noah_D@vid ($1.16 in chips)
Seat 6: freedomcrank ($2.37 in chips)
freedomcrank: posts small blind $0.01
Vlao: posts big blind $0.02
*** HOLE CARDS ***
Rutzy259: raises $0.02 to $0.04
RodriguezDB: folds
BluffJobbbz: folds
Noah_D@vid: folds
freedomcrank: folds
Vlao: calls $0.02
*** FLOP *** [2h 6d Ac]
Vlao: checks
Rutzy259: bets $0.06
Vlao: folds
Uncalled bet ($0.06) returned to Rutzy259
Rutzy259 collected $0.09 from pot
*** SUMMARY ***
Total pot $0.09 | Rake $0
Board [2h 6d Ac]
Seat 1: Vlao (big blind) folded on the Flop
Seat 2: Rutzy259 collected ($0.09)
Seat 3: RodriguezDB folded before Flop (didn't bet)
Seat 4: BluffJobbbz folded before Flop (didn't bet)
Seat 5: Noah_D@vid (button) folded before Flop (didn't bet)
Seat 6: freedomcrank (small blind) folded before Flop


PokerStars Hand #238162445605:  Hold'em No Limit ($0.01/$0.02 USD) - 2022/08/23 2:59:30 ET
Table 'Achilles IV' 6-max Seat #6 is the button
Seat 1: Vlao ($2 in chips)
Seat 2: Rutzy259 ($1.87 in chips)
Seat 3: RodriguezDB ($2.40 in chips)
Seat 4: BluffJobbbz ($2 in chips)
Seat 5: Noah_D@vid ($1.16 in chips)
Seat 6: freedomcrank ($2.36 in chips)
Vlao: posts small blind $0.01
Rutzy259: posts big blind $0.02
*** HOLE CARDS ***
RodriguezDB: raises $0.04 to $0.06
BluffJobbbz: raises $0.12 to $0.18
Noah_D@vid: folds
freedomcrank: folds
Vlao: folds
Rutzy259: calls $0.16
RodriguezDB: folds
*** FLOP *** [6d 8s 2h]
Rutzy259: bets $0.06
BluffJobbbz: raises $0.22 to $0.28
Rutzy259: calls $0.22
*** TURN *** [6d 8s 2h] [Kc]
Rutzy259: bets $0.38
BluffJobbbz: raises $1.16 to $1.54 and is all-in
Rutzy259: calls $1.03 and is all-in
Uncalled bet ($0.13) returned to BluffJobbbz
*** RIVER *** [6d 8s 2h Kc] [9c]
*** SHOW DOWN ***
Rutzy259: shows [3c 4c] (high card King)
BluffJobbbz: shows [Ah Ad] (a pair of Aces)
BluffJobbbz collected $3.68 from pot
*** SUMMARY ***
Total pot $3.81 | Rake $0.13
Board [6d 8s 2h Kc 9c]
Seat 1: Vlao (small blind) folded before Flop
Seat 2: Rutzy259 (big blind) showed [3c 4c] and lost with high card King
Seat 3: RodriguezDB folded before Flop
Seat 4: BluffJobbbz showed [Ah Ad] and won ($3.68) with a pair of Aces
Seat 5: Noah_D@vid folded before Flop (didn't bet)
Seat 6: freedomcrank (button) folded before Flop (didn't bet)


PokerStars Hand #238162453823:  Hold'em No Limit ($0.01/$0.02 USD) - 2022/08/23 3:00:54 ET
Table 'Achilles IV' 6-max Seat #1 is the button
Seat 1: Vlao ($2 in chips)
Seat 3: RodriguezDB ($2.34 in chips)
Seat 4: BluffJobbbz ($3.81 in chips)
Seat 5: Noah_D@vid ($1.16 in chips)
Seat 6: freedomcrank ($2.36 in chips)
RodriguezDB: posts small blind $0.01
BluffJobbbz: posts big blind $0.02
*** HOLE CARDS ***
Noah_D@vid: calls $0.02
freedomcrank: folds
Vlao: folds
RodriguezDB: folds
BluffJobbbz: checks
*** FLOP *** [4c Qd 9d]
BluffJobbbz: checks
Noah_D@vid: checks
*** TURN *** [4c Qd 9d] [Qc]
BluffJobbbz: checks
Noah_D@vid: checks
*** RIVER *** [4c Qd 9d Qc] [8c]
BluffJobbbz: checks
Noah_D@vid: checks
*** SHOW DOWN ***
BluffJobbbz: shows [9c Jd] (two pair, Queens and Nines)
Noah_D@vid: mucks hand
BluffJobbbz collected $0.05 from pot
*** SUMMARY ***
Total pot $0.05 | Rake $0
Board [4c Qd 9d Qc 8c]
Seat 1: Vlao (button) folded before Flop (didn't bet)
Seat 3: RodriguezDB (small blind) folded before Flop
Seat 4: BluffJobbbz (big blind) showed [9c Jd] and won ($0.05) with two pair, Queens and Nines
Seat 5: Noah_D@vid mucked
Seat 6: freedomcrank folded before Flop (didn't bet)


PokerStars Hand #238162459453:  Hold'em No Limit ($0.01/$0.02 USD) - 2022/08/23 3:01:48 ET
Table 'Achilles IV' 6-max Seat #3 is the button
Seat 1: Vlao ($2 in chips)
Seat 2: Rutzy259 ($2 in chips)
Seat 3: RodriguezDB ($2.33 in chips)
Seat 4: BluffJobbbz ($3.84 in chips)
Seat 5: Noah_D@vid ($1.14 in chips)
Seat 6: freedomcrank ($2.36 in chips)
BluffJobbbz: posts small blind $0.01
Noah_D@vid: posts big blind $0.02
Rutzy259: posts small blind $0.01
*** HOLE CARDS ***
freedomcrank has timed out
freedomcrank: folds
Vlao: folds
Rutzy259: folds
RodriguezDB: folds
BluffJobbbz: folds
Uncalled bet ($0.01) returned to Noah_D@vid
Noah_D@vid collected $0.03 from pot
*** SUMMARY ***
Total pot $0.03 | Rake $0
Seat 1: Vlao folded before Flop (didn't bet)
Seat 2: Rutzy259 folded before Flop (didn't bet)
Seat 3: RodriguezDB (button) folded before Flop (didn't bet)
Seat 4: BluffJobbbz (small blind) folded before Flop
Seat 5: Noah_D@vid (big blind) collected ($0.03)
Seat 6: freedomcrank folded before Flop (didn't bet)


PokerStars Hand #238162462134:  Hold'em No Limit ($0.01/$0.02 USD) - 2022/08/23 3:02:14 ET
Table 'Achilles IV' 6-max Seat #4 is the button
Seat 1: Vlao ($2 in chips)
Seat 2: Rutzy259 ($1.99 in chips)
Seat 3: RodriguezDB ($2.33 in chips)
Seat 4: BluffJobbbz ($3.83 in chips)
Seat 5: Noah_D@vid ($1.16 in chips)
Seat 6: freedomcrank ($2.36 in chips)
Noah_D@vid: posts small blind $0.01
freedomcrank: posts big blind $0.02
*** HOLE CARDS ***
Vlao: folds
Rutzy259: folds
RodriguezDB: folds
BluffJobbbz: raises $0.03 to $0.05
Noah_D@vid: folds
freedomcrank: calls $0.03
*** FLOP *** [Qs As 8d]
freedomcrank: checks
BluffJobbbz: bets $0.04
freedomcrank: calls $0.04
*** TURN *** [Qs As 8d] [6s]
freedomcrank: checks
BluffJobbbz: bets $0.14
freedomcrank: folds
Uncalled bet ($0.14) returned to BluffJobbbz
BluffJobbbz collected $0.18 from pot
BluffJobbbz: doesn't show hand
*** SUMMARY ***
Total pot $0.19 | Rake $0.01
Board [Qs As 8d 6s]
Seat 1: Vlao folded before Flop (didn't bet)
Seat 2: Rutzy259 folded before Flop (didn't bet)
Seat 3: RodriguezDB folded before Flop (didn't bet)
Seat 4: BluffJobbbz (button) collected ($0.18)
Seat 5: Noah_D@vid (small blind) folded before Flop
Seat 6: freedomcrank (big blind) folded on the Turn


PokerStars Hand #238162468143:  Hold'em No Limit ($0.01/$0.02 USD) - 2022/08/23 3:03:10 ET
Table 'Achilles IV' 6-max Seat #5 is the button
Seat 1: Vlao ($2 in chips)
Seat 2: Rutzy259 ($1.99 in chips)
Seat 3: RodriguezDB ($2.33 in chips)
Seat 4: BluffJobbbz ($3.92 in chips)
Seat 5: Noah_D@vid ($1.15 in chips)
Seat 6: freedomcrank ($2.27 in chips)
freedomcrank: posts small blind $0.01
Vlao: posts big blind $0.02
*** HOLE CARDS ***
Rutzy259: calls $0.02
RodriguezDB: folds
BluffJobbbz: folds
Noah_D@vid: folds
freedomcrank: raises $0.04 to $0.06
Vlao: calls $0.04
Rutzy259: calls $0.04
*** FLOP *** [4c Kh 5c]
freedomcrank: bets $0.04
Vlao: calls $0.04
Rutzy259: folds
*** TURN *** [4c Kh 5c] [Jh]
freedomcrank: checks
Vlao: bets $0.20
freedomcrank: folds
Uncalled bet ($0.20) returned to Vlao
Vlao collected $0.25 from pot
*** SUMMARY ***
Total pot $0.26 | Rake $0.01
Board [4c Kh 5c Jh]
Seat 1: Vlao (big blind) collected ($0.25)
Seat 2: Rutzy259 folded on the Flop
Seat 3: RodriguezDB folded before Flop (didn't bet)
Seat 4: BluffJobbbz folded before Flop (didn't bet)
Seat 5: Noah_D@vid (button) folded before Flop (didn't bet)
Seat 6: freedomcrank (small blind) folded on the Turn


PokerStars Hand #238162472242:  Hold'em No Limit ($0.01/$0.02 USD) - 2022/08/23 3:03:48 ET
Table 'Achilles IV' 6-max Seat #6 is the button
Seat 1: Vlao ($2.15 in chips)
Seat 2: Rutzy259 ($1.93 in chips)
Seat 3: RodriguezDB ($2.33 in chips)
Seat 4: BluffJobbbz ($3.92 in chips)
Seat 5: Noah_D@vid ($1.15 in chips)
Seat 6: freedomcrank ($2.17 in chips)
Vlao: posts small blind $0.01
Rutzy259: posts big blind $0.02
*** HOLE CARDS ***
RodriguezDB: folds
BluffJobbbz: folds
Noah_D@vid: folds
freedomcrank: folds
Vlao: folds
Uncalled bet ($0.01) returned to Rutzy259
Rutzy259 collected $0.02 from pot
*** SUMMARY ***
Total pot $0.02 | Rake $0
Seat 1: Vlao (small blind) folded before Flop
Seat 2: Rutzy259 (big blind) collected ($0.02)
Seat 3: RodriguezDB folded before Flop (didn't bet)
Seat 4: BluffJobbbz folded before Flop (didn't bet)
Seat 5: Noah_D@vid folded before Flop (didn't bet)
Seat 6: freedomcrank (button) folded before Flop (didn't bet)


PokerStars Hand #238162473485:  Hold'em No Limit ($0.01/$0.02 USD) - 2022/08/23 3:03:59 ET
Table 'Achilles IV' 6-max Seat #1 is the button
Seat 1: Vlao ($2.14 in chips)
Seat 2: Rutzy259 ($1.94 in chips)
Seat 3: RodriguezDB ($2.33 in chips)
Seat 4: BluffJobbbz ($3.92 in chips)
Seat 5: Noah_D@vid ($1.15 in chips)
Seat 6: freedomcrank ($2.17 in chips)
Rutzy259: posts small blind $0.01
RodriguezDB: posts big blind $0.02
*** HOLE CARDS ***
BluffJobbbz: folds
Noah_D@vid: folds
freedomcrank: calls $0.02
Vlao: folds
Rutzy259: folds
RodriguezDB: checks
*** FLOP *** [8c Ah Jc]
RodriguezDB: checks
freedomcrank: bets $0.02
RodriguezDB: calls $0.02
*** TURN *** [8c Ah Jc] [2c]
RodriguezDB: checks
freedomcrank: checks
*** RIVER *** [8c Ah Jc 2c] [4s]
RodriguezDB: checks
freedomcrank: bets $0.04
RodriguezDB: folds
Uncalled bet ($0.04) returned to freedomcrank
freedomcrank collected $0.09 from pot
freedomcrank: doesn't show hand
*** SUMMARY ***
Total pot $0.09 | Rake $0
Board [8c Ah Jc 2c 4s]
Seat 1: Vlao (button) folded before Flop (didn't bet)
Seat 2: Rutzy259 (small blind) folded before Flop
Seat 3: RodriguezDB (big blind) folded on the River
Seat 4: BluffJobbbz folded before Flop (didn't bet)
Seat 5: Noah_D@vid folded before Flop (didn't bet)
Seat 6: freedomcrank collected ($0.09)


PokerStars Hand #238162481174:  Hold'em No Limit ($0.01/$0.02 USD) - 2022/08/23 3:05:11 ET
Table 'Achilles IV' 6-max Seat #2 is the button
Seat 1: Vlao ($2.14 in chips)
Seat 2: Rutzy259 ($1.93 in chips)
Seat 3: RodriguezDB ($2.29 in chips)
Seat 4: BluffJobbbz ($3.92 in chips)
Seat 5: Noah_D@vid ($1.15 in chips)
Seat 6: freedomcrank ($2.22 in chips)
RodriguezDB: posts small blind $0.01
BluffJobbbz: posts big blind $0.02
*** HOLE CARDS ***
Noah_D@vid: folds
freedomcrank: folds
Vlao: folds
Rutzy259: folds
RodriguezDB: folds
Uncalled bet ($0.01) returned to BluffJobbbz
BluffJobbbz collected $0.02 from pot
BluffJobbbz: doesn't show hand
*** SUMMARY ***
Total pot $0.02 | Rake $0
Seat 1: Vlao folded before Flop (didn't bet)
Seat 2: Rutzy259 (button) folded before Flop (didn't bet)
Seat 3: RodriguezDB (small blind) folded before Flop
Seat 4: BluffJobbbz (big blind) collected ($0.02)
Seat 5: Noah_D@vid folded before Flop (didn't bet)
Seat 6: freedomcrank folded before Flop (didn't bet)


PokerStars Hand #238162486390:  Hold'em No Limit ($0.01/$0.02 USD) - 2022/08/23 3:05:59 ET
Table 'Achilles IV' 6-max Seat #4 is the button
Seat 1: Vlao ($2.14 in chips)
Seat 2: Rutzy259 ($1.96 in chips)
Seat 3: RodriguezDB ($2.28 in chips)
Seat 4: BluffJobbbz ($3.92 in chips)
Seat 5: Noah_D@vid ($1.13 in chips)
Seat 6: freedomcrank ($2.22 in chips)
Noah_D@vid: posts small blind $0.01
freedomcrank: posts big blind $0.02
*** HOLE CARDS ***
Vlao: raises $0.03 to $0.05
Rutzy259: calls $0.05
RodriguezDB: folds
BluffJobbbz: folds
Noah_D@vid: folds
freedomcrank: calls $0.03
*** FLOP *** [Tc 7s 7d]
freedomcrank: checks
Vlao: checks
Rutzy259: checks
*** TURN *** [Tc 7s 7d] [Qs]
freedomcrank: bets $0.04
Vlao: folds
Rutzy259: folds
Uncalled bet ($0.04) returned to freedomcrank
freedomcrank collected $0.15 from pot
freedomcrank: doesn't show hand
*** SUMMARY ***
Total pot $0.16 | Rake $0.01
Board [Tc 7s 7d Qs]
Seat 1: Vlao folded on the Turn
Seat 2: Rutzy259 folded on the Turn
Seat 3: RodriguezDB folded before Flop (didn't bet)
Seat 4: BluffJobbbz (button) folded before Flop (didn't bet)
Seat 5: Noah_D@vid (small blind) folded before Flop
Seat 6: freedomcrank (big blind) collected ($0.15)


PokerStars Hand #238162490580:  Hold'em No Limit ($0.01/$0.02 USD) - 2022/08/23 3:06:38 ET
Table 'Achilles IV' 6-max Seat #5 is the button
Seat 2: Rutzy259 ($1.91 in chips)
Seat 3: RodriguezDB ($2.28 in chips)
Seat 4: BluffJobbbz ($3.92 in chips)
Seat 5: Noah_D@vid ($1.12 in chips)
Seat 6: freedomcrank ($2.32 in chips)
freedomcrank: posts small blind $0.01
Vlao: is sitting out
Rutzy259: posts big blind $0.02
*** HOLE CARDS ***
RodriguezDB: folds
BluffJobbbz: folds
Noah_D@vid: calls $0.02
freedomcrank: folds
Rutzy259: checks
*** FLOP *** [Tc Td Jd]
Rutzy259: checks
Noah_D@vid: bets $0.04
Rutzy259: raises $0.04 to $0.08
Noah_D@vid: calls $0.04
*** TURN *** [Tc Td Jd] [6h]
Rutzy259: checks
Noah_D@vid: bets $0.06
Rutzy259: calls $0.06
*** RIVER *** [Tc Td Jd 6h] [Qh]
Rutzy259: bets $0.28
Noah_D@vid: calls $0.28
*** SHOW DOWN ***
Rutzy259: shows [Kh Qd] (two pair, Queens and Tens)
Noah_D@vid: shows [Ah Ts] (three of a kind, Tens)
Noah_D@vid collected $0.86 from pot
*** SUMMARY ***
Total pot $0.89 | Rake $0.03
Board [Tc Td Jd 6h Qh]
Seat 2: Rutzy259 (big blind) showed [Kh Qd] and lost with two pair, Queens and Tens
Seat 3: RodriguezDB folded before Flop (didn't bet)
Seat 4: BluffJobbbz folded before Flop (didn't bet)
Seat 5: Noah_D@vid (button) showed [Ah Ts] and won ($0.86) with three of a kind, Tens
Seat 6: freedomcrank (small blind) folded before Flop


PokerStars Hand #238162495222:  Hold'em No Limit ($0.01/$0.02 USD) - 2022/08/23 3:07:22 ET
Table 'Achilles IV' 6-max Seat #6 is the button
Seat 2: Rutzy259 ($1.47 in chips)
Seat 3: RodriguezDB ($2.28 in chips)
Seat 4: BluffJobbbz ($3.92 in chips)
Seat 5: Noah_D@vid ($1.54 in chips)
Seat 6: freedomcrank ($2.31 in chips)
Rutzy259: posts small blind $0.01
RodriguezDB: posts big blind $0.02
*** HOLE CARDS ***
BluffJobbbz has timed out
BluffJobbbz: folds
Noah_D@vid: calls $0.02
freedomcrank: raises $0.04 to $0.06
Rutzy259: folds
RodriguezDB: folds
Noah_D@vid: calls $0.04
*** FLOP *** [4s 9h 4h]
Noah_D@vid: checks
freedomcrank: checks
*** TURN *** [4s 9h 4h] [Ah]
Noah_D@vid: bets $0.14
freedomcrank: folds
Uncalled bet ($0.14) returned to Noah_D@vid
Noah_D@vid collected $0.14 from pot
*** SUMMARY ***
Total pot $0.15 | Rake $0.01
Board [4s 9h 4h Ah]
Seat 2: Rutzy259 (small blind) folded before Flop
Seat 3: RodriguezDB (big blind) folded before Flop
Seat 4: BluffJobbbz folded before Flop (didn't bet)
Seat 5: Noah_D@vid collected ($0.14)
Seat 6: freedomcrank (button) folded on the Turn


PokerStars Hand #238162499473:  Hold'em No Limit ($0.01/$0.02 USD) - 2022/08/23 3:08:01 ET
Table 'Achilles IV' 6-max Seat #2 is the button
Seat 2: Rutzy259 ($1.46 in chips)
Seat 3: RodriguezDB ($2.26 in chips)
Seat 4: BluffJobbbz ($3.92 in chips)
Seat 5: Noah_D@vid ($1.62 in chips)
Seat 6: freedomcrank ($2.25 in chips)
RodriguezDB: posts small blind $0.01
BluffJobbbz: posts big blind $0.02
*** HOLE CARDS ***
Noah_D@vid: folds
freedomcrank: folds
Rutzy259: calls $0.02
RodriguezDB: folds
Vlao leaves the table
BluffJobbbz: checks
*** FLOP *** [Qs 5c 2d]
BluffJobbbz: bets $0.04
NivelXcamione joins the table at seat #1
Rutzy259: folds
Uncalled bet ($0.04) returned to BluffJobbbz
BluffJobbbz collected $0.05 from pot
BluffJobbbz: doesn't show hand
*** SUMMARY ***
Total pot $0.05 | Rake $0
Board [Qs 5c 2d]
Seat 2: Rutzy259 (button) folded on the Flop
Seat 3: RodriguezDB (small blind) folded before Flop
Seat 4: BluffJobbbz (big blind) collected ($0.05)
Seat 5: Noah_D@vid folded before Flop (didn't bet)
Seat 6: freedomcrank folded before Flop (didn't bet)


PokerStars Hand #238162502965:  Hold'em No Limit ($0.01/$0.02 USD) - 2022/08/23 3:08:33 ET
Table 'Achilles IV' 6-max Seat #3 is the button
Seat 2: Rutzy259 ($1.44 in chips)
Seat 3: RodriguezDB ($2.25 in chips)
Seat 4: BluffJobbbz ($3.95 in chips)
Seat 5: Noah_D@vid ($1.62 in chips)
Seat 6: freedomcrank ($2.25 in chips)
BluffJobbbz: posts small blind $0.01
Noah_D@vid: posts big blind $0.02
NivelXcamione: sits out
*** HOLE CARDS ***
freedomcrank: folds
Rutzy259: folds
RodriguezDB: folds
BluffJobbbz: folds
Uncalled bet ($0.01) returned to Noah_D@vid
Noah_D@vid collected $0.02 from pot
*** SUMMARY ***
Total pot $0.02 | Rake $0
Seat 2: Rutzy259 folded before Flop (didn't bet)
Seat 3: RodriguezDB (button) folded before Flop (didn't bet)
Seat 4: BluffJobbbz (small blind) folded before Flop
Seat 5: Noah_D@vid (big blind) collected ($0.02)
Seat 6: freedomcrank folded before Flop (didn't bet)


PokerStars Hand #238162504332:  Hold'em No Limit ($0.01/$0.02 USD) - 2022/08/23 3:08:46 ET
Table 'Achilles IV' 6-max Seat #4 is the button
Seat 2: Rutzy259 ($1.44 in chips)
Seat 3: RodriguezDB ($2.25 in chips)
Seat 4: BluffJobbbz ($3.94 in chips)
Seat 5: Noah_D@vid ($1.63 in chips)
Seat 6: freedomcrank ($2.25 in chips)
Noah_D@vid: posts small blind $0.01
freedomcrank: posts big blind $0.02
NivelXcamione: sits out
*** HOLE CARDS ***
Rutzy259: calls $0.02
RodriguezDB: folds
BluffJobbbz: folds
Noah_D@vid: calls $0.01
freedomcrank: checks
*** FLOP *** [Kc 5h Ks]
Noah_D@vid: bets $0.04
freedomcrank: folds
Rutzy259: calls $0.04
*** TURN *** [Kc 5h Ks] [As]
Noah_D@vid: bets $0.06
Rutzy259: raises $0.06 to $0.12
Noah_D@vid: calls $0.06
*** RIVER *** [Kc 5h Ks As] [9s]
Noah_D@vid: checks
Rutzy259: bets $1.26 and is all-in
Noah_D@vid: folds
Uncalled bet ($1.26) returned to Rutzy259
Rutzy259 collected $0.37 from pot
*** SUMMARY ***
Total pot $0.38 | Rake $0.01
Board [Kc 5h Ks As 9s]
Seat 2: Rutzy259 collected ($0.37)
Seat 3: RodriguezDB folded before Flop (didn't bet)
Seat 4: BluffJobbbz (button) folded before Flop (didn't bet)
Seat 5: Noah_D@vid (small blind) folded on the River
Seat 6: freedomcrank (big blind) folded on the Flop


PokerStars Hand #238162509729:  Hold'em No Limit ($0.01/$0.02 USD) - 2022/08/23 3:09:35 ET
Table 'Achilles IV' 6-max Seat #5 is the button
Seat 1: NivelXcamione ($1.30 in chips)
Seat 2: Rutzy259 ($1.63 in chips)
Seat 3: RodriguezDB ($2.25 in chips)
Seat 4: BluffJobbbz ($3.94 in chips)
Seat 5: Noah_D@vid ($1.45 in chips)
Seat 6: freedomcrank ($2.23 in chips)
freedomcrank: posts small blind $0.01
NivelXcamione: posts big blind $0.02
*** HOLE CARDS ***
Rutzy259: folds
RodriguezDB: folds
BluffJobbbz: folds
Noah_D@vid: folds
freedomcrank: calls $0.01
NivelXcamione: checks
*** FLOP *** [Td Qh 2h]
freedomcrank: bets $0.02
NivelXcamione: folds
Uncalled bet ($0.02) returned to freedomcrank
freedomcrank collected $0.04 from pot
freedomcrank: doesn't show hand
*** SUMMARY ***
Total pot $0.04 | Rake $0
Board [Td Qh 2h]
Seat 1: NivelXcamione (big blind) folded on the Flop
Seat 2: Rutzy259 folded before Flop (didn't bet)
Seat 3: RodriguezDB folded before Flop (didn't bet)
Seat 4: BluffJobbbz folded before Flop (didn't bet)
Seat 5: Noah_D@vid (button) folded before Flop (didn't bet)
Seat 6: freedomcrank (small blind) collected ($0.04)


PokerStars Hand #238162513069:  Hold'em No Limit ($0.01/$0.02 USD) - 2022/08/23 3:10:07 ET
Table 'Achilles IV' 6-max Seat #6 is the button
Seat 1: NivelXcamione ($1.28 in chips)
Seat 2: Rutzy259 ($1.63 in chips)
Seat 3: RodriguezDB ($2.25 in chips)
Seat 4: BluffJobbbz ($3.94 in chips)
Seat 5: Noah_D@vid ($1.45 in chips)
Seat 6: freedomcrank ($2.25 in chips)
NivelXcamione: posts small blind $0.01
Rutzy259: posts big blind $0.02
*** HOLE CARDS ***
RodriguezDB: folds
BluffJobbbz: folds
Noah_D@vid: folds
freedomcrank: raises $0.04 to $0.06
NivelXcamione: calls $0.05
Rutzy259: calls $0.04
*** FLOP *** [9d Th Ks]
NivelXcamione: checks
Rutzy259: checks
freedomcrank: bets $0.08
NivelXcamione: calls $0.08
Rutzy259: folds
*** TURN *** [9d Th Ks] [Js]
NivelXcamione: checks
freedomcrank: checks
*** RIVER *** [9d Th Ks Js] [8d]
NivelXcamione: bets $0.10
freedomcrank: calls $0.10
*** SHOW DOWN ***
NivelXcamione: shows [Kh 8h] (two pair, Kings and Eights)
freedomcrank: shows [9h Kd] (two pair, Kings and Nines)
freedomcrank collected $0.52 from pot
*** SUMMARY ***
Total pot $0.54 | Rake $0.02
Board [9d Th Ks Js 8d]
Seat 1: NivelXcamione (small blind) showed [Kh 8h] and lost with two pair, Kings and Eights
Seat 2: Rutzy259 (big blind) folded on the Flop
Seat 3: RodriguezDB folded before Flop (didn't bet)
Seat 4: BluffJobbbz folded before Flop (didn't bet)
Seat 5: Noah_D@vid folded before Flop (didn't bet)
Seat 6: freedomcrank (button) showed [9h Kd] and won ($0.52) with two pair, Kings and Nines


PokerStars Hand #238162518282:  Hold'em No Limit ($0.01/$0.02 USD) - 2022/08/23 3:10:55 ET
Table 'Achilles IV' 6-max Seat #1 is the button
Seat 1: NivelXcamione ($1.04 in chips)
Seat 2: Rutzy259 ($1.57 in chips)
Seat 3: RodriguezDB ($2.25 in chips)
Seat 4: BluffJobbbz ($3.94 in chips)
Seat 5: Noah_D@vid ($1.45 in chips)
Seat 6: freedomcrank ($2.53 in chips)
Rutzy259: posts small blind $0.01
RodriguezDB: posts big blind $0.02
*** HOLE CARDS ***
BluffJobbbz: folds
Noah_D@vid: folds
freedomcrank: folds
NivelXcamione: folds
Rutzy259: folds
Uncalled bet ($0.01) returned to RodriguezDB
RodriguezDB collected $0.02 from pot
*** SUMMARY ***
Total pot $0.02 | Rake $0
Seat 1: NivelXcamione (button) folded before Flop (didn't bet)
Seat 2: Rutzy259 (small blind) folded before Flop
Seat 3: RodriguezDB (big blind) collected ($0.02)
Seat 4: BluffJobbbz folded before Flop (didn't bet)
Seat 5: Noah_D@vid folded before Flop (didn't bet)
Seat 6: freedomcrank folded before Flop (didn't bet)


PokerStars Hand #238162519415:  Hold'em No Limit ($0.01/$0.02 USD) - 2022/08/23 3:11:06 ET
Table 'Achilles IV' 6-max Seat #2 is the button
Seat 1: NivelXcamione ($1.04 in chips)
Seat 2: Rutzy259 ($1.56 in chips)
Seat 3: RodriguezDB ($2.26 in chips)
Seat 4: BluffJobbbz ($3.94 in chips)
Seat 5: Noah_D@vid ($1.45 in chips)
Seat 6: freedomcrank ($2.53 in chips)
RodriguezDB: posts small blind $0.01
BluffJobbbz: posts big blind $0.02
*** HOLE CARDS ***
Noah_D@vid: folds
freedomcrank: raises $0.04 to $0.06
NivelXcamione: raises $0.98 to $1.04 and is all-in
Rutzy259: folds
RodriguezDB: folds
BluffJobbbz: folds
freedomcrank: folds
Uncalled bet ($0.98) returned to NivelXcamione
NivelXcamione collected $0.15 from pot
NivelXcamione: doesn't show hand
*** SUMMARY ***
Total pot $0.15 | Rake $0
Seat 1: NivelXcamione collected ($0.15)
Seat 2: Rutzy259 (button) folded before Flop (didn't bet)
Seat 3: RodriguezDB (small blind) folded before Flop
Seat 4: BluffJobbbz (big blind) folded before Flop
Seat 5: Noah_D@vid folded before Flop (didn't bet)
Seat 6: freedomcrank folded before Flop


PokerStars Hand #238162521564:  Hold'em No Limit ($0.01/$0.02 USD) - 2022/08/23 3:11:25 ET
Table 'Achilles IV' 6-max Seat #3 is the button
Seat 1: NivelXcamione ($1.13 in chips)
Seat 2: Rutzy259 ($1.56 in chips)
Seat 3: RodriguezDB ($2.25 in chips)
Seat 4: BluffJobbbz ($3.92 in chips)
Seat 5: Noah_D@vid ($1.45 in chips)
Seat 6: freedomcrank ($2.47 in chips)
BluffJobbbz: posts small blind $0.01
Noah_D@vid: posts big blind $0.02
*** HOLE CARDS ***
freedomcrank: folds
NivelXcamione: raises $0.04 to $0.06
Rutzy259: folds
RodriguezDB: folds
BluffJobbbz: folds
Noah_D@vid: calls $0.04
*** FLOP *** [Ts 9h 4c]
Noah_D@vid: checks
NivelXcamione: bets $0.06
Noah_D@vid: calls $0.06
*** TURN *** [Ts 9h 4c] [5s]
Noah_D@vid: checks
NivelXcamione: checks
*** RIVER *** [Ts 9h 4c 5s] [7h]
Noah_D@vid: checks
NivelXcamione: checks
*** SHOW DOWN ***
Noah_D@vid: shows [Ac Ks] (high card Ace)
NivelXcamione: mucks hand
Noah_D@vid collected $0.24 from pot
*** SUMMARY ***
Total pot $0.25 | Rake $0.01
Board [Ts 9h 4c 5s 7h]
Seat 1: NivelXcamione mucked
Seat 2: Rutzy259 folded before Flop (didn't bet)
Seat 3: RodriguezDB (button) folded before Flop (didn't bet)
Seat 4: BluffJobbbz (small blind) folded before Flop
Seat 5: Noah_D@vid (big blind) showed [Ac Ks] and won ($0.24) with high card Ace
Seat 6: freedomcrank folded before Flop (didn't bet)


PokerStars Hand #238162525724:  Hold'em No Limit ($0.01/$0.02 USD) - 2022/08/23 3:12:03 ET
Table 'Achilles IV' 6-max Seat #4 is the button
Seat 1: NivelXcamione ($1.01 in chips)
Seat 2: Rutzy259 ($1.56 in chips)
Seat 3: RodriguezDB ($2.25 in chips)
Seat 4: BluffJobbbz ($3.91 in chips)
Seat 5: Noah_D@vid ($1.57 in chips)
Seat 6: freedomcrank ($2.47 in chips)
Noah_D@vid: posts small blind $0.01
freedomcrank: posts big blind $0.02
*** HOLE CARDS ***
NivelXcamione: folds
Rutzy259: folds
RodriguezDB: raises $0.04 to $0.06
BluffJobbbz: folds
Noah_D@vid: folds
freedomcrank: folds
Uncalled bet ($0.04) returned to RodriguezDB
RodriguezDB collected $0.05 from pot
*** SUMMARY ***
Total pot $0.05 | Rake $0
Seat 1: NivelXcamione folded before Flop (didn't bet)
Seat 2: Rutzy259 folded before Flop (didn't bet)
Seat 3: RodriguezDB collected ($0.05)
Seat 4: BluffJobbbz (button) folded before Flop (didn't bet)
Seat 5: Noah_D@vid (small blind) folded before Flop
Seat 6: freedomcrank (big blind) folded before Flop


PokerStars Hand #238162528197:  Hold'em No Limit ($0.01/$0.02 USD) - 2022/08/23 3:12:25 ET
Table 'Achilles IV' 6-max Seat #5 is the button
Seat 1: NivelXcamione ($1.01 in chips)
Seat 2: Rutzy259 ($1.56 in chips)
Seat 3: RodriguezDB ($2.28 in chips)
Seat 4: BluffJobbbz ($3.91 in chips)
Seat 5: Noah_D@vid ($1.56 in chips)
Seat 6: freedomcrank ($2.45 in chips)
freedomcrank: posts small blind $0.01
NivelXcamione: posts big blind $0.02
*** HOLE CARDS ***
Rutzy259: calls $0.02
RodriguezDB: folds
BluffJobbbz: folds
Noah_D@vid: folds
freedomcrank: calls $0.01
NivelXcamione: checks
*** FLOP *** [9s 5s 6d]
freedomcrank: checks
NivelXcamione: checks
Rutzy259: checks
*** TURN *** [9s 5s 6d] [Qs]
freedomcrank: checks
NivelXcamione: bets $0.06
Rutzy259: folds
freedomcrank: folds
Uncalled bet ($0.06) returned to NivelXcamione
NivelXcamione collected $0.06 from pot
NivelXcamione: doesn't show hand
*** SUMMARY ***
Total pot $0.06 | Rake $0
Board [9s 5s 6d Qs]
Seat 1: NivelXcamione (big blind) collected ($0.06)
Seat 2: Rutzy259 folded on the Turn
Seat 3: RodriguezDB folded before Flop (didn't bet)
Seat 4: BluffJobbbz folded before Flop (didn't bet)
Seat 5: Noah_D@vid (button) folded before Flop (didn't bet)
Seat 6: freedomcrank (small blind) folded on the Turn


PokerStars Hand #238162531925:  Hold'em No Limit ($0.01/$0.02 USD) - 2022/08/23 3:12:59 ET
Table 'Achilles IV' 6-max Seat #6 is the button
Seat 1: NivelXcamione ($1.05 in chips)
Seat 2: Rutzy259 ($1.54 in chips)
Seat 3: RodriguezDB ($2.28 in chips)
Seat 4: BluffJobbbz ($3.91 in chips)
Seat 5: Noah_D@vid ($1.56 in chips)
Seat 6: freedomcrank ($2.43 in chips)
NivelXcamione: posts small blind $0.01
Rutzy259: posts big blind $0.02
*** HOLE CARDS ***
RodriguezDB: raises $0.04 to $0.06
BluffJobbbz: folds
Noah_D@vid: calls $0.06
freedomcrank: calls $0.06
NivelXcamione: calls $0.05
Rutzy259: folds
*** FLOP *** [Tc 9s Ts]
NivelXcamione: checks
RodriguezDB: checks
Noah_D@vid: bets $0.12
freedomcrank: calls $0.12
NivelXcamione: folds
RodriguezDB: calls $0.12
*** TURN *** [Tc 9s Ts] [5h]
RodriguezDB: checks
Noah_D@vid: bets $0.30
freedomcrank: folds
RodriguezDB: folds
Uncalled bet ($0.30) returned to Noah_D@vid
Noah_D@vid collected $0.60 from pot
*** SUMMARY ***
Total pot $0.62 | Rake $0.02
Board [Tc 9s Ts 5h]
Seat 1: NivelXcamione (small blind) folded on the Flop
Seat 2: Rutzy259 (big blind) folded before Flop
Seat 3: RodriguezDB folded on the Turn
Seat 4: BluffJobbbz folded before Flop (didn't bet)
Seat 5: Noah_D@vid collected ($0.60)
Seat 6: freedomcrank (button) folded on the Turn


PokerStars Hand #238162539751:  Hold'em No Limit ($0.01/$0.02 USD) - 2022/08/23 3:14:09 ET
Table 'Achilles IV' 6-max Seat #1 is the button
Seat 1: NivelXcamione ($0.99 in chips)
Seat 2: Rutzy259 ($1.52 in chips)
Seat 3: RodriguezDB ($2.10 in chips)
Seat 4: BluffJobbbz ($3.91 in chips)
Seat 5: Noah_D@vid ($1.98 in chips)
Seat 6: freedomcrank ($2.25 in chips)
Rutzy259: posts small blind $0.01
RodriguezDB: posts big blind $0.02
*** HOLE CARDS ***
BluffJobbbz: folds
Noah_D@vid: calls $0.02
freedomcrank: raises $0.04 to $0.06
NivelXcamione: folds
Rutzy259: folds
RodriguezDB: folds
Noah_D@vid: calls $0.04
*** FLOP *** [8h 8d Tc]
Noah_D@vid: checks
freedomcrank: bets $0.04
Noah_D@vid: folds
Uncalled bet ($0.04) returned to freedomcrank
freedomcrank collected $0.14 from pot
freedomcrank: doesn't show hand
*** SUMMARY ***
Total pot $0.15 | Rake $0.01
Board [8h 8d Tc]
Seat 1: NivelXcamione (button) folded before Flop (didn't bet)
Seat 2: Rutzy259 (small blind) folded before Flop
Seat 3: RodriguezDB (big blind) folded before Flop
Seat 4: BluffJobbbz folded before Flop (didn't bet)
Seat 5: Noah_D@vid folded on the Flop
Seat 6: freedomcrank collected ($0.14)


PokerStars Hand #238162542967:  Hold'em No Limit ($0.01/$0.02 USD) - 2022/08/23 3:14:38 ET
Table 'Achilles IV' 6-max Seat #2 is the button
Seat 1: NivelXcamione ($0.99 in chips)
Seat 2: Rutzy259 ($1.51 in chips)
Seat 3: RodriguezDB ($2.08 in chips)
Seat 4: BluffJobbbz ($3.91 in chips)
Seat 5: Noah_D@vid ($1.92 in chips)
Seat 6: freedomcrank ($2.33 in chips)
RodriguezDB: posts small blind $0.01
BluffJobbbz: posts big blind $0.02
*** HOLE CARDS ***
Noah_D@vid: folds
freedomcrank: folds
NivelXcamione: folds
Rutzy259: folds
RodriguezDB: folds
Uncalled bet ($0.01) returned to BluffJobbbz
BluffJobbbz collected $0.02 from pot
BluffJobbbz: doesn't show hand
*** SUMMARY ***
Total pot $0.02 | Rake $0
Seat 1: NivelXcamione folded before Flop (didn't bet)
Seat 2: Rutzy259 (button) folded before Flop (didn't bet)
Seat 3: RodriguezDB (small blind) folded before Flop
Seat 4: BluffJobbbz (big blind) collected ($0.02)
Seat 5: Noah_D@vid folded before Flop (didn't bet)
Seat 6: freedomcrank folded before Flop (didn't bet)


PokerStars Hand #238162544236:  Hold'em No Limit ($0.01/$0.02 USD) - 2022/08/23 3:14:50 ET
Table 'Achilles IV' 6-max Seat #3 is the button
Seat 1: NivelXcamione ($0.99 in chips)
Seat 2: Rutzy259 ($1.51 in chips)
Seat 3: RodriguezDB ($2.07 in chips)
Seat 4: BluffJobbbz ($3.92 in chips)
Seat 5: Noah_D@vid ($1.92 in chips)
Seat 6: freedomcrank ($2.33 in chips)
BluffJobbbz: posts small blind $0.01
Noah_D@vid: posts big blind $0.02
*** HOLE CARDS ***
freedomcrank: folds
NivelXcamione: calls $0.02
Rutzy259: folds
RodriguezDB: raises $0.08 to $0.10
BluffJobbbz: folds
Noah_D@vid: folds
NivelXcamione: folds
Uncalled bet ($0.08) returned to RodriguezDB
RodriguezDB collected $0.07 from pot
*** SUMMARY ***
Total pot $0.07 | Rake $0
Seat 1: NivelXcamione folded before Flop
Seat 2: Rutzy259 folded before Flop (didn't bet)
Seat 3: RodriguezDB (button) collected ($0.07)
Seat 4: BluffJobbbz (small blind) folded before Flop
Seat 5: Noah_D@vid (big blind) folded before Flop
Seat 6: freedomcrank folded before Flop (didn't bet)


PokerStars Hand #238162546835:  Hold'em No Limit ($0.01/$0.02 USD) - 2022/08/23 3:15:13 ET
Table 'Achilles IV' 6-max Seat #4 is the button
Seat 1: NivelXcamione ($0.97 in chips)
Seat 2: Rutzy259 ($1.51 in chips)
Seat 3: RodriguezDB ($2.12 in chips)
Seat 4: BluffJobbbz ($3.91 in chips)
Seat 5: Noah_D@vid ($1.90 in chips)
Seat 6: freedomcrank ($2.33 in chips)
Noah_D@vid: posts small blind $0.01
freedomcrank: posts big blind $0.02
*** HOLE CARDS ***
NivelXcamione: folds
Rutzy259: folds
RodriguezDB: folds
BluffJobbbz: raises $0.03 to $0.05
Noah_D@vid: folds
freedomcrank: calls $0.03
*** FLOP *** [4s 5h 6h]
freedomcrank: checks
BluffJobbbz: checks
*** TURN *** [4s 5h 6h] [3s]
freedomcrank: bets $0.08
BluffJobbbz: folds
Uncalled bet ($0.08) returned to freedomcrank
freedomcrank collected $0.11 from pot
freedomcrank: doesn't show hand
*** SUMMARY ***
Total pot $0.11 | Rake $0
Board [4s 5h 6h 3s]
Seat 1: NivelXcamione folded before Flop (didn't bet)
Seat 2: Rutzy259 folded before Flop (didn't bet)
Seat 3: RodriguezDB folded before Flop (didn't bet)
Seat 4: BluffJobbbz (button) folded on the Turn
Seat 5: Noah_D@vid (small blind) folded before Flop
Seat 6: freedomcrank (big blind) collected ($0.11)


PokerStars Hand #238162552270:  Hold'em No Limit ($0.01/$0.02 USD) - 2022/08/23 3:16:02 ET
Table 'Achilles IV' 6-max Seat #5 is the button
Seat 1: NivelXcamione ($0.97 in chips)
Seat 2: Rutzy259 ($1.51 in chips)
Seat 3: RodriguezDB ($2.12 in chips)
Seat 4: BluffJobbbz ($3.86 in chips)
Seat 5: Noah_D@vid ($1.89 in chips)
Seat 6: freedomcrank ($2.39 in chips)
freedomcrank: posts small blind $0.01
NivelXcamione: posts big blind $0.02
*** HOLE CARDS ***
Rutzy259: folds
RodriguezDB: folds
BluffJobbbz: raises $0.03 to $0.05
Noah_D@vid: folds
freedomcrank: folds
NivelXcamione: folds
Uncalled bet ($0.03) returned to BluffJobbbz
BluffJobbbz collected $0.05 from pot
BluffJobbbz: doesn't show hand
*** SUMMARY ***
Total pot $0.05 | Rake $0
Seat 1: NivelXcamione (big blind) folded before Flop
Seat 2: Rutzy259 folded before Flop (didn't bet)
Seat 3: RodriguezDB folded before Flop (didn't bet)
Seat 4: BluffJobbbz collected ($0.05)
Seat 5: Noah_D@vid (button) folded before Flop (didn't bet)
Seat 6: freedomcrank (small blind) folded before Flop


PokerStars Hand #238162554065:  Hold'em No Limit ($0.01/$0.02 USD) - 2022/08/23 3:16:18 ET
Table 'Achilles IV' 6-max Seat #1 is the button
Seat 1: NivelXcamione ($0.95 in chips)
Seat 2: Rutzy259 ($1.51 in chips)
Seat 3: RodriguezDB ($2.12 in chips)
Seat 4: BluffJobbbz ($3.89 in chips)
Seat 5: Noah_D@vid ($1.89 in chips)
Rutzy259: posts small blind $0.01
RodriguezDB: posts big blind $0.02
*** HOLE CARDS ***
freedomcrank leaves the table
BluffJobbbz: folds
BluffJobbbz leaves the table
Noah_D@vid: folds
NivelXcamione: folds
Rutzy259: calls $0.01
RodriguezDB: checks
*** FLOP *** [5d 6h 9s]
Rutzy259: checks
RodriguezDB: checks
*** TURN *** [5d 6h 9s] [3s]
Rutzy259: bets $0.08
RodriguezDB: folds
Uncalled bet ($0.08) returned to Rutzy259
Rutzy259 collected $0.04 from pot
*** SUMMARY ***
Total pot $0.04 | Rake $0
Board [5d 6h 9s 3s]
Seat 1: NivelXcamione (button) folded before Flop (didn't bet)
Seat 2: Rutzy259 (small blind) collected ($0.04)
Seat 3: RodriguezDB (big blind) folded on the Turn
Seat 4: BluffJobbbz folded before Flop (didn't bet)
Seat 5: Noah_D@vid folded before Flop (didn't bet)


PokerStars Hand #238162558183:  Hold'em No Limit ($0.01/$0.02 USD) - 2022/08/23 3:16:54 ET
Table 'Achilles IV' 6-max Seat #2 is the button
Seat 1: NivelXcamione ($0.95 in chips)
Seat 2: Rutzy259 ($1.53 in chips)
Seat 3: RodriguezDB ($2.10 in chips)
Seat 5: Noah_D@vid ($1.89 in chips)
RodriguezDB: posts small blind $0.01
Noah_D@vid: posts big blind $0.02
*** HOLE CARDS ***
NivelXcamione: raises $0.04 to $0.06
Rutzy259: calls $0.06
RodriguezDB: folds
Noah_D@vid: folds
*** FLOP *** [3h Qs Jh]
NivelXcamione: bets $0.07
Rutzy259: calls $0.07
*** TURN *** [3h Qs Jh] [3s]
NivelXcamione: bets $0.14
Rutzy259: folds
Uncalled bet ($0.14) returned to NivelXcamione
NivelXcamione collected $0.28 from pot
NivelXcamione: doesn't show hand
*** SUMMARY ***
Total pot $0.29 | Rake $0.01
Board [3h Qs Jh 3s]
Seat 1: NivelXcamione collected ($0.28)
Seat 2: Rutzy259 (button) folded on the Turn
Seat 3: RodriguezDB (small blind) folded before Flop
Seat 5: Noah_D@vid (big blind) folded before Flop


PokerStars Hand #238162561548:  Hold'em No Limit ($0.01/$0.02 USD) - 2022/08/23 3:17:25 ET
Table 'Achilles IV' 6-max Seat #3 is the button
Seat 1: NivelXcamione ($1.10 in chips)
Seat 2: Rutzy259 ($1.40 in chips)
Seat 3: RodriguezDB ($2.09 in chips)
Seat 5: Noah_D@vid ($1.87 in chips)
Noah_D@vid: posts small blind $0.01
NivelXcamione: posts big blind $0.02
*** HOLE CARDS ***
Rutzy259: folds
RodriguezDB: raises $0.04 to $0.06
Noah_D@vid: folds
blektron1 joins the table at seat #6
H17FS joins the table at seat #4
NivelXcamione: folds
Uncalled bet ($0.04) returned to RodriguezDB
RodriguezDB collected $0.05 from pot
*** SUMMARY ***
Total pot $0.05 | Rake $0
Seat 1: NivelXcamione (big blind) folded before Flop
Seat 2: Rutzy259 folded before Flop (didn't bet)
Seat 3: RodriguezDB (button) collected ($0.05)
Seat 5: Noah_D@vid (small blind) folded before Flop


PokerStars Hand #238162564753:  Hold'em No Limit ($0.01/$0.02 USD) - 2022/08/23 3:17:53 ET
Table 'Achilles IV' 6-max Seat #5 is the button
Seat 1: NivelXcamione ($1.08 in chips)
Seat 2: Rutzy259 ($1.40 in chips)
Seat 3: RodriguezDB ($2.12 in chips)
Seat 4: H17FS ($1.60 in chips)
Seat 5: Noah_D@vid ($1.86 in chips)
NivelXcamione: posts small blind $0.01
Rutzy259: posts big blind $0.02
H17FS: posts big blind $0.02
*** HOLE CARDS ***
RodriguezDB: folds
H17FS: checks
Noah_D@vid: folds
NivelXcamione: calls $0.01
Rutzy259: raises $0.06 to $0.08
H17FS: calls $0.06
NivelXcamione: folds
*** FLOP *** [6h Ad 8s]
Rutzy259: checks
H17FS: checks
*** TURN *** [6h Ad 8s] [9h]
Rutzy259: bets $0.10
H17FS: calls $0.10
*** RIVER *** [6h Ad 8s 9h] [Qs]
Rutzy259: bets $0.14
H17FS: calls $0.14
*** SHOW DOWN ***
Rutzy259: shows [As Jd] (a pair of Aces)
H17FS: mucks hand
Rutzy259 collected $0.64 from pot
*** SUMMARY ***
Total pot $0.66 | Rake $0.02
Board [6h Ad 8s 9h Qs]
Seat 1: NivelXcamione (small blind) folded before Flop
Seat 2: Rutzy259 (big blind) showed [As Jd] and won ($0.64) with a pair of Aces
Seat 3: RodriguezDB folded before Flop (didn't bet)
Seat 4: H17FS mucked
Seat 5: Noah_D@vid (button) folded before Flop (didn't bet)


PokerStars Hand #238162570541:  Hold'em No Limit ($0.01/$0.02 USD) - 2022/08/23 3:18:45 ET
Table 'Achilles IV' 6-max Seat #1 is the button
Seat 1: NivelXcamione ($1.06 in chips)
Seat 2: Rutzy259 ($1.72 in chips)
Seat 3: RodriguezDB ($2.12 in chips)
Seat 4: H17FS ($1.28 in chips)
Seat 5: Noah_D@vid ($1.86 in chips)
Seat 6: blektron1 ($0.80 in chips)
Rutzy259: posts small blind $0.01
RodriguezDB: posts big blind $0.02
blektron1: posts big blind $0.02
*** HOLE CARDS ***
H17FS: calls $0.02
Noah_D@vid: folds
blektron1: checks
NivelXcamione: folds
Rutzy259: raises $0.02 to $0.04
RodriguezDB: folds
H17FS: calls $0.02
blektron1: calls $0.02
*** FLOP *** [Tc Js Jc]
Rutzy259: checks
H17FS: checks
blektron1: checks
*** TURN *** [Tc Js Jc] [6s]
Rutzy259: bets $0.08
H17FS: calls $0.08
blektron1: folds
*** RIVER *** [Tc Js Jc 6s] [5h]
Rutzy259: checks
H17FS: bets $0.14
Rutzy259: folds
Uncalled bet ($0.14) returned to H17FS
H17FS collected $0.29 from pot
*** SUMMARY ***
Total pot $0.30 | Rake $0.01
Board [Tc Js Jc 6s 5h]
Seat 1: NivelXcamione (button) folded before Flop (didn't bet)
Seat 2: Rutzy259 (small blind) folded on the River
Seat 3: RodriguezDB (big blind) folded before Flop
Seat 4: H17FS collected ($0.29)
Seat 5: Noah_D@vid folded before Flop (didn't bet)
Seat 6: blektron1 folded on the Turn


PokerStars Hand #238162576802:  Hold'em No Limit ($0.01/$0.02 USD) - 2022/08/23 3:19:40 ET
Table 'Achilles IV' 6-max Seat #2 is the button
Seat 1: NivelXcamione ($1.06 in chips)
Seat 2: Rutzy259 ($1.60 in chips)
Seat 3: RodriguezDB ($2.10 in chips)
Seat 4: H17FS ($1.45 in chips)
Seat 5: Noah_D@vid ($1.86 in chips)
Seat 6: blektron1 ($0.76 in chips)
RodriguezDB: posts small blind $0.01
H17FS: posts big blind $0.02
*** HOLE CARDS ***
Noah_D@vid: raises $0.02 to $0.04
blektron1: calls $0.04
NivelXcamione: folds
Rutzy259: calls $0.04
RodriguezDB: folds
H17FS: calls $0.02
*** FLOP *** [Jc 2d 4d]
H17FS: checks
Noah_D@vid: bets $0.04
blektron1: folds
Rutzy259: calls $0.04
H17FS: folds
*** TURN *** [Jc 2d 4d] [6s]
Noah_D@vid: checks
Rutzy259: checks
*** RIVER *** [Jc 2d 4d 6s] [Qs]
Noah_D@vid: checks
Rutzy259: bets $0.14
Noah_D@vid: folds
Uncalled bet ($0.14) returned to Rutzy259
Rutzy259 collected $0.24 from pot
*** SUMMARY ***
Total pot $0.25 | Rake $0.01
Board [Jc 2d 4d 6s Qs]
Seat 1: NivelXcamione folded before Flop (didn't bet)
Seat 2: Rutzy259 (button) collected ($0.24)
Seat 3: RodriguezDB (small blind) folded before Flop
Seat 4: H17FS (big blind) folded on the Flop
Seat 5: Noah_D@vid folded on the River
Seat 6: blektron1 folded on the Flop


PokerStars Hand #238162581871:  Hold'em No Limit ($0.01/$0.02 USD) - 2022/08/23 3:20:24 ET
Table 'Achilles IV' 6-max Seat #3 is the button
Seat 1: NivelXcamione ($1.06 in chips)
Seat 2: Rutzy259 ($1.76 in chips)
Seat 3: RodriguezDB ($2.09 in chips)
Seat 4: H17FS ($1.41 in chips)
Seat 5: Noah_D@vid ($1.78 in chips)
Seat 6: blektron1 ($0.72 in chips)
H17FS: posts small blind $0.01
Noah_D@vid: posts big blind $0.02
*** HOLE CARDS ***
blektron1: folds
NivelXcamione: folds
Rutzy259: calls $0.02
RodriguezDB: folds
H17FS: folds
Noah_D@vid: checks
*** FLOP *** [5c 8c 3d]
Noah_D@vid: checks
Rutzy259: checks
*** TURN *** [5c 8c 3d] [8d]
Noah_D@vid: checks
Rutzy259: checks
*** RIVER *** [5c 8c 3d 8d] [4d]
Noah_D@vid: bets $0.02
Rutzy259: folds
Uncalled bet ($0.02) returned to Noah_D@vid
Noah_D@vid collected $0.05 from pot
Noah_D@vid: doesn't show hand
*** SUMMARY ***
Total pot $0.05 | Rake $0
Board [5c 8c 3d 8d 4d]
Seat 1: NivelXcamione folded before Flop (didn't bet)
Seat 2: Rutzy259 folded on the River
Seat 3: RodriguezDB (button) folded before Flop (didn't bet)
Seat 4: H17FS (small blind) folded before Flop
Seat 5: Noah_D@vid (big blind) collected ($0.05)
Seat 6: blektron1 folded before Flop (didn't bet)


PokerStars Hand #238162585054:  Hold'em No Limit ($0.01/$0.02 USD) - 2022/08/23 3:20:53 ET
Table 'Achilles IV' 6-max Seat #4 is the button
Seat 1: NivelXcamione ($1.06 in chips)
Seat 2: Rutzy259 ($1.74 in chips)
Seat 3: RodriguezDB ($2.09 in chips)
Seat 4: H17FS ($1.40 in chips)
Seat 5: Noah_D@vid ($1.81 in chips)
Seat 6: blektron1 ($0.72 in chips)
Noah_D@vid: posts small blind $0.01
blektron1: posts big blind $0.02
*** HOLE CARDS ***
NivelXcamione: calls $0.02
Rutzy259: folds
RodriguezDB: folds
H17FS: folds
Noah_D@vid: folds
blektron1: checks
*** FLOP *** [3s Kh 5h]
blektron1: checks
NivelXcamione: bets $0.04
blektron1: folds
Uncalled bet ($0.04) returned to NivelXcamione
NivelXcamione collected $0.05 from pot
NivelXcamione: doesn't show hand
*** SUMMARY ***
Total pot $0.05 | Rake $0
Board [3s Kh 5h]
Seat 1: NivelXcamione collected ($0.05)
Seat 2: Rutzy259 folded before Flop (didn't bet)
Seat 3: RodriguezDB folded before Flop (didn't bet)
Seat 4: H17FS (button) folded before Flop (didn't bet)
Seat 5: Noah_D@vid (small blind) folded before Flop
Seat 6: blektron1 (big blind) folded on the Flop


PokerStars Hand #238162588339:  Hold'em No Limit ($0.01/$0.02 USD) - 2022/08/23 3:21:22 ET
Table 'Achilles IV' 6-max Seat #5 is the button
Seat 1: NivelXcamione ($1.09 in chips)
Seat 2: Rutzy259 ($1.74 in chips)
Seat 3: RodriguezDB ($2.09 in chips)
Seat 4: H17FS ($1.40 in chips)
Seat 5: Noah_D@vid ($1.80 in chips)
Seat 6: blektron1 ($0.70 in chips)
blektron1: posts small blind $0.01
NivelXcamione: posts big blind $0.02
*** HOLE CARDS ***
Rutzy259: calls $0.02
RodriguezDB: folds
H17FS: calls $0.02
Noah_D@vid: calls $0.02
blektron1: folds
NivelXcamione: checks
*** FLOP *** [6c Ts 4c]
NivelXcamione: checks
Rutzy259: bets $0.02
H17FS: calls $0.02
Noah_D@vid: calls $0.02
NivelXcamione: folds
*** TURN *** [6c Ts 4c] [Jd]
Rutzy259: bets $0.16
H17FS: folds
Noah_D@vid: calls $0.16
*** RIVER *** [6c Ts 4c Jd] [9d]
Rutzy259: bets $0.34
Noah_D@vid: raises $0.34 to $0.68
Rutzy259: folds
Uncalled bet ($0.34) returned to Noah_D@vid
Noah_D@vid collected $1.11 from pot
*** SUMMARY ***
Total pot $1.15 | Rake $0.04
Board [6c Ts 4c Jd 9d]
Seat 1: NivelXcamione (big blind) folded on the Flop
Seat 2: Rutzy259 folded on the River
Seat 3: RodriguezDB folded before Flop (didn't bet)
Seat 4: H17FS folded on the Turn
Seat 5: Noah_D@vid (button) collected ($1.11)
Seat 6: blektron1 (small blind) folded before Flop


PokerStars Hand #238162596996:  Hold'em No Limit ($0.01/$0.02 USD) - 2022/08/23 3:22:41 ET
Table 'Achilles IV' 6-max Seat #6 is the button
Seat 1: NivelXcamione ($1.07 in chips)
Seat 2: Rutzy259 ($1.20 in chips)
Seat 3: RodriguezDB ($2.09 in chips)
Seat 4: H17FS ($1.36 in chips)
Seat 5: Noah_D@vid ($2.37 in chips)
Seat 6: blektron1 ($0.69 in chips)
NivelXcamione: posts small blind $0.01
Rutzy259: posts big blind $0.02
*** HOLE CARDS ***
RodriguezDB: folds
H17FS: folds
Noah_D@vid: folds
blektron1: folds
NivelXcamione: folds
Uncalled bet ($0.01) returned to Rutzy259
Rutzy259 collected $0.02 from pot
*** SUMMARY ***
Total pot $0.02 | Rake $0
Seat 1: NivelXcamione (small blind) folded before Flop
Seat 2: Rutzy259 (big blind) collected ($0.02)
Seat 3: RodriguezDB folded before Flop (didn't bet)
Seat 4: H17FS folded before Flop (didn't bet)
Seat 5: Noah_D@vid folded before Flop (didn't bet)
Seat 6: blektron1 (button) folded before Flop (didn't bet)


PokerStars Hand #238162599125:  Hold'em No Limit ($0.01/$0.02 USD) - 2022/08/23 3:22:59 ET
Table 'Achilles IV' 6-max Seat #1 is the button
Seat 1: NivelXcamione ($1.06 in chips)
Seat 2: Rutzy259 ($1.21 in chips)
Seat 3: RodriguezDB ($2.09 in chips)
Seat 4: H17FS ($1.36 in chips)
Seat 5: Noah_D@vid ($2.37 in chips)
Seat 6: blektron1 ($0.69 in chips)
Rutzy259: posts small blind $0.01
RodriguezDB: posts big blind $0.02
*** HOLE CARDS ***
H17FS: folds
Noah_D@vid: folds
blektron1: calls $0.02
NivelXcamione: raises $0.04 to $0.06
Rutzy259: calls $0.05
RodriguezDB: folds
blektron1: calls $0.04
*** FLOP *** [3d 7s 3s]
Rutzy259: bets $0.06
blektron1: folds
NivelXcamione: calls $0.06
*** TURN *** [3d 7s 3s] [Ts]
Rutzy259: bets $0.16
NivelXcamione: folds
Uncalled bet ($0.16) returned to Rutzy259
Rutzy259 collected $0.31 from pot
*** SUMMARY ***
Total pot $0.32 | Rake $0.01
Board [3d 7s 3s Ts]
Seat 1: NivelXcamione (button) folded on the Turn
Seat 2: Rutzy259 (small blind) collected ($0.31)
Seat 3: RodriguezDB (big blind) folded before Flop
Seat 4: H17FS folded before Flop (didn't bet)
Seat 5: Noah_D@vid folded before Flop (didn't bet)
Seat 6: blektron1 folded on the Flop


PokerStars Hand #238162605816:  Hold'em No Limit ($0.01/$0.02 USD) - 2022/08/23 3:23:59 ET
Table 'Achilles IV' 6-max Seat #2 is the button
Seat 1: NivelXcamione ($0.94 in chips)
Seat 2: Rutzy259 ($1.40 in chips)
Seat 3: RodriguezDB ($2.07 in chips)
Seat 4: H17FS ($1.36 in chips)
Seat 5: Noah_D@vid ($2.37 in chips)
Seat 6: blektron1 ($0.63 in chips)
RodriguezDB: posts small blind $0.01
H17FS: posts big blind $0.02
*** HOLE CARDS ***
Noah_D@vid: folds
blektron1: folds
NivelXcamione: folds
Rutzy259: calls $0.02
RodriguezDB: raises $0.04 to $0.06
H17FS: calls $0.04
Rutzy259: raises $0.04 to $0.10
RodriguezDB: calls $0.04
H17FS: calls $0.04
*** FLOP *** [Th 9d 6s]
RodriguezDB: checks
H17FS: checks
Rutzy259: checks
*** TURN *** [Th 9d 6s] [6c]
RodriguezDB: checks
H17FS: bets $0.08
Rutzy259: calls $0.08
RodriguezDB: folds
*** RIVER *** [Th 9d 6s 6c] [7c]
H17FS: bets $0.06
Rutzy259: calls $0.06
*** SHOW DOWN ***
H17FS: shows [5c 5h] (two pair, Sixes and Fives)
Rutzy259: shows [As 7s] (two pair, Sevens and Sixes)
Rutzy259 collected $0.56 from pot
*** SUMMARY ***
Total pot $0.58 | Rake $0.02
Board [Th 9d 6s 6c 7c]
Seat 1: NivelXcamione folded before Flop (didn't bet)
Seat 2: Rutzy259 (button) showed [As 7s] and won ($0.56) with two pair, Sevens and Sixes
Seat 3: RodriguezDB (small blind) folded on the Turn
Seat 4: H17FS (big blind) showed [5c 5h] and lost with two pair, Sixes and Fives
Seat 5: Noah_D@vid folded before Flop (didn't bet)
Seat 6: blektron1 folded before Flop (didn't bet)


PokerStars Hand #238162612415:  Hold'em No Limit ($0.01/$0.02 USD) - 2022/08/23 3:24:58 ET
Table 'Achilles IV' 6-max Seat #3 is the button
Seat 1: NivelXcamione ($0.94 in chips)
Seat 2: Rutzy259 ($1.72 in chips)
Seat 3: RodriguezDB ($2 in chips)
Seat 4: H17FS ($1.12 in chips)
Seat 5: Noah_D@vid ($2.37 in chips)
Seat 6: blektron1 ($0.63 in chips)
H17FS: posts small blind $0.01
Noah_D@vid: posts big blind $0.02
*** HOLE CARDS ***
blektron1: folds
NivelXcamione: folds
Rutzy259: calls $0.02
RodriguezDB: raises $0.02 to $0.04
H17FS: calls $0.03
Noah_D@vid: calls $0.02
Rutzy259: raises $0.02 to $0.06
RodriguezDB: calls $0.02
H17FS: calls $0.02
Noah_D@vid: calls $0.02
*** FLOP *** [Kh Ac Tc]
H17FS: checks
Noah_D@vid: checks
Rutzy259: checks
RodriguezDB: bets $0.22
H17FS: folds
Noah_D@vid: folds
Rutzy259: raises $0.34 to $0.56
RodriguezDB: raises $1.38 to $1.94 and is all-in
Rutzy259: calls $1.10 and is all-in
Uncalled bet ($0.28) returned to RodriguezDB
*** TURN *** [Kh Ac Tc] [Ts]
*** RIVER *** [Kh Ac Tc Ts] [3c]
*** SHOW DOWN ***
Rutzy259: shows [8h Jh] (a pair of Tens)
RodriguezDB: shows [Qd As] (two pair, Aces and Tens)
RodriguezDB collected $3.44 from pot
*** SUMMARY ***
Total pot $3.56 | Rake $0.12
Board [Kh Ac Tc Ts 3c]
Seat 1: NivelXcamione folded before Flop (didn't bet)
Seat 2: Rutzy259 showed [8h Jh] and lost with a pair of Tens
Seat 3: RodriguezDB (button) showed [Qd As] and won ($3.44) with two pair, Aces and Tens
Seat 4: H17FS (small blind) folded on the Flop
Seat 5: Noah_D@vid (big blind) folded on the Flop
Seat 6: blektron1 folded before Flop (didn't bet)


PokerStars Hand #238162623599:  Hold'em No Limit ($0.01/$0.02 USD) - 2022/08/23 3:26:02 ET
Table 'Achilles IV' 6-max Seat #4 is the button
Seat 1: NivelXcamione ($0.94 in chips)
Seat 3: RodriguezDB ($3.72 in chips)
Seat 4: H17FS ($1.06 in chips)
Seat 5: Noah_D@vid ($2.31 in chips)
Seat 6: blektron1 ($0.63 in chips)
Noah_D@vid: posts small blind $0.01
blektron1: posts big blind $0.02
*** HOLE CARDS ***
NivelXcamione: raises $0.02 to $0.04
RodriguezDB: folds
Rutzy259 leaves the table
H17FS: folds
Noah_D@vid: calls $0.03
blektron1: folds
*** FLOP *** [Jc Qc 7h]
Noah_D@vid: checks
Xtens joins the table at seat #2
NivelXcamione: checks
*** TURN *** [Jc Qc 7h] [As]
Noah_D@vid: checks
NivelXcamione: checks
*** RIVER *** [Jc Qc 7h As] [Th]
Noah_D@vid: checks
NivelXcamione: bets $0.10
Noah_D@vid: folds
Uncalled bet ($0.10) returned to NivelXcamione
NivelXcamione collected $0.10 from pot
NivelXcamione: doesn't show hand
*** SUMMARY ***
Total pot $0.10 | Rake $0
Board [Jc Qc 7h As Th]
Seat 1: NivelXcamione collected ($0.10)
Seat 3: RodriguezDB folded before Flop (didn't bet)
Seat 4: H17FS (button) folded before Flop (didn't bet)
Seat 5: Noah_D@vid (small blind) folded on the River
Seat 6: blektron1 (big blind) folded before Flop


PokerStars Hand #238162628713:  Hold'em No Limit ($0.01/$0.02 USD) - 2022/08/23 3:26:48 ET
Table 'Achilles IV' 6-max Seat #5 is the button
Seat 1: NivelXcamione ($1 in chips)
Seat 3: RodriguezDB ($3.72 in chips)
Seat 4: H17FS ($1.06 in chips)
Seat 5: Noah_D@vid ($2.27 in chips)
Seat 6: blektron1 ($0.61 in chips)
blektron1: posts small blind $0.01
NivelXcamione: posts big blind $0.02
Xtens: sits out
*** HOLE CARDS ***
RodriguezDB: folds
H17FS: calls $0.02
Noah_D@vid: folds
blektron1: calls $0.01
NivelXcamione: checks
*** FLOP *** [Kh 6h Td]
blektron1: checks
NivelXcamione: checks
H17FS: checks
*** TURN *** [Kh 6h Td] [Ad]
blektron1: bets $0.04
NivelXcamione: folds
H17FS: calls $0.04
*** RIVER *** [Kh 6h Td Ad] [2s]
blektron1: bets $0.09
H17FS: folds
Uncalled bet ($0.09) returned to blektron1
blektron1 collected $0.14 from pot
blektron1: doesn't show hand
*** SUMMARY ***
Total pot $0.14 | Rake $0
Board [Kh 6h Td Ad 2s]
Seat 1: NivelXcamione (big blind) folded on the Turn
Seat 3: RodriguezDB folded before Flop (didn't bet)
Seat 4: H17FS folded on the River
Seat 5: Noah_D@vid (button) folded before Flop (didn't bet)
Seat 6: blektron1 (small blind) collected ($0.14)


PokerStars Hand #238162632869:  Hold'em No Limit ($0.01/$0.02 USD) - 2022/08/23 3:27:25 ET
Table 'Achilles IV' 6-max Seat #6 is the button
Seat 1: NivelXcamione ($0.98 in chips)
Seat 2: Xtens ($2 in chips)
Seat 3: RodriguezDB ($3.72 in chips)
Seat 4: H17FS ($1 in chips)
Seat 5: Noah_D@vid ($2.27 in chips)
Seat 6: blektron1 ($0.69 in chips)
NivelXcamione: posts small blind $0.01
Xtens: posts big blind $0.02
*** HOLE CARDS ***
RodriguezDB: folds
H17FS: folds
Noah_D@vid: folds
blektron1: calls $0.02
NivelXcamione: calls $0.01
Xtens: checks
*** FLOP *** [7d Ah Ts]
NivelXcamione: checks
Xtens: checks
blektron1: checks
*** TURN *** [7d Ah Ts] [Ks]
NivelXcamione: checks
Xtens: checks
blektron1: checks
*** RIVER *** [7d Ah Ts Ks] [Td]
NivelXcamione: checks
Xtens: checks
blektron1: bets $0.04
NivelXcamione: folds
Xtens: calls $0.04
*** SHOW DOWN ***
blektron1: shows [2c 2s] (two pair, Tens and Deuces)
Xtens: shows [8h Kd] (two pair, Kings and Tens)
Xtens collected $0.14 from pot
*** SUMMARY ***
Total pot $0.14 | Rake $0
Board [7d Ah Ts Ks Td]
Seat 1: NivelXcamione (small blind) folded on the River
Seat 2: Xtens (big blind) showed [8h Kd] and won ($0.14) with two pair, Kings and Tens
Seat 3: RodriguezDB folded before Flop (didn't bet)
Seat 4: H17FS folded before Flop (didn't bet)
Seat 5: Noah_D@vid folded before Flop (didn't bet)
Seat 6: blektron1 (button) showed [2c 2s] and lost with two pair, Tens and Deuces


PokerStars Hand #238162638220:  Hold'em No Limit ($0.01/$0.02 USD) - 2022/08/23 3:28:11 ET
Table 'Achilles IV' 6-max Seat #1 is the button
Seat 1: NivelXcamione ($0.96 in chips)
Seat 2: Xtens ($2.08 in chips)
Seat 3: RodriguezDB ($3.72 in chips)
Seat 4: H17FS ($1 in chips)
Seat 5: Noah_D@vid ($2.27 in chips)
Seat 6: blektron1 ($0.63 in chips)
Xtens: posts small blind $0.01
RodriguezDB: posts big blind $0.02
*** HOLE CARDS ***
H17FS: calls $0.02
Noah_D@vid: folds
blektron1: folds
NivelXcamione: folds
Xtens: folds
RodriguezDB: checks
*** FLOP *** [Kc 9h 6h]
RodriguezDB: checks
H17FS: checks
*** TURN *** [Kc 9h 6h] [Js]
RodriguezDB: checks
H17FS: checks
*** RIVER *** [Kc 9h 6h Js] [2c]
RodriguezDB: checks
H17FS: checks
*** SHOW DOWN ***
RodriguezDB: shows [2d Qh] (a pair of Deuces)
H17FS: mucks hand
RodriguezDB collected $0.05 from pot
*** SUMMARY ***
Total pot $0.05 | Rake $0
Board [Kc 9h 6h Js 2c]
Seat 1: NivelXcamione (button) folded before Flop (didn't bet)
Seat 2: Xtens (small blind) folded before Flop
Seat 3: RodriguezDB (big blind) showed [2d Qh] and won ($0.05) with a pair of Deuces
Seat 4: H17FS mucked
Seat 5: Noah_D@vid folded before Flop (didn't bet)
Seat 6: blektron1 folded before Flop (didn't bet)


PokerStars Hand #238162643160:  Hold'em No Limit ($0.01/$0.02 USD) - 2022/08/23 3:28:54 ET
Table 'Achilles IV' 6-max Seat #2 is the button
Seat 1: NivelXcamione ($0.96 in chips)
Seat 2: Xtens ($2.07 in chips)
Seat 3: RodriguezDB ($3.75 in chips)
Seat 4: H17FS ($0.98 in chips)
Seat 5: Noah_D@vid ($2.27 in chips)
Seat 6: blektron1 ($0.63 in chips)
RodriguezDB: posts small blind $0.01
H17FS: posts big blind $0.02
*** HOLE CARDS ***
Noah_D@vid: folds
blektron1: folds
NivelXcamione: folds
Noah_D@vid leaves the table
Xtens: raises $0.03 to $0.05
Koresh153 joins the table at seat #5
RodriguezDB: folds
H17FS: calls $0.03
*** FLOP *** [Jd 8d Jc]
H17FS: checks
Xtens: checks
*** TURN *** [Jd 8d Jc] [2s]
H17FS: checks
Xtens: checks
*** RIVER *** [Jd 8d Jc 2s] [6h]
H17FS: checks
Xtens: checks
*** SHOW DOWN ***
H17FS: shows [9h 7s] (a pair of Jacks)
Xtens: shows [Qd Ah] (a pair of Jacks - Ace kicker)
Xtens collected $0.11 from pot
*** SUMMARY ***
Total pot $0.11 | Rake $0
Board [Jd 8d Jc 2s 6h]
Seat 1: NivelXcamione folded before Flop (didn't bet)
Seat 2: Xtens (button) showed [Qd Ah] and won ($0.11) with a pair of Jacks
Seat 3: RodriguezDB (small blind) folded before Flop
Seat 4: H17FS (big blind) showed [9h 7s] and lost with a pair of Jacks
Seat 5: Noah_D@vid folded before Flop (didn't bet)
Seat 6: blektron1 folded before Flop (didn't bet)


PokerStars Hand #238162651927:  Hold'em No Limit ($0.01/$0.02 USD) - 2022/08/23 3:30:10 ET
Table 'Achilles IV' 6-max Seat #3 is the button
Seat 1: NivelXcamione ($0.96 in chips)
Seat 2: Xtens ($2.13 in chips)
Seat 3: RodriguezDB ($3.74 in chips)
Seat 4: H17FS ($0.93 in chips)
Seat 5: Koresh153 ($2 in chips)
Seat 6: blektron1 ($0.63 in chips)
H17FS: posts small blind $0.01
Koresh153: posts big blind $0.02
*** HOLE CARDS ***
blektron1: folds
NivelXcamione: folds
Xtens: folds
RodriguezDB: folds
H17FS: raises $0.02 to $0.04
Koresh153: folds
Uncalled bet ($0.02) returned to H17FS
H17FS collected $0.04 from pot
*** SUMMARY ***
Total pot $0.04 | Rake $0
Seat 1: NivelXcamione folded before Flop (didn't bet)
Seat 2: Xtens folded before Flop (didn't bet)
Seat 3: RodriguezDB (button) folded before Flop (didn't bet)
Seat 4: H17FS (small blind) collected ($0.04)
Seat 5: Koresh153 (big blind) folded before Flop
Seat 6: blektron1 folded before Flop (didn't bet)


PokerStars Hand #238162654009:  Hold'em No Limit ($0.01/$0.02 USD) - 2022/08/23 3:30:29 ET
Table 'Achilles IV' 6-max Seat #4 is the button
Seat 1: NivelXcamione ($0.96 in chips)
Seat 2: Xtens ($2.13 in chips)
Seat 3: RodriguezDB ($3.74 in chips)
Seat 4: H17FS ($0.95 in chips)
Seat 5: Koresh153 ($1.98 in chips)
Seat 6: blektron1 ($0.63 in chips)
Koresh153: posts small blind $0.01
blektron1: posts big blind $0.02
*** HOLE CARDS ***
NivelXcamione: calls $0.02
Xtens: folds
RodriguezDB: raises $0.04 to $0.06
H17FS: raises $0.04 to $0.10
Koresh153: folds
blektron1: folds
NivelXcamione: folds
RodriguezDB: calls $0.04
*** FLOP *** [6c 4c 9h]
RodriguezDB: checks
H17FS: bets $0.85 and is all-in
RodriguezDB: folds
Uncalled bet ($0.85) returned to H17FS
H17FS collected $0.24 from pot
*** SUMMARY ***
Total pot $0.25 | Rake $0.01
Board [6c 4c 9h]
Seat 1: NivelXcamione folded before Flop
Seat 2: Xtens folded before Flop (didn't bet)
Seat 3: RodriguezDB folded on the Flop
Seat 4: H17FS (button) collected ($0.24)
Seat 5: Koresh153 (small blind) folded before Flop
Seat 6: blektron1 (big blind) folded before Flop


PokerStars Hand #238162659949:  Hold'em No Limit ($0.01/$0.02 USD) - 2022/08/23 3:31:20 ET
Table 'Achilles IV' 6-max Seat #5 is the button
Seat 1: NivelXcamione ($0.94 in chips)
Seat 2: Xtens ($2.13 in chips)
Seat 3: RodriguezDB ($3.64 in chips)
Seat 4: H17FS ($1.09 in chips)
Seat 5: Koresh153 ($1.97 in chips)
Seat 6: blektron1 ($0.61 in chips)
blektron1: posts small blind $0.01
NivelXcamione: posts big blind $0.02
*** HOLE CARDS ***
Xtens: folds
RodriguezDB: folds
H17FS: calls $0.02
Koresh153: folds
blektron1: folds
NivelXcamione: checks
*** FLOP *** [Kc 4d 3d]
NivelXcamione: checks
H17FS: checks
*** TURN *** [Kc 4d 3d] [Kh]
NivelXcamione: checks
H17FS: checks
*** RIVER *** [Kc 4d 3d Kh] [7d]
NivelXcamione: bets $0.04
H17FS: folds
Uncalled bet ($0.04) returned to NivelXcamione
NivelXcamione collected $0.05 from pot
NivelXcamione: doesn't show hand
*** SUMMARY ***
Total pot $0.05 | Rake $0
Board [Kc 4d 3d Kh 7d]
Seat 1: NivelXcamione (big blind) collected ($0.05)
Seat 2: Xtens folded before Flop (didn't bet)
Seat 3: RodriguezDB folded before Flop (didn't bet)
Seat 4: H17FS folded on the River
Seat 5: Koresh153 (button) folded before Flop (didn't bet)
Seat 6: blektron1 (small blind) folded before Flop


PokerStars Hand #238162664700:  Hold'em No Limit ($0.01/$0.02 USD) - 2022/08/23 3:32:01 ET
Table 'Achilles IV' 6-max Seat #6 is the button
Seat 1: NivelXcamione ($0.97 in chips)
Seat 2: Xtens ($2.13 in chips)
Seat 3: RodriguezDB ($3.64 in chips)
Seat 4: H17FS ($1.07 in chips)
Seat 5: Koresh153 ($1.97 in chips)
Seat 6: blektron1 ($0.60 in chips)
NivelXcamione: posts small blind $0.01
Xtens: posts big blind $0.02
*** HOLE CARDS ***
RodriguezDB: folds
H17FS: folds
Koresh153: folds
blektron1: folds
NivelXcamione: calls $0.01
Xtens: checks
*** FLOP *** [6d Qc Jc]
NivelXcamione: checks
Xtens: bets $0.02
NivelXcamione: folds
Uncalled bet ($0.02) returned to Xtens
Xtens collected $0.04 from pot
Xtens: doesn't show hand
*** SUMMARY ***
Total pot $0.04 | Rake $0
Board [6d Qc Jc]
Seat 1: NivelXcamione (small blind) folded on the Flop
Seat 2: Xtens (big blind) collected ($0.04)
Seat 3: RodriguezDB folded before Flop (didn't bet)
Seat 4: H17FS folded before Flop (didn't bet)
Seat 5: Koresh153 folded before Flop (didn't bet)
Seat 6: blektron1 (button) folded before Flop (didn't bet)


PokerStars Hand #238162669021:  Hold'em No Limit ($0.01/$0.02 USD) - 2022/08/23 3:32:39 ET
Table 'Achilles IV' 6-max Seat #1 is the button
Seat 1: NivelXcamione ($0.95 in chips)
Seat 2: Xtens ($2.15 in chips)
Seat 3: RodriguezDB ($3.64 in chips)
Seat 4: H17FS ($1.07 in chips)
Seat 5: Koresh153 ($1.97 in chips)
Seat 6: blektron1 ($0.60 in chips)
Xtens: posts small blind $0.01
RodriguezDB: posts big blind $0.02
*** HOLE CARDS ***
H17FS: calls $0.02
Koresh153: folds
blektron1: folds
NivelXcamione: calls $0.02
Xtens: calls $0.01
RodriguezDB: checks
*** FLOP *** [6s Qs 8s]
Xtens: checks
RodriguezDB: checks
H17FS: bets $0.04
NivelXcamione: calls $0.04
Xtens: calls $0.04
RodriguezDB: folds
*** TURN *** [6s Qs 8s] [3s]
Xtens: checks
H17FS: bets $0.04
NivelXcamione: calls $0.04
Xtens: folds
*** RIVER *** [6s Qs 8s 3s] [8h]
H17FS: bets $0.97 and is all-in
NivelXcamione: folds
Uncalled bet ($0.97) returned to H17FS
H17FS collected $0.27 from pot
*** SUMMARY ***
Total pot $0.28 | Rake $0.01
Board [6s Qs 8s 3s 8h]
Seat 1: NivelXcamione (button) folded on the River
Seat 2: Xtens (small blind) folded on the Turn
Seat 3: RodriguezDB (big blind) folded on the Flop
Seat 4: H17FS collected ($0.27)
Seat 5: Koresh153 folded before Flop (didn't bet)
Seat 6: blektron1 folded before Flop (didn't bet)


PokerStars Hand #238162680845:  Hold'em No Limit ($0.01/$0.02 USD) - 2022/08/23 3:34:21 ET
Table 'Achilles IV' 6-max Seat #2 is the button
Seat 1: NivelXcamione ($0.85 in chips)
Seat 2: Xtens ($2.09 in chips)
Seat 3: RodriguezDB ($3.62 in chips)
Seat 4: H17FS ($1.24 in chips)
Seat 5: Koresh153 ($1.97 in chips)
Seat 6: blektron1 ($0.60 in chips)
RodriguezDB: posts small blind $0.01
H17FS: posts big blind $0.02
*** HOLE CARDS ***
Koresh153: folds
blektron1: folds
NivelXcamione: folds
Xtens: raises $0.03 to $0.05
RodriguezDB: folds
H17FS: calls $0.03
*** FLOP *** [9d 6c 6s]
H17FS: bets $0.02
Xtens: raises $0.07 to $0.09
H17FS: calls $0.07
*** TURN *** [9d 6c 6s] [Qh]
H17FS: checks
Xtens: bets $0.14
H17FS: calls $0.14
*** RIVER *** [9d 6c 6s Qh] [Qc]
H17FS: checks
Xtens: checks
*** SHOW DOWN ***
H17FS: shows [Ad As] (two pair, Aces and Queens)
Xtens: mucks hand
H17FS collected $0.55 from pot
*** SUMMARY ***
Total pot $0.57 | Rake $0.02
Board [9d 6c 6s Qh Qc]
Seat 1: NivelXcamione folded before Flop (didn't bet)
Seat 2: Xtens (button) mucked
Seat 3: RodriguezDB (small blind) folded before Flop
Seat 4: H17FS (big blind) showed [Ad As] and won ($0.55) with two pair, Aces and Queens
Seat 5: Koresh153 folded before Flop (didn't bet)
Seat 6: blektron1 folded before Flop (didn't bet)


PokerStars Hand #238162686956:  Hold'em No Limit ($0.01/$0.02 USD) - 2022/08/23 3:35:14 ET
Table 'Achilles IV' 6-max Seat #3 is the button
Seat 1: NivelXcamione ($0.85 in chips)
Seat 2: Xtens ($1.81 in chips)
Seat 3: RodriguezDB ($3.61 in chips)
Seat 4: H17FS ($1.51 in chips)
Seat 5: Koresh153 ($1.97 in chips)
Seat 6: blektron1 ($0.60 in chips)
H17FS: posts small blind $0.01
Koresh153: posts big blind $0.02
*** HOLE CARDS ***
blektron1: folds
NivelXcamione: folds
Xtens: folds
RodriguezDB: raises $0.04 to $0.06
H17FS: folds
Koresh153: folds
Uncalled bet ($0.04) returned to RodriguezDB
RodriguezDB collected $0.05 from pot
RodriguezDB: doesn't show hand
*** SUMMARY ***
Total pot $0.05 | Rake $0
Seat 1: NivelXcamione folded before Flop (didn't bet)
Seat 2: Xtens folded before Flop (didn't bet)
Seat 3: RodriguezDB (button) collected ($0.05)
Seat 4: H17FS (small blind) folded before Flop
Seat 5: Koresh153 (big blind) folded before Flop
Seat 6: blektron1 folded before Flop (didn't bet)


PokerStars Hand #238162688544:  Hold'em No Limit ($0.01/$0.02 USD) - 2022/08/23 3:35:28 ET
Table 'Achilles IV' 6-max Seat #4 is the button
Seat 1: NivelXcamione ($0.85 in chips)
Seat 2: Xtens ($1.81 in chips)
Seat 3: RodriguezDB ($3.64 in chips)
Seat 4: H17FS ($1.50 in chips)
Seat 5: Koresh153 ($1.95 in chips)
Seat 6: blektron1 ($0.60 in chips)
Koresh153: posts small blind $0.01
blektron1: posts big blind $0.02
*** HOLE CARDS ***
NivelXcamione: folds
Xtens: folds
RodriguezDB: folds
H17FS: folds
Koresh153: folds
Uncalled bet ($0.01) returned to blektron1
blektron1 collected $0.02 from pot
blektron1: doesn't show hand
*** SUMMARY ***
Total pot $0.02 | Rake $0
Seat 1: NivelXcamione folded before Flop (didn't bet)
Seat 2: Xtens folded before Flop (didn't bet)
Seat 3: RodriguezDB folded before Flop (didn't bet)
Seat 4: H17FS (button) folded before Flop (didn't bet)
Seat 5: Koresh153 (small blind) folded before Flop
Seat 6: blektron1 (big blind) collected ($0.02)


PokerStars Hand #238162689879:  Hold'em No Limit ($0.01/$0.02 USD) - 2022/08/23 3:35:39 ET
Table 'Achilles IV' 6-max Seat #5 is the button
Seat 1: NivelXcamione ($0.85 in chips)
Seat 2: Xtens ($1.81 in chips)
Seat 3: RodriguezDB ($3.64 in chips)
Seat 4: H17FS ($1.50 in chips)
Seat 5: Koresh153 ($1.94 in chips)
Seat 6: blektron1 ($0.61 in chips)
blektron1: posts small blind $0.01
NivelXcamione: posts big blind $0.02
*** HOLE CARDS ***
Xtens: folds
RodriguezDB: folds
H17FS: folds
Koresh153: raises $0.04 to $0.06
blektron1: folds
NivelXcamione: folds
Uncalled bet ($0.04) returned to Koresh153
blektron1 leaves the table
Koresh153 collected $0.05 from pot
Koresh153: doesn't show hand
*** SUMMARY ***
Total pot $0.05 | Rake $0
Seat 1: NivelXcamione (big blind) folded before Flop
Seat 2: Xtens folded before Flop (didn't bet)
Seat 3: RodriguezDB folded before Flop (didn't bet)
Seat 4: H17FS folded before Flop (didn't bet)
Seat 5: Koresh153 (button) collected ($0.05)
Seat 6: blektron1 (small blind) folded before Flop


PokerStars Hand #238162693232:  Hold'em No Limit ($0.01/$0.02 USD) - 2022/08/23 3:36:09 ET
Table 'Achilles IV' 6-max Seat #1 is the button
Seat 1: NivelXcamione ($0.83 in chips)
Seat 2: Xtens ($1.81 in chips)
Seat 3: RodriguezDB ($3.64 in chips)
Seat 4: H17FS ($1.50 in chips)
Seat 5: Koresh153 ($1.97 in chips)
Xtens: posts small blind $0.01
RodriguezDB: posts big blind $0.02
*** HOLE CARDS ***
H17FS: folds
Koresh153: raises $0.04 to $0.06
NivelXcamione: calls $0.06
Xtens: folds
Siensei joins the table at seat #6
RodriguezDB: calls $0.04
*** FLOP *** [Qc 7d 6s]
RodriguezDB: checks
Koresh153: bets $0.12
NivelXcamione: folds
RodriguezDB: folds
Uncalled bet ($0.12) returned to Koresh153
Koresh153 collected $0.18 from pot
Koresh153: doesn't show hand
*** SUMMARY ***
Total pot $0.19 | Rake $0.01
Board [Qc 7d 6s]
Seat 1: NivelXcamione (button) folded on the Flop
Seat 2: Xtens (small blind) folded before Flop
Seat 3: RodriguezDB (big blind) folded on the Flop
Seat 4: H17FS folded before Flop (didn't bet)
Seat 5: Koresh153 collected ($0.18)


PokerStars Hand #238162697240:  Hold'em No Limit ($0.01/$0.02 USD) - 2022/08/23 3:36:43 ET
Table 'Achilles IV' 6-max Seat #2 is the button
Seat 1: NivelXcamione ($0.77 in chips)
Seat 2: Xtens ($1.80 in chips)
Seat 3: RodriguezDB ($3.58 in chips)
Seat 4: H17FS ($1.50 in chips)
Seat 5: Koresh153 ($2.09 in chips)
RodriguezDB: posts small blind $0.01
H17FS: posts big blind $0.02
Siensei: sits out
*** HOLE CARDS ***
Koresh153: folds
NivelXcamione: folds
NivelXcamione leaves the table
Xtens: raises $0.03 to $0.05
RodriguezDB: calls $0.04
H17FS: calls $0.03
*** FLOP *** [8c Qh 5c]
RodriguezDB: checks
H17FS: checks
Flix2204 joins the table at seat #1
Xtens: bets $0.08
RodriguezDB: folds
H17FS: folds
Uncalled bet ($0.08) returned to Xtens
Xtens collected $0.14 from pot
Xtens: doesn't show hand
*** SUMMARY ***
Total pot $0.15 | Rake $0.01
Board [8c Qh 5c]
Seat 1: NivelXcamione folded before Flop (didn't bet)
Seat 2: Xtens (button) collected ($0.14)
Seat 3: RodriguezDB (small blind) folded on the Flop
Seat 4: H17FS (big blind) folded on the Flop
Seat 5: Koresh153 folded before Flop (didn't bet)


PokerStars Hand #238162702719:  Hold'em No Limit ($0.01/$0.02 USD) - 2022/08/23 3:37:31 ET
Table 'Achilles IV' 6-max Seat #3 is the button
Seat 2: Xtens ($1.89 in chips)
Seat 3: RodriguezDB ($3.53 in chips)
Seat 4: H17FS ($1.45 in chips)
Seat 5: Koresh153 ($2.09 in chips)
H17FS: posts small blind $0.01
Koresh153: posts big blind $0.02
Siensei: sits out
Flix2204: sits out
*** HOLE CARDS ***
Xtens: folds
RodriguezDB: folds
H17FS: calls $0.01
Koresh153: checks
*** FLOP *** [Qc 4s Kh]
H17FS: checks
Koresh153: checks
*** TURN *** [Qc 4s Kh] [3c]
H17FS: checks
Koresh153: checks
*** RIVER *** [Qc 4s Kh 3c] [Ac]
H17FS: bets $0.04
Koresh153: folds
Uncalled bet ($0.04) returned to H17FS
H17FS collected $0.04 from pot
*** SUMMARY ***
Total pot $0.04 | Rake $0
Board [Qc 4s Kh 3c Ac]
Seat 2: Xtens folded before Flop (didn't bet)
Seat 3: RodriguezDB (button) folded before Flop (didn't bet)
Seat 4: H17FS (small blind) collected ($0.04)
Seat 5: Koresh153 (big blind) folded on the River


PokerStars Hand #238162707977:  Hold'em No Limit ($0.01/$0.02 USD) - 2022/08/23 3:38:17 ET
Table 'Achilles IV' 6-max Seat #4 is the button
Seat 2: Xtens ($1.89 in chips)
Seat 3: RodriguezDB ($3.53 in chips)
Seat 4: H17FS ($1.47 in chips)
Seat 5: Koresh153 ($2.07 in chips)
Seat 6: Siensei ($2 in chips)
Koresh153: posts small blind $0.01
Siensei: posts big blind $0.02
Flix2204: sits out
*** HOLE CARDS ***
Xtens: folds
RodriguezDB: folds
H17FS: folds
Koresh153: folds
Uncalled bet ($0.01) returned to Siensei
Siensei collected $0.02 from pot
Siensei: doesn't show hand
*** SUMMARY ***
Total pot $0.02 | Rake $0
Seat 2: Xtens folded before Flop (didn't bet)
Seat 3: RodriguezDB folded before Flop (didn't bet)
Seat 4: H17FS (button) folded before Flop (didn't bet)
Seat 5: Koresh153 (small blind) folded before Flop
Seat 6: Siensei (big blind) collected ($0.02)


PokerStars Hand #238162709276:  Hold'em No Limit ($0.01/$0.02 USD) - 2022/08/23 3:38:28 ET
Table 'Achilles IV' 6-max Seat #5 is the button
Seat 1: Flix2204 ($2 in chips)
Seat 2: Xtens ($1.89 in chips)
Seat 3: RodriguezDB ($3.53 in chips)
Seat 4: H17FS ($1.47 in chips)
Seat 5: Koresh153 ($2.06 in chips)
Seat 6: Siensei ($2.01 in chips)
Siensei: posts small blind $0.01
Flix2204: posts big blind $0.02
*** HOLE CARDS ***
Xtens: folds
RodriguezDB: folds
H17FS: calls $0.02
Koresh153: folds
Siensei: calls $0.01
Flix2204: checks
*** FLOP *** [9s 9c 6h]
Siensei: checks
Flix2204: checks
H17FS: bets $0.02
Siensei: folds
Flix2204: folds
Uncalled bet ($0.02) returned to H17FS
H17FS collected $0.06 from pot
*** SUMMARY ***
Total pot $0.06 | Rake $0
Board [9s 9c 6h]
Seat 1: Flix2204 (big blind) folded on the Flop
Seat 2: Xtens folded before Flop (didn't bet)
Seat 3: RodriguezDB folded before Flop (didn't bet)
Seat 4: H17FS collected ($0.06)
Seat 5: Koresh153 (button) folded before Flop (didn't bet)
Seat 6: Siensei (small blind) folded on the Flop


PokerStars Hand #238162714049:  Hold'em No Limit ($0.01/$0.02 USD) - 2022/08/23 3:39:11 ET
Table 'Achilles IV' 6-max Seat #6 is the button
Seat 1: Flix2204 ($2 in chips)
Seat 2: Xtens ($1.89 in chips)
Seat 3: RodriguezDB ($3.53 in chips)
Seat 4: H17FS ($1.51 in chips)
Seat 5: Koresh153 ($2.06 in chips)
Seat 6: Siensei ($2 in chips)
Flix2204: posts small blind $0.01
Xtens: posts big blind $0.02
*** HOLE CARDS ***
RodriguezDB: raises $0.04 to $0.06
H17FS: calls $0.06
Koresh153: calls $0.06
Siensei: folds
Flix2204: folds
Xtens: folds
*** FLOP *** [9h 5c 5h]
RodriguezDB: checks
H17FS: bets $0.10
Koresh153: folds
RodriguezDB: folds
Uncalled bet ($0.10) returned to H17FS
H17FS collected $0.20 from pot
*** SUMMARY ***
Total pot $0.21 | Rake $0.01
Board [9h 5c 5h]
Seat 1: Flix2204 (small blind) folded before Flop
Seat 2: Xtens (big blind) folded before Flop
Seat 3: RodriguezDB folded on the Flop
Seat 4: H17FS collected ($0.20)
Seat 5: Koresh153 folded on the Flop
Seat 6: Siensei (button) folded before Flop (didn't bet)


PokerStars Hand #238162718816:  Hold'em No Limit ($0.01/$0.02 USD) - 2022/08/23 3:39:53 ET
Table 'Achilles IV' 6-max Seat #1 is the button
Seat 1: Flix2204 ($2 in chips)
Seat 2: Xtens ($1.87 in chips)
Seat 3: RodriguezDB ($3.47 in chips)
Seat 4: H17FS ($1.65 in chips)
Seat 5: Koresh153 ($2 in chips)
Seat 6: Siensei ($2 in chips)
Xtens: posts small blind $0.01
RodriguezDB: posts big blind $0.02
*** HOLE CARDS ***
H17FS: folds
Koresh153: folds
Siensei: folds
Flix2204: raises $0.03 to $0.05
Xtens: folds
RodriguezDB: folds
Uncalled bet ($0.03) returned to Flix2204
Flix2204 collected $0.05 from pot
Flix2204: doesn't show hand
*** SUMMARY ***
Total pot $0.05 | Rake $0
Seat 1: Flix2204 (button) collected ($0.05)
Seat 2: Xtens (small blind) folded before Flop
Seat 3: RodriguezDB (big blind) folded before Flop
Seat 4: H17FS folded before Flop (didn't bet)
Seat 5: Koresh153 folded before Flop (didn't bet)
Seat 6: Siensei folded before Flop (didn't bet)


PokerStars Hand #238162722062:  Hold'em No Limit ($0.01/$0.02 USD) - 2022/08/23 3:40:21 ET
Table 'Achilles IV' 6-max Seat #2 is the button
Seat 1: Flix2204 ($2.03 in chips)
Seat 2: Xtens ($1.86 in chips)
Seat 3: RodriguezDB ($3.45 in chips)
Seat 4: H17FS ($1.65 in chips)
Seat 5: Koresh153 ($2 in chips)
Seat 6: Siensei ($2 in chips)
RodriguezDB: posts small blind $0.01
H17FS: posts big blind $0.02
*** HOLE CARDS ***
Koresh153: folds
Siensei: folds
Flix2204: raises $0.03 to $0.05
Xtens: folds
RodriguezDB: folds
H17FS: calls $0.03
*** FLOP *** [9s 9h Qh]
H17FS: checks
Flix2204: bets $0.04
H17FS: calls $0.04
*** TURN *** [9s 9h Qh] [4c]
H17FS: checks
Flix2204: bets $0.12
H17FS: folds
Uncalled bet ($0.12) returned to Flix2204
Flix2204 collected $0.18 from pot
Flix2204: doesn't show hand
*** SUMMARY ***
Total pot $0.19 | Rake $0.01
Board [9s 9h Qh 4c]
Seat 1: Flix2204 collected ($0.18)
Seat 2: Xtens (button) folded before Flop (didn't bet)
Seat 3: RodriguezDB (small blind) folded before Flop
Seat 4: H17FS (big blind) folded on the Turn
Seat 5: Koresh153 folded before Flop (didn't bet)
Seat 6: Siensei folded before Flop (didn't bet)


PokerStars Hand #238162729473:  Hold'em No Limit ($0.01/$0.02 USD) - 2022/08/23 3:41:25 ET
Table 'Achilles IV' 6-max Seat #3 is the button
Seat 1: Flix2204 ($2.12 in chips)
Seat 2: Xtens ($1.86 in chips)
Seat 3: RodriguezDB ($3.44 in chips)
Seat 4: H17FS ($1.56 in chips)
Seat 5: Koresh153 ($2 in chips)
Seat 6: Siensei ($2 in chips)
H17FS: posts small blind $0.01
Koresh153: posts big blind $0.02
*** HOLE CARDS ***
Siensei: folds
Flix2204: raises $0.04 to $0.06
Xtens: folds
RodriguezDB: calls $0.06
H17FS: folds
Koresh153: folds
*** FLOP *** [Qc Qd 6d]
Flix2204: bets $0.05
RodriguezDB: folds
Uncalled bet ($0.05) returned to Flix2204
Flix2204 collected $0.14 from pot
Flix2204: doesn't show hand
*** SUMMARY ***
Total pot $0.15 | Rake $0.01
Board [Qc Qd 6d]
Seat 1: Flix2204 collected ($0.14)
Seat 2: Xtens folded before Flop (didn't bet)
Seat 3: RodriguezDB (button) folded on the Flop
Seat 4: H17FS (small blind) folded before Flop
Seat 5: Koresh153 (big blind) folded before Flop
Seat 6: Siensei folded before Flop (didn't bet)


PokerStars Hand #238162733847:  Hold'em No Limit ($0.01/$0.02 USD) - 2022/08/23 3:42:02 ET
Table 'Achilles IV' 6-max Seat #4 is the button
Seat 1: Flix2204 ($2.20 in chips)
Seat 2: Xtens ($1.86 in chips)
Seat 3: RodriguezDB ($3.38 in chips)
Seat 4: H17FS ($1.55 in chips)
Seat 5: Koresh153 ($1.98 in chips)
Koresh153: posts small blind $0.01
Siensei: is sitting out
Flix2204: posts big blind $0.02
*** HOLE CARDS ***
Xtens: folds
RodriguezDB: folds
H17FS: folds
Koresh153: raises $0.04 to $0.06
Flix2204: raises $0.12 to $0.18
Siensei leaves the table
Koresh153: calls $0.12
*** FLOP *** [Kc 4s 3h]
Koresh153: checks
Flix2204: checks
*** TURN *** [Kc 4s 3h] [4d]
Koresh153: checks
Flix2204: bets $0.17
Koresh153: calls $0.17
*** RIVER *** [Kc 4s 3h 4d] [Ah]
Koresh153: checks
Flix2204: checks
*** SHOW DOWN ***
Koresh153: shows [6d 6s] (two pair, Sixes and Fours)
Flix2204: mucks hand
Koresh153 collected $0.68 from pot
*** SUMMARY ***
Total pot $0.70 | Rake $0.02
Board [Kc 4s 3h 4d Ah]
Seat 1: Flix2204 (big blind) mucked
Seat 2: Xtens folded before Flop (didn't bet)
Seat 3: RodriguezDB folded before Flop (didn't bet)
Seat 4: H17FS (button) folded before Flop (didn't bet)
Seat 5: Koresh153 (small blind) showed [6d 6s] and won ($0.68) with two pair, Sixes and Fours


PokerStars Hand #238162739575:  Hold'em No Limit ($0.01/$0.02 USD) - 2022/08/23 3:42:50 ET
Table 'Achilles IV' 6-max Seat #5 is the button
Seat 1: Flix2204 ($2 in chips)
Seat 2: Xtens ($1.86 in chips)
Seat 3: RodriguezDB ($3.38 in chips)
Seat 4: H17FS ($1.55 in chips)
Seat 5: Koresh153 ($2.31 in chips)
Flix2204: posts small blind $0.01
Xtens: posts big blind $0.02
*** HOLE CARDS ***
RodriguezDB: folds
VK$$$215 joins the table at seat #6
H17FS: folds
Koresh153: folds
Flix2204: folds
Uncalled bet ($0.01) returned to Xtens
Xtens collected $0.02 from pot
Xtens: doesn't show hand
*** SUMMARY ***
Total pot $0.02 | Rake $0
Seat 1: Flix2204 (small blind) folded before Flop
Seat 2: Xtens (big blind) collected ($0.02)
Seat 3: RodriguezDB folded before Flop (didn't bet)
Seat 4: H17FS folded before Flop (didn't bet)
Seat 5: Koresh153 (button) folded before Flop (didn't bet)


PokerStars Hand #238162741492:  Hold'em No Limit ($0.01/$0.02 USD) - 2022/08/23 3:43:06 ET
Table 'Achilles IV' 6-max Seat #1 is the button
Seat 1: Flix2204 ($2 in chips)
Seat 2: Xtens ($1.87 in chips)
Seat 3: RodriguezDB ($3.38 in chips)
Seat 4: H17FS ($1.55 in chips)
Seat 5: Koresh153 ($2.31 in chips)
Seat 6: VK$$$215 ($1.60 in chips)
Xtens: posts small blind $0.01
RodriguezDB: posts big blind $0.02
VK$$$215: posts big blind $0.02
*** HOLE CARDS ***
H17FS: calls $0.02
Koresh153: folds
VK$$$215: checks
Flix2204: folds
Xtens: calls $0.01
RodriguezDB: checks
*** FLOP *** [2d Ts Jh]
Xtens: checks
RodriguezDB: checks
H17FS: bets $0.04
VK$$$215: folds
Xtens: folds
RodriguezDB: folds
Uncalled bet ($0.04) returned to H17FS
H17FS collected $0.08 from pot
*** SUMMARY ***
Total pot $0.08 | Rake $0
Board [2d Ts Jh]
Seat 1: Flix2204 (button) folded before Flop (didn't bet)
Seat 2: Xtens (small blind) folded on the Flop
Seat 3: RodriguezDB (big blind) folded on the Flop
Seat 4: H17FS collected ($0.08)
Seat 5: Koresh153 folded before Flop (didn't bet)
Seat 6: VK$$$215 folded on the Flop (didn't bet)


PokerStars Hand #238162746629:  Hold'em No Limit ($0.01/$0.02 USD) - 2022/08/23 3:43:51 ET
Table 'Achilles IV' 6-max Seat #2 is the button
Seat 1: Flix2204 ($2 in chips)
Seat 2: Xtens ($1.85 in chips)
Seat 3: RodriguezDB ($3.36 in chips)
Seat 4: H17FS ($1.61 in chips)
Seat 5: Koresh153 ($2.31 in chips)
Seat 6: VK$$$215 ($1.58 in chips)
RodriguezDB: posts small blind $0.01
H17FS: posts big blind $0.02
*** HOLE CARDS ***
Koresh153: folds
VK$$$215: calls $0.02
Flix2204: raises $0.06 to $0.08
Xtens: folds
RodriguezDB: folds
H17FS: folds
VK$$$215: calls $0.06
*** FLOP *** [Ah 3d 2h]
VK$$$215: checks
Flix2204: checks
*** TURN *** [Ah 3d 2h] [4h]
VK$$$215: bets $0.02
Flix2204: raises $0.11 to $0.13
VK$$$215: folds
Uncalled bet ($0.11) returned to Flix2204
Flix2204 collected $0.22 from pot
Flix2204: doesn't show hand
*** SUMMARY ***
Total pot $0.23 | Rake $0.01
Board [Ah 3d 2h 4h]
Seat 1: Flix2204 collected ($0.22)
Seat 2: Xtens (button) folded before Flop (didn't bet)
Seat 3: RodriguezDB (small blind) folded before Flop
Seat 4: H17FS (big blind) folded before Flop
Seat 5: Koresh153 folded before Flop (didn't bet)
Seat 6: VK$$$215 folded on the Turn


PokerStars Hand #238162754204:  Hold'em No Limit ($0.01/$0.02 USD) - 2022/08/23 3:44:56 ET
Table 'Achilles IV' 6-max Seat #3 is the button
Seat 1: Flix2204 ($2.12 in chips)
Seat 2: Xtens ($1.85 in chips)
Seat 3: RodriguezDB ($3.35 in chips)
Seat 4: H17FS ($1.59 in chips)
Seat 5: Koresh153 ($2.31 in chips)
Seat 6: VK$$$215 ($1.48 in chips)
H17FS: posts small blind $0.01
Koresh153: posts big blind $0.02
*** HOLE CARDS ***
VK$$$215: calls $0.02
Flix2204: folds
Xtens: folds
RodriguezDB: folds
H17FS: raises $0.02 to $0.04
Koresh153: folds
VK$$$215: calls $0.02
*** FLOP *** [5h Tc 6h]
H17FS: bets $0.05
VK$$$215: calls $0.05
*** TURN *** [5h Tc 6h] [Ah]
H17FS: bets $0.04
VK$$$215: calls $0.04
*** RIVER *** [5h Tc 6h Ah] [4s]
H17FS: bets $0.13
VK$$$215: folds
Uncalled bet ($0.13) returned to H17FS
H17FS collected $0.27 from pot
*** SUMMARY ***
Total pot $0.28 | Rake $0.01
Board [5h Tc 6h Ah 4s]
Seat 1: Flix2204 folded before Flop (didn't bet)
Seat 2: Xtens folded before Flop (didn't bet)
Seat 3: RodriguezDB (button) folded before Flop (didn't bet)
Seat 4: H17FS (small blind) collected ($0.27)
Seat 5: Koresh153 (big blind) folded before Flop
Seat 6: VK$$$215 folded on the River


PokerStars Hand #238162762291:  Hold'em No Limit ($0.01/$0.02 USD) - 2022/08/23 3:46:03 ET
Table 'Achilles IV' 6-max Seat #4 is the button
Seat 1: Flix2204 ($2.12 in chips)
Seat 2: Xtens ($1.85 in chips)
Seat 3: RodriguezDB ($3.35 in chips)
Seat 4: H17FS ($1.73 in chips)
Seat 5: Koresh153 ($2.29 in chips)
Seat 6: VK$$$215 ($1.35 in chips)
Koresh153: posts small blind $0.01
VK$$$215: posts big blind $0.02
*** HOLE CARDS ***
Flix2204: folds
Xtens: folds
RodriguezDB: raises $0.04 to $0.06
H17FS: calls $0.06
Koresh153: folds
VK$$$215: folds
*** FLOP *** [4d 3h Ac]
VK$$$215 leaves the table
RodriguezDB: checks
H17FS: checks
*** TURN *** [4d 3h Ac] [Qh]
RodriguezDB: checks
H17FS: checks
*** RIVER *** [4d 3h Ac Qh] [Ks]
RodriguezDB: checks
H17FS: checks
*** SHOW DOWN ***
RodriguezDB: shows [7c 7s] (a pair of Sevens)
H17FS: shows [Th Kc] (a pair of Kings)
H17FS collected $0.14 from pot
*** SUMMARY ***
Total pot $0.15 | Rake $0.01
Board [4d 3h Ac Qh Ks]
Seat 1: Flix2204 folded before Flop (didn't bet)
Seat 2: Xtens folded before Flop (didn't bet)
Seat 3: RodriguezDB showed [7c 7s] and lost with a pair of Sevens
Seat 4: H17FS (button) showed [Th Kc] and won ($0.14) with a pair of Kings
Seat 5: Koresh153 (small blind) folded before Flop
Seat 6: VK$$$215 (big blind) folded before Flop


PokerStars Hand #238162767878:  Hold'em No Limit ($0.01/$0.02 USD) - 2022/08/23 3:46:52 ET
Table 'Achilles IV' 6-max Seat #5 is the button
Seat 1: Flix2204 ($2.12 in chips)
Seat 2: Xtens ($1.85 in chips)
Seat 3: RodriguezDB ($3.29 in chips)
Seat 4: H17FS ($1.81 in chips)
Seat 5: Koresh153 ($2.28 in chips)
Flix2204: posts small blind $0.01
Xtens: posts big blind $0.02
*** HOLE CARDS ***
RodriguezDB: folds
H17FS: folds
Koresh153: folds
Flix2204: folds
Uncalled bet ($0.01) returned to Xtens
Xtens collected $0.02 from pot
Xtens: doesn't show hand
*** SUMMARY ***
Total pot $0.02 | Rake $0
Seat 1: Flix2204 (small blind) folded before Flop
Seat 2: Xtens (big blind) collected ($0.02)
Seat 3: RodriguezDB folded before Flop (didn't bet)
Seat 4: H17FS folded before Flop (didn't bet)
Seat 5: Koresh153 (button) folded before Flop (didn't bet)


PokerStars Hand #238162769660:  Hold'em No Limit ($0.01/$0.02 USD) - 2022/08/23 3:47:06 ET
Table 'Achilles IV' 6-max Seat #1 is the button
Seat 1: Flix2204 ($2.11 in chips)
Seat 2: Xtens ($1.86 in chips)
Seat 3: RodriguezDB ($3.29 in chips)
Seat 4: H17FS ($1.81 in chips)
Seat 5: Koresh153 ($2.28 in chips)
Xtens: posts small blind $0.01
RodriguezDB: posts big blind $0.02
*** HOLE CARDS ***
H17FS: calls $0.02
Koresh153: folds
Flix2204: folds
Xtens: folds
RodriguezDB: checks
*** FLOP *** [Js 5s 8s]
mermila joins the table at seat #6
RodriguezDB: bets $0.06
H17FS: folds
Uncalled bet ($0.06) returned to RodriguezDB
RodriguezDB collected $0.05 from pot
*** SUMMARY ***
Total pot $0.05 | Rake $0
Board [Js 5s 8s]
Seat 1: Flix2204 (button) folded before Flop (didn't bet)
Seat 2: Xtens (small blind) folded before Flop
Seat 3: RodriguezDB (big blind) collected ($0.05)
Seat 4: H17FS folded on the Flop
Seat 5: Koresh153 folded before Flop (didn't bet)


PokerStars Hand #238162774106:  Hold'em No Limit ($0.01/$0.02 USD) - 2022/08/23 3:47:43 ET
Table 'Achilles IV' 6-max Seat #2 is the button
Seat 1: Flix2204 ($2.11 in chips)
Seat 2: Xtens ($1.85 in chips)
Seat 3: RodriguezDB ($3.32 in chips)
Seat 4: H17FS ($1.79 in chips)
Seat 5: Koresh153 ($2.28 in chips)
Seat 6: mermila ($0.80 in chips)
RodriguezDB: posts small blind $0.01
H17FS: posts big blind $0.02
mermila: posts big blind $0.02
*** HOLE CARDS ***
Koresh153: folds
mermila: checks
Flix2204: folds
Xtens: folds
RodriguezDB: folds
H17FS: checks
*** FLOP *** [Jd Th 8h]
H17FS: checks
mermila: checks
*** TURN *** [Jd Th 8h] [Ad]
H17FS: checks
mermila: checks
*** RIVER *** [Jd Th 8h Ad] [Kc]
H17FS: bets $0.05
mermila: folds
Uncalled bet ($0.05) returned to H17FS
H17FS collected $0.05 from pot
*** SUMMARY ***
Total pot $0.05 | Rake $0
Board [Jd Th 8h Ad Kc]
Seat 1: Flix2204 folded before Flop (didn't bet)
Seat 2: Xtens (button) folded before Flop (didn't bet)
Seat 3: RodriguezDB (small blind) folded before Flop
Seat 4: H17FS (big blind) collected ($0.05)
Seat 5: Koresh153 folded before Flop (didn't bet)
Seat 6: mermila folded on the River (didn't bet)


PokerStars Hand #238162779707:  Hold'em No Limit ($0.01/$0.02 USD) - 2022/08/23 3:48:31 ET
Table 'Achilles IV' 6-max Seat #3 is the button
Seat 1: Flix2204 ($2.11 in chips)
Seat 2: Xtens ($1.85 in chips)
Seat 3: RodriguezDB ($3.31 in chips)
Seat 4: H17FS ($1.82 in chips)
Seat 5: Koresh153 ($2.28 in chips)
Seat 6: mermila ($0.78 in chips)
H17FS: posts small blind $0.01
Koresh153: posts big blind $0.02
*** HOLE CARDS ***
mermila: folds
Flix2204: folds
Xtens: folds
RodriguezDB has timed out
RodriguezDB: folds
H17FS: calls $0.01
Koresh153: checks
*** FLOP *** [4s 8c 4c]
H17FS: checks
mermila leaves the table
yarik7879 joins the table at seat #6
Koresh153: checks
*** TURN *** [4s 8c 4c] [4h]
H17FS: checks
Koresh153: checks
*** RIVER *** [4s 8c 4c 4h] [6d]
H17FS: checks
Koresh153: checks
*** SHOW DOWN ***
H17FS: shows [5h Kd] (three of a kind, Fours)
Koresh153: shows [5c 8d] (a full house, Fours full of Eights)
Koresh153 collected $0.04 from pot
*** SUMMARY ***
Total pot $0.04 | Rake $0
Board [4s 8c 4c 4h 6d]
Seat 1: Flix2204 folded before Flop (didn't bet)
Seat 2: Xtens folded before Flop (didn't bet)
Seat 3: RodriguezDB (button) folded before Flop (didn't bet)
Seat 4: H17FS (small blind) showed [5h Kd] and lost with three of a kind, Fours
Seat 5: Koresh153 (big blind) showed [5c 8d] and won ($0.04) with a full house, Fours full of Eights
Seat 6: mermila folded before Flop (didn't bet)


PokerStars Hand #238162790012:  Hold'em No Limit ($0.01/$0.02 USD) - 2022/08/23 3:49:58 ET
Table 'Achilles IV' 6-max Seat #4 is the button
Seat 1: Flix2204 ($2.11 in chips)
Seat 2: Xtens ($1.85 in chips)
Seat 3: RodriguezDB ($3.31 in chips)
Seat 4: H17FS ($1.80 in chips)
Seat 5: Koresh153 ($2.30 in chips)
Seat 6: yarik7879 ($0.80 in chips)
Koresh153: posts small blind $0.01
yarik7879: posts big blind $0.02
*** HOLE CARDS ***
Flix2204: raises $0.04 to $0.06
Xtens: folds
RodriguezDB: folds
H17FS: folds
Koresh153: folds
yarik7879: calls $0.04
*** FLOP *** [Th 3h 9h]
yarik7879: checks
Flix2204: bets $0.04
yarik7879: calls $0.04
*** TURN *** [Th 3h 9h] [4s]
yarik7879: checks
Flix2204: bets $0.10
yarik7879: raises $0.10 to $0.20
Flix2204: calls $0.10
*** RIVER *** [Th 3h 9h 4s] [6s]
yarik7879: bets $0.29
Flix2204: calls $0.29
*** SHOW DOWN ***
yarik7879: shows [9c 9d] (three of a kind, Nines)
Flix2204: mucks hand
yarik7879 collected $1.15 from pot
*** SUMMARY ***
Total pot $1.19 | Rake $0.04
Board [Th 3h 9h 4s 6s]
Seat 1: Flix2204 mucked
Seat 2: Xtens folded before Flop (didn't bet)
Seat 3: RodriguezDB folded before Flop (didn't bet)
Seat 4: H17FS (button) folded before Flop (didn't bet)
Seat 5: Koresh153 (small blind) folded before Flop
Seat 6: yarik7879 (big blind) showed [9c 9d] and won ($1.15) with three of a kind, Nines


PokerStars Hand #238162797538:  Hold'em No Limit ($0.01/$0.02 USD) - 2022/08/23 3:51:01 ET
Table 'Achilles IV' 6-max Seat #5 is the button
Seat 1: Flix2204 ($2 in chips)
Seat 2: Xtens ($1.85 in chips)
Seat 3: RodriguezDB ($3.31 in chips)
Seat 4: H17FS ($1.80 in chips)
Seat 5: Koresh153 ($2.29 in chips)
Seat 6: yarik7879 ($1.36 in chips)
yarik7879: posts small blind $0.01
Flix2204: posts big blind $0.02
*** HOLE CARDS ***
Xtens: folds
RodriguezDB: raises $0.04 to $0.06
H17FS: folds
Koresh153: raises $0.16 to $0.22
yarik7879: folds
Flix2204: folds
RodriguezDB: folds
Uncalled bet ($0.16) returned to Koresh153
Koresh153 collected $0.15 from pot
Koresh153: doesn't show hand
*** SUMMARY ***
Total pot $0.15 | Rake $0
Seat 1: Flix2204 (big blind) folded before Flop
Seat 2: Xtens folded before Flop (didn't bet)
Seat 3: RodriguezDB folded before Flop
Seat 4: H17FS folded before Flop (didn't bet)
Seat 5: Koresh153 (button) collected ($0.15)
Seat 6: yarik7879 (small blind) folded before Flop


PokerStars Hand #238162802144:  Hold'em No Limit ($0.01/$0.02 USD) - 2022/08/23 3:51:40 ET
Table 'Achilles IV' 6-max Seat #6 is the button
Seat 1: Flix2204 ($2 in chips)
Seat 2: Xtens ($1.85 in chips)
Seat 3: RodriguezDB ($3.25 in chips)
Seat 4: H17FS ($1.80 in chips)
Seat 5: Koresh153 ($2.38 in chips)
Seat 6: yarik7879 ($1.35 in chips)
Flix2204: posts small blind $0.01
Xtens: posts big blind $0.02
*** HOLE CARDS ***
RodriguezDB: folds
H17FS: raises $0.02 to $0.04
Koresh153: folds
yarik7879: calls $0.04
Flix2204: folds
Xtens: folds
*** FLOP *** [8c 9s Qh]
H17FS: bets $0.05
yarik7879: folds
Uncalled bet ($0.05) returned to H17FS
H17FS collected $0.11 from pot
*** SUMMARY ***
Total pot $0.11 | Rake $0
Board [8c 9s Qh]
Seat 1: Flix2204 (small blind) folded before Flop
Seat 2: Xtens (big blind) folded before Flop
Seat 3: RodriguezDB folded before Flop (didn't bet)
Seat 4: H17FS collected ($0.11)
Seat 5: Koresh153 folded before Flop (didn't bet)
Seat 6: yarik7879 (button) folded on the Flop


PokerStars Hand #238162810582:  Hold'em No Limit ($0.01/$0.02 USD) - 2022/08/23 3:52:08 ET
Table 'Achilles IV' 6-max Seat #1 is the button
Seat 1: Flix2204 ($2 in chips)
Seat 2: Xtens ($1.83 in chips)
Seat 3: RodriguezDB ($3.25 in chips)
Seat 4: H17FS ($1.87 in chips)
Seat 5: Koresh153 ($2.38 in chips)
Seat 6: yarik7879 ($1.31 in chips)
Xtens: posts small blind $0.01
RodriguezDB: posts big blind $0.02
*** HOLE CARDS ***
H17FS: raises $0.02 to $0.04
Koresh153: folds
yarik7879: calls $0.04
Flix2204: folds
Xtens: folds
RodriguezDB: folds
*** FLOP *** [Jh 5d Qc]
H17FS: bets $0.02
yarik7879: calls $0.02
*** TURN *** [Jh 5d Qc] [6s]
H17FS: bets $0.07
yarik7879: folds
Uncalled bet ($0.07) returned to H17FS
H17FS collected $0.14 from pot
*** SUMMARY ***
Total pot $0.15 | Rake $0.01
Board [Jh 5d Qc 6s]
Seat 1: Flix2204 (button) folded before Flop (didn't bet)
Seat 2: Xtens (small blind) folded before Flop
Seat 3: RodriguezDB (big blind) folded before Flop
Seat 4: H17FS collected ($0.14)
Seat 5: Koresh153 folded before Flop (didn't bet)
Seat 6: yarik7879 folded on the Turn


PokerStars Hand #238162815241:  Hold'em No Limit ($0.01/$0.02 USD) - 2022/08/23 3:52:47 ET
Table 'Achilles IV' 6-max Seat #2 is the button
Seat 1: Flix2204 ($2 in chips)
Seat 2: Xtens ($1.82 in chips)
Seat 3: RodriguezDB ($3.23 in chips)
Seat 4: H17FS ($1.95 in chips)
Seat 5: Koresh153 ($2.38 in chips)
Seat 6: yarik7879 ($1.25 in chips)
RodriguezDB: posts small blind $0.01
H17FS: posts big blind $0.02
*** HOLE CARDS ***
Koresh153: folds
yarik7879: folds
Flix2204: raises $0.03 to $0.05
Xtens: folds
RodriguezDB: folds
H17FS: folds
Uncalled bet ($0.03) returned to Flix2204
Flix2204 collected $0.05 from pot
Flix2204: doesn't show hand
*** SUMMARY ***
Total pot $0.05 | Rake $0
Seat 1: Flix2204 collected ($0.05)
Seat 2: Xtens (button) folded before Flop (didn't bet)
Seat 3: RodriguezDB (small blind) folded before Flop
Seat 4: H17FS (big blind) folded before Flop
Seat 5: Koresh153 folded before Flop (didn't bet)
Seat 6: yarik7879 folded before Flop (didn't bet)


PokerStars Hand #238162817966:  Hold'em No Limit ($0.01/$0.02 USD) - 2022/08/23 3:53:09 ET
Table 'Achilles IV' 6-max Seat #3 is the button
Seat 1: Flix2204 ($2.03 in chips)
Seat 2: Xtens ($1.82 in chips)
Seat 3: RodriguezDB ($3.22 in chips)
Seat 4: H17FS ($1.93 in chips)
Seat 5: Koresh153 ($2.38 in chips)
Seat 6: yarik7879 ($1.25 in chips)
H17FS: posts small blind $0.01
Koresh153: posts big blind $0.02
*** HOLE CARDS ***
yarik7879: folds
Flix2204: folds
Xtens has timed out
Xtens: folds
RodriguezDB: folds
H17FS: calls $0.01
Koresh153: checks
*** FLOP *** [Th 2h 3d]
H17FS: checks
Koresh153: checks
*** TURN *** [Th 2h 3d] [6c]
H17FS: checks
Koresh153: checks
*** RIVER *** [Th 2h 3d 6c] [6d]
H17FS: checks
Koresh153: checks
*** SHOW DOWN ***
H17FS: shows [Kd 7d] (a pair of Sixes)
Koresh153: shows [2d 8h] (two pair, Sixes and Deuces)
Koresh153 collected $0.04 from pot
*** SUMMARY ***
Total pot $0.04 | Rake $0
Board [Th 2h 3d 6c 6d]
Seat 1: Flix2204 folded before Flop (didn't bet)
Seat 2: Xtens folded before Flop (didn't bet)
Seat 3: RodriguezDB (button) folded before Flop (didn't bet)
Seat 4: H17FS (small blind) showed [Kd 7d] and lost with a pair of Sixes
Seat 5: Koresh153 (big blind) showed [2d 8h] and won ($0.04) with two pair, Sixes and Deuces
Seat 6: yarik7879 folded before Flop (didn't bet)


PokerStars Hand #238162825418:  Hold'em No Limit ($0.01/$0.02 USD) - 2022/08/23 3:54:12 ET
Table 'Achilles IV' 6-max Seat #4 is the button
Seat 1: Flix2204 ($2.03 in chips)
Seat 2: Xtens ($1.82 in chips)
Seat 3: RodriguezDB ($3.22 in chips)
Seat 4: H17FS ($1.91 in chips)
Seat 6: yarik7879 ($1.25 in chips)
yarik7879: posts small blind $0.01
Flix2204: posts big blind $0.02
*** HOLE CARDS ***
Xtens: folds
RodriguezDB: folds
H17FS: calls $0.02
yarik7879: folds
Flix2204: raises $0.08 to $0.10
H17FS: calls $0.08
*** FLOP *** [5c 2c 7h]
manolelps joins the table at seat #5
Flix2204: checks
H17FS: checks
*** TURN *** [5c 2c 7h] [4h]
Flix2204: checks
H17FS: checks
*** RIVER *** [5c 2c 7h 4h] [9s]
Flix2204: checks
H17FS: checks
*** SHOW DOWN ***
Flix2204: shows [Ah Jc] (high card Ace)
H17FS: shows [Qs Ad] (high card Ace - Queen kicker)
H17FS collected $0.20 from pot
*** SUMMARY ***
Total pot $0.21 | Rake $0.01
Board [5c 2c 7h 4h 9s]
Seat 1: Flix2204 (big blind) showed [Ah Jc] and lost with high card Ace
Seat 2: Xtens folded before Flop (didn't bet)
Seat 3: RodriguezDB folded before Flop (didn't bet)
Seat 4: H17FS (button) showed [Qs Ad] and won ($0.20) with high card Ace
Seat 6: yarik7879 (small blind) folded before Flop


PokerStars Hand #238162836465:  Hold'em No Limit ($0.01/$0.02 USD) - 2022/08/23 3:55:49 ET
Table 'Achilles IV' 6-max Seat #6 is the button
Seat 1: Flix2204 ($2 in chips)
Seat 2: Xtens ($1.82 in chips)
Seat 3: RodriguezDB ($3.22 in chips)
Seat 4: H17FS ($2.01 in chips)
Seat 6: yarik7879 ($1.24 in chips)
Flix2204: posts small blind $0.01
Xtens: posts big blind $0.02
manolelps: sits out
*** HOLE CARDS ***
RodriguezDB has timed out
RodriguezDB: folds
H17FS: folds
yarik7879: folds
Flix2204: folds
Uncalled bet ($0.01) returned to Xtens
Xtens collected $0.02 from pot
Xtens: doesn't show hand
*** SUMMARY ***
Total pot $0.02 | Rake $0
Seat 1: Flix2204 (small blind) folded before Flop
Seat 2: Xtens (big blind) collected ($0.02)
Seat 3: RodriguezDB folded before Flop (didn't bet)
Seat 4: H17FS folded before Flop (didn't bet)
Seat 6: yarik7879 (button) folded before Flop (didn't bet)


PokerStars Hand #238162838205:  Hold'em No Limit ($0.01/$0.02 USD) - 2022/08/23 3:56:05 ET
Table 'Achilles IV' 6-max Seat #1 is the button
Seat 1: Flix2204 ($2 in chips)
Seat 2: Xtens ($1.83 in chips)
Seat 3: RodriguezDB ($3.22 in chips)
Seat 4: H17FS ($2.01 in chips)
Seat 6: yarik7879 ($1.24 in chips)
Xtens: posts small blind $0.01
RodriguezDB: posts big blind $0.02
manolelps: sits out
*** HOLE CARDS ***
H17FS has timed out
H17FS: folds
yarik7879: folds
Flix2204: folds
Xtens: folds
Uncalled bet ($0.01) returned to RodriguezDB
RodriguezDB collected $0.02 from pot
*** SUMMARY ***
Total pot $0.02 | Rake $0
Seat 1: Flix2204 (button) folded before Flop (didn't bet)
Seat 2: Xtens (small blind) folded before Flop
Seat 3: RodriguezDB (big blind) collected ($0.02)
Seat 4: H17FS folded before Flop (didn't bet)
Seat 6: yarik7879 folded before Flop (didn't bet)


PokerStars Hand #238162840221:  Hold'em No Limit ($0.01/$0.02 USD) - 2022/08/23 3:56:23 ET
Table 'Achilles IV' 6-max Seat #2 is the button
Seat 1: Flix2204 ($2 in chips)
Seat 2: Xtens ($1.82 in chips)
Seat 3: RodriguezDB ($3.23 in chips)
Seat 5: manolelps ($2 in chips)
Seat 6: yarik7879 ($1.24 in chips)
RodriguezDB: posts small blind $0.01
manolelps: posts big blind $0.02
*** HOLE CARDS ***
yarik7879: folds
Flix2204: folds
Xtens: folds
RodriguezDB: folds
Uncalled bet ($0.01) returned to manolelps
manolelps collected $0.02 from pot
*** SUMMARY ***
Total pot $0.02 | Rake $0
Seat 1: Flix2204 folded before Flop (didn't bet)
Seat 2: Xtens (button) folded before Flop (didn't bet)
Seat 3: RodriguezDB (small blind) folded before Flop
Seat 5: manolelps (big blind) collected ($0.02)
Seat 6: yarik7879 folded before Flop (didn't bet)


PokerStars Hand #238162842804:  Hold'em No Limit ($0.01/$0.02 USD) - 2022/08/23 3:56:48 ET
Table 'Achilles IV' 6-max Seat #3 is the button
Seat 1: Flix2204 ($2 in chips)
Seat 2: Xtens ($1.82 in chips)
Seat 3: RodriguezDB ($3.22 in chips)
Seat 5: manolelps ($2.01 in chips)
Seat 6: yarik7879 ($1.24 in chips)
manolelps: posts small blind $0.01
yarik7879: posts big blind $0.02
*** HOLE CARDS ***
Flix2204: folds
Xtens: folds
RodriguezDB: raises $0.04 to $0.06
manolelps: folds
yarik7879: folds
Uncalled bet ($0.04) returned to RodriguezDB
RodriguezDB collected $0.05 from pot
*** SUMMARY ***
Total pot $0.05 | Rake $0
Seat 1: Flix2204 folded before Flop (didn't bet)
Seat 2: Xtens folded before Flop (didn't bet)
Seat 3: RodriguezDB (button) collected ($0.05)
Seat 5: manolelps (small blind) folded before Flop
Seat 6: yarik7879 (big blind) folded before Flop


PokerStars Hand #238162846513:  Hold'em No Limit ($0.01/$0.02 USD) - 2022/08/23 3:57:23 ET
Table 'Achilles IV' 6-max Seat #5 is the button
Seat 1: Flix2204 ($2 in chips)
Seat 2: Xtens ($1.82 in chips)
Seat 3: RodriguezDB ($3.25 in chips)
Seat 4: H17FS ($2.01 in chips)
Seat 5: manolelps ($2 in chips)
Seat 6: yarik7879 ($1.22 in chips)
yarik7879: posts small blind $0.01
Flix2204: posts big blind $0.02
H17FS: posts small & big blinds $0.03
*** HOLE CARDS ***
Xtens: raises $0.05 to $0.07
RodriguezDB: folds
H17FS: calls $0.05
manolelps: folds
yarik7879: folds
Flix2204: folds
*** FLOP *** [7d 5d Qs]
Xtens: bets $0.09
H17FS: folds
Uncalled bet ($0.09) returned to Xtens
Xtens collected $0.17 from pot
Xtens: doesn't show hand
*** SUMMARY ***
Total pot $0.18 | Rake $0.01
Board [7d 5d Qs]
Seat 1: Flix2204 (big blind) folded before Flop
Seat 2: Xtens collected ($0.17)
Seat 3: RodriguezDB folded before Flop (didn't bet)
Seat 4: H17FS folded on the Flop
Seat 5: manolelps (button) folded before Flop (didn't bet)
Seat 6: yarik7879 (small blind) folded before Flop


PokerStars Hand #238162852011:  Hold'em No Limit ($0.01/$0.02 USD) - 2022/08/23 3:58:14 ET
Table 'Achilles IV' 6-max Seat #6 is the button
Seat 1: Flix2204 ($2 in chips)
Seat 2: Xtens ($1.92 in chips)
Seat 3: RodriguezDB ($3.25 in chips)
Seat 4: H17FS ($1.93 in chips)
Seat 5: manolelps ($2 in chips)
Seat 6: yarik7879 ($1.21 in chips)
Flix2204: posts small blind $0.01
Xtens: posts big blind $0.02
*** HOLE CARDS ***
RodriguezDB: folds
H17FS: folds
manolelps: folds
yarik7879: raises $0.02 to $0.04
Flix2204: folds
Xtens: calls $0.02
*** FLOP *** [Ad 7h Qh]
Xtens: checks
yarik7879: bets $0.02
Xtens: calls $0.02
*** TURN *** [Ad 7h Qh] [Jh]
Xtens: checks
yarik7879: bets $0.04
Xtens: raises $0.04 to $0.08
yarik7879: calls $0.04
*** RIVER *** [Ad 7h Qh Jh] [5c]
Xtens: bets $0.21
yarik7879: folds
Uncalled bet ($0.21) returned to Xtens
Xtens collected $0.28 from pot
Xtens: doesn't show hand
*** SUMMARY ***
Total pot $0.29 | Rake $0.01
Board [Ad 7h Qh Jh 5c]
Seat 1: Flix2204 (small blind) folded before Flop
Seat 2: Xtens (big blind) collected ($0.28)
Seat 3: RodriguezDB folded before Flop (didn't bet)
Seat 4: H17FS folded before Flop (didn't bet)
Seat 5: manolelps folded before Flop (didn't bet)
Seat 6: yarik7879 (button) folded on the River


PokerStars Hand #238162856059:  Hold'em No Limit ($0.01/$0.02 USD) - 2022/08/23 3:58:51 ET
Table 'Achilles IV' 6-max Seat #1 is the button
Seat 1: Flix2204 ($2 in chips)
Seat 2: Xtens ($2.06 in chips)
Seat 3: RodriguezDB ($3.25 in chips)
Seat 4: H17FS ($1.93 in chips)
Seat 5: manolelps ($2 in chips)
Seat 6: yarik7879 ($1.07 in chips)
Xtens: posts small blind $0.01
RodriguezDB: posts big blind $0.02
*** HOLE CARDS ***
H17FS: calls $0.02
manolelps: folds
yarik7879: folds
Flix2204: folds
Xtens: folds
RodriguezDB: checks
*** FLOP *** [3h 2d 8d]
RodriguezDB: checks
H17FS: checks
*** TURN *** [3h 2d 8d] [Jd]
RodriguezDB: checks
H17FS: checks
*** RIVER *** [3h 2d 8d Jd] [Tc]
RodriguezDB: checks
H17FS: checks
*** SHOW DOWN ***
RodriguezDB: shows [Ks 6c] (high card King)
H17FS: shows [As Qh] (high card Ace)
H17FS collected $0.05 from pot
*** SUMMARY ***
Total pot $0.05 | Rake $0
Board [3h 2d 8d Jd Tc]
Seat 1: Flix2204 (button) folded before Flop (didn't bet)
Seat 2: Xtens (small blind) folded before Flop
Seat 3: RodriguezDB (big blind) showed [Ks 6c] and lost with high card King
Seat 4: H17FS showed [As Qh] and won ($0.05) with high card Ace
Seat 5: manolelps folded before Flop (didn't bet)
Seat 6: yarik7879 folded before Flop (didn't bet)


PokerStars Hand #238162861137:  Hold'em No Limit ($0.01/$0.02 USD) - 2022/08/23 3:59:38 ET
Table 'Achilles IV' 6-max Seat #2 is the button
Seat 1: Flix2204 ($2 in chips)
Seat 2: Xtens ($2.05 in chips)
Seat 3: RodriguezDB ($3.23 in chips)
Seat 4: H17FS ($1.96 in chips)
Seat 5: manolelps ($2 in chips)
Seat 6: yarik7879 ($1.07 in chips)
RodriguezDB: posts small blind $0.01
H17FS: posts big blind $0.02
*** HOLE CARDS ***
manolelps: folds
yarik7879: folds
Flix2204: raises $0.03 to $0.05
Xtens: calls $0.05
RodriguezDB: folds
H17FS: calls $0.03
*** FLOP *** [3c Kc 5c]
H17FS: checks
Flix2204: checks
Xtens: checks
*** TURN *** [3c Kc 5c] [Qh]
H17FS: checks
Flix2204: bets $0.07
Xtens: calls $0.07
H17FS: folds
*** RIVER *** [3c Kc 5c Qh] [6d]
Flix2204: checks
Xtens: bets $0.10
Flix2204: folds
Uncalled bet ($0.10) returned to Xtens
Xtens collected $0.29 from pot
Xtens: doesn't show hand
*** SUMMARY ***
Total pot $0.30 | Rake $0.01
Board [3c Kc 5c Qh 6d]
Seat 1: Flix2204 folded on the River
Seat 2: Xtens (button) collected ($0.29)
Seat 3: RodriguezDB (small blind) folded before Flop
Seat 4: H17FS (big blind) folded on the Turn
Seat 5: manolelps folded before Flop (didn't bet)
Seat 6: yarik7879 folded before Flop (didn't bet)


PokerStars Hand #238162874318:  Hold'em No Limit ($0.01/$0.02 USD) - 2022/08/23 4:01:33 ET
Table 'Achilles IV' 6-max Seat #3 is the button
Seat 1: Flix2204 ($2 in chips)
Seat 2: Xtens ($2.22 in chips)
Seat 3: RodriguezDB ($3.22 in chips)
Seat 4: H17FS ($1.91 in chips)
Seat 5: manolelps ($2 in chips)
Seat 6: yarik7879 ($1.07 in chips)
H17FS: posts small blind $0.01
manolelps: posts big blind $0.02
*** HOLE CARDS ***
yarik7879: calls $0.02
Flix2204: folds
Xtens: folds
RodriguezDB: folds
H17FS: calls $0.01
manolelps: raises $0.08 to $0.10
yarik7879: calls $0.08
H17FS: folds
*** FLOP *** [Qd Jd 3h]
manolelps: checks
yarik7879: bets $0.21
manolelps: folds
Uncalled bet ($0.21) returned to yarik7879
yarik7879 collected $0.21 from pot
*** SUMMARY ***
Total pot $0.22 | Rake $0.01
Board [Qd Jd 3h]
Seat 1: Flix2204 folded before Flop (didn't bet)
Seat 2: Xtens folded before Flop (didn't bet)
Seat 3: RodriguezDB (button) folded before Flop (didn't bet)
Seat 4: H17FS (small blind) folded before Flop
Seat 5: manolelps (big blind) folded on the Flop
Seat 6: yarik7879 collected ($0.21)


PokerStars Hand #238162885623:  Hold'em No Limit ($0.01/$0.02 USD) - 2022/08/23 4:03:04 ET
Table 'Achilles IV' 6-max Seat #4 is the button
Seat 1: Flix2204 ($2 in chips)
Seat 2: Xtens ($2.22 in chips)
Seat 3: RodriguezDB ($3.22 in chips)
Seat 4: H17FS ($1.89 in chips)
Seat 5: manolelps ($1.90 in chips)
Seat 6: yarik7879 ($1.18 in chips)
manolelps: posts small blind $0.01
yarik7879: posts big blind $0.02
*** HOLE CARDS ***
Flix2204: folds
Xtens: folds
RodriguezDB: folds
H17FS: calls $0.02
manolelps: folds
yarik7879: checks
*** FLOP *** [Qd Qc 4s]
yarik7879: checks
H17FS: checks
*** TURN *** [Qd Qc 4s] [Kd]
yarik7879: checks
H17FS: checks
*** RIVER *** [Qd Qc 4s Kd] [6h]
yarik7879: checks
H17FS: checks
*** SHOW DOWN ***
yarik7879: shows [8c 9c] (a pair of Queens)
H17FS: shows [Js Ts] (a pair of Queens - King+Jack kicker)
H17FS collected $0.05 from pot
*** SUMMARY ***
Total pot $0.05 | Rake $0
Board [Qd Qc 4s Kd 6h]
Seat 1: Flix2204 folded before Flop (didn't bet)
Seat 2: Xtens folded before Flop (didn't bet)
Seat 3: RodriguezDB folded before Flop (didn't bet)
Seat 4: H17FS (button) showed [Js Ts] and won ($0.05) with a pair of Queens
Seat 5: manolelps (small blind) folded before Flop
Seat 6: yarik7879 (big blind) showed [8c 9c] and lost with a pair of Queens


PokerStars Hand #238162890690:  Hold'em No Limit ($0.01/$0.02 USD) - 2022/08/23 4:03:45 ET
Table 'Achilles IV' 6-max Seat #5 is the button
Seat 1: Flix2204 ($2 in chips)
Seat 2: Xtens ($2.22 in chips)
Seat 3: RodriguezDB ($3.22 in chips)
Seat 4: H17FS ($1.92 in chips)
Seat 5: manolelps ($1.89 in chips)
Seat 6: yarik7879 ($1.16 in chips)
yarik7879: posts small blind $0.01
Flix2204: posts big blind $0.02
*** HOLE CARDS ***
Xtens: folds
RodriguezDB: folds
H17FS: calls $0.02
manolelps: folds
yarik7879: raises $0.08 to $0.10
Flix2204: folds
H17FS: calls $0.08
*** FLOP *** [5d 5h Ah]
yarik7879: bets $0.04
H17FS: folds
Uncalled bet ($0.04) returned to yarik7879
yarik7879 collected $0.21 from pot
*** SUMMARY ***
Total pot $0.22 | Rake $0.01
Board [5d 5h Ah]
Seat 1: Flix2204 (big blind) folded before Flop
Seat 2: Xtens folded before Flop (didn't bet)
Seat 3: RodriguezDB folded before Flop (didn't bet)
Seat 4: H17FS folded on the Flop
Seat 5: manolelps (button) folded before Flop (didn't bet)
Seat 6: yarik7879 (small blind) collected ($0.21)


PokerStars Hand #238162895659:  Hold'em No Limit ($0.01/$0.02 USD) - 2022/08/23 4:04:25 ET
Table 'Achilles IV' 6-max Seat #6 is the button
Seat 1: Flix2204 ($2 in chips)
Seat 2: Xtens ($2.22 in chips)
Seat 3: RodriguezDB ($3.22 in chips)
Seat 4: H17FS ($1.82 in chips)
Seat 5: manolelps ($2 in chips)
Seat 6: yarik7879 ($1.27 in chips)
Flix2204: posts small blind $0.01
Xtens: posts big blind $0.02
*** HOLE CARDS ***
RodriguezDB: folds
H17FS: folds
manolelps: raises $0.04 to $0.06
yarik7879: calls $0.06
Flix2204: folds
Xtens: folds
*** FLOP *** [Ks Kc 7c]
manolelps: checks
yarik7879: bets $0.04
manolelps: folds
Uncalled bet ($0.04) returned to yarik7879
yarik7879 collected $0.14 from pot
*** SUMMARY ***
Total pot $0.15 | Rake $0.01
Board [Ks Kc 7c]
Seat 1: Flix2204 (small blind) folded before Flop
Seat 2: Xtens (big blind) folded before Flop
Seat 3: RodriguezDB folded before Flop (didn't bet)
Seat 4: H17FS folded before Flop (didn't bet)
Seat 5: manolelps folded on the Flop
Seat 6: yarik7879 (button) collected ($0.14)


PokerStars Hand #238162902371:  Hold'em No Limit ($0.01/$0.02 USD) - 2022/08/23 4:05:19 ET
Table 'Achilles IV' 6-max Seat #1 is the button
Seat 1: Flix2204 ($2 in chips)
Seat 2: Xtens ($2.20 in chips)
Seat 3: RodriguezDB ($3.22 in chips)
Seat 4: H17FS ($1.82 in chips)
Seat 5: manolelps ($1.94 in chips)
Seat 6: yarik7879 ($1.35 in chips)
Xtens: posts small blind $0.01
RodriguezDB: posts big blind $0.02
*** HOLE CARDS ***
H17FS: folds
manolelps: folds
yarik7879: folds
Flix2204: folds
Xtens: raises $0.03 to $0.05
RodriguezDB: folds
Uncalled bet ($0.03) returned to Xtens
Xtens collected $0.04 from pot
Xtens: doesn't show hand
*** SUMMARY ***
Total pot $0.04 | Rake $0
Seat 1: Flix2204 (button) folded before Flop (didn't bet)
Seat 2: Xtens (small blind) collected ($0.04)
Seat 3: RodriguezDB (big blind) folded before Flop
Seat 4: H17FS folded before Flop (didn't bet)
Seat 5: manolelps folded before Flop (didn't bet)
Seat 6: yarik7879 folded before Flop (didn't bet)


PokerStars Hand #238162905235:  Hold'em No Limit ($0.01/$0.02 USD) - 2022/08/23 4:05:42 ET
Table 'Achilles IV' 6-max Seat #2 is the button
Seat 1: Flix2204 ($2 in chips)
Seat 2: Xtens ($2.22 in chips)
Seat 3: RodriguezDB ($3.20 in chips)
Seat 4: H17FS ($1.82 in chips)
Seat 5: manolelps ($1.94 in chips)
Seat 6: yarik7879 ($1.35 in chips)
RodriguezDB: posts small blind $0.01
H17FS: posts big blind $0.02
*** HOLE CARDS ***
manolelps: folds
yarik7879: folds
Flix2204: raises $0.03 to $0.05
Xtens: folds
RodriguezDB: folds
H17FS: calls $0.03
*** FLOP *** [2d 2h Jh]
H17FS: checks
Flix2204: bets $0.04
H17FS: calls $0.04
*** TURN *** [2d 2h Jh] [Ah]
H17FS: bets $0.09
Flix2204: calls $0.09
*** RIVER *** [2d 2h Jh Ah] [3s]
H17FS: bets $0.06
Flix2204: calls $0.06
*** SHOW DOWN ***
H17FS: shows [Tc Th] (two pair, Tens and Deuces)
Flix2204: shows [Ts Js] (two pair, Jacks and Deuces)
Flix2204 collected $0.47 from pot
*** SUMMARY ***
Total pot $0.49 | Rake $0.02
Board [2d 2h Jh Ah 3s]
Seat 1: Flix2204 showed [Ts Js] and won ($0.47) with two pair, Jacks and Deuces
Seat 2: Xtens (button) folded before Flop (didn't bet)
Seat 3: RodriguezDB (small blind) folded before Flop
Seat 4: H17FS (big blind) showed [Tc Th] and lost with two pair, Tens and Deuces
Seat 5: manolelps folded before Flop (didn't bet)
Seat 6: yarik7879 folded before Flop (didn't bet)


PokerStars Hand #238162912564:  Hold'em No Limit ($0.01/$0.02 USD) - 2022/08/23 4:06:41 ET
Table 'Achilles IV' 6-max Seat #3 is the button
Seat 1: Flix2204 ($2.23 in chips)
Seat 2: Xtens ($2.22 in chips)
Seat 3: RodriguezDB ($3.19 in chips)
Seat 4: H17FS ($1.58 in chips)
Seat 5: manolelps ($1.94 in chips)
Seat 6: yarik7879 ($1.35 in chips)
H17FS: posts small blind $0.01
manolelps: posts big blind $0.02
*** HOLE CARDS ***
yarik7879: folds
Flix2204: folds
Xtens: folds
RodriguezDB: folds
H17FS: calls $0.01
manolelps: checks
*** FLOP *** [2d 5s Th]
H17FS: checks
manolelps: bets $0.04
H17FS: folds
Uncalled bet ($0.04) returned to manolelps
manolelps collected $0.04 from pot
*** SUMMARY ***
Total pot $0.04 | Rake $0
Board [2d 5s Th]
Seat 1: Flix2204 folded before Flop (didn't bet)
Seat 2: Xtens folded before Flop (didn't bet)
Seat 3: RodriguezDB (button) folded before Flop (didn't bet)
Seat 4: H17FS (small blind) folded on the Flop
Seat 5: manolelps (big blind) collected ($0.04)
Seat 6: yarik7879 folded before Flop (didn't bet)


PokerStars Hand #238162917237:  Hold'em No Limit ($0.01/$0.02 USD) - 2022/08/23 4:07:19 ET
Table 'Achilles IV' 6-max Seat #4 is the button
Seat 1: Flix2204 ($2.23 in chips)
Seat 2: Xtens ($2.22 in chips)
Seat 3: RodriguezDB ($3.19 in chips)
Seat 4: H17FS ($1.56 in chips)
Seat 5: manolelps ($1.96 in chips)
Seat 6: yarik7879 ($1.35 in chips)
manolelps: posts small blind $0.01
yarik7879: posts big blind $0.02
*** HOLE CARDS ***
Flix2204: raises $0.04 to $0.06
Xtens: calls $0.06
RodriguezDB: folds
H17FS: folds
manolelps: folds
yarik7879: folds
*** FLOP *** [3c 6s 7s]
Flix2204: checks
Xtens: bets $0.08
Flix2204: folds
Uncalled bet ($0.08) returned to Xtens
Xtens collected $0.14 from pot
Xtens: doesn't show hand
*** SUMMARY ***
Total pot $0.15 | Rake $0.01
Board [3c 6s 7s]
Seat 1: Flix2204 folded on the Flop
Seat 2: Xtens collected ($0.14)
Seat 3: RodriguezDB folded before Flop (didn't bet)
Seat 4: H17FS (button) folded before Flop (didn't bet)
Seat 5: manolelps (small blind) folded before Flop
Seat 6: yarik7879 (big blind) folded before Flop


PokerStars Hand #238162921941:  Hold'em No Limit ($0.01/$0.02 USD) - 2022/08/23 4:07:57 ET
Table 'Achilles IV' 6-max Seat #5 is the button
Seat 1: Flix2204 ($2.17 in chips)
Seat 2: Xtens ($2.30 in chips)
Seat 3: RodriguezDB ($3.19 in chips)
Seat 4: H17FS ($1.56 in chips)
Seat 5: manolelps ($1.95 in chips)
Seat 6: yarik7879 ($1.33 in chips)
yarik7879: posts small blind $0.01
Flix2204: posts big blind $0.02
*** HOLE CARDS ***
Xtens: raises $0.03 to $0.05
RodriguezDB: folds
H17FS: folds
manolelps: folds
yarik7879: calls $0.04
Flix2204: folds
*** FLOP *** [5c 3d 3c]
yarik7879: checks
Xtens: bets $0.08
yarik7879: folds
Uncalled bet ($0.08) returned to Xtens
Xtens collected $0.12 from pot
Xtens: doesn't show hand
*** SUMMARY ***
Total pot $0.12 | Rake $0
Board [5c 3d 3c]
Seat 1: Flix2204 (big blind) folded before Flop
Seat 2: Xtens collected ($0.12)
Seat 3: RodriguezDB folded before Flop (didn't bet)
Seat 4: H17FS folded before Flop (didn't bet)
Seat 5: manolelps (button) folded before Flop (didn't bet)
Seat 6: yarik7879 (small blind) folded on the Flop


PokerStars Hand #238162925173:  Hold'em No Limit ($0.01/$0.02 USD) - 2022/08/23 4:08:23 ET
Table 'Achilles IV' 6-max Seat #6 is the button
Seat 1: Flix2204 ($2.15 in chips)
Seat 2: Xtens ($2.37 in chips)
Seat 3: RodriguezDB ($3.19 in chips)
Seat 4: H17FS ($1.56 in chips)
Seat 5: manolelps ($1.95 in chips)
Seat 6: yarik7879 ($1.28 in chips)
Flix2204: posts small blind $0.01
Xtens: posts big blind $0.02
*** HOLE CARDS ***
RodriguezDB: folds
H17FS: folds
manolelps: folds
yarik7879: folds
Flix2204: folds
Uncalled bet ($0.01) returned to Xtens
Xtens collected $0.02 from pot
Xtens: doesn't show hand
*** SUMMARY ***
Total pot $0.02 | Rake $0
Seat 1: Flix2204 (small blind) folded before Flop
Seat 2: Xtens (big blind) collected ($0.02)
Seat 3: RodriguezDB folded before Flop (didn't bet)
Seat 4: H17FS folded before Flop (didn't bet)
Seat 5: manolelps folded before Flop (didn't bet)
Seat 6: yarik7879 (button) folded before Flop (didn't bet)


PokerStars Hand #238162926267:  Hold'em No Limit ($0.01/$0.02 USD) - 2022/08/23 4:08:32 ET
Table 'Achilles IV' 6-max Seat #1 is the button
Seat 1: Flix2204 ($2.14 in chips)
Seat 2: Xtens ($2.38 in chips)
Seat 3: RodriguezDB ($3.19 in chips)
Seat 4: H17FS ($1.56 in chips)
Seat 5: manolelps ($1.95 in chips)
Seat 6: yarik7879 ($1.28 in chips)
Xtens: posts small blind $0.01
RodriguezDB: posts big blind $0.02
*** HOLE CARDS ***
H17FS: folds
manolelps: folds
yarik7879: raises $0.05 to $0.07
Flix2204: folds
Xtens: folds
RodriguezDB: calls $0.05
*** FLOP *** [5d 4h Ah]
RodriguezDB: checks
yarik7879: bets $0.14
RodriguezDB: folds
Uncalled bet ($0.14) returned to yarik7879
yarik7879 collected $0.14 from pot
*** SUMMARY ***
Total pot $0.15 | Rake $0.01
Board [5d 4h Ah]
Seat 1: Flix2204 (button) folded before Flop (didn't bet)
Seat 2: Xtens (small blind) folded before Flop
Seat 3: RodriguezDB (big blind) folded on the Flop
Seat 4: H17FS folded before Flop (didn't bet)
Seat 5: manolelps folded before Flop (didn't bet)
Seat 6: yarik7879 collected ($0.14)


PokerStars Hand #238162930659:  Hold'em No Limit ($0.01/$0.02 USD) - 2022/08/23 4:09:07 ET
Table 'Achilles IV' 6-max Seat #2 is the button
Seat 1: Flix2204 ($2.14 in chips)
Seat 2: Xtens ($2.37 in chips)
Seat 3: RodriguezDB ($3.12 in chips)
Seat 4: H17FS ($1.56 in chips)
Seat 5: manolelps ($1.95 in chips)
Seat 6: yarik7879 ($1.35 in chips)
RodriguezDB: posts small blind $0.01
H17FS: posts big blind $0.02
*** HOLE CARDS ***
manolelps: folds
yarik7879: raises $0.07 to $0.09
Flix2204: calls $0.09
Xtens: folds
RodriguezDB: folds
H17FS: calls $0.07
*** FLOP *** [Td 8h Jd]
H17FS: checks
yarik7879: bets $0.04
Flix2204: calls $0.04
H17FS: calls $0.04
*** TURN *** [Td 8h Jd] [9d]
H17FS: checks
yarik7879: bets $0.06
manolelps was removed from the table for failing to post
manolelps leaves the table
Flix2204: calls $0.06
H17FS: calls $0.06
*** RIVER *** [Td 8h Jd 9d] [Ad]
H17FS: checks
yarik7879: checks
Flix2204: checks
*** SHOW DOWN ***
H17FS: shows [6h Qh] (a straight, Eight to Queen)
yarik7879: mucks hand
Flix2204: mucks hand
H17FS collected $0.56 from pot
*** SUMMARY ***
Total pot $0.58 | Rake $0.02
Board [Td 8h Jd 9d Ad]
Seat 1: Flix2204 mucked
Seat 2: Xtens (button) folded before Flop (didn't bet)
Seat 3: RodriguezDB (small blind) folded before Flop
Seat 4: H17FS (big blind) showed [6h Qh] and won ($0.56) with a straight, Eight to Queen
Seat 5: manolelps folded before Flop (didn't bet)
Seat 6: yarik7879 mucked


PokerStars Hand #238162939906:  Hold'em No Limit ($0.01/$0.02 USD) - 2022/08/23 4:10:20 ET
Table 'Achilles IV' 6-max Seat #3 is the button
Seat 1: Flix2204 ($2 in chips)
Seat 2: Xtens ($2.37 in chips)
Seat 3: RodriguezDB ($3.11 in chips)
Seat 4: H17FS ($1.93 in chips)
Seat 6: yarik7879 ($1.16 in chips)
H17FS: posts small blind $0.01
yarik7879: posts big blind $0.02
*** HOLE CARDS ***
Flix2204: raises $0.04 to $0.06
Xtens: folds
RodriguezDB: folds
H17FS: folds
yarik7879: calls $0.04
*** FLOP *** [6s 8c Td]
RodriguezDB leaves the table
yarik7879: checks
Flix2204: bets $0.09
yarik7879: folds
Uncalled bet ($0.09) returned to Flix2204
Flix2204 collected $0.13 from pot
Flix2204: doesn't show hand
*** SUMMARY ***
Total pot $0.13 | Rake $0
Board [6s 8c Td]
Seat 1: Flix2204 collected ($0.13)
Seat 2: Xtens folded before Flop (didn't bet)
Seat 3: RodriguezDB (button) folded before Flop (didn't bet)
Seat 4: H17FS (small blind) folded before Flop
Seat 6: yarik7879 (big blind) folded on the Flop


PokerStars Hand #238162944005:  Hold'em No Limit ($0.01/$0.02 USD) - 2022/08/23 4:10:53 ET
Table 'Achilles IV' 6-max Seat #4 is the button
Seat 2: Xtens ($2.37 in chips)
Seat 4: H17FS ($1.92 in chips)
Seat 6: yarik7879 ($1.10 in chips)
yarik7879: posts small blind $0.01
Xtens: posts big blind $0.02
*** HOLE CARDS ***
Fedorenko26 joins the table at seat #3
H17FS: folds
yarik7879: raises $0.04 to $0.06
H17FS leaves the table
Xtens: folds
Uncalled bet ($0.04) returned to yarik7879
yarik7879 collected $0.04 from pot
*** SUMMARY ***
Total pot $0.04 | Rake $0
Seat 2: Xtens (big blind) folded before Flop
Seat 4: H17FS (button) folded before Flop (didn't bet)
Seat 6: yarik7879 (small blind) collected ($0.04)


PokerStars Hand #238162945157:  Hold'em No Limit ($0.01/$0.02 USD) - 2022/08/23 4:11:02 ET
Table 'Achilles IV' 6-max Seat #6 is the button
Seat 2: Xtens ($2.35 in chips)
Seat 3: Fedorenko26 ($2 in chips)
Seat 6: yarik7879 ($1.12 in chips)
Xtens: posts small blind $0.01
Fedorenko26: posts big blind $0.02
*** HOLE CARDS ***
yarik7879: folds
Xtens: folds
Uncalled bet ($0.01) returned to Fedorenko26
Fedorenko26 collected $0.02 from pot
*** SUMMARY ***
Total pot $0.02 | Rake $0
Seat 2: Xtens (small blind) folded before Flop
Seat 3: Fedorenko26 (big blind) collected ($0.02)
Seat 6: yarik7879 (button) folded before Flop (didn't bet)


PokerStars Hand #238162950505:  Hold'em No Limit ($0.01/$0.02 USD) - 2022/08/23 4:11:44 ET
Table 'Achilles IV' 6-max Seat #3 is the button
Seat 2: Xtens ($2.34 in chips)
Seat 3: Fedorenko26 ($2 in chips)
Seat 6: yarik7879 ($1.18 in chips)
yarik7879: posts small blind $0.01
Xtens: posts big blind $0.02
*** HOLE CARDS ***
Fedorenko26: folds
yarik7879: folds
Uncalled bet ($0.01) returned to Xtens
Xtens collected $0.02 from pot
Xtens: doesn't show hand
*** SUMMARY ***
Total pot $0.02 | Rake $0
Seat 2: Xtens (big blind) collected ($0.02)
Seat 3: Fedorenko26 (button) folded before Flop (didn't bet)
Seat 6: yarik7879 (small blind) folded before Flop


PokerStars Hand #238162946767:  Hold'em No Limit ($0.01/$0.02 USD) - 2022/08/23 4:11:15 ET
Table 'Achilles IV' 6-max Seat #2 is the button
Seat 2: Xtens ($2.34 in chips)
Seat 3: Fedorenko26 ($2.01 in chips)
Seat 6: yarik7879 ($1.12 in chips)
Fedorenko26: posts small blind $0.01
yarik7879: posts big blind $0.02
*** HOLE CARDS ***
Xtens has timed out
Xtens: folds
Fedorenko26: calls $0.01
yarik7879: raises $0.04 to $0.06
Fedorenko26: calls $0.04
*** FLOP *** [6s 3h Qd]
Fedorenko26: checks
yarik7879: bets $0.12
Fedorenko26: folds
Uncalled bet ($0.12) returned to yarik7879
yarik7879 collected $0.12 from pot
*** SUMMARY ***
Total pot $0.12 | Rake $0
Board [6s 3h Qd]
Seat 2: Xtens (button) folded before Flop (didn't bet)
Seat 3: Fedorenko26 (small blind) folded on the Flop
Seat 6: yarik7879 (big blind) collected ($0.12)


PokerStars Hand #238162951221:  Hold'em No Limit ($0.01/$0.02 USD) - 2022/08/23 4:11:50 ET
Table 'Achilles IV' 6-max Seat #6 is the button
Seat 2: Xtens ($2.35 in chips)
Seat 3: Fedorenko26 ($2 in chips)
Seat 6: yarik7879 ($1.17 in chips)
Xtens: posts small blind $0.01
Fedorenko26: posts big blind $0.02
*** HOLE CARDS ***
yarik7879: folds
Xtens: raises $0.03 to $0.05
Fedorenko26: calls $0.03
*** FLOP *** [9d Th Qh]
Xtens: checks
Fedorenko26: checks
*** TURN *** [9d Th Qh] [Ac]
Xtens: checks
Fedorenko26: checks
*** RIVER *** [9d Th Qh Ac] [Qs]
Xtens: checks
Fedorenko26: checks
*** SHOW DOWN ***
Xtens: shows [8d 8h] (two pair, Queens and Eights)
Fedorenko26: mucks hand
Xtens collected $0.10 from pot
*** SUMMARY ***
Total pot $0.10 | Rake $0
Board [9d Th Qh Ac Qs]
Seat 2: Xtens (small blind) showed [8d 8h] and won ($0.10) with two pair, Queens and Eights
Seat 3: Fedorenko26 (big blind) mucked
Seat 6: yarik7879 (button) folded before Flop (didn't bet)


PokerStars Hand #238162959520:  Hold'em No Limit ($0.01/$0.02 USD) - 2022/08/23 4:12:55 ET
Table 'Achilles IV' 6-max Seat #3 is the button
Seat 1: Flix2204 ($2.07 in chips)
Seat 2: Xtens ($2.40 in chips)
Seat 3: Fedorenko26 ($2 in chips)
Seat 6: yarik7879 ($1.18 in chips)
yarik7879: posts small blind $0.01
Flix2204: posts big blind $0.02
*** HOLE CARDS ***
Xtens: folds
Fedorenko26: folds
yarik7879: folds
Uncalled bet ($0.01) returned to Flix2204
Flix2204 collected $0.02 from pot
Flix2204: doesn't show hand
*** SUMMARY ***
Total pot $0.02 | Rake $0
Seat 1: Flix2204 (big blind) collected ($0.02)
Seat 2: Xtens folded before Flop (didn't bet)
Seat 3: Fedorenko26 (button) folded before Flop (didn't bet)
Seat 6: yarik7879 (small blind) folded before Flop


PokerStars Hand #238162958257:  Hold'em No Limit ($0.01/$0.02 USD) - 2022/08/23 4:12:45 ET
Table 'Achilles IV' 6-max Seat #2 is the button
Seat 2: Xtens ($2.40 in chips)
Seat 3: Fedorenko26 ($2 in chips)
Seat 6: yarik7879 ($1.17 in chips)
Fedorenko26: posts small blind $0.01
yarik7879: posts big blind $0.02
*** HOLE CARDS ***
Xtens: folds
Fedorenko26: folds
Uncalled bet ($0.01) returned to yarik7879
yarik7879 collected $0.02 from pot
*** SUMMARY ***
Total pot $0.02 | Rake $0
Seat 2: Xtens (button) folded before Flop (didn't bet)
Seat 3: Fedorenko26 (small blind) folded before Flop
Seat 6: yarik7879 (big blind) collected ($0.02)


PokerStars Hand #238162960698:  Hold'em No Limit ($0.01/$0.02 USD) - 2022/08/23 4:13:04 ET
Table 'Achilles IV' 6-max Seat #6 is the button
Seat 1: Flix2204 ($2.08 in chips)
Seat 2: Xtens ($2.40 in chips)
Seat 3: Fedorenko26 ($2 in chips)
Seat 6: yarik7879 ($1.17 in chips)
Flix2204: posts small blind $0.01
Xtens: posts big blind $0.02
*** HOLE CARDS ***
hoholas22 joins the table at seat #5
Fedorenko26: folds
yarik7879: folds
Flix2204: raises $0.04 to $0.06
Xtens: folds
Uncalled bet ($0.04) returned to Flix2204
Flix2204 collected $0.04 from pot
Flix2204: doesn't show hand
*** SUMMARY ***
Total pot $0.04 | Rake $0
Seat 1: Flix2204 (small blind) collected ($0.04)
Seat 2: Xtens (big blind) folded before Flop
Seat 3: Fedorenko26 folded before Flop (didn't bet)
Seat 6: yarik7879 (button) folded before Flop (didn't bet)


PokerStars Hand #238162962679:  Hold'em No Limit ($0.01/$0.02 USD) - 2022/08/23 4:13:20 ET
Table 'Achilles IV' 6-max Seat #1 is the button
Seat 1: Flix2204 ($2.10 in chips)
Seat 2: Xtens ($2.38 in chips)
Seat 3: Fedorenko26 ($2 in chips)
Seat 6: yarik7879 ($1.17 in chips)
Xtens: posts small blind $0.01
Fedorenko26: posts big blind $0.02
hoholas22: sits out
*** HOLE CARDS ***
yuyu767 joins the table at seat #4
yarik7879: calls $0.02
Flix2204: folds
Xtens: calls $0.01
Fedorenko26: checks
*** FLOP *** [Kh 4h 3c]
Xtens: checks
Fedorenko26: checks
yarik7879: checks
*** TURN *** [Kh 4h 3c] [8c]
Xtens: checks
Fedorenko26: bets $0.03
yarik7879: folds
Xtens: folds
Uncalled bet ($0.03) returned to Fedorenko26
Fedorenko26 collected $0.06 from pot
*** SUMMARY ***
Total pot $0.06 | Rake $0
Board [Kh 4h 3c 8c]
Seat 1: Flix2204 (button) folded before Flop (didn't bet)
Seat 2: Xtens (small blind) folded on the Turn
Seat 3: Fedorenko26 (big blind) collected ($0.06)
Seat 6: yarik7879 folded on the Turn


PokerStars Hand #238162970944:  Hold'em No Limit ($0.01/$0.02 USD) - 2022/08/23 4:14:24 ET
Table 'Achilles IV' 6-max Seat #2 is the button
Seat 1: Flix2204 ($2.10 in chips)
Seat 2: Xtens ($2.36 in chips)
Seat 3: Fedorenko26 ($2.04 in chips)
Seat 4: yuyu767 ($1.60 in chips)
Seat 6: yarik7879 ($1.15 in chips)
Fedorenko26: posts small blind $0.01
yuyu767: posts big blind $0.02
hoholas22: sits out
*** HOLE CARDS ***
yarik7879: raises $0.02 to $0.04
Flix2204: folds
Xtens: folds
Fedorenko26: folds
yuyu767: calls $0.02
*** FLOP *** [Ac 5c 5h]
yuyu767: checks
yarik7879: bets $0.04
yuyu767: calls $0.04
*** TURN *** [Ac 5c 5h] [Kd]
yuyu767: checks
yarik7879: bets $0.06
yuyu767: calls $0.06
*** RIVER *** [Ac 5c 5h Kd] [Qc]
yuyu767: checks
yarik7879: checks
*** SHOW DOWN ***
yuyu767: shows [9c Ah] (two pair, Aces and Fives)
yarik7879: mucks hand
yuyu767 collected $0.28 from pot
*** SUMMARY ***
Total pot $0.29 | Rake $0.01
Board [Ac 5c 5h Kd Qc]
Seat 1: Flix2204 folded before Flop (didn't bet)
Seat 2: Xtens (button) folded before Flop (didn't bet)
Seat 3: Fedorenko26 (small blind) folded before Flop
Seat 4: yuyu767 (big blind) showed [9c Ah] and won ($0.28) with two pair, Aces and Fives
Seat 6: yarik7879 mucked


PokerStars Hand #238162975176:  Hold'em No Limit ($0.01/$0.02 USD) - 2022/08/23 4:14:57 ET
Table 'Achilles IV' 6-max Seat #3 is the button
Seat 1: Flix2204 ($2.10 in chips)
Seat 2: Xtens ($2.36 in chips)
Seat 3: Fedorenko26 ($2.03 in chips)
Seat 4: yuyu767 ($1.74 in chips)
Seat 5: hoholas22 ($2 in chips)
Seat 6: yarik7879 ($1.01 in chips)
yuyu767: posts small blind $0.01
hoholas22: posts big blind $0.02
*** HOLE CARDS ***
yarik7879: raises $0.07 to $0.09
Flix2204: folds
Xtens: folds
Fedorenko26: folds
yuyu767: folds
hoholas22: folds
Uncalled bet ($0.07) returned to yarik7879
yarik7879 collected $0.05 from pot
*** SUMMARY ***
Total pot $0.05 | Rake $0
Seat 1: Flix2204 folded before Flop (didn't bet)
Seat 2: Xtens folded before Flop (didn't bet)
Seat 3: Fedorenko26 (button) folded before Flop (didn't bet)
Seat 4: yuyu767 (small blind) folded before Flop
Seat 5: hoholas22 (big blind) folded before Flop
Seat 6: yarik7879 collected ($0.05)


PokerStars Hand #238162982282:  Hold'em No Limit ($0.01/$0.02 USD) - 2022/08/23 4:15:23 ET
Table 'Achilles IV' 6-max Seat #4 is the button
Seat 1: Flix2204 ($2.10 in chips)
Seat 2: Xtens ($2.36 in chips)
Seat 3: Fedorenko26 ($2.03 in chips)
Seat 4: yuyu767 ($1.73 in chips)
Seat 5: hoholas22 ($1.98 in chips)
Seat 6: yarik7879 ($1.04 in chips)
hoholas22: posts small blind $0.01
yarik7879: posts big blind $0.02
*** HOLE CARDS ***
Flix2204: folds
Xtens: raises $0.03 to $0.05
Fedorenko26: raises $0.13 to $0.18
yuyu767: folds
hoholas22: folds
yarik7879: folds
Xtens: calls $0.13
*** FLOP *** [Jh Ad 4s]
Xtens: checks
Fedorenko26: checks
*** TURN *** [Jh Ad 4s] [7c]
Xtens: checks
Fedorenko26: checks
*** RIVER *** [Jh Ad 4s 7c] [4h]
Xtens: bets $0.29
Fedorenko26: folds
Uncalled bet ($0.29) returned to Xtens
Xtens collected $0.38 from pot
Xtens: doesn't show hand
*** SUMMARY ***
Total pot $0.39 | Rake $0.01
Board [Jh Ad 4s 7c 4h]
Seat 1: Flix2204 folded before Flop (didn't bet)
Seat 2: Xtens collected ($0.38)
Seat 3: Fedorenko26 folded on the River
Seat 4: yuyu767 (button) folded before Flop (didn't bet)
Seat 5: hoholas22 (small blind) folded before Flop
Seat 6: yarik7879 (big blind) folded before Flop


PokerStars Hand #238162990167:  Hold'em No Limit ($0.01/$0.02 USD) - 2022/08/23 4:16:25 ET
Table 'Achilles IV' 6-max Seat #5 is the button
Seat 1: Flix2204 ($2.10 in chips)
Seat 2: Xtens ($2.56 in chips)
Seat 3: Fedorenko26 ($2 in chips)
Seat 4: yuyu767 ($1.73 in chips)
Seat 5: hoholas22 ($1.97 in chips)
Seat 6: yarik7879 ($1.02 in chips)
yarik7879: posts small blind $0.01
Flix2204: posts big blind $0.02
*** HOLE CARDS ***
Xtens: folds
Fedorenko26: raises $0.04 to $0.06
yuyu767: folds
hoholas22: folds
yarik7879: folds
Flix2204: raises $0.18 to $0.24
Fedorenko26: folds
Uncalled bet ($0.18) returned to Flix2204
Flix2204 collected $0.13 from pot
Flix2204: doesn't show hand
*** SUMMARY ***
Total pot $0.13 | Rake $0
Seat 1: Flix2204 (big blind) collected ($0.13)
Seat 2: Xtens folded before Flop (didn't bet)
Seat 3: Fedorenko26 folded before Flop
Seat 4: yuyu767 folded before Flop (didn't bet)
Seat 5: hoholas22 (button) folded before Flop (didn't bet)
Seat 6: yarik7879 (small blind) folded before Flop


PokerStars Hand #238162993016:  Hold'em No Limit ($0.01/$0.02 USD) - 2022/08/23 4:16:47 ET
Table 'Achilles IV' 6-max Seat #6 is the button
Seat 1: Flix2204 ($2.17 in chips)
Seat 2: Xtens ($2.56 in chips)
Seat 3: Fedorenko26 ($2 in chips)
Seat 4: yuyu767 ($1.73 in chips)
Seat 5: hoholas22 ($1.97 in chips)
Seat 6: yarik7879 ($1.01 in chips)
Flix2204: posts small blind $0.01
Xtens: posts big blind $0.02
*** HOLE CARDS ***
Fedorenko26: folds
yuyu767: folds
hoholas22: folds
yarik7879: folds
Flix2204: raises $0.04 to $0.06
Xtens: folds
Uncalled bet ($0.04) returned to Flix2204
Flix2204 collected $0.04 from pot
Flix2204: doesn't show hand
*** SUMMARY ***
Total pot $0.04 | Rake $0
Seat 1: Flix2204 (small blind) collected ($0.04)
Seat 2: Xtens (big blind) folded before Flop
Seat 3: Fedorenko26 folded before Flop (didn't bet)
Seat 4: yuyu767 folded before Flop (didn't bet)
Seat 5: hoholas22 folded before Flop (didn't bet)
Seat 6: yarik7879 (button) folded before Flop (didn't bet)


PokerStars Hand #238162994516:  Hold'em No Limit ($0.01/$0.02 USD) - 2022/08/23 4:16:59 ET
Table 'Achilles IV' 6-max Seat #1 is the button
Seat 1: Flix2204 ($2.19 in chips)
Seat 2: Xtens ($2.54 in chips)
Seat 3: Fedorenko26 ($2 in chips)
Seat 4: yuyu767 ($1.73 in chips)
Seat 5: hoholas22 ($1.97 in chips)
Seat 6: yarik7879 ($1.01 in chips)
Xtens: posts small blind $0.01
Fedorenko26: posts big blind $0.02
*** HOLE CARDS ***
yuyu767: folds
hoholas22: folds
yarik7879: folds
Flix2204: folds
Xtens: folds
Uncalled bet ($0.01) returned to Fedorenko26
Fedorenko26 collected $0.02 from pot
*** SUMMARY ***
Total pot $0.02 | Rake $0
Seat 1: Flix2204 (button) folded before Flop (didn't bet)
Seat 2: Xtens (small blind) folded before Flop
Seat 3: Fedorenko26 (big blind) collected ($0.02)
Seat 4: yuyu767 folded before Flop (didn't bet)
Seat 5: hoholas22 folded before Flop (didn't bet)
Seat 6: yarik7879 folded before Flop (didn't bet)


PokerStars Hand #238162996113:  Hold'em No Limit ($0.01/$0.02 USD) - 2022/08/23 4:17:11 ET
Table 'Achilles IV' 6-max Seat #2 is the button
Seat 1: Flix2204 ($2.19 in chips)
Seat 2: Xtens ($2.53 in chips)
Seat 3: Fedorenko26 ($2.01 in chips)
Seat 4: yuyu767 ($1.73 in chips)
Seat 5: hoholas22 ($1.97 in chips)
Seat 6: yarik7879 ($1.01 in chips)
Fedorenko26: posts small blind $0.01
yuyu767: posts big blind $0.02
*** HOLE CARDS ***
hoholas22: folds
yarik7879: raises $0.05 to $0.07
Flix2204: folds
Xtens: folds
Fedorenko26: folds
yuyu767: folds
Uncalled bet ($0.05) returned to yarik7879
yarik7879 collected $0.05 from pot
*** SUMMARY ***
Total pot $0.05 | Rake $0
Seat 1: Flix2204 folded before Flop (didn't bet)
Seat 2: Xtens (button) folded before Flop (didn't bet)
Seat 3: Fedorenko26 (small blind) folded before Flop
Seat 4: yuyu767 (big blind) folded before Flop
Seat 5: hoholas22 folded before Flop (didn't bet)
Seat 6: yarik7879 collected ($0.05)


PokerStars Hand #238163006181:  Hold'em No Limit ($0.01/$0.02 USD) - 2022/08/23 4:18:28 ET
Table 'Achilles IV' 6-max Seat #4 is the button
Seat 2: Xtens ($2.53 in chips)
Seat 3: Fedorenko26 ($2 in chips)
Seat 4: yuyu767 ($2.70 in chips)
Seat 5: hoholas22 ($1.95 in chips)
hoholas22: posts small blind $0.01
Xtens: posts big blind $0.02
*** HOLE CARDS ***
Fedorenko26: folds
yuyu767: folds
hoholas22: folds
Uncalled bet ($0.01) returned to Xtens
Xtens collected $0.02 from pot
Xtens: doesn't show hand
*** SUMMARY ***
Total pot $0.02 | Rake $0
Seat 2: Xtens (big blind) collected ($0.02)
Seat 3: Fedorenko26 folded before Flop (didn't bet)
Seat 4: yuyu767 (button) folded before Flop (didn't bet)
Seat 5: hoholas22 (small blind) folded before Flop


PokerStars Hand #238162997608:  Hold'em No Limit ($0.01/$0.02 USD) - 2022/08/23 4:17:22 ET
Table 'Achilles IV' 6-max Seat #3 is the button
Seat 1: Flix2204 ($2.19 in chips)
Seat 2: Xtens ($2.53 in chips)
Seat 3: Fedorenko26 ($2 in chips)
Seat 4: yuyu767 ($1.71 in chips)
Seat 5: hoholas22 ($1.97 in chips)
Seat 6: yarik7879 ($1.04 in chips)
yuyu767: posts small blind $0.01
hoholas22: posts big blind $0.02
*** HOLE CARDS ***
yarik7879: calls $0.02
Flix2204 has timed out
Flix2204: folds
Xtens: folds
Fedorenko26: folds
yuyu767: raises $0.04 to $0.06
hoholas22: folds
yarik7879: calls $0.04
*** FLOP *** [Th 6c Js]
yuyu767: checks
yarik7879: checks
*** TURN *** [Th 6c Js] [Kd]
yuyu767: checks
yarik7879: checks
*** RIVER *** [Th 6c Js Kd] [7h]
yuyu767: bets $0.07
yarik7879: raises $0.14 to $0.21
yuyu767: raises $0.53 to $0.74
yarik7879: raises $0.24 to $0.98 and is all-in
yuyu767: calls $0.24
*** SHOW DOWN ***
yarik7879: shows [8c 9d] (a straight, Seven to Jack)
yuyu767: shows [As Qs] (a straight, Ten to Ace)
yuyu767 collected $2.03 from pot
*** SUMMARY ***
Total pot $2.10 | Rake $0.07
Board [Th 6c Js Kd 7h]
Seat 1: Flix2204 folded before Flop (didn't bet)
Seat 2: Xtens folded before Flop (didn't bet)
Seat 3: Fedorenko26 (button) folded before Flop (didn't bet)
Seat 4: yuyu767 (small blind) showed [As Qs] and won ($2.03) with a straight, Ten to Ace
Seat 5: hoholas22 (big blind) folded before Flop
Seat 6: yarik7879 showed [8c 9d] and lost with a straight, Seven to Jack


PokerStars Hand #238163007291:  Hold'em No Limit ($0.01/$0.02 USD) - 2022/08/23 4:18:37 ET
Table 'Achilles IV' 6-max Seat #5 is the button
Seat 2: Xtens ($2.54 in chips)
Seat 3: Fedorenko26 ($2 in chips)
Seat 4: yuyu767 ($2.70 in chips)
Seat 5: hoholas22 ($1.94 in chips)
Xtens: posts small blind $0.01
Fedorenko26: posts big blind $0.02
*** HOLE CARDS ***
yarik7879 leaves the table
yuyu767: folds
hoholas22: raises $0.04 to $0.06
Xtens: calls $0.05
Fedorenko26: folds
*** FLOP *** [Ks Kd 7d]
Xtens: checks
hoholas22: checks
*** TURN *** [Ks Kd 7d] [3s]
Xtens: checks
hoholas22: bets $0.07
Xtens: folds
Uncalled bet ($0.07) returned to hoholas22
hoholas22 collected $0.14 from pot
*** SUMMARY ***
Total pot $0.14 | Rake $0
Board [Ks Kd 7d 3s]
Seat 2: Xtens (small blind) folded on the Turn
Seat 3: Fedorenko26 (big blind) folded before Flop
Seat 4: yuyu767 folded before Flop (didn't bet)
Seat 5: hoholas22 (button) collected ($0.14)


PokerStars Hand #238163011686:  Hold'em No Limit ($0.01/$0.02 USD) - 2022/08/23 4:19:12 ET
Table 'Achilles IV' 6-max Seat #2 is the button
Seat 2: Xtens ($2.48 in chips)
Seat 3: Fedorenko26 ($2 in chips)
Seat 4: yuyu767 ($2.70 in chips)
Seat 5: hoholas22 ($2.02 in chips)
Fedorenko26: posts small blind $0.01
yuyu767: posts big blind $0.02
*** HOLE CARDS ***
hoholas22: raises $0.04 to $0.06
Xtens: folds
Fedorenko26: folds
yuyu767: calls $0.04
*** FLOP *** [6s Td 9h]
yuyu767: checks
hoholas22: bets $0.06
yuyu767: calls $0.06
*** TURN *** [6s Td 9h] [Jd]
yuyu767: checks
hoholas22: bets $0.12
yuyu767: raises $0.12 to $0.24
hoholas22: calls $0.12
*** RIVER *** [6s Td 9h Jd] [6h]
yuyu767: checks
hoholas22: bets $0.22
yuyu767: calls $0.22
*** SHOW DOWN ***
hoholas22: shows [Jh Ac] (two pair, Jacks and Sixes)
yuyu767: shows [Js As] (two pair, Jacks and Sixes)
yuyu767 collected $0.57 from pot
hoholas22 collected $0.56 from pot
*** SUMMARY ***
Total pot $1.17 | Rake $0.04
Board [6s Td 9h Jd 6h]
Seat 2: Xtens (button) folded before Flop (didn't bet)
Seat 3: Fedorenko26 (small blind) folded before Flop
Seat 4: yuyu767 (big blind) showed [Js As] and won ($0.57) with two pair, Jacks and Sixes
Seat 5: hoholas22 showed [Jh Ac] and won ($0.56) with two pair, Jacks and Sixes


PokerStars Hand #238163028399:  Hold'em No Limit ($0.01/$0.02 USD) - 2022/08/23 4:21:23 ET
Table 'Achilles IV' 6-max Seat #4 is the button
Seat 2: Xtens ($2.49 in chips)
Seat 3: Fedorenko26 ($2.01 in chips)
Seat 4: yuyu767 ($2.68 in chips)
Seat 5: hoholas22 ($1.98 in chips)
Seat 6: UncleArb1612 ($2 in chips)
hoholas22: posts small blind $0.01
UncleArb1612: posts big blind $0.02
Flix2204: sits out
*** HOLE CARDS ***
Xtens: folds
Fedorenko26: folds
yuyu767: folds
hoholas22: folds
Uncalled bet ($0.01) returned to UncleArb1612
UncleArb1612 collected $0.02 from pot
*** SUMMARY ***
Total pot $0.02 | Rake $0
Seat 2: Xtens folded before Flop (didn't bet)
Seat 3: Fedorenko26 folded before Flop (didn't bet)
Seat 4: yuyu767 (button) folded before Flop (didn't bet)
Seat 5: hoholas22 (small blind) folded before Flop
Seat 6: UncleArb1612 (big blind) collected ($0.02)


PokerStars Hand #238163020361:  Hold'em No Limit ($0.01/$0.02 USD) - 2022/08/23 4:20:20 ET
Table 'Achilles IV' 6-max Seat #3 is the button
Seat 2: Xtens ($2.48 in chips)
Seat 3: Fedorenko26 ($2 in chips)
Seat 4: yuyu767 ($2.69 in chips)
Seat 5: hoholas22 ($2 in chips)
yuyu767: posts small blind $0.01
hoholas22: posts big blind $0.02
*** HOLE CARDS ***
UncleArb1612 joins the table at seat #6
Xtens: raises $0.03 to $0.05
Fedorenko26: raises $0.13 to $0.18
yuyu767: folds
hoholas22: folds
Xtens: calls $0.13
*** FLOP *** [5s 5h 4h]
Xtens: checks
Fedorenko26: checks
*** TURN *** [5s 5h 4h] [9d]
Xtens: checks
Fedorenko26: checks
*** RIVER *** [5s 5h 4h 9d] [3c]
Xtens: checks
Fedorenko26: checks
*** SHOW DOWN ***
Xtens: shows [Ah Jh] (a pair of Fives)
Fedorenko26: shows [Jd Ad] (a pair of Fives)
Xtens collected $0.19 from pot
Fedorenko26 collected $0.19 from pot
*** SUMMARY ***
Total pot $0.39 | Rake $0.01
Board [5s 5h 4h 9d 3c]
Seat 2: Xtens showed [Ah Jh] and won ($0.19) with a pair of Fives
Seat 3: Fedorenko26 (button) showed [Jd Ad] and won ($0.19) with a pair of Fives
Seat 4: yuyu767 (small blind) folded before Flop
Seat 5: hoholas22 (big blind) folded before Flop


PokerStars Hand #238163029675:  Hold'em No Limit ($0.01/$0.02 USD) - 2022/08/23 4:21:33 ET
Table 'Achilles IV' 6-max Seat #5 is the button
Seat 1: Flix2204 ($2.19 in chips)
Seat 2: Xtens ($2.49 in chips)
Seat 3: Fedorenko26 ($2.01 in chips)
Seat 4: yuyu767 ($2.68 in chips)
Seat 5: hoholas22 ($1.97 in chips)
Seat 6: UncleArb1612 ($2.01 in chips)
UncleArb1612: posts small blind $0.01
Flix2204: posts big blind $0.02
*** HOLE CARDS ***
Xtens: folds
Fedorenko26: folds
yuyu767: folds
hoholas22: raises $0.04 to $0.06
UncleArb1612: folds
Flix2204: folds
Uncalled bet ($0.04) returned to hoholas22
hoholas22 collected $0.05 from pot
*** SUMMARY ***
Total pot $0.05 | Rake $0
Seat 1: Flix2204 (big blind) folded before Flop
Seat 2: Xtens folded before Flop (didn't bet)
Seat 3: Fedorenko26 folded before Flop (didn't bet)
Seat 4: yuyu767 folded before Flop (didn't bet)
Seat 5: hoholas22 (button) collected ($0.05)
Seat 6: UncleArb1612 (small blind) folded before Flop


PokerStars Hand #238163032729:  Hold'em No Limit ($0.01/$0.02 USD) - 2022/08/23 4:21:57 ET
Table 'Achilles IV' 6-max Seat #6 is the button
Seat 1: Flix2204 ($2.17 in chips)
Seat 2: Xtens ($2.49 in chips)
Seat 3: Fedorenko26 ($2.01 in chips)
Seat 4: yuyu767 ($2.68 in chips)
Seat 5: hoholas22 ($2 in chips)
Seat 6: UncleArb1612 ($2 in chips)
Flix2204: posts small blind $0.01
Xtens: posts big blind $0.02
*** HOLE CARDS ***
Fedorenko26: folds
yuyu767: raises $0.02 to $0.04
hoholas22: folds
UncleArb1612: folds
Flix2204: folds
Xtens: calls $0.02
*** FLOP *** [7h 7d 9h]
Xtens: checks
yuyu767: bets $0.06
Xtens: calls $0.06
*** TURN *** [7h 7d 9h] [6h]
Xtens: checks
yuyu767: checks
*** RIVER *** [7h 7d 9h 6h] [As]
Xtens: checks
yuyu767: checks
*** SHOW DOWN ***
Xtens: shows [Kc 9s] (two pair, Nines and Sevens)
yuyu767: mucks hand
Xtens collected $0.20 from pot
*** SUMMARY ***
Total pot $0.21 | Rake $0.01
Board [7h 7d 9h 6h As]
Seat 1: Flix2204 (small blind) folded before Flop
Seat 2: Xtens (big blind) showed [Kc 9s] and won ($0.20) with two pair, Nines and Sevens
Seat 3: Fedorenko26 folded before Flop (didn't bet)
Seat 4: yuyu767 mucked
Seat 5: hoholas22 folded before Flop (didn't bet)
Seat 6: UncleArb1612 (button) folded before Flop (didn't bet)


PokerStars Hand #238163038690:  Hold'em No Limit ($0.01/$0.02 USD) - 2022/08/23 4:22:44 ET
Table 'Achilles IV' 6-max Seat #1 is the button
Seat 1: Flix2204 ($2.16 in chips)
Seat 2: Xtens ($2.59 in chips)
Seat 3: Fedorenko26 ($2.01 in chips)
Seat 4: yuyu767 ($2.58 in chips)
Seat 5: hoholas22 ($2 in chips)
Seat 6: UncleArb1612 ($2 in chips)
Xtens: posts small blind $0.01
Fedorenko26: posts big blind $0.02
*** HOLE CARDS ***
yuyu767: folds
hoholas22: folds
UncleArb1612: calls $0.02
Flix2204: folds
Xtens: folds
Fedorenko26: checks
*** FLOP *** [Kc 3c As]
Fedorenko26: bets $0.04
UncleArb1612: folds
Uncalled bet ($0.04) returned to Fedorenko26
Fedorenko26 collected $0.05 from pot
*** SUMMARY ***
Total pot $0.05 | Rake $0
Board [Kc 3c As]
Seat 1: Flix2204 (button) folded before Flop (didn't bet)
Seat 2: Xtens (small blind) folded before Flop
Seat 3: Fedorenko26 (big blind) collected ($0.05)
Seat 4: yuyu767 folded before Flop (didn't bet)
Seat 5: hoholas22 folded before Flop (didn't bet)
Seat 6: UncleArb1612 folded on the Flop


PokerStars Hand #238163043005:  Hold'em No Limit ($0.01/$0.02 USD) - 2022/08/23 4:23:17 ET
Table 'Achilles IV' 6-max Seat #2 is the button
Seat 1: Flix2204 ($2.16 in chips)
Seat 2: Xtens ($2.58 in chips)
Seat 3: Fedorenko26 ($2.04 in chips)
Seat 4: yuyu767 ($2.58 in chips)
Seat 5: hoholas22 ($2 in chips)
Seat 6: UncleArb1612 ($1.98 in chips)
Fedorenko26: posts small blind $0.01
yuyu767: posts big blind $0.02
*** HOLE CARDS ***
hoholas22: raises $0.04 to $0.06
UncleArb1612: folds
Flix2204: folds
Xtens: folds
Fedorenko26: folds
yuyu767: calls $0.04
*** FLOP *** [3c Qc 4h]
yuyu767: checks
hoholas22: bets $0.06
yuyu767: raises $0.13 to $0.19
hoholas22: folds
Uncalled bet ($0.13) returned to yuyu767
yuyu767 collected $0.24 from pot
*** SUMMARY ***
Total pot $0.25 | Rake $0.01
Board [3c Qc 4h]
Seat 1: Flix2204 folded before Flop (didn't bet)
Seat 2: Xtens (button) folded before Flop (didn't bet)
Seat 3: Fedorenko26 (small blind) folded before Flop
Seat 4: yuyu767 (big blind) collected ($0.24)
Seat 5: hoholas22 folded on the Flop
Seat 6: UncleArb1612 folded before Flop (didn't bet)


PokerStars Hand #238163051527:  Hold'em No Limit ($0.01/$0.02 USD) - 2022/08/23 4:24:22 ET
Table 'Achilles IV' 6-max Seat #3 is the button
Seat 1: Flix2204 ($2.16 in chips)
Seat 2: Xtens ($2.58 in chips)
Seat 3: Fedorenko26 ($2.03 in chips)
Seat 4: yuyu767 ($2.70 in chips)
Seat 5: hoholas22 ($1.88 in chips)
Seat 6: UncleArb1612 ($1.98 in chips)
yuyu767: posts small blind $0.01
hoholas22: posts big blind $0.02
*** HOLE CARDS ***
UncleArb1612: raises $0.02 to $0.04
Flix2204: folds
Xtens: folds
Fedorenko26: folds
yuyu767: folds
hoholas22: folds
Uncalled bet ($0.02) returned to UncleArb1612
UncleArb1612 collected $0.05 from pot
*** SUMMARY ***
Total pot $0.05 | Rake $0
Seat 1: Flix2204 folded before Flop (didn't bet)
Seat 2: Xtens folded before Flop (didn't bet)
Seat 3: Fedorenko26 (button) folded before Flop (didn't bet)
Seat 4: yuyu767 (small blind) folded before Flop
Seat 5: hoholas22 (big blind) folded before Flop
Seat 6: UncleArb1612 collected ($0.05)


PokerStars Hand #238163053039:  Hold'em No Limit ($0.01/$0.02 USD) - 2022/08/23 4:24:34 ET
Table 'Achilles IV' 6-max Seat #4 is the button
Seat 1: Flix2204 ($2.16 in chips)
Seat 2: Xtens ($2.58 in chips)
Seat 3: Fedorenko26 ($2.03 in chips)
Seat 4: yuyu767 ($2.69 in chips)
Seat 5: hoholas22 ($1.86 in chips)
Seat 6: UncleArb1612 ($2.01 in chips)
hoholas22: posts small blind $0.01
UncleArb1612: posts big blind $0.02
*** HOLE CARDS ***
Flix2204: folds
Xtens: folds
Fedorenko26: folds
yuyu767: folds
hoholas22: raises $0.04 to $0.06
UncleArb1612: calls $0.04
*** FLOP *** [Td 8h Jd]
hoholas22: checks
UncleArb1612: bets $0.06
hoholas22: folds
Uncalled bet ($0.06) returned to UncleArb1612
UncleArb1612 collected $0.12 from pot
*** SUMMARY ***
Total pot $0.12 | Rake $0
Board [Td 8h Jd]
Seat 1: Flix2204 folded before Flop (didn't bet)
Seat 2: Xtens folded before Flop (didn't bet)
Seat 3: Fedorenko26 folded before Flop (didn't bet)
Seat 4: yuyu767 (button) folded before Flop (didn't bet)
Seat 5: hoholas22 (small blind) folded on the Flop
Seat 6: UncleArb1612 (big blind) collected ($0.12)


PokerStars Hand #238163056727:  Hold'em No Limit ($0.01/$0.02 USD) - 2022/08/23 4:25:03 ET
Table 'Achilles IV' 6-max Seat #5 is the button
Seat 1: Flix2204 ($2.16 in chips)
Seat 2: Xtens ($2.58 in chips)
Seat 3: Fedorenko26 ($2.03 in chips)
Seat 4: yuyu767 ($2.69 in chips)
Seat 5: hoholas22 ($1.80 in chips)
Seat 6: UncleArb1612 ($2.07 in chips)
UncleArb1612: posts small blind $0.01
Flix2204: posts big blind $0.02
*** HOLE CARDS ***
Xtens: folds
Fedorenko26: raises $0.04 to $0.06
yuyu767: folds
hoholas22: folds
UncleArb1612: folds
Flix2204: folds
Uncalled bet ($0.04) returned to Fedorenko26
Fedorenko26 collected $0.05 from pot
*** SUMMARY ***
Total pot $0.05 | Rake $0
Seat 1: Flix2204 (big blind) folded before Flop
Seat 2: Xtens folded before Flop (didn't bet)
Seat 3: Fedorenko26 collected ($0.05)
Seat 4: yuyu767 folded before Flop (didn't bet)
Seat 5: hoholas22 (button) folded before Flop (didn't bet)
Seat 6: UncleArb1612 (small blind) folded before Flop


PokerStars Hand #238163058971:  Hold'em No Limit ($0.01/$0.02 USD) - 2022/08/23 4:25:20 ET
Table 'Achilles IV' 6-max Seat #6 is the button
Seat 1: Flix2204 ($2.14 in chips)
Seat 2: Xtens ($2.58 in chips)
Seat 3: Fedorenko26 ($2.06 in chips)
Seat 4: yuyu767 ($2.69 in chips)
Seat 5: hoholas22 ($1.80 in chips)
Seat 6: UncleArb1612 ($2.06 in chips)
Flix2204: posts small blind $0.01
Xtens: posts big blind $0.02
*** HOLE CARDS ***
Fedorenko26: folds
yuyu767: folds
hoholas22: folds
UncleArb1612: folds
Flix2204: folds
Uncalled bet ($0.01) returned to Xtens
Xtens collected $0.02 from pot
Xtens: doesn't show hand
*** SUMMARY ***
Total pot $0.02 | Rake $0
Seat 1: Flix2204 (small blind) folded before Flop
Seat 2: Xtens (big blind) collected ($0.02)
Seat 3: Fedorenko26 folded before Flop (didn't bet)
Seat 4: yuyu767 folded before Flop (didn't bet)
Seat 5: hoholas22 folded before Flop (didn't bet)
Seat 6: UncleArb1612 (button) folded before Flop (didn't bet)


PokerStars Hand #238163060280:  Hold'em No Limit ($0.01/$0.02 USD) - 2022/08/23 4:25:30 ET
Table 'Achilles IV' 6-max Seat #1 is the button
Seat 1: Flix2204 ($2.13 in chips)
Seat 2: Xtens ($2.59 in chips)
Seat 3: Fedorenko26 ($2.06 in chips)
Seat 4: yuyu767 ($2.69 in chips)
Seat 5: hoholas22 ($1.80 in chips)
Seat 6: UncleArb1612 ($2.06 in chips)
Xtens: posts small blind $0.01
Fedorenko26: posts big blind $0.02
*** HOLE CARDS ***
yuyu767: folds
hoholas22: folds
UncleArb1612: calls $0.02
Flix2204: raises $0.06 to $0.08
Xtens: calls $0.07
Fedorenko26: folds
UncleArb1612: calls $0.06
*** FLOP *** [2c 3d Kh]
Xtens: checks
UncleArb1612: checks
Flix2204: checks
*** TURN *** [2c 3d Kh] [Tc]
Xtens: checks
UncleArb1612: bets $0.12
Flix2204: calls $0.12
Xtens: folds
*** RIVER *** [2c 3d Kh Tc] [7c]
UncleArb1612: checks
Flix2204: bets $0.32
UncleArb1612: folds
Uncalled bet ($0.32) returned to Flix2204
Flix2204 collected $0.48 from pot
Flix2204: doesn't show hand
*** SUMMARY ***
Total pot $0.50 | Rake $0.02
Board [2c 3d Kh Tc 7c]
Seat 1: Flix2204 (button) collected ($0.48)
Seat 2: Xtens (small blind) folded on the Turn
Seat 3: Fedorenko26 (big blind) folded before Flop
Seat 4: yuyu767 folded before Flop (didn't bet)
Seat 5: hoholas22 folded before Flop (didn't bet)
Seat 6: UncleArb1612 folded on the River


PokerStars Hand #238163069910:  Hold'em No Limit ($0.01/$0.02 USD) - 2022/08/23 4:26:46 ET
Table 'Achilles IV' 6-max Seat #2 is the button
Seat 1: Flix2204 ($2.41 in chips)
Seat 2: Xtens ($2.51 in chips)
Seat 3: Fedorenko26 ($2.04 in chips)
Seat 4: yuyu767 ($2.69 in chips)
Seat 5: hoholas22 ($1.80 in chips)
Seat 6: UncleArb1612 ($1.86 in chips)
Fedorenko26: posts small blind $0.01
yuyu767: posts big blind $0.02
*** HOLE CARDS ***
hoholas22: folds
UncleArb1612: folds
Flix2204: folds
Xtens: raises $0.03 to $0.05
UncleArb1612 leaves the table
Fedorenko26: folds
yuyu767: folds
Uncalled bet ($0.03) returned to Xtens
Xtens collected $0.05 from pot
Xtens: doesn't show hand
*** SUMMARY ***
Total pot $0.05 | Rake $0
Seat 1: Flix2204 folded before Flop (didn't bet)
Seat 2: Xtens (button) collected ($0.05)
Seat 3: Fedorenko26 (small blind) folded before Flop
Seat 4: yuyu767 (big blind) folded before Flop
Seat 5: hoholas22 folded before Flop (didn't bet)
Seat 6: UncleArb1612 folded before Flop (didn't bet)


PokerStars Hand #238163072187:  Hold'em No Limit ($0.01/$0.02 USD) - 2022/08/23 4:27:04 ET
Table 'Achilles IV' 6-max Seat #3 is the button
Seat 1: Flix2204 ($2.41 in chips)
Seat 2: Xtens ($2.54 in chips)
Seat 3: Fedorenko26 ($2.03 in chips)
Seat 4: yuyu767 ($2.67 in chips)
Seat 5: hoholas22 ($1.80 in chips)
yuyu767: posts small blind $0.01
hoholas22: posts big blind $0.02
*** HOLE CARDS ***
Daklien_Poke joins the table at seat #6
Flix2204: folds
Xtens: folds
Fedorenko26: raises $0.03 to $0.05
yuyu767: folds
hoholas22: folds
Uncalled bet ($0.03) returned to Fedorenko26
Fedorenko26 collected $0.05 from pot
*** SUMMARY ***
Total pot $0.05 | Rake $0
Seat 1: Flix2204 folded before Flop (didn't bet)
Seat 2: Xtens folded before Flop (didn't bet)
Seat 3: Fedorenko26 (button) collected ($0.05)
Seat 4: yuyu767 (small blind) folded before Flop
Seat 5: hoholas22 (big blind) folded before Flop


PokerStars Hand #238163080106:  Hold'em No Limit ($0.01/$0.02 USD) - 2022/08/23 4:27:19 ET
Table 'Achilles IV' 6-max Seat #4 is the button
Seat 1: Flix2204 ($2.41 in chips)
Seat 2: Xtens ($2.54 in chips)
Seat 3: Fedorenko26 ($2.06 in chips)
Seat 4: yuyu767 ($2.66 in chips)
Seat 5: hoholas22 ($1.78 in chips)
Seat 6: Daklien_Poke ($2 in chips)
hoholas22: posts small blind $0.01
Daklien_Poke: posts big blind $0.02
*** HOLE CARDS ***
Flix2204: folds
Xtens: folds
Fedorenko26: raises $0.04 to $0.06
yuyu767: calls $0.06
hoholas22: folds
Daklien_Poke: calls $0.04
*** FLOP *** [9d Td Ac]
Daklien_Poke: checks
Fedorenko26: bets $0.14
yuyu767: folds
Daklien_Poke: folds
Uncalled bet ($0.14) returned to Fedorenko26
Fedorenko26 collected $0.18 from pot
*** SUMMARY ***
Total pot $0.19 | Rake $0.01
Board [9d Td Ac]
Seat 1: Flix2204 folded before Flop (didn't bet)
Seat 2: Xtens folded before Flop (didn't bet)
Seat 3: Fedorenko26 collected ($0.18)
Seat 4: yuyu767 (button) folded on the Flop
Seat 5: hoholas22 (small blind) folded before Flop
Seat 6: Daklien_Poke (big blind) folded on the Flop


PokerStars Hand #238163084096:  Hold'em No Limit ($0.01/$0.02 USD) - 2022/08/23 4:27:50 ET
Table 'Achilles IV' 6-max Seat #5 is the button
Seat 1: Flix2204 ($2.41 in chips)
Seat 2: Xtens ($2.54 in chips)
Seat 3: Fedorenko26 ($2.18 in chips)
Seat 4: yuyu767 ($2.60 in chips)
Seat 5: hoholas22 ($1.77 in chips)
Seat 6: Daklien_Poke ($1.94 in chips)
Daklien_Poke: posts small blind $0.01
Flix2204: posts big blind $0.02
*** HOLE CARDS ***
Xtens: folds
Fedorenko26: raises $0.04 to $0.06
yuyu767: folds
hoholas22: folds
Daklien_Poke: calls $0.05
Flix2204: folds
*** FLOP *** [Ad Qc 4h]
Daklien_Poke: checks
Fedorenko26: bets $0.07
Daklien_Poke: calls $0.07
*** TURN *** [Ad Qc 4h] [Jd]
Daklien_Poke: checks
Fedorenko26: checks
*** RIVER *** [Ad Qc 4h Jd] [5h]
Daklien_Poke: checks
Fedorenko26: checks
*** SHOW DOWN ***
Daklien_Poke: shows [9c 9d] (a pair of Nines)
Fedorenko26: mucks hand
Daklien_Poke collected $0.27 from pot
*** SUMMARY ***
Total pot $0.28 | Rake $0.01
Board [Ad Qc 4h Jd 5h]
Seat 1: Flix2204 (big blind) folded before Flop
Seat 2: Xtens folded before Flop (didn't bet)
Seat 3: Fedorenko26 mucked
Seat 4: yuyu767 folded before Flop (didn't bet)
Seat 5: hoholas22 (button) folded before Flop (didn't bet)
Seat 6: Daklien_Poke (small blind) showed [9c 9d] and won ($0.27) with a pair of Nines


PokerStars Hand #238163089631:  Hold'em No Limit ($0.01/$0.02 USD) - 2022/08/23 4:28:33 ET
Table 'Achilles IV' 6-max Seat #6 is the button
Seat 1: Flix2204 ($2.39 in chips)
Seat 2: Xtens ($2.54 in chips)
Seat 3: Fedorenko26 ($2.05 in chips)
Seat 4: yuyu767 ($2.60 in chips)
Seat 5: hoholas22 ($1.77 in chips)
Seat 6: Daklien_Poke ($2.08 in chips)
Flix2204: posts small blind $0.01
Xtens: posts big blind $0.02
*** HOLE CARDS ***
Fedorenko26: folds
yuyu767: raises $0.02 to $0.04
hoholas22: folds
Daklien_Poke: folds
Flix2204: folds
Xtens: folds
Uncalled bet ($0.02) returned to yuyu767
yuyu767 collected $0.05 from pot
*** SUMMARY ***
Total pot $0.05 | Rake $0
Seat 1: Flix2204 (small blind) folded before Flop
Seat 2: Xtens (big blind) folded before Flop
Seat 3: Fedorenko26 folded before Flop (didn't bet)
Seat 4: yuyu767 collected ($0.05)
Seat 5: hoholas22 folded before Flop (didn't bet)
Seat 6: Daklien_Poke (button) folded before Flop (didn't bet)


PokerStars Hand #238163091778:  Hold'em No Limit ($0.01/$0.02 USD) - 2022/08/23 4:28:49 ET
Table 'Achilles IV' 6-max Seat #1 is the button
Seat 1: Flix2204 ($2.38 in chips)
Seat 2: Xtens ($2.52 in chips)
Seat 3: Fedorenko26 ($2.05 in chips)
Seat 4: yuyu767 ($2.63 in chips)
Seat 5: hoholas22 ($1.77 in chips)
Seat 6: Daklien_Poke ($2.08 in chips)
Xtens: posts small blind $0.01
Fedorenko26: posts big blind $0.02
*** HOLE CARDS ***
yuyu767: folds
hoholas22: folds
Daklien_Poke: folds
Flix2204: raises $0.03 to $0.05
Xtens: folds
Fedorenko26: folds
Uncalled bet ($0.03) returned to Flix2204
Flix2204 collected $0.05 from pot
Flix2204: doesn't show hand
*** SUMMARY ***
Total pot $0.05 | Rake $0
Seat 1: Flix2204 (button) collected ($0.05)
Seat 2: Xtens (small blind) folded before Flop
Seat 3: Fedorenko26 (big blind) folded before Flop
Seat 4: yuyu767 folded before Flop (didn't bet)
Seat 5: hoholas22 folded before Flop (didn't bet)
Seat 6: Daklien_Poke folded before Flop (didn't bet)


PokerStars Hand #238163093101:  Hold'em No Limit ($0.01/$0.02 USD) - 2022/08/23 4:28:59 ET
Table 'Achilles IV' 6-max Seat #2 is the button
Seat 1: Flix2204 ($2.41 in chips)
Seat 2: Xtens ($2.51 in chips)
Seat 3: Fedorenko26 ($2.03 in chips)
Seat 4: yuyu767 ($2.63 in chips)
Seat 5: hoholas22 ($1.77 in chips)
Seat 6: Daklien_Poke ($2.08 in chips)
Fedorenko26: posts small blind $0.01
yuyu767: posts big blind $0.02
*** HOLE CARDS ***
hoholas22: folds
Daklien_Poke: folds
Flix2204: folds
Xtens: folds
Fedorenko26: folds
Uncalled bet ($0.01) returned to yuyu767
yuyu767 collected $0.02 from pot
*** SUMMARY ***
Total pot $0.02 | Rake $0
Seat 1: Flix2204 folded before Flop (didn't bet)
Seat 2: Xtens (button) folded before Flop (didn't bet)
Seat 3: Fedorenko26 (small blind) folded before Flop
Seat 4: yuyu767 (big blind) collected ($0.02)
Seat 5: hoholas22 folded before Flop (didn't bet)
Seat 6: Daklien_Poke folded before Flop (didn't bet)


PokerStars Hand #238163095309:  Hold'em No Limit ($0.01/$0.02 USD) - 2022/08/23 4:29:16 ET
Table 'Achilles IV' 6-max Seat #3 is the button
Seat 1: Flix2204 ($2.41 in chips)
Seat 2: Xtens ($2.51 in chips)
Seat 3: Fedorenko26 ($2.02 in chips)
Seat 4: yuyu767 ($2.64 in chips)
Seat 5: hoholas22 ($1.77 in chips)
Seat 6: Daklien_Poke ($2.08 in chips)
yuyu767: posts small blind $0.01
hoholas22: posts big blind $0.02
*** HOLE CARDS ***
Daklien_Poke: folds
Flix2204: raises $0.04 to $0.06
Xtens: folds
Fedorenko26: folds
yuyu767: folds
hoholas22: folds
Uncalled bet ($0.04) returned to Flix2204
Flix2204 collected $0.05 from pot
Flix2204: doesn't show hand
*** SUMMARY ***
Total pot $0.05 | Rake $0
Seat 1: Flix2204 collected ($0.05)
Seat 2: Xtens folded before Flop (didn't bet)
Seat 3: Fedorenko26 (button) folded before Flop (didn't bet)
Seat 4: yuyu767 (small blind) folded before Flop
Seat 5: hoholas22 (big blind) folded before Flop
Seat 6: Daklien_Poke folded before Flop (didn't bet)


PokerStars Hand #238163097905:  Hold'em No Limit ($0.01/$0.02 USD) - 2022/08/23 4:29:36 ET
Table 'Achilles IV' 6-max Seat #4 is the button
Seat 1: Flix2204 ($2.44 in chips)
Seat 2: Xtens ($2.51 in chips)
Seat 3: Fedorenko26 ($2.02 in chips)
Seat 4: yuyu767 ($2.63 in chips)
Seat 5: hoholas22 ($1.75 in chips)
Seat 6: Daklien_Poke ($2.08 in chips)
hoholas22: posts small blind $0.01
Daklien_Poke: posts big blind $0.02
*** HOLE CARDS ***
Flix2204: folds
Xtens: folds
Fedorenko26: folds
yuyu767: folds
hoholas22: folds
Uncalled bet ($0.01) returned to Daklien_Poke
Daklien_Poke collected $0.02 from pot
Daklien_Poke: doesn't show hand
*** SUMMARY ***
Total pot $0.02 | Rake $0
Seat 1: Flix2204 folded before Flop (didn't bet)
Seat 2: Xtens folded before Flop (didn't bet)
Seat 3: Fedorenko26 folded before Flop (didn't bet)
Seat 4: yuyu767 (button) folded before Flop (didn't bet)
Seat 5: hoholas22 (small blind) folded before Flop
Seat 6: Daklien_Poke (big blind) collected ($0.02)


PokerStars Hand #238163099685:  Hold'em No Limit ($0.01/$0.02 USD) - 2022/08/23 4:29:49 ET
Table 'Achilles IV' 6-max Seat #5 is the button
Seat 1: Flix2204 ($2.44 in chips)
Seat 2: Xtens ($2.51 in chips)
Seat 3: Fedorenko26 ($2.02 in chips)
Seat 4: yuyu767 ($2.63 in chips)
Seat 5: hoholas22 ($1.74 in chips)
Seat 6: Daklien_Poke ($2.09 in chips)
Daklien_Poke: posts small blind $0.01
Flix2204: posts big blind $0.02
*** HOLE CARDS ***
Xtens: folds
Fedorenko26: raises $0.04 to $0.06
yuyu767: folds
hoholas22: folds
Daklien_Poke: raises $0.16 to $0.22
Flix2204: folds
Fedorenko26: folds
Uncalled bet ($0.16) returned to Daklien_Poke
Daklien_Poke collected $0.14 from pot
Daklien_Poke: doesn't show hand
*** SUMMARY ***
Total pot $0.14 | Rake $0
Seat 1: Flix2204 (big blind) folded before Flop
Seat 2: Xtens folded before Flop (didn't bet)
Seat 3: Fedorenko26 folded before Flop
Seat 4: yuyu767 folded before Flop (didn't bet)
Seat 5: hoholas22 (button) folded before Flop (didn't bet)
Seat 6: Daklien_Poke (small blind) collected ($0.14)


PokerStars Hand #238163103959:  Hold'em No Limit ($0.01/$0.02 USD) - 2022/08/23 4:30:22 ET
Table 'Achilles IV' 6-max Seat #6 is the button
Seat 1: Flix2204 ($2.42 in chips)
Seat 2: Xtens ($2.51 in chips)
Seat 3: Fedorenko26 ($2 in chips)
Seat 4: yuyu767 ($2.63 in chips)
Seat 5: hoholas22 ($1.74 in chips)
Seat 6: Daklien_Poke ($2.17 in chips)
Flix2204: posts small blind $0.01
Xtens: posts big blind $0.02
*** HOLE CARDS ***
Fedorenko26: folds
yuyu767: folds
hoholas22: folds
Daklien_Poke: folds
Flix2204: folds
Uncalled bet ($0.01) returned to Xtens
Xtens collected $0.02 from pot
Xtens: doesn't show hand
*** SUMMARY ***
Total pot $0.02 | Rake $0
Seat 1: Flix2204 (small blind) folded before Flop
Seat 2: Xtens (big blind) collected ($0.02)
Seat 3: Fedorenko26 folded before Flop (didn't bet)
Seat 4: yuyu767 folded before Flop (didn't bet)
Seat 5: hoholas22 folded before Flop (didn't bet)
Seat 6: Daklien_Poke (button) folded before Flop (didn't bet)


PokerStars Hand #238163105229:  Hold'em No Limit ($0.01/$0.02 USD) - 2022/08/23 4:30:32 ET
Table 'Achilles IV' 6-max Seat #1 is the button
Seat 1: Flix2204 ($2.41 in chips)
Seat 2: Xtens ($2.52 in chips)
Seat 4: yuyu767 ($2.63 in chips)
Seat 5: hoholas22 ($1.74 in chips)
Seat 6: Daklien_Poke ($2.17 in chips)
Xtens: posts small blind $0.01
Fedorenko26: is sitting out
yuyu767: posts big blind $0.02
*** HOLE CARDS ***
Fedorenko26 leaves the table
hoholas22: folds
Daklien_Poke: folds
Flix2204: raises $0.03 to $0.05
Xtens: folds
yuyu767: calls $0.03
*** FLOP *** [3h Jh Qc]
Fran1809 joins the table at seat #3
yuyu767: checks
Flix2204: bets $0.07
yuyu767: calls $0.07
*** TURN *** [3h Jh Qc] [4d]
yuyu767: checks
Flix2204: checks
*** RIVER *** [3h Jh Qc 4d] [6c]
yuyu767: bets $0.14
Flix2204: folds
Uncalled bet ($0.14) returned to yuyu767
yuyu767 collected $0.24 from pot
*** SUMMARY ***
Total pot $0.25 | Rake $0.01
Board [3h Jh Qc 4d 6c]
Seat 1: Flix2204 (button) folded on the River
Seat 2: Xtens (small blind) folded before Flop
Seat 4: yuyu767 (big blind) collected ($0.24)
Seat 5: hoholas22 folded before Flop (didn't bet)
Seat 6: Daklien_Poke folded before Flop (didn't bet)


PokerStars Hand #238163112901:  Hold'em No Limit ($0.01/$0.02 USD) - 2022/08/23 4:31:32 ET
Table 'Achilles IV' 6-max Seat #4 is the button
Seat 1: Flix2204 ($2.29 in chips)
Seat 2: Xtens ($2.54 in chips)
Seat 4: yuyu767 ($2.74 in chips)
Seat 5: hoholas22 ($1.72 in chips)
Seat 6: Daklien_Poke ($2.17 in chips)
hoholas22: posts small blind $0.01
Daklien_Poke: posts big blind $0.02
Fran1809: sits out
*** HOLE CARDS ***
Flix2204: raises $0.04 to $0.06
Xtens: folds
yuyu767: folds
hoholas22: folds
Daklien_Poke: folds
Uncalled bet ($0.04) returned to Flix2204
Flix2204 collected $0.05 from pot
Flix2204: doesn't show hand
*** SUMMARY ***
Total pot $0.05 | Rake $0
Seat 1: Flix2204 collected ($0.05)
Seat 2: Xtens folded before Flop (didn't bet)
Seat 4: yuyu767 (button) folded before Flop (didn't bet)
Seat 5: hoholas22 (small blind) folded before Flop
Seat 6: Daklien_Poke (big blind) folded before Flop


PokerStars Hand #238163111494:  Hold'em No Limit ($0.01/$0.02 USD) - 2022/08/23 4:31:21 ET
Table 'Achilles IV' 6-max Seat #2 is the button
Seat 1: Flix2204 ($2.29 in chips)
Seat 2: Xtens ($2.51 in chips)
Seat 4: yuyu767 ($2.75 in chips)
Seat 5: hoholas22 ($1.74 in chips)
Seat 6: Daklien_Poke ($2.17 in chips)
yuyu767: posts small blind $0.01
hoholas22: posts big blind $0.02
*** HOLE CARDS ***
Daklien_Poke: folds
Flix2204: folds
Xtens: raises $0.03 to $0.05
yuyu767: folds
hoholas22: folds
Uncalled bet ($0.03) returned to Xtens
Xtens collected $0.05 from pot
Xtens: doesn't show hand
*** SUMMARY ***
Total pot $0.05 | Rake $0
Seat 1: Flix2204 folded before Flop (didn't bet)
Seat 2: Xtens (button) collected ($0.05)
Seat 4: yuyu767 (small blind) folded before Flop
Seat 5: hoholas22 (big blind) folded before Flop
Seat 6: Daklien_Poke folded before Flop (didn't bet)


PokerStars Hand #238163114219:  Hold'em No Limit ($0.01/$0.02 USD) - 2022/08/23 4:31:43 ET
Table 'Achilles IV' 6-max Seat #5 is the button
Seat 1: Flix2204 ($2.32 in chips)
Seat 2: Xtens ($2.54 in chips)
Seat 4: yuyu767 ($2.74 in chips)
Seat 5: hoholas22 ($1.71 in chips)
Seat 6: Daklien_Poke ($2.15 in chips)
Daklien_Poke: posts small blind $0.01
Flix2204: posts big blind $0.02
Fran1809: sits out
*** HOLE CARDS ***
Xtens: folds
yuyu767: folds
hoholas22: folds
Daklien_Poke: folds
Uncalled bet ($0.01) returned to Flix2204
Flix2204 collected $0.02 from pot
Flix2204: doesn't show hand
*** SUMMARY ***
Total pot $0.02 | Rake $0
Seat 1: Flix2204 (big blind) collected ($0.02)
Seat 2: Xtens folded before Flop (didn't bet)
Seat 4: yuyu767 folded before Flop (didn't bet)
Seat 5: hoholas22 (button) folded before Flop (didn't bet)
Seat 6: Daklien_Poke (small blind) folded before Flop


PokerStars Hand #238163115667:  Hold'em No Limit ($0.01/$0.02 USD) - 2022/08/23 4:31:54 ET
Table 'Achilles IV' 6-max Seat #6 is the button
Seat 1: Flix2204 ($2.33 in chips)
Seat 2: Xtens ($2.54 in chips)
Seat 4: yuyu767 ($2.74 in chips)
Seat 5: hoholas22 ($1.71 in chips)
Seat 6: Daklien_Poke ($2.14 in chips)
Flix2204: posts small blind $0.01
Xtens: posts big blind $0.02
Fran1809: sits out
*** HOLE CARDS ***
yuyu767: folds
hoholas22: raises $0.04 to $0.06
Daklien_Poke: folds
Flix2204: folds
Xtens: folds
Uncalled bet ($0.04) returned to hoholas22
hoholas22 collected $0.05 from pot
*** SUMMARY ***
Total pot $0.05 | Rake $0
Seat 1: Flix2204 (small blind) folded before Flop
Seat 2: Xtens (big blind) folded before Flop
Seat 4: yuyu767 folded before Flop (didn't bet)
Seat 5: hoholas22 collected ($0.05)
Seat 6: Daklien_Poke (button) folded before Flop (didn't bet)


PokerStars Hand #238163117732:  Hold'em No Limit ($0.01/$0.02 USD) - 2022/08/23 4:32:10 ET
Table 'Achilles IV' 6-max Seat #1 is the button
Seat 1: Flix2204 ($2.32 in chips)
Seat 2: Xtens ($2.52 in chips)
Seat 3: Fran1809 ($1.60 in chips)
Seat 4: yuyu767 ($2.74 in chips)
Seat 5: hoholas22 ($1.74 in chips)
Seat 6: Daklien_Poke ($2.14 in chips)
Xtens: posts small blind $0.01
Fran1809: posts big blind $0.02
*** HOLE CARDS ***
yuyu767: folds
hoholas22: folds
Daklien_Poke: folds
Flix2204: folds
Xtens: folds
Uncalled bet ($0.01) returned to Fran1809
Fran1809 collected $0.02 from pot
*** SUMMARY ***
Total pot $0.02 | Rake $0
Seat 1: Flix2204 (button) folded before Flop (didn't bet)
Seat 2: Xtens (small blind) folded before Flop
Seat 3: Fran1809 (big blind) collected ($0.02)
Seat 4: yuyu767 folded before Flop (didn't bet)
Seat 5: hoholas22 folded before Flop (didn't bet)
Seat 6: Daklien_Poke folded before Flop (didn't bet)


PokerStars Hand #238163121509:  Hold'em No Limit ($0.01/$0.02 USD) - 2022/08/23 4:32:40 ET
Table 'Achilles IV' 6-max Seat #2 is the button
Seat 1: Flix2204 ($2.32 in chips)
Seat 2: Xtens ($2.51 in chips)
Seat 3: Fran1809 ($1.61 in chips)
Seat 4: yuyu767 ($2.74 in chips)
Seat 5: hoholas22 ($1.74 in chips)
Seat 6: Daklien_Poke ($2.14 in chips)
Fran1809: posts small blind $0.01
yuyu767: posts big blind $0.02
*** HOLE CARDS ***
hoholas22: raises $0.04 to $0.06
Daklien_Poke: folds
Flix2204: calls $0.06
Xtens: folds
Fran1809: folds
yuyu767: raises $0.14 to $0.20
hoholas22: folds
Flix2204: calls $0.14
*** FLOP *** [Jc 5s Kh]
yuyu767: bets $0.22
Flix2204: calls $0.22
*** TURN *** [Jc 5s Kh] [Th]
yuyu767: bets $0.88
Flix2204: folds
Uncalled bet ($0.88) returned to yuyu767
yuyu767 collected $0.88 from pot
*** SUMMARY ***
Total pot $0.91 | Rake $0.03
Board [Jc 5s Kh Th]
Seat 1: Flix2204 folded on the Turn
Seat 2: Xtens (button) folded before Flop (didn't bet)
Seat 3: Fran1809 (small blind) folded before Flop
Seat 4: yuyu767 (big blind) collected ($0.88)
Seat 5: hoholas22 folded before Flop
Seat 6: Daklien_Poke folded before Flop (didn't bet)


PokerStars Hand #238163132062:  Hold'em No Limit ($0.01/$0.02 USD) - 2022/08/23 4:34:03 ET
Table 'Achilles IV' 6-max Seat #3 is the button
Seat 1: Flix2204 ($2 in chips)
Seat 2: Xtens ($2.51 in chips)
Seat 3: Fran1809 ($1.60 in chips)
Seat 4: yuyu767 ($3.20 in chips)
Seat 5: hoholas22 ($1.68 in chips)
Seat 6: Daklien_Poke ($2.14 in chips)
yuyu767: posts small blind $0.01
hoholas22: posts big blind $0.02
*** HOLE CARDS ***
Daklien_Poke: folds
Flix2204: folds
Xtens: folds
Fran1809: calls $0.02
yuyu767: folds
hoholas22: checks
*** FLOP *** [8h Jc 7h]
hoholas22: checks
Fran1809: checks
*** TURN *** [8h Jc 7h] [2d]
hoholas22: checks
Fran1809: checks
*** RIVER *** [8h Jc 7h 2d] [8c]
hoholas22: checks
Fran1809: bets $0.05
hoholas22: folds
Uncalled bet ($0.05) returned to Fran1809
Fran1809 collected $0.05 from pot
*** SUMMARY ***
Total pot $0.05 | Rake $0
Board [8h Jc 7h 2d 8c]
Seat 1: Flix2204 folded before Flop (didn't bet)
Seat 2: Xtens folded before Flop (didn't bet)
Seat 3: Fran1809 (button) collected ($0.05)
Seat 4: yuyu767 (small blind) folded before Flop
Seat 5: hoholas22 (big blind) folded on the River
Seat 6: Daklien_Poke folded before Flop (didn't bet)


PokerStars Hand #238163136110:  Hold'em No Limit ($0.01/$0.02 USD) - 2022/08/23 4:34:35 ET
Table 'Achilles IV' 6-max Seat #4 is the button
Seat 1: Flix2204 ($2 in chips)
Seat 2: Xtens ($2.51 in chips)
Seat 3: Fran1809 ($1.63 in chips)
Seat 4: yuyu767 ($3.19 in chips)
Seat 5: hoholas22 ($1.66 in chips)
Seat 6: Daklien_Poke ($2.14 in chips)
hoholas22: posts small blind $0.01
Daklien_Poke: posts big blind $0.02
*** HOLE CARDS ***
Flix2204: folds
Xtens: folds
Fran1809: calls $0.02
yuyu767: folds
hoholas22: calls $0.01
Daklien_Poke: checks
*** FLOP *** [3d Jh 9h]
hoholas22: checks
Daklien_Poke: checks
Fran1809: checks
*** TURN *** [3d Jh 9h] [2c]
hoholas22: checks
Daklien_Poke: bets $0.05
Fran1809: folds
hoholas22: folds
Uncalled bet ($0.05) returned to Daklien_Poke
Daklien_Poke collected $0.06 from pot
Daklien_Poke: doesn't show hand
*** SUMMARY ***
Total pot $0.06 | Rake $0
Board [3d Jh 9h 2c]
Seat 1: Flix2204 folded before Flop (didn't bet)
Seat 2: Xtens folded before Flop (didn't bet)
Seat 3: Fran1809 folded on the Turn
Seat 4: yuyu767 (button) folded before Flop (didn't bet)
Seat 5: hoholas22 (small blind) folded on the Turn
Seat 6: Daklien_Poke (big blind) collected ($0.06)


PokerStars Hand #238163140419:  Hold'em No Limit ($0.01/$0.02 USD) - 2022/08/23 4:35:08 ET
Table 'Achilles IV' 6-max Seat #5 is the button
Seat 1: Flix2204 ($2 in chips)
Seat 2: Xtens ($2.51 in chips)
Seat 3: Fran1809 ($1.61 in chips)
Seat 4: yuyu767 ($3.19 in chips)
Seat 5: hoholas22 ($1.64 in chips)
Seat 6: Daklien_Poke ($2.18 in chips)
Daklien_Poke: posts small blind $0.01
Flix2204: posts big blind $0.02
*** HOLE CARDS ***
Xtens: folds
Fran1809: folds
yuyu767: calls $0.02
hoholas22: raises $0.04 to $0.06
Daklien_Poke: folds
Flix2204: calls $0.04
yuyu767: calls $0.04
*** FLOP *** [5d Qs 8h]
Flix2204: checks
yuyu767: checks
hoholas22: bets $0.09
Flix2204: calls $0.09
yuyu767: folds
*** TURN *** [5d Qs 8h] [7c]
Flix2204: checks
hoholas22: bets $0.18
Flix2204: calls $0.18
*** RIVER *** [5d Qs 8h 7c] [3c]
Flix2204: checks
hoholas22: bets $0.25
Flix2204: calls $0.25
*** SHOW DOWN ***
hoholas22: shows [Ah Ad] (a pair of Aces)
Flix2204: mucks hand
hoholas22 collected $1.19 from pot
*** SUMMARY ***
Total pot $1.23 | Rake $0.04
Board [5d Qs 8h 7c 3c]
Seat 1: Flix2204 (big blind) mucked
Seat 2: Xtens folded before Flop (didn't bet)
Seat 3: Fran1809 folded before Flop (didn't bet)
Seat 4: yuyu767 folded on the Flop
Seat 5: hoholas22 (button) showed [Ah Ad] and won ($1.19) with a pair of Aces
Seat 6: Daklien_Poke (small blind) folded before Flop


PokerStars Hand #238163151383:  Hold'em No Limit ($0.01/$0.02 USD) - 2022/08/23 4:36:33 ET
Table 'Achilles IV' 6-max Seat #6 is the button
Seat 1: Flix2204 ($2 in chips)
Seat 2: Xtens ($2.51 in chips)
Seat 3: Fran1809 ($1.61 in chips)
Seat 4: yuyu767 ($3.13 in chips)
Seat 5: hoholas22 ($2.25 in chips)
Seat 6: Daklien_Poke ($2.17 in chips)
Flix2204: posts small blind $0.01
Xtens: posts big blind $0.02
*** HOLE CARDS ***
Fran1809: calls $0.02
yuyu767: folds
hoholas22: folds
Daklien_Poke: folds
Flix2204: folds
Xtens: checks
*** FLOP *** [3s 9s 2h]
Xtens: checks
Flix2204 leaves the table
Fran1809: checks
*** TURN *** [3s 9s 2h] [5h]
Xtens: checks
Fran1809: bets $0.05
hilarjo joins the table at seat #1
Xtens: folds
Uncalled bet ($0.05) returned to Fran1809
Fran1809 collected $0.05 from pot
*** SUMMARY ***
Total pot $0.05 | Rake $0
Board [3s 9s 2h 5h]
Seat 1: Flix2204 (small blind) folded before Flop
Seat 2: Xtens (big blind) folded on the Turn
Seat 3: Fran1809 collected ($0.05)
Seat 4: yuyu767 folded before Flop (didn't bet)
Seat 5: hoholas22 folded before Flop (didn't bet)
Seat 6: Daklien_Poke (button) folded before Flop (didn't bet)


PokerStars Hand #238163157482:  Hold'em No Limit ($0.01/$0.02 USD) - 2022/08/23 4:37:21 ET
Table 'Achilles IV' 6-max Seat #2 is the button
Seat 2: Xtens ($2.49 in chips)
Seat 3: Fran1809 ($1.64 in chips)
Seat 4: yuyu767 ($3.13 in chips)
Seat 5: hoholas22 ($2.25 in chips)
Seat 6: Daklien_Poke ($2.17 in chips)
Fran1809: posts small blind $0.01
yuyu767: posts big blind $0.02
hilarjo: sits out
*** HOLE CARDS ***
hoholas22: raises $0.04 to $0.06
Daklien_Poke: folds
Xtens: folds
Fran1809: calls $0.05
yuyu767: folds
*** FLOP *** [9c 5d Jh]
Fran1809: checks
hoholas22: bets $0.07
Fran1809: folds
Uncalled bet ($0.07) returned to hoholas22
hoholas22 collected $0.14 from pot
*** SUMMARY ***
Total pot $0.14 | Rake $0
Board [9c 5d Jh]
Seat 2: Xtens (button) folded before Flop (didn't bet)
Seat 3: Fran1809 (small blind) folded on the Flop
Seat 4: yuyu767 (big blind) folded before Flop
Seat 5: hoholas22 collected ($0.14)
Seat 6: Daklien_Poke folded before Flop (didn't bet)


PokerStars Hand #238163162221:  Hold'em No Limit ($0.01/$0.02 USD) - 2022/08/23 4:37:57 ET
Table 'Achilles IV' 6-max Seat #4 is the button
Seat 2: Xtens ($2.52 in chips)
Seat 3: Fran1809 ($1.58 in chips)
Seat 4: yuyu767 ($3.10 in chips)
Seat 5: hoholas22 ($2.31 in chips)
Seat 6: Daklien_Poke ($2.17 in chips)
hoholas22: posts small blind $0.01
Daklien_Poke: posts big blind $0.02
hilarjo: sits out
*** HOLE CARDS ***
Xtens: raises $0.03 to $0.05
Fran1809: folds
yuyu767: folds
hoholas22: folds
Daklien_Poke: folds
Uncalled bet ($0.03) returned to Xtens
Xtens collected $0.05 from pot
Xtens: doesn't show hand
*** SUMMARY ***
Total pot $0.05 | Rake $0
Seat 2: Xtens collected ($0.05)
Seat 3: Fran1809 folded before Flop (didn't bet)
Seat 4: yuyu767 (button) folded before Flop (didn't bet)
Seat 5: hoholas22 (small blind) folded before Flop
Seat 6: Daklien_Poke (big blind) folded before Flop


PokerStars Hand #238163160959:  Hold'em No Limit ($0.01/$0.02 USD) - 2022/08/23 4:37:47 ET
Table 'Achilles IV' 6-max Seat #3 is the button
Seat 2: Xtens ($2.49 in chips)
Seat 3: Fran1809 ($1.58 in chips)
Seat 4: yuyu767 ($3.11 in chips)
Seat 5: hoholas22 ($2.33 in chips)
Seat 6: Daklien_Poke ($2.17 in chips)
yuyu767: posts small blind $0.01
hoholas22: posts big blind $0.02
hilarjo: sits out
*** HOLE CARDS ***
Daklien_Poke: folds
Xtens: raises $0.03 to $0.05
Fran1809: folds
yuyu767: folds
hoholas22: folds
Uncalled bet ($0.03) returned to Xtens
Xtens collected $0.05 from pot
Xtens: doesn't show hand
*** SUMMARY ***
Total pot $0.05 | Rake $0
Seat 2: Xtens collected ($0.05)
Seat 3: Fran1809 (button) folded before Flop (didn't bet)
Seat 4: yuyu767 (small blind) folded before Flop
Seat 5: hoholas22 (big blind) folded before Flop
Seat 6: Daklien_Poke folded before Flop (didn't bet)


PokerStars Hand #238163163544:  Hold'em No Limit ($0.01/$0.02 USD) - 2022/08/23 4:38:07 ET
Table 'Achilles IV' 6-max Seat #5 is the button
Seat 1: hilarjo ($2 in chips)
Seat 2: Xtens ($2.55 in chips)
Seat 3: Fran1809 ($1.58 in chips)
Seat 4: yuyu767 ($3.10 in chips)
Seat 5: hoholas22 ($2.30 in chips)
Seat 6: Daklien_Poke ($2.15 in chips)
Daklien_Poke: posts small blind $0.01
hilarjo: posts big blind $0.02
*** HOLE CARDS ***
Xtens: folds
Fran1809: calls $0.02
yuyu767: folds
hoholas22: raises $0.06 to $0.08
Daklien_Poke: folds
hilarjo: folds
Fran1809: calls $0.06
*** FLOP *** [8h 4h Qd]
Fran1809: checks
hoholas22: bets $0.09
Fran1809: folds
Uncalled bet ($0.09) returned to hoholas22
hoholas22 collected $0.18 from pot
*** SUMMARY ***
Total pot $0.19 | Rake $0.01
Board [8h 4h Qd]
Seat 1: hilarjo (big blind) folded before Flop
Seat 2: Xtens folded before Flop (didn't bet)
Seat 3: Fran1809 folded on the Flop
Seat 4: yuyu767 folded before Flop (didn't bet)
Seat 5: hoholas22 (button) collected ($0.18)
Seat 6: Daklien_Poke (small blind) folded before Flop


PokerStars Hand #238163168052:  Hold'em No Limit ($0.01/$0.02 USD) - 2022/08/23 4:38:42 ET
Table 'Achilles IV' 6-max Seat #6 is the button
Seat 1: hilarjo ($2 in chips)
Seat 2: Xtens ($2.55 in chips)
Seat 3: Fran1809 ($1.50 in chips)
Seat 4: yuyu767 ($3.10 in chips)
Seat 5: hoholas22 ($2.40 in chips)
Seat 6: Daklien_Poke ($2.14 in chips)
hilarjo: posts small blind $0.01
Xtens: posts big blind $0.02
*** HOLE CARDS ***
Fran1809: folds
yuyu767: folds
hoholas22: folds
Daklien_Poke: folds
hilarjo: raises $0.04 to $0.06
Xtens: folds
Uncalled bet ($0.04) returned to hilarjo
hilarjo collected $0.04 from pot
hilarjo: doesn't show hand
*** SUMMARY ***
Total pot $0.04 | Rake $0
Seat 1: hilarjo (small blind) collected ($0.04)
Seat 2: Xtens (big blind) folded before Flop
Seat 3: Fran1809 folded before Flop (didn't bet)
Seat 4: yuyu767 folded before Flop (didn't bet)
Seat 5: hoholas22 folded before Flop (didn't bet)
Seat 6: Daklien_Poke (button) folded before Flop (didn't bet)


PokerStars Hand #238163169525:  Hold'em No Limit ($0.01/$0.02 USD) - 2022/08/23 4:38:53 ET
Table 'Achilles IV' 6-max Seat #1 is the button
Seat 1: hilarjo ($2.02 in chips)
Seat 2: Xtens ($2.53 in chips)
Seat 3: Fran1809 ($1.50 in chips)
Seat 4: yuyu767 ($3.10 in chips)
Seat 5: hoholas22 ($2.40 in chips)
Seat 6: Daklien_Poke ($2.14 in chips)
Xtens: posts small blind $0.01
Fran1809: posts big blind $0.02
*** HOLE CARDS ***
yuyu767: raises $0.02 to $0.04
hoholas22: folds
Daklien_Poke: folds
hilarjo: folds
Xtens: folds
Fran1809: calls $0.02
*** FLOP *** [Qc Qs 4h]
Fran1809: checks
yuyu767: bets $0.04
Fran1809: calls $0.04
*** TURN *** [Qc Qs 4h] [Qd]
Fran1809: checks
yuyu767: bets $0.08
Fran1809: calls $0.08
*** RIVER *** [Qc Qs 4h Qd] [Ac]
Fran1809: checks
yuyu767: checks
*** SHOW DOWN ***
Fran1809: shows [Jc Js] (a full house, Queens full of Jacks)
yuyu767: mucks hand
Fran1809 collected $0.32 from pot
*** SUMMARY ***
Total pot $0.33 | Rake $0.01
Board [Qc Qs 4h Qd Ac]
Seat 1: hilarjo (button) folded before Flop (didn't bet)
Seat 2: Xtens (small blind) folded before Flop
Seat 3: Fran1809 (big blind) showed [Jc Js] and won ($0.32) with a full house, Queens full of Jacks
Seat 4: yuyu767 mucked
Seat 5: hoholas22 folded before Flop (didn't bet)
Seat 6: Daklien_Poke folded before Flop (didn't bet)


PokerStars Hand #238163176566:  Hold'em No Limit ($0.01/$0.02 USD) - 2022/08/23 4:39:48 ET
Table 'Achilles IV' 6-max Seat #2 is the button
Seat 1: hilarjo ($2.02 in chips)
Seat 2: Xtens ($2.52 in chips)
Seat 3: Fran1809 ($1.66 in chips)
Seat 4: yuyu767 ($2.94 in chips)
Seat 5: hoholas22 ($2.40 in chips)
Seat 6: Daklien_Poke ($2.14 in chips)
Fran1809: posts small blind $0.01
yuyu767: posts big blind $0.02
*** HOLE CARDS ***
hoholas22: folds
Daklien_Poke: raises $0.03 to $0.05
hilarjo: folds
Xtens: folds
Fran1809: calls $0.04
yuyu767: folds
*** FLOP *** [Qc 8d Td]
Fran1809: checks
Daklien_Poke: bets $0.05
Fran1809: calls $0.05
*** TURN *** [Qc 8d Td] [3d]
Fran1809: checks
Daklien_Poke: bets $0.09
Fran1809: calls $0.09
*** RIVER *** [Qc 8d Td 3d] [Js]
Fran1809: bets $0.19
Daklien_Poke: folds
Uncalled bet ($0.19) returned to Fran1809
Fran1809 collected $0.39 from pot
*** SUMMARY ***
Total pot $0.40 | Rake $0.01
Board [Qc 8d Td 3d Js]
Seat 1: hilarjo folded before Flop (didn't bet)
Seat 2: Xtens (button) folded before Flop (didn't bet)
Seat 3: Fran1809 (small blind) collected ($0.39)
Seat 4: yuyu767 (big blind) folded before Flop
Seat 5: hoholas22 folded before Flop (didn't bet)
Seat 6: Daklien_Poke folded on the River


PokerStars Hand #238163187171:  Hold'em No Limit ($0.01/$0.02 USD) - 2022/08/23 4:41:08 ET
Table 'Achilles IV' 6-max Seat #3 is the button
Seat 1: hilarjo ($2.02 in chips)
Seat 2: Xtens ($2.52 in chips)
Seat 3: Fran1809 ($1.86 in chips)
Seat 4: yuyu767 ($2.92 in chips)
Seat 5: hoholas22 ($2.40 in chips)
Seat 6: Daklien_Poke ($1.95 in chips)
yuyu767: posts small blind $0.01
hoholas22: posts big blind $0.02
*** HOLE CARDS ***
Daklien_Poke: raises $0.03 to $0.05
hilarjo: folds
Xtens: folds
Fran1809: folds
yuyu767: folds
hoholas22: folds
Uncalled bet ($0.03) returned to Daklien_Poke
Daklien_Poke collected $0.05 from pot
Daklien_Poke: doesn't show hand
*** SUMMARY ***
Total pot $0.05 | Rake $0
Seat 1: hilarjo folded before Flop (didn't bet)
Seat 2: Xtens folded before Flop (didn't bet)
Seat 3: Fran1809 (button) folded before Flop (didn't bet)
Seat 4: yuyu767 (small blind) folded before Flop
Seat 5: hoholas22 (big blind) folded before Flop
Seat 6: Daklien_Poke collected ($0.05)


PokerStars Hand #238163189135:  Hold'em No Limit ($0.01/$0.02 USD) - 2022/08/23 4:41:22 ET
Table 'Achilles IV' 6-max Seat #4 is the button
Seat 1: hilarjo ($2.02 in chips)
Seat 2: Xtens ($2.52 in chips)
Seat 3: Fran1809 ($1.86 in chips)
Seat 4: yuyu767 ($2.91 in chips)
Seat 5: hoholas22 ($2.38 in chips)
Seat 6: Daklien_Poke ($1.98 in chips)
hoholas22: posts small blind $0.01
Daklien_Poke: posts big blind $0.02
*** HOLE CARDS ***
hilarjo: folds
Xtens: folds
Fran1809: calls $0.02
yuyu767: folds
hoholas22: calls $0.01
Daklien_Poke: checks
*** FLOP *** [6h Qh 3d]
hoholas22: checks
Daklien_Poke: checks
Fran1809: checks
*** TURN *** [6h Qh 3d] [5h]
hoholas22: checks
Daklien_Poke: bets $0.05
Fran1809: folds
hoholas22: folds
Uncalled bet ($0.05) returned to Daklien_Poke
Daklien_Poke collected $0.06 from pot
Daklien_Poke: doesn't show hand
*** SUMMARY ***
Total pot $0.06 | Rake $0
Board [6h Qh 3d 5h]
Seat 1: hilarjo folded before Flop (didn't bet)
Seat 2: Xtens folded before Flop (didn't bet)
Seat 3: Fran1809 folded on the Turn
Seat 4: yuyu767 (button) folded before Flop (didn't bet)
Seat 5: hoholas22 (small blind) folded on the Turn
Seat 6: Daklien_Poke (big blind) collected ($0.06)


PokerStars Hand #238163194552:  Hold'em No Limit ($0.01/$0.02 USD) - 2022/08/23 4:42:03 ET
Table 'Achilles IV' 6-max Seat #5 is the button
Seat 1: hilarjo ($2.02 in chips)
Seat 2: Xtens ($2.52 in chips)
Seat 3: Fran1809 ($1.84 in chips)
Seat 4: yuyu767 ($2.91 in chips)
Seat 5: hoholas22 ($2.36 in chips)
Seat 6: Daklien_Poke ($2.02 in chips)
Daklien_Poke: posts small blind $0.01
hilarjo: posts big blind $0.02
*** HOLE CARDS ***
Xtens: folds
Fran1809: calls $0.02
yuyu767: folds
hoholas22: folds
Daklien_Poke: folds
hilarjo: checks
*** FLOP *** [Jc Kd Qs]
hilarjo: checks
Fran1809: bets $0.02
hilarjo: calls $0.02
*** TURN *** [Jc Kd Qs] [9d]
hilarjo: checks
Fran1809: checks
*** RIVER *** [Jc Kd Qs 9d] [6h]
hilarjo: checks
Fran1809: checks
*** SHOW DOWN ***
hilarjo: shows [Qh 8d] (a pair of Queens)
Fran1809: shows [Qc 4s] (a pair of Queens)
hilarjo collected $0.05 from pot
Fran1809 collected $0.04 from pot
*** SUMMARY ***
Total pot $0.09 | Rake $0
Board [Jc Kd Qs 9d 6h]
Seat 1: hilarjo (big blind) showed [Qh 8d] and won ($0.05) with a pair of Queens
Seat 2: Xtens folded before Flop (didn't bet)
Seat 3: Fran1809 showed [Qc 4s] and won ($0.04) with a pair of Queens
Seat 4: yuyu767 folded before Flop (didn't bet)
Seat 5: hoholas22 (button) folded before Flop (didn't bet)
Seat 6: Daklien_Poke (small blind) folded before Flop


PokerStars Hand #238163198789:  Hold'em No Limit ($0.01/$0.02 USD) - 2022/08/23 4:42:35 ET
Table 'Achilles IV' 6-max Seat #6 is the button
Seat 1: hilarjo ($2.03 in chips)
Seat 2: Xtens ($2.52 in chips)
Seat 3: Fran1809 ($1.84 in chips)
Seat 4: yuyu767 ($2.91 in chips)
Seat 5: hoholas22 ($2.36 in chips)
Seat 6: Daklien_Poke ($2.01 in chips)
hilarjo: posts small blind $0.01
Xtens: posts big blind $0.02
*** HOLE CARDS ***
Fran1809: calls $0.02
yuyu767: folds
hoholas22: folds
Daklien_Poke: folds
hilarjo: calls $0.01
Xtens: raises $0.06 to $0.08
Fran1809: folds
hilarjo: folds
Uncalled bet ($0.06) returned to Xtens
Xtens collected $0.06 from pot
Xtens: doesn't show hand
*** SUMMARY ***
Total pot $0.06 | Rake $0
Seat 1: hilarjo (small blind) folded before Flop
Seat 2: Xtens (big blind) collected ($0.06)
Seat 3: Fran1809 folded before Flop
Seat 4: yuyu767 folded before Flop (didn't bet)
Seat 5: hoholas22 folded before Flop (didn't bet)
Seat 6: Daklien_Poke (button) folded before Flop (didn't bet)


PokerStars Hand #238163202784:  Hold'em No Limit ($0.01/$0.02 USD) - 2022/08/23 4:43:05 ET
Table 'Achilles IV' 6-max Seat #1 is the button
Seat 1: hilarjo ($2.01 in chips)
Seat 2: Xtens ($2.56 in chips)
Seat 3: Fran1809 ($1.82 in chips)
Seat 4: yuyu767 ($2.91 in chips)
Seat 5: hoholas22 ($2.36 in chips)
Seat 6: Daklien_Poke ($2.01 in chips)
Xtens: posts small blind $0.01
Fran1809: posts big blind $0.02
*** HOLE CARDS ***
yuyu767: raises $0.04 to $0.06
hoholas22: folds
Daklien_Poke: folds
hilarjo: folds
Xtens: folds
Fran1809: calls $0.04
*** FLOP *** [5h Qh 4s]
Fran1809: checks
yuyu767: bets $0.06
Fran1809: folds
Uncalled bet ($0.06) returned to yuyu767
yuyu767 collected $0.13 from pot
*** SUMMARY ***
Total pot $0.13 | Rake $0
Board [5h Qh 4s]
Seat 1: hilarjo (button) folded before Flop (didn't bet)
Seat 2: Xtens (small blind) folded before Flop
Seat 3: Fran1809 (big blind) folded on the Flop
Seat 4: yuyu767 collected ($0.13)
Seat 5: hoholas22 folded before Flop (didn't bet)
Seat 6: Daklien_Poke folded before Flop (didn't bet)


PokerStars Hand #238163207165:  Hold'em No Limit ($0.01/$0.02 USD) - 2022/08/23 4:43:38 ET
Table 'Achilles IV' 6-max Seat #2 is the button
Seat 1: hilarjo ($2.01 in chips)
Seat 2: Xtens ($2.55 in chips)
Seat 3: Fran1809 ($1.76 in chips)
Seat 4: yuyu767 ($2.98 in chips)
Seat 5: hoholas22 ($2.36 in chips)
Seat 6: Daklien_Poke ($2.01 in chips)
Fran1809: posts small blind $0.01
yuyu767: posts big blind $0.02
*** HOLE CARDS ***
hoholas22: folds
Daklien_Poke: folds
hilarjo: raises $0.04 to $0.06
Xtens: calls $0.06
Fran1809: folds
yuyu767: calls $0.04
*** FLOP *** [8s Tc Kc]
yuyu767: checks
hilarjo: checks
Xtens: checks
*** TURN *** [8s Tc Kc] [6c]
yuyu767: bets $0.07
hilarjo: folds
Xtens: folds
Uncalled bet ($0.07) returned to yuyu767
yuyu767 collected $0.18 from pot
*** SUMMARY ***
Total pot $0.19 | Rake $0.01
Board [8s Tc Kc 6c]
Seat 1: hilarjo folded on the Turn
Seat 2: Xtens (button) folded on the Turn
Seat 3: Fran1809 (small blind) folded before Flop
Seat 4: yuyu767 (big blind) collected ($0.18)
Seat 5: hoholas22 folded before Flop (didn't bet)
Seat 6: Daklien_Poke folded before Flop (didn't bet)


PokerStars Hand #238163213657:  Hold'em No Limit ($0.01/$0.02 USD) - 2022/08/23 4:44:26 ET
Table 'Achilles IV' 6-max Seat #3 is the button
Seat 1: hilarjo ($2 in chips)
Seat 2: Xtens ($2.49 in chips)
Seat 3: Fran1809 ($1.75 in chips)
Seat 4: yuyu767 ($3.10 in chips)
Seat 5: hoholas22 ($2.36 in chips)
Seat 6: Daklien_Poke ($2.01 in chips)
yuyu767: posts small blind $0.01
hoholas22: posts big blind $0.02
*** HOLE CARDS ***
Daklien_Poke: folds
hilarjo: folds
Xtens: folds
Fran1809: folds
yuyu767: folds
Uncalled bet ($0.01) returned to hoholas22
hoholas22 collected $0.02 from pot
*** SUMMARY ***
Total pot $0.02 | Rake $0
Seat 1: hilarjo folded before Flop (didn't bet)
Seat 2: Xtens folded before Flop (didn't bet)
Seat 3: Fran1809 (button) folded before Flop (didn't bet)
Seat 4: yuyu767 (small blind) folded before Flop
Seat 5: hoholas22 (big blind) collected ($0.02)
Seat 6: Daklien_Poke folded before Flop (didn't bet)


PokerStars Hand #238163214681:  Hold'em No Limit ($0.01/$0.02 USD) - 2022/08/23 4:44:34 ET
Table 'Achilles IV' 6-max Seat #4 is the button
Seat 1: hilarjo ($2 in chips)
Seat 2: Xtens ($2.49 in chips)
Seat 3: Fran1809 ($1.75 in chips)
Seat 4: yuyu767 ($3.09 in chips)
Seat 5: hoholas22 ($2.37 in chips)
Seat 6: Daklien_Poke ($2.01 in chips)
hoholas22: posts small blind $0.01
Daklien_Poke: posts big blind $0.02
*** HOLE CARDS ***
hilarjo: folds
Xtens: folds
Fran1809: folds
yuyu767: folds
hoholas22: folds
Uncalled bet ($0.01) returned to Daklien_Poke
Daklien_Poke collected $0.02 from pot
Daklien_Poke: doesn't show hand
*** SUMMARY ***
Total pot $0.02 | Rake $0
Seat 1: hilarjo folded before Flop (didn't bet)
Seat 2: Xtens folded before Flop (didn't bet)
Seat 3: Fran1809 folded before Flop (didn't bet)
Seat 4: yuyu767 (button) folded before Flop (didn't bet)
Seat 5: hoholas22 (small blind) folded before Flop
Seat 6: Daklien_Poke (big blind) collected ($0.02)


PokerStars Hand #238163218022:  Hold'em No Limit ($0.01/$0.02 USD) - 2022/08/23 4:44:58 ET
Table 'Achilles IV' 6-max Seat #5 is the button
Seat 1: hilarjo ($2 in chips)
Seat 2: Xtens ($2.49 in chips)
Seat 3: Fran1809 ($1.75 in chips)
Seat 4: yuyu767 ($3.09 in chips)
Seat 5: hoholas22 ($2.36 in chips)
Seat 6: Daklien_Poke ($2.02 in chips)
Daklien_Poke: posts small blind $0.01
hilarjo: posts big blind $0.02
*** HOLE CARDS ***
Xtens: folds
Fran1809: calls $0.02
yuyu767: folds
hoholas22: folds
Daklien_Poke: folds
hilarjo: checks
*** FLOP *** [3c Qs 4d]
hilarjo: checks
Fran1809: bets $0.02
hilarjo: calls $0.02
*** TURN *** [3c Qs 4d] [Jd]
hilarjo: checks
Fran1809: bets $0.09
hilarjo: folds
Uncalled bet ($0.09) returned to Fran1809
Fran1809 collected $0.09 from pot
*** SUMMARY ***
Total pot $0.09 | Rake $0
Board [3c Qs 4d Jd]
Seat 1: hilarjo (big blind) folded on the Turn
Seat 2: Xtens folded before Flop (didn't bet)
Seat 3: Fran1809 collected ($0.09)
Seat 4: yuyu767 folded before Flop (didn't bet)
Seat 5: hoholas22 (button) folded before Flop (didn't bet)
Seat 6: Daklien_Poke (small blind) folded before Flop


PokerStars Hand #238163223050:  Hold'em No Limit ($0.01/$0.02 USD) - 2022/08/23 4:45:36 ET
Table 'Achilles IV' 6-max Seat #6 is the button
Seat 1: hilarjo ($2 in chips)
Seat 2: Xtens ($2.49 in chips)
Seat 3: Fran1809 ($1.80 in chips)
Seat 4: yuyu767 ($3.09 in chips)
Seat 5: hoholas22 ($2.36 in chips)
Seat 6: Daklien_Poke ($2.01 in chips)
hilarjo: posts small blind $0.01
Xtens: posts big blind $0.02
*** HOLE CARDS ***
Fran1809: calls $0.02
yuyu767: raises $0.02 to $0.04
hoholas22: folds
Daklien_Poke: folds
hilarjo: folds
Xtens: folds
Fran1809: calls $0.02
*** FLOP *** [Qs Ad 3s]
Fran1809: checks
yuyu767: bets $0.05
Fran1809: calls $0.05
*** TURN *** [Qs Ad 3s] [7c]
Fran1809: checks
yuyu767: checks
*** RIVER *** [Qs Ad 3s 7c] [9d]
Fran1809: bets $0.20
yuyu767: calls $0.20
*** SHOW DOWN ***
Fran1809: shows [6s 5s] (high card Ace)
yuyu767: shows [Jd Qh] (a pair of Queens)
yuyu767 collected $0.59 from pot
*** SUMMARY ***
Total pot $0.61 | Rake $0.02
Board [Qs Ad 3s 7c 9d]
Seat 1: hilarjo (small blind) folded before Flop
Seat 2: Xtens (big blind) folded before Flop
Seat 3: Fran1809 showed [6s 5s] and lost with high card Ace
Seat 4: yuyu767 showed [Jd Qh] and won ($0.59) with a pair of Queens
Seat 5: hoholas22 folded before Flop (didn't bet)
Seat 6: Daklien_Poke (button) folded before Flop (didn't bet)


PokerStars Hand #238163232370:  Hold'em No Limit ($0.01/$0.02 USD) - 2022/08/23 4:46:44 ET
Table 'Achilles IV' 6-max Seat #1 is the button
Seat 1: hilarjo ($2 in chips)
Seat 2: Xtens ($2.47 in chips)
Seat 3: Fran1809 ($1.51 in chips)
Seat 4: yuyu767 ($3.39 in chips)
Seat 5: hoholas22 ($2.36 in chips)
Seat 6: Daklien_Poke ($2.01 in chips)
Xtens: posts small blind $0.01
Fran1809: posts big blind $0.02
*** HOLE CARDS ***
yuyu767: folds
hoholas22: folds
Daklien_Poke: folds
hilarjo: folds
Xtens: raises $0.03 to $0.05
Fran1809: calls $0.03
*** FLOP *** [2c 8h 4d]
Xtens: bets $0.03
Fran1809: calls $0.03
*** TURN *** [2c 8h 4d] [9d]
Xtens: checks
Fran1809: bets $0.15
Xtens: folds
Uncalled bet ($0.15) returned to Fran1809
Fran1809 collected $0.15 from pot
*** SUMMARY ***
Total pot $0.16 | Rake $0.01
Board [2c 8h 4d 9d]
Seat 1: hilarjo (button) folded before Flop (didn't bet)
Seat 2: Xtens (small blind) folded on the Turn
Seat 3: Fran1809 (big blind) collected ($0.15)
Seat 4: yuyu767 folded before Flop (didn't bet)
Seat 5: hoholas22 folded before Flop (didn't bet)
Seat 6: Daklien_Poke folded before Flop (didn't bet)


PokerStars Hand #238163236203:  Hold'em No Limit ($0.01/$0.02 USD) - 2022/08/23 4:47:12 ET
Table 'Achilles IV' 6-max Seat #2 is the button
Seat 1: hilarjo ($2 in chips)
Seat 2: Xtens ($2.39 in chips)
Seat 3: Fran1809 ($1.58 in chips)
Seat 4: yuyu767 ($3.39 in chips)
Seat 5: hoholas22 ($2.36 in chips)
Seat 6: Daklien_Poke ($2.01 in chips)
Fran1809: posts small blind $0.01
yuyu767: posts big blind $0.02
*** HOLE CARDS ***
hoholas22: folds
Daklien_Poke: folds
hilarjo: folds
Xtens: folds
Fran1809: raises $0.02 to $0.04
yuyu767: calls $0.02
*** FLOP *** [2c Qh 9h]
Fran1809: bets $0.08
yuyu767: folds
Uncalled bet ($0.08) returned to Fran1809
Fran1809 collected $0.08 from pot
*** SUMMARY ***
Total pot $0.08 | Rake $0
Board [2c Qh 9h]
Seat 1: hilarjo folded before Flop (didn't bet)
Seat 2: Xtens (button) folded before Flop (didn't bet)
Seat 3: Fran1809 (small blind) collected ($0.08)
Seat 4: yuyu767 (big blind) folded on the Flop
Seat 5: hoholas22 folded before Flop (didn't bet)
Seat 6: Daklien_Poke folded before Flop (didn't bet)


PokerStars Hand #238163240172:  Hold'em No Limit ($0.01/$0.02 USD) - 2022/08/23 4:47:41 ET
Table 'Achilles IV' 6-max Seat #3 is the button
Seat 1: hilarjo ($2 in chips)
Seat 2: Xtens ($2.39 in chips)
Seat 3: Fran1809 ($1.62 in chips)
Seat 4: yuyu767 ($3.35 in chips)
Seat 5: hoholas22 ($2.36 in chips)
Seat 6: Daklien_Poke ($2.01 in chips)
yuyu767: posts small blind $0.01
hoholas22: posts big blind $0.02
*** HOLE CARDS ***
Daklien_Poke: folds
hilarjo: folds
Xtens: folds
Fran1809: raises $0.02 to $0.04
yuyu767: folds
hoholas22: folds
Uncalled bet ($0.02) returned to Fran1809
Fran1809 collected $0.05 from pot
*** SUMMARY ***
Total pot $0.05 | Rake $0
Seat 1: hilarjo folded before Flop (didn't bet)
Seat 2: Xtens folded before Flop (didn't bet)
Seat 3: Fran1809 (button) collected ($0.05)
Seat 4: yuyu767 (small blind) folded before Flop
Seat 5: hoholas22 (big blind) folded before Flop
Seat 6: Daklien_Poke folded before Flop (didn't bet)


PokerStars Hand #238163242016:  Hold'em No Limit ($0.01/$0.02 USD) - 2022/08/23 4:47:54 ET
Table 'Achilles IV' 6-max Seat #4 is the button
Seat 1: hilarjo ($2 in chips)
Seat 2: Xtens ($2.39 in chips)
Seat 3: Fran1809 ($1.65 in chips)
Seat 4: yuyu767 ($3.34 in chips)
Seat 5: hoholas22 ($2.34 in chips)
Seat 6: Daklien_Poke ($2.01 in chips)
hoholas22: posts small blind $0.01
Daklien_Poke: posts big blind $0.02
*** HOLE CARDS ***
hilarjo: folds
Xtens: raises $0.03 to $0.05
Fran1809: folds
yuyu767: folds
hoholas22: folds
Daklien_Poke: folds
Uncalled bet ($0.03) returned to Xtens
Xtens collected $0.05 from pot
Xtens: doesn't show hand
*** SUMMARY ***
Total pot $0.05 | Rake $0
Seat 1: hilarjo folded before Flop (didn't bet)
Seat 2: Xtens collected ($0.05)
Seat 3: Fran1809 folded before Flop (didn't bet)
Seat 4: yuyu767 (button) folded before Flop (didn't bet)
Seat 5: hoholas22 (small blind) folded before Flop
Seat 6: Daklien_Poke (big blind) folded before Flop


PokerStars Hand #238163243571:  Hold'em No Limit ($0.01/$0.02 USD) - 2022/08/23 4:48:06 ET
Table 'Achilles IV' 6-max Seat #5 is the button
Seat 1: hilarjo ($2 in chips)
Seat 2: Xtens ($2.42 in chips)
Seat 3: Fran1809 ($1.65 in chips)
Seat 4: yuyu767 ($3.34 in chips)
Seat 5: hoholas22 ($2.33 in chips)
Seat 6: Daklien_Poke ($1.99 in chips)
Daklien_Poke: posts small blind $0.01
hilarjo: posts big blind $0.02
*** HOLE CARDS ***
Xtens: folds
Fran1809: calls $0.02
yuyu767: folds
hoholas22: calls $0.02
Daklien_Poke: folds
hilarjo: checks
*** FLOP *** [4s Ac Qh]
hilarjo: checks
Fran1809: checks
hoholas22: checks
*** TURN *** [4s Ac Qh] [9c]
hilarjo: checks
Fran1809: checks
hoholas22: checks
*** RIVER *** [4s Ac Qh 9c] [7d]
hilarjo: checks
Fran1809: checks
hoholas22: checks
*** SHOW DOWN ***
hilarjo: shows [3c 4c] (a pair of Fours)
Fran1809: mucks hand
hoholas22: shows [5h 5d] (a pair of Fives)
hoholas22 collected $0.07 from pot
*** SUMMARY ***
Total pot $0.07 | Rake $0
Board [4s Ac Qh 9c 7d]
Seat 1: hilarjo (big blind) showed [3c 4c] and lost with a pair of Fours
Seat 2: Xtens folded before Flop (didn't bet)
Seat 3: Fran1809 mucked
Seat 4: yuyu767 folded before Flop (didn't bet)
Seat 5: hoholas22 (button) showed [5h 5d] and won ($0.07) with a pair of Fives
Seat 6: Daklien_Poke (small blind) folded before Flop


PokerStars Hand #238163247842:  Hold'em No Limit ($0.01/$0.02 USD) - 2022/08/23 4:48:37 ET
Table 'Achilles IV' 6-max Seat #6 is the button
Seat 1: hilarjo ($2 in chips)
Seat 2: Xtens ($2.42 in chips)
Seat 3: Fran1809 ($1.63 in chips)
Seat 4: yuyu767 ($3.34 in chips)
Seat 5: hoholas22 ($2.38 in chips)
Seat 6: Daklien_Poke ($1.98 in chips)
hilarjo: posts small blind $0.01
Xtens: posts big blind $0.02
*** HOLE CARDS ***
Fran1809: calls $0.02
yuyu767: folds
hoholas22: folds
Daklien_Poke: calls $0.02
hilarjo: raises $0.10 to $0.12
Xtens: folds
Fran1809: calls $0.10
Daklien_Poke: calls $0.10
*** FLOP *** [3h 7h Jc]
hilarjo: checks
Fran1809: checks
Daklien_Poke: checks
*** TURN *** [3h 7h Jc] [Jh]
hilarjo: checks
Fran1809: checks
Daklien_Poke: bets $0.22
hilarjo: folds
Fran1809: calls $0.22
*** RIVER *** [3h 7h Jc Jh] [5c]
Fran1809: checks
Daklien_Poke: bets $0.68
Fran1809: calls $0.68
*** SHOW DOWN ***
Daklien_Poke: shows [Ac Qd] (a pair of Jacks)
Fran1809: shows [Qh Kh] (a flush, King high)
Fran1809 collected $2.10 from pot
*** SUMMARY ***
Total pot $2.18 | Rake $0.08
Board [3h 7h Jc Jh 5c]
Seat 1: hilarjo (small blind) folded on the Turn
Seat 2: Xtens (big blind) folded before Flop
Seat 3: Fran1809 showed [Qh Kh] and won ($2.10) with a flush, King high
Seat 4: yuyu767 folded before Flop (didn't bet)
Seat 5: hoholas22 folded before Flop (didn't bet)
Seat 6: Daklien_Poke (button) showed [Ac Qd] and lost with a pair of Jacks


PokerStars Hand #238163257448:  Hold'em No Limit ($0.01/$0.02 USD) - 2022/08/23 4:49:47 ET
Table 'Achilles IV' 6-max Seat #2 is the button
Seat 1: hilarjo ($2 in chips)
Seat 2: Xtens ($2.39 in chips)
Seat 3: Fran1809 ($2.72 in chips)
Seat 4: yuyu767 ($3.34 in chips)
Seat 5: hoholas22 ($2.38 in chips)
Seat 6: Daklien_Poke ($0.96 in chips)
Fran1809: posts small blind $0.01
yuyu767: posts big blind $0.02
*** HOLE CARDS ***
hoholas22: folds
Daklien_Poke: folds
hilarjo: folds
Xtens: folds
Fran1809: raises $0.04 to $0.06
yuyu767: folds
Uncalled bet ($0.04) returned to Fran1809
Fran1809 collected $0.04 from pot
*** SUMMARY ***
Total pot $0.04 | Rake $0
Seat 1: hilarjo folded before Flop (didn't bet)
Seat 2: Xtens (button) folded before Flop (didn't bet)
Seat 3: Fran1809 (small blind) collected ($0.04)
Seat 4: yuyu767 (big blind) folded before Flop
Seat 5: hoholas22 folded before Flop (didn't bet)
Seat 6: Daklien_Poke folded before Flop (didn't bet)


PokerStars Hand #238163255663:  Hold'em No Limit ($0.01/$0.02 USD) - 2022/08/23 4:49:34 ET
Table 'Achilles IV' 6-max Seat #1 is the button
Seat 1: hilarjo ($2 in chips)
Seat 2: Xtens ($2.40 in chips)
Seat 3: Fran1809 ($2.71 in chips)
Seat 4: yuyu767 ($3.34 in chips)
Seat 5: hoholas22 ($2.38 in chips)
Seat 6: Daklien_Poke ($0.96 in chips)
Xtens: posts small blind $0.01
Fran1809: posts big blind $0.02
*** HOLE CARDS ***
yuyu767: folds
hoholas22: folds
Daklien_Poke: folds
hilarjo: folds
Xtens: folds
Uncalled bet ($0.01) returned to Fran1809
Fran1809 collected $0.02 from pot
*** SUMMARY ***
Total pot $0.02 | Rake $0
Seat 1: hilarjo (button) folded before Flop (didn't bet)
Seat 2: Xtens (small blind) folded before Flop
Seat 3: Fran1809 (big blind) collected ($0.02)
Seat 4: yuyu767 folded before Flop (didn't bet)
Seat 5: hoholas22 folded before Flop (didn't bet)
Seat 6: Daklien_Poke folded before Flop (didn't bet)


PokerStars Hand #238163260012:  Hold'em No Limit ($0.01/$0.02 USD) - 2022/08/23 4:50:06 ET
Table 'Achilles IV' 6-max Seat #3 is the button
Seat 1: hilarjo ($2 in chips)
Seat 2: Xtens ($2.39 in chips)
Seat 3: Fran1809 ($2.74 in chips)
Seat 4: yuyu767 ($3.32 in chips)
Seat 5: hoholas22 ($2.38 in chips)
Seat 6: Daklien_Poke ($0.96 in chips)
yuyu767: posts small blind $0.01
hoholas22: posts big blind $0.02
*** HOLE CARDS ***
Daklien_Poke: folds
hilarjo: folds
Xtens: folds
Fran1809: calls $0.02
yuyu767: folds
hoholas22: checks
*** FLOP *** [Ts Td 8d]
hoholas22: checks
Fran1809: bets $0.05
hoholas22: folds
Uncalled bet ($0.05) returned to Fran1809
Fran1809 collected $0.05 from pot
*** SUMMARY ***
Total pot $0.05 | Rake $0
Board [Ts Td 8d]
Seat 1: hilarjo folded before Flop (didn't bet)
Seat 2: Xtens folded before Flop (didn't bet)
Seat 3: Fran1809 (button) collected ($0.05)
Seat 4: yuyu767 (small blind) folded before Flop
Seat 5: hoholas22 (big blind) folded on the Flop
Seat 6: Daklien_Poke folded before Flop (didn't bet)


PokerStars Hand #238163263267:  Hold'em No Limit ($0.01/$0.02 USD) - 2022/08/23 4:50:30 ET
Table 'Achilles IV' 6-max Seat #4 is the button
Seat 1: hilarjo ($2 in chips)
Seat 2: Xtens ($2.39 in chips)
Seat 3: Fran1809 ($2.77 in chips)
Seat 4: yuyu767 ($3.31 in chips)
Seat 5: hoholas22 ($2.36 in chips)
Seat 6: Daklien_Poke ($0.96 in chips)
hoholas22: posts small blind $0.01
Daklien_Poke: posts big blind $0.02
*** HOLE CARDS ***
hilarjo: folds
Xtens: folds
Fran1809: calls $0.02
yuyu767: folds
hoholas22: folds
Daklien_Poke: checks
*** FLOP *** [3c 9c Ks]
Daklien_Poke: checks
Fran1809: checks
*** TURN *** [3c 9c Ks] [Js]
Daklien_Poke: bets $0.02
Fran1809: calls $0.02
*** RIVER *** [3c 9c Ks Js] [Qc]
Daklien_Poke: checks
Fran1809: checks
*** SHOW DOWN ***
Daklien_Poke: shows [7c Jd] (a pair of Jacks)
Fran1809: mucks hand
Daklien_Poke collected $0.09 from pot
*** SUMMARY ***
Total pot $0.09 | Rake $0
Board [3c 9c Ks Js Qc]
Seat 1: hilarjo folded before Flop (didn't bet)
Seat 2: Xtens folded before Flop (didn't bet)
Seat 3: Fran1809 mucked
Seat 4: yuyu767 (button) folded before Flop (didn't bet)
Seat 5: hoholas22 (small blind) folded before Flop
Seat 6: Daklien_Poke (big blind) showed [7c Jd] and won ($0.09) with a pair of Jacks


PokerStars Hand #238163267600:  Hold'em No Limit ($0.01/$0.02 USD) - 2022/08/23 4:51:02 ET
Table 'Achilles IV' 6-max Seat #5 is the button
Seat 1: hilarjo ($2 in chips)
Seat 2: Xtens ($2.39 in chips)
Seat 3: Fran1809 ($2.73 in chips)
Seat 4: yuyu767 ($3.31 in chips)
Seat 5: hoholas22 ($2.35 in chips)
Seat 6: Daklien_Poke ($1.01 in chips)
Daklien_Poke: posts small blind $0.01
hilarjo: posts big blind $0.02
*** HOLE CARDS ***
Xtens: folds
Fran1809: calls $0.02
yuyu767: folds
hoholas22: folds
Daklien_Poke: folds
hilarjo: checks
*** FLOP *** [7c Kh 2c]
hilarjo: checks
Fran1809: bets $0.05
hilarjo: folds
Uncalled bet ($0.05) returned to Fran1809
Fran1809 collected $0.05 from pot
*** SUMMARY ***
Total pot $0.05 | Rake $0
Board [7c Kh 2c]
Seat 1: hilarjo (big blind) folded on the Flop
Seat 2: Xtens folded before Flop (didn't bet)
Seat 3: Fran1809 collected ($0.05)
Seat 4: yuyu767 folded before Flop (didn't bet)
Seat 5: hoholas22 (button) folded before Flop (didn't bet)
Seat 6: Daklien_Poke (small blind) folded before Flop


PokerStars Hand #238163271414:  Hold'em No Limit ($0.01/$0.02 USD) - 2022/08/23 4:51:29 ET
Table 'Achilles IV' 6-max Seat #6 is the button
Seat 1: hilarjo ($2 in chips)
Seat 2: Xtens ($2.39 in chips)
Seat 3: Fran1809 ($2.76 in chips)
Seat 4: yuyu767 ($3.31 in chips)
Seat 5: hoholas22 ($2.35 in chips)
Seat 6: Daklien_Poke ($1 in chips)
hilarjo: posts small blind $0.01
Xtens: posts big blind $0.02
*** HOLE CARDS ***
Fran1809: folds
yuyu767: folds
hoholas22: folds
Daklien_Poke: folds
hilarjo: folds
Uncalled bet ($0.01) returned to Xtens
Xtens collected $0.02 from pot
Xtens: doesn't show hand
*** SUMMARY ***
Total pot $0.02 | Rake $0
Seat 1: hilarjo (small blind) folded before Flop
Seat 2: Xtens (big blind) collected ($0.02)
Seat 3: Fran1809 folded before Flop (didn't bet)
Seat 4: yuyu767 folded before Flop (didn't bet)
Seat 5: hoholas22 folded before Flop (didn't bet)
Seat 6: Daklien_Poke (button) folded before Flop (didn't bet)


PokerStars Hand #238163272515:  Hold'em No Limit ($0.01/$0.02 USD) - 2022/08/23 4:51:38 ET
Table 'Achilles IV' 6-max Seat #1 is the button
Seat 1: hilarjo ($2 in chips)
Seat 2: Xtens ($2.40 in chips)
Seat 3: Fran1809 ($2.76 in chips)
Seat 4: yuyu767 ($3.31 in chips)
Seat 5: hoholas22 ($2.35 in chips)
Seat 6: Daklien_Poke ($1 in chips)
Xtens: posts small blind $0.01
Fran1809: posts big blind $0.02
*** HOLE CARDS ***
yuyu767: folds
hoholas22: folds
Daklien_Poke: raises $0.03 to $0.05
hilarjo: raises $0.13 to $0.18
Xtens: folds
Fran1809: folds
Daklien_Poke: folds
Uncalled bet ($0.13) returned to hilarjo
hilarjo collected $0.13 from pot
hilarjo: doesn't show hand
*** SUMMARY ***
Total pot $0.13 | Rake $0
Seat 1: hilarjo (button) collected ($0.13)
Seat 2: Xtens (small blind) folded before Flop
Seat 3: Fran1809 (big blind) folded before Flop
Seat 4: yuyu767 folded before Flop (didn't bet)
Seat 5: hoholas22 folded before Flop (didn't bet)
Seat 6: Daklien_Poke folded before Flop


PokerStars Hand #238163275639:  Hold'em No Limit ($0.01/$0.02 USD) - 2022/08/23 4:52:01 ET
Table 'Achilles IV' 6-max Seat #2 is the button
Seat 1: hilarjo ($2.08 in chips)
Seat 2: Xtens ($2.39 in chips)
Seat 3: Fran1809 ($2.74 in chips)
Seat 4: yuyu767 ($3.31 in chips)
Seat 5: hoholas22 ($2.35 in chips)
Seat 6: Daklien_Poke ($0.95 in chips)
Fran1809: posts small blind $0.01
yuyu767: posts big blind $0.02
*** HOLE CARDS ***
hoholas22: folds
Daklien_Poke: folds
hilarjo: folds
Xtens: raises $0.03 to $0.05
Fran1809: folds
yuyu767: raises $0.05 to $0.10
Xtens: calls $0.05
*** FLOP *** [Js 2d Qh]
yuyu767: checks
Xtens: checks
*** TURN *** [Js 2d Qh] [Ad]
yuyu767: bets $0.10
Xtens: calls $0.10
*** RIVER *** [Js 2d Qh Ad] [6s]
yuyu767: bets $0.20
Xtens: calls $0.20
*** SHOW DOWN ***
yuyu767: shows [Kd Ac] (a pair of Aces)
Xtens: mucks hand
yuyu767 collected $0.78 from pot
*** SUMMARY ***
Total pot $0.81 | Rake $0.03
Board [Js 2d Qh Ad 6s]
Seat 1: hilarjo folded before Flop (didn't bet)
Seat 2: Xtens (button) mucked
Seat 3: Fran1809 (small blind) folded before Flop
Seat 4: yuyu767 (big blind) showed [Kd Ac] and won ($0.78) with a pair of Aces
Seat 5: hoholas22 folded before Flop (didn't bet)
Seat 6: Daklien_Poke folded before Flop (didn't bet)


PokerStars Hand #238163284563:  Hold'em No Limit ($0.01/$0.02 USD) - 2022/08/23 4:53:07 ET
Table 'Achilles IV' 6-max Seat #3 is the button
Seat 1: hilarjo ($2.08 in chips)
Seat 2: Xtens ($1.99 in chips)
Seat 3: Fran1809 ($2.73 in chips)
Seat 4: yuyu767 ($3.69 in chips)
Seat 5: hoholas22 ($2.35 in chips)
Seat 6: Daklien_Poke ($0.95 in chips)
yuyu767: posts small blind $0.01
hoholas22: posts big blind $0.02
*** HOLE CARDS ***
Daklien_Poke: folds
hilarjo: raises $0.04 to $0.06
Xtens: folds
Fran1809: calls $0.06
yuyu767: folds
hoholas22: calls $0.04
*** FLOP *** [Kh Jd 7d]
hoholas22: checks
hilarjo: checks
Fran1809: checks
*** TURN *** [Kh Jd 7d] [7h]
hoholas22: bets $0.09
hilarjo: folds
Fran1809: calls $0.09
*** RIVER *** [Kh Jd 7d 7h] [8h]
hoholas22: bets $0.36
Fran1809: folds
Uncalled bet ($0.36) returned to hoholas22
hoholas22 collected $0.36 from pot
*** SUMMARY ***
Total pot $0.37 | Rake $0.01
Board [Kh Jd 7d 7h 8h]
Seat 1: hilarjo folded on the Turn
Seat 2: Xtens folded before Flop (didn't bet)
Seat 3: Fran1809 (button) folded on the River
Seat 4: yuyu767 (small blind) folded before Flop
Seat 5: hoholas22 (big blind) collected ($0.36)
Seat 6: Daklien_Poke folded before Flop (didn't bet)


PokerStars Hand #238163292425:  Hold'em No Limit ($0.01/$0.02 USD) - 2022/08/23 4:54:05 ET
Table 'Achilles IV' 6-max Seat #4 is the button
Seat 1: hilarjo ($2.02 in chips)
Seat 2: Xtens ($1.99 in chips)
Seat 3: Fran1809 ($2.58 in chips)
Seat 4: yuyu767 ($3.68 in chips)
Seat 5: hoholas22 ($2.56 in chips)
Seat 6: Daklien_Poke ($0.95 in chips)
hoholas22: posts small blind $0.01
Daklien_Poke: posts big blind $0.02
*** HOLE CARDS ***
hilarjo: folds
Xtens: folds
Fran1809: calls $0.02
yuyu767: folds
hoholas22: folds
Daklien_Poke: checks
*** FLOP *** [Qh 6c Ks]
Daklien_Poke: checks
Fran1809: bets $0.02
Daklien_Poke: calls $0.02
*** TURN *** [Qh 6c Ks] [7h]
Daklien_Poke: checks
Fran1809: bets $0.02
Daklien_Poke: calls $0.02
*** RIVER *** [Qh 6c Ks 7h] [Th]
Daklien_Poke: checks
Fran1809: bets $0.13
Daklien_Poke: folds
Uncalled bet ($0.13) returned to Fran1809
Fran1809 collected $0.13 from pot
*** SUMMARY ***
Total pot $0.13 | Rake $0
Board [Qh 6c Ks 7h Th]
Seat 1: hilarjo folded before Flop (didn't bet)
Seat 2: Xtens folded before Flop (didn't bet)
Seat 3: Fran1809 collected ($0.13)
Seat 4: yuyu767 (button) folded before Flop (didn't bet)
Seat 5: hoholas22 (small blind) folded before Flop
Seat 6: Daklien_Poke (big blind) folded on the River


PokerStars Hand #238163296512:  Hold'em No Limit ($0.01/$0.02 USD) - 2022/08/23 4:54:35 ET
Table 'Achilles IV' 6-max Seat #5 is the button
Seat 1: hilarjo ($2.02 in chips)
Seat 2: Xtens ($1.99 in chips)
Seat 4: yuyu767 ($3.68 in chips)
Seat 5: hoholas22 ($2.55 in chips)
Seat 6: Daklien_Poke ($0.89 in chips)
Daklien_Poke: posts small blind $0.01
hilarjo: posts big blind $0.02
*** HOLE CARDS ***
Xtens: folds
Fran1809 leaves the table
yuyu767: raises $0.02 to $0.04
hoholas22: folds
Daklien_Poke: folds
hilarjo: calls $0.02
*** FLOP *** [3c 6d Qs]
hilarjo: checks
yuyu767: checks
*** TURN *** [3c 6d Qs] [2c]
hilarjo: bets $0.07
yuyu767: calls $0.07
*** RIVER *** [3c 6d Qs 2c] [As]
hilarjo: checks
yuyu767: bets $0.15
hilarjo: folds
Uncalled bet ($0.15) returned to yuyu767
yuyu767 collected $0.22 from pot
*** SUMMARY ***
Total pot $0.23 | Rake $0.01
Board [3c 6d Qs 2c As]
Seat 1: hilarjo (big blind) folded on the River
Seat 2: Xtens folded before Flop (didn't bet)
Seat 4: yuyu767 collected ($0.22)
Seat 5: hoholas22 (button) folded before Flop (didn't bet)
Seat 6: Daklien_Poke (small blind) folded before Flop


PokerStars Hand #238163304345:  Hold'em No Limit ($0.01/$0.02 USD) - 2022/08/23 4:55:35 ET
Table 'Achilles IV' 6-max Seat #1 is the button
Seat 1: hilarjo ($2 in chips)
Seat 4: yuyu767 ($3.80 in chips)
Seat 5: hoholas22 ($2.55 in chips)
Seat 6: Daklien_Poke ($0.88 in chips)
yuyu767: posts small blind $0.01
hoholas22: posts big blind $0.02
*** HOLE CARDS ***
Daklien_Poke: folds
hilarjo: folds
yuyu767: folds
Uncalled bet ($0.01) returned to hoholas22
hoholas22 collected $0.02 from pot
*** SUMMARY ***
Total pot $0.02 | Rake $0
Seat 1: hilarjo (button) folded before Flop (didn't bet)
Seat 4: yuyu767 (small blind) folded before Flop
Seat 5: hoholas22 (big blind) collected ($0.02)
Seat 6: Daklien_Poke folded before Flop (didn't bet)


PokerStars Hand #238163303308:  Hold'em No Limit ($0.01/$0.02 USD) - 2022/08/23 4:55:26 ET
Table 'Achilles IV' 6-max Seat #6 is the button
Seat 1: hilarjo ($2 in chips)
Seat 4: yuyu767 ($3.79 in chips)
Seat 5: hoholas22 ($2.55 in chips)
Seat 6: Daklien_Poke ($0.88 in chips)
hilarjo: posts small blind $0.01
Xtens: is sitting out
yuyu767: posts big blind $0.02
*** HOLE CARDS ***
hoholas22: folds
Daklien_Poke: folds
Xtens leaves the table
hilarjo: folds
Uncalled bet ($0.01) returned to yuyu767
yuyu767 collected $0.02 from pot
*** SUMMARY ***
Total pot $0.02 | Rake $0
Seat 1: hilarjo (small blind) folded before Flop
Seat 4: yuyu767 (big blind) collected ($0.02)
Seat 5: hoholas22 folded before Flop (didn't bet)
Seat 6: Daklien_Poke (button) folded before Flop (didn't bet)


PokerStars Hand #238163305070:  Hold'em No Limit ($0.01/$0.02 USD) - 2022/08/23 4:55:41 ET
Table 'Achilles IV' 6-max Seat #4 is the button
Seat 1: hilarjo ($2 in chips)
Seat 4: yuyu767 ($3.79 in chips)
Seat 5: hoholas22 ($2.56 in chips)
Seat 6: Daklien_Poke ($0.88 in chips)
hoholas22: posts small blind $0.01
Daklien_Poke: posts big blind $0.02
*** HOLE CARDS ***
hilarjo: folds
yuyu767: folds
hoholas22: folds
Uncalled bet ($0.01) returned to Daklien_Poke
Daklien_Poke collected $0.02 from pot
Daklien_Poke: doesn't show hand
*** SUMMARY ***
Total pot $0.02 | Rake $0
Seat 1: hilarjo folded before Flop (didn't bet)
Seat 4: yuyu767 (button) folded before Flop (didn't bet)
Seat 5: hoholas22 (small blind) folded before Flop
Seat 6: Daklien_Poke (big blind) collected ($0.02)


PokerStars Hand #238163306057:  Hold'em No Limit ($0.01/$0.02 USD) - 2022/08/23 4:55:50 ET
Table 'Achilles IV' 6-max Seat #5 is the button
Seat 1: hilarjo ($2 in chips)
Seat 4: yuyu767 ($3.79 in chips)
Seat 5: hoholas22 ($2.55 in chips)
Seat 6: Daklien_Poke ($0.89 in chips)
Daklien_Poke: posts small blind $0.01
hilarjo: posts big blind $0.02
*** HOLE CARDS ***
yuyu767: raises $0.02 to $0.04
hoholas22: folds
Daklien_Poke: folds
hilarjo: folds
Uncalled bet ($0.02) returned to yuyu767
yuyu767 collected $0.05 from pot
*** SUMMARY ***
Total pot $0.05 | Rake $0
Seat 1: hilarjo (big blind) folded before Flop
Seat 4: yuyu767 collected ($0.05)
Seat 5: hoholas22 (button) folded before Flop (didn't bet)
Seat 6: Daklien_Poke (small blind) folded before Flop


PokerStars Hand #238163309780:  Hold'em No Limit ($0.01/$0.02 USD) - 2022/08/23 4:56:21 ET
Table 'Achilles IV' 6-max Seat #1 is the button
Seat 1: hilarjo ($2 in chips)
Seat 4: yuyu767 ($3.80 in chips)
Seat 5: hoholas22 ($2.55 in chips)
Seat 6: Daklien_Poke ($0.91 in chips)
yuyu767: posts small blind $0.01
hoholas22: posts big blind $0.02
*** HOLE CARDS ***
Daklien_Poke: raises $0.03 to $0.05
hilarjo: folds
yuyu767: folds
hoholas22: folds
Uncalled bet ($0.03) returned to Daklien_Poke
Daklien_Poke collected $0.05 from pot
Daklien_Poke: doesn't show hand
*** SUMMARY ***
Total pot $0.05 | Rake $0
Seat 1: hilarjo (button) folded before Flop (didn't bet)
Seat 4: yuyu767 (small blind) folded before Flop
Seat 5: hoholas22 (big blind) folded before Flop
Seat 6: Daklien_Poke collected ($0.05)


PokerStars Hand #238163308434:  Hold'em No Limit ($0.01/$0.02 USD) - 2022/08/23 4:56:09 ET
Table 'Achilles IV' 6-max Seat #6 is the button
Seat 1: hilarjo ($2 in chips)
Seat 4: yuyu767 ($3.82 in chips)
Seat 5: hoholas22 ($2.55 in chips)
Seat 6: Daklien_Poke ($0.88 in chips)
hilarjo: posts small blind $0.01
yuyu767: posts big blind $0.02
*** HOLE CARDS ***
hoholas22: folds
Daklien_Poke: raises $0.03 to $0.05
hilarjo: folds
yuyu767: folds
Uncalled bet ($0.03) returned to Daklien_Poke
Daklien_Poke collected $0.05 from pot
Daklien_Poke: doesn't show hand
*** SUMMARY ***
Total pot $0.05 | Rake $0
Seat 1: hilarjo (small blind) folded before Flop
Seat 4: yuyu767 (big blind) folded before Flop
Seat 5: hoholas22 folded before Flop (didn't bet)
Seat 6: Daklien_Poke (button) collected ($0.05)


PokerStars Hand #238163311288:  Hold'em No Limit ($0.01/$0.02 USD) - 2022/08/23 4:56:33 ET
Table 'Achilles IV' 6-max Seat #4 is the button
Seat 1: hilarjo ($2 in chips)
Seat 4: yuyu767 ($3.79 in chips)
Seat 5: hoholas22 ($2.53 in chips)
Seat 6: Daklien_Poke ($0.94 in chips)
hoholas22: posts small blind $0.01
Daklien_Poke: posts big blind $0.02
*** HOLE CARDS ***
hilarjo: folds
yuyu767: folds
hoholas22: folds
Uncalled bet ($0.01) returned to Daklien_Poke
Daklien_Poke collected $0.02 from pot
Daklien_Poke: doesn't show hand
*** SUMMARY ***
Total pot $0.02 | Rake $0
Seat 1: hilarjo folded before Flop (didn't bet)
Seat 4: yuyu767 (button) folded before Flop (didn't bet)
Seat 5: hoholas22 (small blind) folded before Flop
Seat 6: Daklien_Poke (big blind) collected ($0.02)


PokerStars Hand #238163312608:  Hold'em No Limit ($0.01/$0.02 USD) - 2022/08/23 4:56:44 ET
Table 'Achilles IV' 6-max Seat #5 is the button
Seat 1: hilarjo ($2 in chips)
Seat 4: yuyu767 ($3.79 in chips)
Seat 5: hoholas22 ($2.52 in chips)
Seat 6: Daklien_Poke ($0.95 in chips)
Daklien_Poke: posts small blind $0.01
hilarjo: posts big blind $0.02
*** HOLE CARDS ***
yuyu767: folds
yuyu767 leaves the table
hoholas22: folds
Daklien_Poke: calls $0.01
hilarjo: checks
*** FLOP *** [9s Jh 9c]
Daklien_Poke: bets $0.02
hilarjo: folds
Uncalled bet ($0.02) returned to Daklien_Poke
Daklien_Poke collected $0.04 from pot
Daklien_Poke: doesn't show hand
*** SUMMARY ***
Total pot $0.04 | Rake $0
Board [9s Jh 9c]
Seat 1: hilarjo (big blind) folded on the Flop
Seat 4: yuyu767 folded before Flop (didn't bet)
Seat 5: hoholas22 (button) folded before Flop (didn't bet)
Seat 6: Daklien_Poke (small blind) collected ($0.04)


PokerStars Hand #238163315658:  Hold'em No Limit ($0.01/$0.02 USD) - 2022/08/23 4:57:10 ET
Table 'Achilles IV' 6-max Seat #6 is the button
Seat 1: hilarjo ($2 in chips)
Seat 5: hoholas22 ($2.52 in chips)
Seat 6: Daklien_Poke ($0.97 in chips)
hilarjo: posts small blind $0.01
hoholas22: posts big blind $0.02
*** HOLE CARDS ***
Daklien_Poke: raises $0.03 to $0.05
hilarjo: folds
hoholas22: folds
Uncalled bet ($0.03) returned to Daklien_Poke
Daklien_Poke collected $0.05 from pot
Daklien_Poke: doesn't show hand
*** SUMMARY ***
Total pot $0.05 | Rake $0
Seat 1: hilarjo (small blind) folded before Flop
Seat 5: hoholas22 (big blind) folded before Flop
Seat 6: Daklien_Poke (button) collected ($0.05)


PokerStars Hand #238163316632:  Hold'em No Limit ($0.01/$0.02 USD) - 2022/08/23 4:57:18 ET
Table 'Achilles IV' 6-max Seat #1 is the button
Seat 1: hilarjo ($2 in chips)
Seat 5: hoholas22 ($2.50 in chips)
Seat 6: Daklien_Poke ($1 in chips)
hoholas22: posts small blind $0.01
Daklien_Poke: posts big blind $0.02
*** HOLE CARDS ***
hilarjo: folds
hoholas22: folds
Uncalled bet ($0.01) returned to Daklien_Poke
Daklien_Poke collected $0.02 from pot
Daklien_Poke: doesn't show hand
*** SUMMARY ***
Total pot $0.02 | Rake $0
Seat 1: hilarjo (button) folded before Flop (didn't bet)
Seat 5: hoholas22 (small blind) folded before Flop
Seat 6: Daklien_Poke (big blind) collected ($0.02)


