PokerStars Hand #238166986633:  Hold'em No Limit ($0.01/$0.02 USD) - 2022/08/23 10:11:18 ET
Table 'Despina IV' 6-max Seat #3 is the button
Seat 1: superRODRI ($2.01 in chips)
Seat 3: KraVasya ($2 in chips)
Seat 6: pphu1 ($0.87 in chips)
pphu1: posts small blind $0.01
superRODRI: posts big blind $0.02
*** HOLE CARDS ***
axel030997 joins the table at seat #2
KraVasya: raises $0.03 to $0.05
pphu1: folds
palomino02 joins the table at seat #4
superRODRI: folds
Uncalled bet ($0.03) returned to KraVasya
KraVasya collected $0.05 from pot
KraVasya: doesn't show hand
*** SUMMARY ***
Total pot $0.05 | Rake $0
Seat 1: superRODRI (big blind) folded before Flop
Seat 3: KraVasya (button) collected ($0.05)
Seat 6: pphu1 (small blind) folded before Flop


PokerStars Hand #238166980649:  Hold'em No Limit ($0.01/$0.02 USD) - 2022/08/23 10:10:54 ET
Table 'Despina IV' 6-max Seat #1 is the button
Seat 1: superRODRI ($2.01 in chips)
Seat 3: KraVasya ($2 in chips)
Seat 6: pphu1 ($0.80 in chips)
KraVasya: posts small blind $0.01
rrvs100 joins the table at seat #5
pphu1: posts big blind $0.02
*** HOLE CARDS ***
superRODRI: folds
KraVasya: raises $0.03 to $0.05
pphu1: calls $0.03
*** FLOP *** [9c 6d 8h]
KraVasya: checks
pphu1: bets $0.02
KraVasya: calls $0.02
*** TURN *** [9c 6d 8h] [4h]
KraVasya: checks
pphu1: checks
*** RIVER *** [9c 6d 8h 4h] [Jc]
KraVasya: checks
pphu1: checks
*** SHOW DOWN ***
KraVasya: shows [7s Ks] (high card King)
pphu1: shows [Kd 8c] (a pair of Eights)
pphu1 collected $0.14 from pot
*** SUMMARY ***
Total pot $0.14 | Rake $0
Board [9c 6d 8h 4h Jc]
Seat 1: superRODRI (button) folded before Flop (didn't bet)
Seat 3: KraVasya (small blind) showed [7s Ks] and lost with high card King
Seat 6: pphu1 (big blind) showed [Kd 8c] and won ($0.14) with a pair of Eights


PokerStars Hand #238166988519:  Hold'em No Limit ($0.01/$0.02 USD) - 2022/08/23 10:11:25 ET
Table 'Despina IV' 6-max Seat #6 is the button
Seat 1: superRODRI ($2 in chips)
Seat 2: axel030997 ($2 in chips)
Seat 3: KraVasya ($2.03 in chips)
Seat 5: rrvs100 ($0.80 in chips)
Seat 6: pphu1 ($0.86 in chips)
superRODRI: posts small blind $0.01
axel030997: posts big blind $0.02
palomino02: sits out
rrvs100: posts big blind $0.02
*** HOLE CARDS ***
KraVasya: calls $0.02
rrvs100: checks
pphu1 has timed out
pphu1: folds
superRODRI: folds
axel030997: checks
*** FLOP *** [2c 6s Kh]
axel030997: checks
KraVasya: checks
rrvs100: checks
*** TURN *** [2c 6s Kh] [4s]
axel030997: checks
KraVasya: checks
rrvs100: checks
*** RIVER *** [2c 6s Kh 4s] [8s]
axel030997: checks
KraVasya: checks
rrvs100: bets $0.02
axel030997: folds
KraVasya: folds
Uncalled bet ($0.02) returned to rrvs100
rrvs100 collected $0.07 from pot
*** SUMMARY ***
Total pot $0.07 | Rake $0
Board [2c 6s Kh 4s 8s]
Seat 1: superRODRI (small blind) folded before Flop
Seat 2: axel030997 (big blind) folded on the River
Seat 3: KraVasya folded on the River
Seat 5: rrvs100 collected ($0.07)
Seat 6: pphu1 (button) folded before Flop (didn't bet)


PokerStars Hand #238167004356:  Hold'em No Limit ($0.01/$0.02 USD) - 2022/08/23 10:12:27 ET
Table 'Despina IV' 6-max Seat #1 is the button
Seat 1: superRODRI ($2 in chips)
Seat 2: axel030997 ($1.98 in chips)
Seat 3: KraVasya ($2.01 in chips)
Seat 4: palomino02 ($2 in chips)
Seat 5: rrvs100 ($0.85 in chips)
axel030997: posts small blind $0.01
KraVasya: posts big blind $0.02
palomino02: posts big blind $0.02
*** HOLE CARDS ***
palomino02: checks
rrvs100: folds
superRODRI: calls $0.02
axel030997: folds
KraVasya: folds
*** FLOP *** [Js 2h Kc]
KraVasya leaves the table
palomino02: checks
superRODRI: checks
*** TURN *** [Js 2h Kc] [3h]
palomino02: checks
superRODRI: bets $0.08
palomino02: folds
Uncalled bet ($0.08) returned to superRODRI
superRODRI collected $0.07 from pot
superRODRI: doesn't show hand
*** SUMMARY ***
Total pot $0.07 | Rake $0
Board [Js 2h Kc 3h]
Seat 1: superRODRI (button) collected ($0.07)
Seat 2: axel030997 (small blind) folded before Flop
Seat 3: KraVasya (big blind) folded before Flop
Seat 4: palomino02 folded on the Turn (didn't bet)
Seat 5: rrvs100 folded before Flop (didn't bet)


PokerStars Hand #238167012997:  Hold'em No Limit ($0.01/$0.02 USD) - 2022/08/23 10:13:01 ET
Table 'Despina IV' 6-max Seat #2 is the button
Seat 1: superRODRI ($2.05 in chips)
Seat 2: axel030997 ($1.97 in chips)
Seat 4: palomino02 ($1.98 in chips)
Seat 5: rrvs100 ($0.85 in chips)
palomino02: posts small blind $0.01
rrvs100: posts big blind $0.02
*** HOLE CARDS ***
superRODRI: raises $0.05 to $0.07
Jero0987 joins the table at seat #3
axel030997: folds
palomino02: folds
rrvs100: folds
Uncalled bet ($0.05) returned to superRODRI
superRODRI collected $0.05 from pot
superRODRI: doesn't show hand
*** SUMMARY ***
Total pot $0.05 | Rake $0
Seat 1: superRODRI collected ($0.05)
Seat 2: axel030997 (button) folded before Flop (didn't bet)
Seat 4: palomino02 (small blind) folded before Flop
Seat 5: rrvs100 (big blind) folded before Flop


PokerStars Hand #238167017705:  Hold'em No Limit ($0.01/$0.02 USD) - 2022/08/23 10:13:20 ET
Table 'Despina IV' 6-max Seat #4 is the button
Seat 1: superRODRI ($2.08 in chips)
Seat 2: axel030997 ($1.97 in chips)
Seat 4: palomino02 ($1.97 in chips)
Seat 5: rrvs100 ($0.83 in chips)
rrvs100: posts small blind $0.01
superRODRI: posts big blind $0.02
Jero0987: sits out
*** HOLE CARDS ***
axel030997: folds
palomino02: folds
rrvs100: calls $0.01
superRODRI: raises $0.04 to $0.06
rrvs100: calls $0.04
*** FLOP *** [5h Qc 9d]
rrvs100: checks
superRODRI: bets $0.10
rrvs100: folds
Uncalled bet ($0.10) returned to superRODRI
superRODRI collected $0.12 from pot
superRODRI: doesn't show hand
*** SUMMARY ***
Total pot $0.12 | Rake $0
Board [5h Qc 9d]
Seat 1: superRODRI (big blind) collected ($0.12)
Seat 2: axel030997 folded before Flop (didn't bet)
Seat 4: palomino02 (button) folded before Flop (didn't bet)
Seat 5: rrvs100 (small blind) folded on the Flop


PokerStars Hand #238167030402:  Hold'em No Limit ($0.01/$0.02 USD) - 2022/08/23 10:14:10 ET
Table 'Despina IV' 6-max Seat #5 is the button
Seat 1: superRODRI ($2.14 in chips)
Seat 2: axel030997 ($1.97 in chips)
Seat 4: palomino02 ($1.97 in chips)
Seat 5: rrvs100 ($0.77 in chips)
superRODRI: posts small blind $0.01
axel030997: posts big blind $0.02
Jero0987: sits out
*** HOLE CARDS ***
palomino02: folds
rrvs100: folds
superRODRI: raises $0.05 to $0.07
axel030997: folds
Uncalled bet ($0.05) returned to superRODRI
superRODRI collected $0.04 from pot
superRODRI: doesn't show hand
*** SUMMARY ***
Total pot $0.04 | Rake $0
Seat 1: superRODRI (small blind) collected ($0.04)
Seat 2: axel030997 (big blind) folded before Flop
Seat 4: palomino02 folded before Flop (didn't bet)
Seat 5: rrvs100 (button) folded before Flop (didn't bet)


PokerStars Hand #238167034633:  Hold'em No Limit ($0.01/$0.02 USD) - 2022/08/23 10:14:26 ET
Table 'Despina IV' 6-max Seat #1 is the button
Seat 1: superRODRI ($2.16 in chips)
Seat 2: axel030997 ($1.95 in chips)
Seat 3: Jero0987 ($2 in chips)
Seat 4: palomino02 ($1.97 in chips)
Seat 5: rrvs100 ($0.77 in chips)
axel030997: posts small blind $0.01
Jero0987: posts big blind $0.02
*** HOLE CARDS ***
palomino02: raises $0.04 to $0.06
rrvs100: folds
superRODRI: folds
axel030997: folds
Jero0987: folds
Uncalled bet ($0.04) returned to palomino02
palomino02 collected $0.05 from pot
*** SUMMARY ***
Total pot $0.05 | Rake $0
Seat 1: superRODRI (button) folded before Flop (didn't bet)
Seat 2: axel030997 (small blind) folded before Flop
Seat 3: Jero0987 (big blind) folded before Flop
Seat 4: palomino02 collected ($0.05)
Seat 5: rrvs100 folded before Flop (didn't bet)


PokerStars Hand #238167039355:  Hold'em No Limit ($0.01/$0.02 USD) - 2022/08/23 10:14:45 ET
Table 'Despina IV' 6-max Seat #2 is the button
Seat 1: superRODRI ($2.16 in chips)
Seat 2: axel030997 ($1.94 in chips)
Seat 3: Jero0987 ($1.98 in chips)
Seat 4: palomino02 ($2 in chips)
Seat 5: rrvs100 ($0.77 in chips)
Jero0987: posts small blind $0.01
palomino02: posts big blind $0.02
*** HOLE CARDS ***
rrvs100: folds
superRODRI: raises $0.05 to $0.07
axel030997: folds
Jero0987: folds
palomino02: raises $0.15 to $0.22
superRODRI: folds
Uncalled bet ($0.15) returned to palomino02
palomino02 collected $0.15 from pot
*** SUMMARY ***
Total pot $0.15 | Rake $0
Seat 1: superRODRI folded before Flop
Seat 2: axel030997 (button) folded before Flop (didn't bet)
Seat 3: Jero0987 (small blind) folded before Flop
Seat 4: palomino02 (big blind) collected ($0.15)
Seat 5: rrvs100 folded before Flop (didn't bet)


PokerStars Hand #238167046560:  Hold'em No Limit ($0.01/$0.02 USD) - 2022/08/23 10:15:13 ET
Table 'Despina IV' 6-max Seat #3 is the button
Seat 1: superRODRI ($2.09 in chips)
Seat 2: axel030997 ($1.94 in chips)
Seat 3: Jero0987 ($1.97 in chips)
Seat 4: palomino02 ($2.08 in chips)
Seat 5: rrvs100 ($0.77 in chips)
palomino02: posts small blind $0.01
rrvs100: posts big blind $0.02
*** HOLE CARDS ***
superRODRI: folds
axel030997: folds
Jero0987: folds
palomino02: calls $0.01
rrvs100: checks
*** FLOP *** [8d Ad 2s]
palomino02: bets $0.02
rrvs100: folds
Uncalled bet ($0.02) returned to palomino02
palomino02 collected $0.04 from pot
*** SUMMARY ***
Total pot $0.04 | Rake $0
Board [8d Ad 2s]
Seat 1: superRODRI folded before Flop (didn't bet)
Seat 2: axel030997 folded before Flop (didn't bet)
Seat 3: Jero0987 (button) folded before Flop (didn't bet)
Seat 4: palomino02 (small blind) collected ($0.04)
Seat 5: rrvs100 (big blind) folded on the Flop


PokerStars Hand #238167052300:  Hold'em No Limit ($0.01/$0.02 USD) - 2022/08/23 10:15:35 ET
Table 'Despina IV' 6-max Seat #4 is the button
Seat 1: superRODRI ($2.09 in chips)
Seat 2: axel030997 ($1.94 in chips)
Seat 3: Jero0987 ($1.97 in chips)
Seat 4: palomino02 ($2.10 in chips)
Seat 5: rrvs100 ($0.75 in chips)
rrvs100: posts small blind $0.01
superRODRI: posts big blind $0.02
*** HOLE CARDS ***
axel030997: folds
Jero0987: raises $0.04 to $0.06
palomino02: folds
rrvs100: calls $0.05
superRODRI: folds
*** FLOP *** [6h 8h 2s]
rrvs100: checks
Jero0987: checks
*** TURN *** [6h 8h 2s] [9d]
rrvs100: checks
Jero0987: bets $0.10
rrvs100: calls $0.10
*** RIVER *** [6h 8h 2s 9d] [2d]
rrvs100: bets $0.02
Jero0987: raises $0.18 to $0.20
rrvs100: folds
Uncalled bet ($0.18) returned to Jero0987
Jero0987 collected $0.37 from pot
*** SUMMARY ***
Total pot $0.38 | Rake $0.01
Board [6h 8h 2s 9d 2d]
Seat 1: superRODRI (big blind) folded before Flop
Seat 2: axel030997 folded before Flop (didn't bet)
Seat 3: Jero0987 collected ($0.37)
Seat 4: palomino02 (button) folded before Flop (didn't bet)
Seat 5: rrvs100 (small blind) folded on the River


PokerStars Hand #238167068016:  Hold'em No Limit ($0.01/$0.02 USD) - 2022/08/23 10:16:36 ET
Table 'Despina IV' 6-max Seat #5 is the button
Seat 1: superRODRI ($2.07 in chips)
Seat 2: axel030997 ($1.94 in chips)
Seat 3: Jero0987 ($2.16 in chips)
Seat 4: palomino02 ($2.10 in chips)
Seat 5: rrvs100 ($0.57 in chips)
superRODRI: posts small blind $0.01
axel030997: posts big blind $0.02
*** HOLE CARDS ***
Jero0987: folds
palomino02: raises $0.04 to $0.06
rrvs100: folds
superRODRI: folds
axel030997: folds
Uncalled bet ($0.04) returned to palomino02
palomino02 collected $0.05 from pot
*** SUMMARY ***
Total pot $0.05 | Rake $0
Seat 1: superRODRI (small blind) folded before Flop
Seat 2: axel030997 (big blind) folded before Flop
Seat 3: Jero0987 folded before Flop (didn't bet)
Seat 4: palomino02 collected ($0.05)
Seat 5: rrvs100 (button) folded before Flop (didn't bet)


PokerStars Hand #238167071549:  Hold'em No Limit ($0.01/$0.02 USD) - 2022/08/23 10:16:49 ET
Table 'Despina IV' 6-max Seat #1 is the button
Seat 1: superRODRI ($2.06 in chips)
Seat 2: axel030997 ($1.92 in chips)
Seat 3: Jero0987 ($2.16 in chips)
Seat 4: palomino02 ($2.13 in chips)
Seat 5: rrvs100 ($0.57 in chips)
axel030997: posts small blind $0.01
Jero0987: posts big blind $0.02
*** HOLE CARDS ***
palomino02: folds
rrvs100: folds
superRODRI: folds
axel030997: raises $0.04 to $0.06
Jero0987: calls $0.04
*** FLOP *** [6d 9d 3d]
axel030997: bets $0.04
Jero0987: calls $0.04
*** TURN *** [6d 9d 3d] [4h]
axel030997: bets $0.08
Jero0987: calls $0.08
*** RIVER *** [6d 9d 3d 4h] [Kc]
axel030997: bets $0.18
Jero0987: folds
Uncalled bet ($0.18) returned to axel030997
axel030997 collected $0.35 from pot
axel030997: doesn't show hand
*** SUMMARY ***
Total pot $0.36 | Rake $0.01
Board [6d 9d 3d 4h Kc]
Seat 1: superRODRI (button) folded before Flop (didn't bet)
Seat 2: axel030997 (small blind) collected ($0.35)
Seat 3: Jero0987 (big blind) folded on the River
Seat 4: palomino02 folded before Flop (didn't bet)
Seat 5: rrvs100 folded before Flop (didn't bet)


PokerStars Hand #238167085599:  Hold'em No Limit ($0.01/$0.02 USD) - 2022/08/23 10:17:44 ET
Table 'Despina IV' 6-max Seat #2 is the button
Seat 1: superRODRI ($2.06 in chips)
Seat 2: axel030997 ($2.09 in chips)
Seat 3: Jero0987 ($1.98 in chips)
Seat 4: palomino02 ($2.13 in chips)
Seat 5: rrvs100 ($0.57 in chips)
Jero0987: posts small blind $0.01
palomino02: posts big blind $0.02
*** HOLE CARDS ***
rrvs100: folds
superRODRI: folds
axel030997: folds
Jero0987: raises $0.04 to $0.06
palomino02: calls $0.04
*** FLOP *** [3s Qh As]
Jero0987: bets $0.04
palomino02: folds
Uncalled bet ($0.04) returned to Jero0987
Jero0987 collected $0.12 from pot
*** SUMMARY ***
Total pot $0.12 | Rake $0
Board [3s Qh As]
Seat 1: superRODRI folded before Flop (didn't bet)
Seat 2: axel030997 (button) folded before Flop (didn't bet)
Seat 3: Jero0987 (small blind) collected ($0.12)
Seat 4: palomino02 (big blind) folded on the Flop
Seat 5: rrvs100 folded before Flop (didn't bet)


PokerStars Hand #238167092070:  Hold'em No Limit ($0.01/$0.02 USD) - 2022/08/23 10:18:09 ET
Table 'Despina IV' 6-max Seat #3 is the button
Seat 1: superRODRI ($2.06 in chips)
Seat 2: axel030997 ($2.09 in chips)
Seat 3: Jero0987 ($2.04 in chips)
Seat 4: palomino02 ($2.07 in chips)
Seat 5: rrvs100 ($0.57 in chips)
palomino02: posts small blind $0.01
rrvs100: posts big blind $0.02
*** HOLE CARDS ***
superRODRI: folds
axel030997: folds
Jero0987: folds
palomino02: folds
Uncalled bet ($0.01) returned to rrvs100
rrvs100 collected $0.02 from pot
*** SUMMARY ***
Total pot $0.02 | Rake $0
Seat 1: superRODRI folded before Flop (didn't bet)
Seat 2: axel030997 folded before Flop (didn't bet)
Seat 3: Jero0987 (button) folded before Flop (didn't bet)
Seat 4: palomino02 (small blind) folded before Flop
Seat 5: rrvs100 (big blind) collected ($0.02)


PokerStars Hand #238167095705:  Hold'em No Limit ($0.01/$0.02 USD) - 2022/08/23 10:18:23 ET
Table 'Despina IV' 6-max Seat #4 is the button
Seat 1: superRODRI ($2.06 in chips)
Seat 2: axel030997 ($2.09 in chips)
Seat 3: Jero0987 ($2.04 in chips)
Seat 4: palomino02 ($2.06 in chips)
Seat 5: rrvs100 ($0.58 in chips)
rrvs100: posts small blind $0.01
superRODRI: posts big blind $0.02
*** HOLE CARDS ***
axel030997: folds
Jero0987: raises $0.04 to $0.06
palomino02: folds
rrvs100: folds
superRODRI: folds
Uncalled bet ($0.04) returned to Jero0987
Jero0987 collected $0.05 from pot
*** SUMMARY ***
Total pot $0.05 | Rake $0
Seat 1: superRODRI (big blind) folded before Flop
Seat 2: axel030997 folded before Flop (didn't bet)
Seat 3: Jero0987 collected ($0.05)
Seat 4: palomino02 (button) folded before Flop (didn't bet)
Seat 5: rrvs100 (small blind) folded before Flop


PokerStars Hand #238167104400:  Hold'em No Limit ($0.01/$0.02 USD) - 2022/08/23 10:18:56 ET
Table 'Despina IV' 6-max Seat #5 is the button
Seat 1: superRODRI ($2.04 in chips)
Seat 2: axel030997 ($2.09 in chips)
Seat 3: Jero0987 ($2.07 in chips)
Seat 4: palomino02 ($2.06 in chips)
Seat 5: rrvs100 ($0.57 in chips)
superRODRI: posts small blind $0.01
axel030997: posts big blind $0.02
*** HOLE CARDS ***
Jero0987: folds
palomino02: raises $0.04 to $0.06
rrvs100: folds
superRODRI: folds
axel030997: folds
Uncalled bet ($0.04) returned to palomino02
palomino02 collected $0.05 from pot
*** SUMMARY ***
Total pot $0.05 | Rake $0
Seat 1: superRODRI (small blind) folded before Flop
Seat 2: axel030997 (big blind) folded before Flop
Seat 3: Jero0987 folded before Flop (didn't bet)
Seat 4: palomino02 collected ($0.05)
Seat 5: rrvs100 (button) folded before Flop (didn't bet)


PokerStars Hand #238167109373:  Hold'em No Limit ($0.01/$0.02 USD) - 2022/08/23 10:19:15 ET
Table 'Despina IV' 6-max Seat #1 is the button
Seat 1: superRODRI ($2.03 in chips)
Seat 2: axel030997 ($2.07 in chips)
Seat 3: Jero0987 ($2.07 in chips)
Seat 4: palomino02 ($2.09 in chips)
Seat 5: rrvs100 ($0.57 in chips)
axel030997: posts small blind $0.01
Jero0987: posts big blind $0.02
*** HOLE CARDS ***
palomino02: raises $0.04 to $0.06
rrvs100: folds
superRODRI: folds
axel030997: folds
Jero0987: folds
Uncalled bet ($0.04) returned to palomino02
palomino02 collected $0.05 from pot
*** SUMMARY ***
Total pot $0.05 | Rake $0
Seat 1: superRODRI (button) folded before Flop (didn't bet)
Seat 2: axel030997 (small blind) folded before Flop
Seat 3: Jero0987 (big blind) folded before Flop
Seat 4: palomino02 collected ($0.05)
Seat 5: rrvs100 folded before Flop (didn't bet)


PokerStars Hand #238167112386:  Hold'em No Limit ($0.01/$0.02 USD) - 2022/08/23 10:19:27 ET
Table 'Despina IV' 6-max Seat #2 is the button
Seat 1: superRODRI ($2.03 in chips)
Seat 2: axel030997 ($2.06 in chips)
Seat 3: Jero0987 ($2.05 in chips)
Seat 4: palomino02 ($2.12 in chips)
Seat 5: rrvs100 ($0.57 in chips)
Jero0987: posts small blind $0.01
palomino02: posts big blind $0.02
*** HOLE CARDS ***
rrvs100: calls $0.02
superRODRI: folds
axel030997: folds
Jero0987: folds
palomino02: checks
*** FLOP *** [7h 4d 2h]
palomino02: checks
rrvs100: checks
*** TURN *** [7h 4d 2h] [7s]
palomino02: checks
rrvs100: checks
*** RIVER *** [7h 4d 2h 7s] [9h]
palomino02: checks
rrvs100: bets $0.02
palomino02: folds
Uncalled bet ($0.02) returned to rrvs100
rrvs100 collected $0.05 from pot
*** SUMMARY ***
Total pot $0.05 | Rake $0
Board [7h 4d 2h 7s 9h]
Seat 1: superRODRI folded before Flop (didn't bet)
Seat 2: axel030997 (button) folded before Flop (didn't bet)
Seat 3: Jero0987 (small blind) folded before Flop
Seat 4: palomino02 (big blind) folded on the River
Seat 5: rrvs100 collected ($0.05)


PokerStars Hand #238167121043:  Hold'em No Limit ($0.01/$0.02 USD) - 2022/08/23 10:20:00 ET
Table 'Despina IV' 6-max Seat #3 is the button
Seat 1: superRODRI ($2.03 in chips)
Seat 2: axel030997 ($2.06 in chips)
Seat 3: Jero0987 ($2.04 in chips)
Seat 4: palomino02 ($2.10 in chips)
Seat 5: rrvs100 ($0.60 in chips)
palomino02: posts small blind $0.01
rrvs100: posts big blind $0.02
*** HOLE CARDS ***
superRODRI: folds
axel030997: folds
Jero0987: folds
palomino02: raises $0.04 to $0.06
rrvs100: folds
Uncalled bet ($0.04) returned to palomino02
palomino02 collected $0.04 from pot
*** SUMMARY ***
Total pot $0.04 | Rake $0
Seat 1: superRODRI folded before Flop (didn't bet)
Seat 2: axel030997 folded before Flop (didn't bet)
Seat 3: Jero0987 (button) folded before Flop (didn't bet)
Seat 4: palomino02 (small blind) collected ($0.04)
Seat 5: rrvs100 (big blind) folded before Flop


PokerStars Hand #238167124248:  Hold'em No Limit ($0.01/$0.02 USD) - 2022/08/23 10:20:12 ET
Table 'Despina IV' 6-max Seat #4 is the button
Seat 1: superRODRI ($2.03 in chips)
Seat 2: axel030997 ($2.06 in chips)
Seat 3: Jero0987 ($2.04 in chips)
Seat 4: palomino02 ($2.12 in chips)
Seat 5: rrvs100 ($0.58 in chips)
rrvs100: posts small blind $0.01
superRODRI: posts big blind $0.02
*** HOLE CARDS ***
axel030997: folds
Jero0987: folds
palomino02: folds
rrvs100: folds
Uncalled bet ($0.01) returned to superRODRI
superRODRI collected $0.02 from pot
pphu1 was removed from the table for failing to post
pphu1 leaves the table
superRODRI: doesn't show hand
*** SUMMARY ***
Total pot $0.02 | Rake $0
Seat 1: superRODRI (big blind) collected ($0.02)
Seat 2: axel030997 folded before Flop (didn't bet)
Seat 3: Jero0987 folded before Flop (didn't bet)
Seat 4: palomino02 (button) folded before Flop (didn't bet)
Seat 5: rrvs100 (small blind) folded before Flop


PokerStars Hand #238167127127:  Hold'em No Limit ($0.01/$0.02 USD) - 2022/08/23 10:20:23 ET
Table 'Despina IV' 6-max Seat #5 is the button
Seat 1: superRODRI ($2.04 in chips)
Seat 2: axel030997 ($2.06 in chips)
Seat 3: Jero0987 ($2.04 in chips)
Seat 4: palomino02 ($2.12 in chips)
Seat 5: rrvs100 ($0.57 in chips)
superRODRI: posts small blind $0.01
axel030997: posts big blind $0.02
*** HOLE CARDS ***
Jero0987: folds
palomino02: folds
suetam4i20 joins the table at seat #6
rrvs100: folds
superRODRI: raises $0.05 to $0.07
axel030997: folds
Uncalled bet ($0.05) returned to superRODRI
superRODRI collected $0.04 from pot
superRODRI: doesn't show hand
*** SUMMARY ***
Total pot $0.04 | Rake $0
Seat 1: superRODRI (small blind) collected ($0.04)
Seat 2: axel030997 (big blind) folded before Flop
Seat 3: Jero0987 folded before Flop (didn't bet)
Seat 4: palomino02 folded before Flop (didn't bet)
Seat 5: rrvs100 (button) folded before Flop (didn't bet)


PokerStars Hand #238167131565:  Hold'em No Limit ($0.01/$0.02 USD) - 2022/08/23 10:20:40 ET
Table 'Despina IV' 6-max Seat #1 is the button
Seat 1: superRODRI ($2.06 in chips)
Seat 2: axel030997 ($2.04 in chips)
Seat 3: Jero0987 ($2.04 in chips)
Seat 4: palomino02 ($2.12 in chips)
Seat 5: rrvs100 ($0.57 in chips)
axel030997: posts small blind $0.01
Jero0987: posts big blind $0.02
suetam4i20: sits out
*** HOLE CARDS ***
palomino02: folds
rrvs100: folds
superRODRI: raises $0.05 to $0.07
axel030997: folds
Jero0987: calls $0.05
*** FLOP *** [7s 4d 6h]
Jero0987: checks
superRODRI: checks
*** TURN *** [7s 4d 6h] [7c]
Jero0987: checks
superRODRI: checks
*** RIVER *** [7s 4d 6h 7c] [6d]
Jero0987: checks
superRODRI: checks
*** SHOW DOWN ***
Jero0987: shows [Ad Jc] (two pair, Sevens and Sixes)
superRODRI: mucks hand
Jero0987 collected $0.14 from pot
*** SUMMARY ***
Total pot $0.15 | Rake $0.01
Board [7s 4d 6h 7c 6d]
Seat 1: superRODRI (button) mucked
Seat 2: axel030997 (small blind) folded before Flop
Seat 3: Jero0987 (big blind) showed [Ad Jc] and won ($0.14) with two pair, Sevens and Sixes
Seat 4: palomino02 folded before Flop (didn't bet)
Seat 5: rrvs100 folded before Flop (didn't bet)


PokerStars Hand #238167161840:  Hold'em No Limit ($0.01/$0.02 USD) - 2022/08/23 10:22:38 ET
Table 'Despina IV' 6-max Seat #3 is the button
Seat 1: superRODRI ($2 in chips)
Seat 2: axel030997 ($2.03 in chips)
Seat 3: Jero0987 ($1.92 in chips)
Seat 4: palomino02 ($2.10 in chips)
Seat 5: rrvs100 ($0.57 in chips)
Seat 6: suetam4i20 ($1.80 in chips)
palomino02: posts small blind $0.01
rrvs100: posts big blind $0.02
*** HOLE CARDS ***
suetam4i20: raises $0.02 to $0.04
superRODRI: folds
axel030997: calls $0.04
Jero0987: calls $0.04
palomino02: calls $0.03
rrvs100: calls $0.02
*** FLOP *** [2s Ah 8c]
palomino02: checks
rrvs100: checks
suetam4i20: checks
axel030997: bets $0.08
Jero0987: folds
palomino02: folds
rrvs100: folds
suetam4i20: folds
Uncalled bet ($0.08) returned to axel030997
axel030997 collected $0.19 from pot
axel030997: doesn't show hand
*** SUMMARY ***
Total pot $0.20 | Rake $0.01
Board [2s Ah 8c]
Seat 1: superRODRI folded before Flop (didn't bet)
Seat 2: axel030997 collected ($0.19)
Seat 3: Jero0987 (button) folded on the Flop
Seat 4: palomino02 (small blind) folded on the Flop
Seat 5: rrvs100 (big blind) folded on the Flop
Seat 6: suetam4i20 folded on the Flop


PokerStars Hand #238167141531:  Hold'em No Limit ($0.01/$0.02 USD) - 2022/08/23 10:21:19 ET
Table 'Despina IV' 6-max Seat #2 is the button
Seat 1: superRODRI ($2 in chips)
Seat 2: axel030997 ($2.03 in chips)
Seat 3: Jero0987 ($2.11 in chips)
Seat 4: palomino02 ($2.12 in chips)
Seat 5: rrvs100 ($0.57 in chips)
Seat 6: suetam4i20 ($1.60 in chips)
Jero0987: posts small blind $0.01
palomino02: posts big blind $0.02
suetam4i20: posts big blind $0.02
*** HOLE CARDS ***
rrvs100: folds
suetam4i20: checks
superRODRI: folds
axel030997: folds
Jero0987: raises $0.04 to $0.06
palomino02: folds
suetam4i20: calls $0.04
*** FLOP *** [9c 7s Ad]
Jero0987: bets $0.05
suetam4i20: calls $0.05
*** TURN *** [9c 7s Ad] [9s]
Jero0987: checks
suetam4i20: checks
*** RIVER *** [9c 7s Ad 9s] [2h]
Jero0987: bets $0.08
suetam4i20: raises $0.10 to $0.18
Jero0987: folds
Uncalled bet ($0.10) returned to suetam4i20
suetam4i20 collected $0.39 from pot
*** SUMMARY ***
Total pot $0.40 | Rake $0.01
Board [9c 7s Ad 9s 2h]
Seat 1: superRODRI folded before Flop (didn't bet)
Seat 2: axel030997 (button) folded before Flop (didn't bet)
Seat 3: Jero0987 (small blind) folded on the River
Seat 4: palomino02 (big blind) folded before Flop
Seat 5: rrvs100 folded before Flop (didn't bet)
Seat 6: suetam4i20 collected ($0.39)


PokerStars Hand #238167177981:  Hold'em No Limit ($0.01/$0.02 USD) - 2022/08/23 10:23:40 ET
Table 'Despina IV' 6-max Seat #4 is the button
Seat 1: superRODRI ($2 in chips)
Seat 2: axel030997 ($2.18 in chips)
Seat 3: Jero0987 ($1.88 in chips)
Seat 4: palomino02 ($2.06 in chips)
Seat 5: rrvs100 ($0.53 in chips)
Seat 6: suetam4i20 ($1.76 in chips)
rrvs100: posts small blind $0.01
suetam4i20: posts big blind $0.02
*** HOLE CARDS ***
superRODRI: folds
axel030997: folds
Jero0987: folds
palomino02: raises $0.04 to $0.06
rrvs100: folds
suetam4i20: calls $0.04
*** FLOP *** [9c Qc 8c]
suetam4i20: bets $0.02
palomino02: calls $0.02
*** TURN *** [9c Qc 8c] [9s]
suetam4i20: bets $0.02
palomino02: folds
Uncalled bet ($0.02) returned to suetam4i20
suetam4i20 collected $0.16 from pot
*** SUMMARY ***
Total pot $0.17 | Rake $0.01
Board [9c Qc 8c 9s]
Seat 1: superRODRI folded before Flop (didn't bet)
Seat 2: axel030997 folded before Flop (didn't bet)
Seat 3: Jero0987 folded before Flop (didn't bet)
Seat 4: palomino02 (button) folded on the Turn
Seat 5: rrvs100 (small blind) folded before Flop
Seat 6: suetam4i20 (big blind) collected ($0.16)


PokerStars Hand #238167188422:  Hold'em No Limit ($0.01/$0.02 USD) - 2022/08/23 10:24:13 ET
Table 'Despina IV' 6-max Seat #5 is the button
Seat 1: superRODRI ($2 in chips)
Seat 2: axel030997 ($2.18 in chips)
Seat 3: Jero0987 ($1.88 in chips)
Seat 4: palomino02 ($1.98 in chips)
Seat 5: rrvs100 ($0.52 in chips)
Seat 6: suetam4i20 ($1.84 in chips)
suetam4i20: posts small blind $0.01
superRODRI: posts big blind $0.02
*** HOLE CARDS ***
axel030997: folds
Jero0987: folds
palomino02: folds
rrvs100 has timed out
rrvs100: folds
suetam4i20: calls $0.01
superRODRI: checks
*** FLOP *** [2s 2h 5h]
suetam4i20: checks
superRODRI: checks
*** TURN *** [2s 2h 5h] [5d]
suetam4i20: checks
superRODRI: checks
*** RIVER *** [2s 2h 5h 5d] [7h]
suetam4i20: checks
superRODRI: checks
*** SHOW DOWN ***
suetam4i20: shows [As 6s] (two pair, Fives and Deuces)
superRODRI: mucks hand
suetam4i20 collected $0.04 from pot
*** SUMMARY ***
Total pot $0.04 | Rake $0
Board [2s 2h 5h 5d 7h]
Seat 1: superRODRI (big blind) mucked
Seat 2: axel030997 folded before Flop (didn't bet)
Seat 3: Jero0987 folded before Flop (didn't bet)
Seat 4: palomino02 folded before Flop (didn't bet)
Seat 5: rrvs100 (button) folded before Flop (didn't bet)
Seat 6: suetam4i20 (small blind) showed [As 6s] and won ($0.04) with two pair, Fives and Deuces


PokerStars Hand #238167200354:  Hold'em No Limit ($0.01/$0.02 USD) - 2022/08/23 10:24:59 ET
Table 'Despina IV' 6-max Seat #6 is the button
Seat 1: superRODRI ($2 in chips)
Seat 2: axel030997 ($2.18 in chips)
Seat 3: Jero0987 ($1.88 in chips)
Seat 4: palomino02 ($1.98 in chips)
Seat 6: suetam4i20 ($1.86 in chips)
superRODRI: posts small blind $0.01
axel030997: posts big blind $0.02
*** HOLE CARDS ***
Jero0987: folds
palomino02: raises $0.04 to $0.06
suetam4i20: folds
superRODRI: folds
axel030997: folds
Uncalled bet ($0.04) returned to palomino02
palomino02 collected $0.05 from pot
*** SUMMARY ***
Total pot $0.05 | Rake $0
Seat 1: superRODRI (small blind) folded before Flop
Seat 2: axel030997 (big blind) folded before Flop
Seat 3: Jero0987 folded before Flop (didn't bet)
Seat 4: palomino02 collected ($0.05)
Seat 6: suetam4i20 (button) folded before Flop (didn't bet)


PokerStars Hand #238167206105:  Hold'em No Limit ($0.01/$0.02 USD) - 2022/08/23 10:25:21 ET
Table 'Despina IV' 6-max Seat #1 is the button
Seat 1: superRODRI ($2 in chips)
Seat 2: axel030997 ($2.16 in chips)
Seat 3: Jero0987 ($1.88 in chips)
Seat 4: palomino02 ($2.01 in chips)
Seat 6: suetam4i20 ($1.86 in chips)
axel030997: posts small blind $0.01
Jero0987: posts big blind $0.02
*** HOLE CARDS ***
palomino02: folds
suetam4i20: folds
superRODRI: raises $0.05 to $0.07
axel030997: folds
Jero0987: folds
Uncalled bet ($0.05) returned to superRODRI
superRODRI collected $0.05 from pot
superRODRI: doesn't show hand
*** SUMMARY ***
Total pot $0.05 | Rake $0
Seat 1: superRODRI (button) collected ($0.05)
Seat 2: axel030997 (small blind) folded before Flop
Seat 3: Jero0987 (big blind) folded before Flop
Seat 4: palomino02 folded before Flop (didn't bet)
Seat 6: suetam4i20 folded before Flop (didn't bet)


PokerStars Hand #238167209111:  Hold'em No Limit ($0.01/$0.02 USD) - 2022/08/23 10:25:32 ET
Table 'Despina IV' 6-max Seat #2 is the button
Seat 1: superRODRI ($2.03 in chips)
Seat 2: axel030997 ($2.15 in chips)
Seat 3: Jero0987 ($1.86 in chips)
Seat 4: palomino02 ($2.01 in chips)
Seat 6: suetam4i20 ($1.86 in chips)
Jero0987: posts small blind $0.01
palomino02: posts big blind $0.02
*** HOLE CARDS ***
suetam4i20: calls $0.02
superRODRI: folds
axel030997: folds
Jero0987: raises $0.04 to $0.06
palomino02: folds
suetam4i20: calls $0.04
*** FLOP *** [Td 9h 4d]
Jero0987: checks
suetam4i20: bets $0.04
Jero0987: calls $0.04
*** TURN *** [Td 9h 4d] [9c]
Jero0987: checks
suetam4i20: bets $0.10
Jero0987: folds
Uncalled bet ($0.10) returned to suetam4i20
suetam4i20 collected $0.21 from pot
*** SUMMARY ***
Total pot $0.22 | Rake $0.01
Board [Td 9h 4d 9c]
Seat 1: superRODRI folded before Flop (didn't bet)
Seat 2: axel030997 (button) folded before Flop (didn't bet)
Seat 3: Jero0987 (small blind) folded on the Turn
Seat 4: palomino02 (big blind) folded before Flop
Seat 6: suetam4i20 collected ($0.21)


PokerStars Hand #238167224805:  Hold'em No Limit ($0.01/$0.02 USD) - 2022/08/23 10:26:32 ET
Table 'Despina IV' 6-max Seat #3 is the button
Seat 1: superRODRI ($2.03 in chips)
Seat 2: axel030997 ($2.15 in chips)
Seat 3: Jero0987 ($2 in chips)
Seat 4: palomino02 ($1.99 in chips)
Seat 5: rrvs100 ($0.52 in chips)
Seat 6: suetam4i20 ($1.97 in chips)
palomino02: posts small blind $0.01
rrvs100: posts big blind $0.02
*** HOLE CARDS ***
suetam4i20: folds
superRODRI: folds
axel030997: folds
Jero0987: raises $0.04 to $0.06
palomino02: folds
rrvs100: calls $0.04
*** FLOP *** [Ad 7c 8h]
rrvs100: bets $0.13
Jero0987: raises $0.71 to $0.84
rrvs100: calls $0.33 and is all-in
Uncalled bet ($0.38) returned to Jero0987
*** TURN *** [Ad 7c 8h] [9c]
*** RIVER *** [Ad 7c 8h 9c] [6d]
*** SHOW DOWN ***
rrvs100: shows [As Td] (a straight, Six to Ten)
Jero0987: shows [Ac Kd] (a pair of Aces)
rrvs100 collected $1.01 from pot
*** SUMMARY ***
Total pot $1.05 | Rake $0.04
Board [Ad 7c 8h 9c 6d]
Seat 1: superRODRI folded before Flop (didn't bet)
Seat 2: axel030997 folded before Flop (didn't bet)
Seat 3: Jero0987 (button) showed [Ac Kd] and lost with a pair of Aces
Seat 4: palomino02 (small blind) folded before Flop
Seat 5: rrvs100 (big blind) showed [As Td] and won ($1.01) with a straight, Six to Ten
Seat 6: suetam4i20 folded before Flop (didn't bet)


PokerStars Hand #238167234846:  Hold'em No Limit ($0.01/$0.02 USD) - 2022/08/23 10:27:10 ET
Table 'Despina IV' 6-max Seat #4 is the button
Seat 1: superRODRI ($2.03 in chips)
Seat 2: axel030997 ($2.15 in chips)
Seat 3: Jero0987 ($2 in chips)
Seat 4: palomino02 ($1.98 in chips)
Seat 5: rrvs100 ($1.01 in chips)
Seat 6: suetam4i20 ($1.97 in chips)
rrvs100: posts small blind $0.01
suetam4i20: posts big blind $0.02
*** HOLE CARDS ***
superRODRI: folds
axel030997: folds
Jero0987: folds
palomino02: folds
rrvs100: calls $0.01
suetam4i20: raises $0.04 to $0.06
rrvs100: folds
Uncalled bet ($0.04) returned to suetam4i20
suetam4i20 collected $0.04 from pot
*** SUMMARY ***
Total pot $0.04 | Rake $0
Seat 1: superRODRI folded before Flop (didn't bet)
Seat 2: axel030997 folded before Flop (didn't bet)
Seat 3: Jero0987 folded before Flop (didn't bet)
Seat 4: palomino02 (button) folded before Flop (didn't bet)
Seat 5: rrvs100 (small blind) folded before Flop
Seat 6: suetam4i20 (big blind) collected ($0.04)


PokerStars Hand #238167240685:  Hold'em No Limit ($0.01/$0.02 USD) - 2022/08/23 10:27:33 ET
Table 'Despina IV' 6-max Seat #5 is the button
Seat 1: superRODRI ($2.03 in chips)
Seat 2: axel030997 ($2.15 in chips)
Seat 3: Jero0987 ($2 in chips)
Seat 4: palomino02 ($1.98 in chips)
Seat 5: rrvs100 ($0.99 in chips)
Seat 6: suetam4i20 ($1.99 in chips)
suetam4i20: posts small blind $0.01
superRODRI: posts big blind $0.02
*** HOLE CARDS ***
axel030997: folds
Jero0987: folds
palomino02: folds
rrvs100: calls $0.02
suetam4i20: calls $0.01
superRODRI: raises $0.16 to $0.18
rrvs100: folds
suetam4i20: folds
Uncalled bet ($0.16) returned to superRODRI
superRODRI collected $0.06 from pot
superRODRI: doesn't show hand
*** SUMMARY ***
Total pot $0.06 | Rake $0
Seat 1: superRODRI (big blind) collected ($0.06)
Seat 2: axel030997 folded before Flop (didn't bet)
Seat 3: Jero0987 folded before Flop (didn't bet)
Seat 4: palomino02 folded before Flop (didn't bet)
Seat 5: rrvs100 (button) folded before Flop
Seat 6: suetam4i20 (small blind) folded before Flop


PokerStars Hand #238167248408:  Hold'em No Limit ($0.01/$0.02 USD) - 2022/08/23 10:28:02 ET
Table 'Despina IV' 6-max Seat #6 is the button
Seat 1: superRODRI ($2.07 in chips)
Seat 2: axel030997 ($2.15 in chips)
Seat 3: Jero0987 ($2 in chips)
Seat 4: palomino02 ($1.98 in chips)
Seat 5: rrvs100 ($0.97 in chips)
Seat 6: suetam4i20 ($1.97 in chips)
superRODRI: posts small blind $0.01
axel030997: posts big blind $0.02
*** HOLE CARDS ***
Jero0987: folds
palomino02: raises $0.04 to $0.06
rrvs100: folds
suetam4i20: calls $0.06
superRODRI: calls $0.05
axel030997: calls $0.04
*** FLOP *** [3c Jc Ks]
superRODRI: bets $0.17
axel030997: calls $0.17
palomino02: folds
suetam4i20: folds
*** TURN *** [3c Jc Ks] [8c]
superRODRI: bets $0.30
axel030997: folds
Uncalled bet ($0.30) returned to superRODRI
superRODRI collected $0.56 from pot
superRODRI: doesn't show hand
*** SUMMARY ***
Total pot $0.58 | Rake $0.02
Board [3c Jc Ks 8c]
Seat 1: superRODRI (small blind) collected ($0.56)
Seat 2: axel030997 (big blind) folded on the Turn
Seat 3: Jero0987 folded before Flop (didn't bet)
Seat 4: palomino02 folded on the Flop
Seat 5: rrvs100 folded before Flop (didn't bet)
Seat 6: suetam4i20 (button) folded on the Flop


PokerStars Hand #238167259612:  Hold'em No Limit ($0.01/$0.02 USD) - 2022/08/23 10:28:44 ET
Table 'Despina IV' 6-max Seat #1 is the button
Seat 1: superRODRI ($2.40 in chips)
Seat 2: axel030997 ($1.92 in chips)
Seat 3: Jero0987 ($2 in chips)
Seat 4: palomino02 ($1.92 in chips)
Seat 5: rrvs100 ($0.97 in chips)
Seat 6: suetam4i20 ($1.91 in chips)
axel030997: posts small blind $0.01
Jero0987: posts big blind $0.02
*** HOLE CARDS ***
palomino02: folds
rrvs100: folds
suetam4i20: folds
superRODRI: raises $0.05 to $0.07
axel030997: folds
Jero0987: folds
Uncalled bet ($0.05) returned to superRODRI
superRODRI collected $0.05 from pot
superRODRI: doesn't show hand
*** SUMMARY ***
Total pot $0.05 | Rake $0
Seat 1: superRODRI (button) collected ($0.05)
Seat 2: axel030997 (small blind) folded before Flop
Seat 3: Jero0987 (big blind) folded before Flop
Seat 4: palomino02 folded before Flop (didn't bet)
Seat 5: rrvs100 folded before Flop (didn't bet)
Seat 6: suetam4i20 folded before Flop (didn't bet)


PokerStars Hand #238167265332:  Hold'em No Limit ($0.01/$0.02 USD) - 2022/08/23 10:29:06 ET
Table 'Despina IV' 6-max Seat #2 is the button
Seat 1: superRODRI ($2.43 in chips)
Seat 2: axel030997 ($1.91 in chips)
Seat 3: Jero0987 ($1.98 in chips)
Seat 4: palomino02 ($1.92 in chips)
Seat 5: rrvs100 ($0.97 in chips)
Seat 6: suetam4i20 ($1.91 in chips)
Jero0987: posts small blind $0.01
palomino02: posts big blind $0.02
*** HOLE CARDS ***
rrvs100: folds
suetam4i20: calls $0.02
superRODRI: folds
axel030997: folds
Jero0987: folds
palomino02: raises $0.07 to $0.09
suetam4i20: calls $0.07
*** FLOP *** [3h 8d Tc]
palomino02: bets $0.13
suetam4i20: calls $0.13
*** TURN *** [3h 8d Tc] [5s]
palomino02: checks
suetam4i20: bets $0.21
palomino02: folds
Uncalled bet ($0.21) returned to suetam4i20
suetam4i20 collected $0.43 from pot
*** SUMMARY ***
Total pot $0.45 | Rake $0.02
Board [3h 8d Tc 5s]
Seat 1: superRODRI folded before Flop (didn't bet)
Seat 2: axel030997 (button) folded before Flop (didn't bet)
Seat 3: Jero0987 (small blind) folded before Flop
Seat 4: palomino02 (big blind) folded on the Turn
Seat 5: rrvs100 folded before Flop (didn't bet)
Seat 6: suetam4i20 collected ($0.43)


PokerStars Hand #238167278665:  Hold'em No Limit ($0.01/$0.02 USD) - 2022/08/23 10:29:57 ET
Table 'Despina IV' 6-max Seat #3 is the button
Seat 1: superRODRI ($2.43 in chips)
Seat 2: axel030997 ($1.91 in chips)
Seat 3: Jero0987 ($1.97 in chips)
Seat 4: palomino02 ($1.70 in chips)
Seat 5: rrvs100 ($0.97 in chips)
Seat 6: suetam4i20 ($2.12 in chips)
palomino02: posts small blind $0.01
rrvs100: posts big blind $0.02
*** HOLE CARDS ***
suetam4i20: folds
superRODRI: folds
axel030997: folds
Jero0987: folds
palomino02: raises $0.04 to $0.06
rrvs100: calls $0.04
*** FLOP *** [5d Jc Ad]
palomino02: checks
rrvs100: bets $0.02
palomino02: folds
Uncalled bet ($0.02) returned to rrvs100
rrvs100 collected $0.12 from pot
*** SUMMARY ***
Total pot $0.12 | Rake $0
Board [5d Jc Ad]
Seat 1: superRODRI folded before Flop (didn't bet)
Seat 2: axel030997 folded before Flop (didn't bet)
Seat 3: Jero0987 (button) folded before Flop (didn't bet)
Seat 4: palomino02 (small blind) folded on the Flop
Seat 5: rrvs100 (big blind) collected ($0.12)
Seat 6: suetam4i20 folded before Flop (didn't bet)


PokerStars Hand #238167287592:  Hold'em No Limit ($0.01/$0.02 USD) - 2022/08/23 10:30:31 ET
Table 'Despina IV' 6-max Seat #4 is the button
Seat 1: superRODRI ($2.43 in chips)
Seat 2: axel030997 ($1.91 in chips)
Seat 3: Jero0987 ($1.97 in chips)
Seat 4: palomino02 ($1.64 in chips)
Seat 5: rrvs100 ($1.03 in chips)
Seat 6: suetam4i20 ($2.12 in chips)
rrvs100: posts small blind $0.01
suetam4i20: posts big blind $0.02
*** HOLE CARDS ***
superRODRI: folds
axel030997: folds
Jero0987: raises $0.04 to $0.06
palomino02: folds
rrvs100: folds
suetam4i20: raises $0.06 to $0.12
Jero0987: folds
Uncalled bet ($0.06) returned to suetam4i20
suetam4i20 collected $0.13 from pot
*** SUMMARY ***
Total pot $0.13 | Rake $0
Seat 1: superRODRI folded before Flop (didn't bet)
Seat 2: axel030997 folded before Flop (didn't bet)
Seat 3: Jero0987 folded before Flop
Seat 4: palomino02 (button) folded before Flop (didn't bet)
Seat 5: rrvs100 (small blind) folded before Flop
Seat 6: suetam4i20 (big blind) collected ($0.13)


PokerStars Hand #238167292868:  Hold'em No Limit ($0.01/$0.02 USD) - 2022/08/23 10:30:52 ET
Table 'Despina IV' 6-max Seat #5 is the button
Seat 1: superRODRI ($2.43 in chips)
Seat 2: axel030997 ($1.91 in chips)
Seat 3: Jero0987 ($1.91 in chips)
Seat 4: palomino02 ($1.64 in chips)
Seat 5: rrvs100 ($1.02 in chips)
Seat 6: suetam4i20 ($2.19 in chips)
suetam4i20: posts small blind $0.01
superRODRI: posts big blind $0.02
*** HOLE CARDS ***
axel030997: folds
Jero0987: folds
palomino02: raises $0.04 to $0.06
rrvs100: folds
suetam4i20: raises $0.06 to $0.12
superRODRI: folds
palomino02: calls $0.06
*** FLOP *** [3d 2c 3c]
superRODRI leaves the table
suetam4i20: checks
palomino02: bets $0.12
suetam4i20: calls $0.12
*** TURN *** [3d 2c 3c] [Js]
suetam4i20: checks
palomino02: checks
*** RIVER *** [3d 2c 3c Js] [7c]
suetam4i20: checks
ketomaldonado joins the table at seat #1
palomino02: bets $0.48
suetam4i20: folds
Uncalled bet ($0.48) returned to palomino02
palomino02 collected $0.48 from pot
*** SUMMARY ***
Total pot $0.50 | Rake $0.02
Board [3d 2c 3c Js 7c]
Seat 1: superRODRI (big blind) folded before Flop
Seat 2: axel030997 folded before Flop (didn't bet)
Seat 3: Jero0987 folded before Flop (didn't bet)
Seat 4: palomino02 collected ($0.48)
Seat 5: rrvs100 (button) folded before Flop (didn't bet)
Seat 6: suetam4i20 (small blind) folded on the River


PokerStars Hand #238167317743:  Hold'em No Limit ($0.01/$0.02 USD) - 2022/08/23 10:31:59 ET
Table 'Despina IV' 6-max Seat #6 is the button
Seat 2: axel030997 ($1.91 in chips)
Seat 3: Jero0987 ($1.91 in chips)
Seat 4: palomino02 ($1.88 in chips)
Seat 5: rrvs100 ($1.02 in chips)
Seat 6: suetam4i20 ($1.95 in chips)
axel030997: posts small blind $0.01
Jero0987: posts big blind $0.02
*** HOLE CARDS ***
palomino02: folds
rrvs100: folds
suetam4i20: calls $0.02
axel030997: raises $0.06 to $0.08
Jero0987: folds
suetam4i20: calls $0.06
*** FLOP *** [Td Qd 9c]
axel030997: checks
suetam4i20: bets $0.04
axel030997: calls $0.04
*** TURN *** [Td Qd 9c] [6c]
axel030997: checks
suetam4i20: bets $0.25
axel030997: folds
Uncalled bet ($0.25) returned to suetam4i20
suetam4i20 collected $0.25 from pot
suetam4i20: doesn't show hand
*** SUMMARY ***
Total pot $0.26 | Rake $0.01
Board [Td Qd 9c 6c]
Seat 2: axel030997 (small blind) folded on the Turn
Seat 3: Jero0987 (big blind) folded before Flop
Seat 4: palomino02 folded before Flop (didn't bet)
Seat 5: rrvs100 folded before Flop (didn't bet)
Seat 6: suetam4i20 (button) collected ($0.25)


PokerStars Hand #238167330714:  Hold'em No Limit ($0.01/$0.02 USD) - 2022/08/23 10:32:48 ET
Table 'Despina IV' 6-max Seat #2 is the button
Seat 1: ketomaldonado ($2 in chips)
Seat 2: axel030997 ($1.79 in chips)
Seat 3: Jero0987 ($1.89 in chips)
Seat 4: palomino02 ($1.88 in chips)
Seat 5: rrvs100 ($1.02 in chips)
Seat 6: suetam4i20 ($2.08 in chips)
Jero0987: posts small blind $0.01
palomino02: posts big blind $0.02
ketomaldonado: posts big blind $0.02
*** HOLE CARDS ***
rrvs100: folds
suetam4i20: calls $0.02
ketomaldonado: checks
axel030997: folds
Jero0987: calls $0.01
palomino02: checks
*** FLOP *** [Js 4s 6s]
Jero0987: checks
palomino02: checks
suetam4i20: bets $0.04
ketomaldonado: calls $0.04
Jero0987: folds
palomino02: folds
*** TURN *** [Js 4s 6s] [5s]
suetam4i20: checks
ketomaldonado: checks
*** RIVER *** [Js 4s 6s 5s] [4h]
suetam4i20: bets $0.15
ketomaldonado: raises $0.48 to $0.63
suetam4i20: folds
Uncalled bet ($0.48) returned to ketomaldonado
ketomaldonado collected $0.44 from pot
*** SUMMARY ***
Total pot $0.46 | Rake $0.02
Board [Js 4s 6s 5s 4h]
Seat 1: ketomaldonado collected ($0.44)
Seat 2: axel030997 (button) folded before Flop (didn't bet)
Seat 3: Jero0987 (small blind) folded on the Flop
Seat 4: palomino02 (big blind) folded on the Flop
Seat 5: rrvs100 folded before Flop (didn't bet)
Seat 6: suetam4i20 folded on the River


PokerStars Hand #238167346849:  Hold'em No Limit ($0.01/$0.02 USD) - 2022/08/23 10:33:49 ET
Table 'Despina IV' 6-max Seat #3 is the button
Seat 1: ketomaldonado ($2.23 in chips)
Seat 2: axel030997 ($1.79 in chips)
Seat 3: Jero0987 ($1.87 in chips)
Seat 4: palomino02 ($1.86 in chips)
Seat 5: rrvs100 ($1.02 in chips)
Seat 6: suetam4i20 ($1.87 in chips)
palomino02: posts small blind $0.01
rrvs100: posts big blind $0.02
*** HOLE CARDS ***
suetam4i20: folds
ketomaldonado: folds
axel030997: folds
Jero0987: folds
palomino02: raises $0.04 to $0.06
rrvs100: calls $0.04
*** FLOP *** [Ac 4s Ks]
palomino02: bets $0.06
rrvs100: folds
Uncalled bet ($0.06) returned to palomino02
palomino02 collected $0.12 from pot
*** SUMMARY ***
Total pot $0.12 | Rake $0
Board [Ac 4s Ks]
Seat 1: ketomaldonado folded before Flop (didn't bet)
Seat 2: axel030997 folded before Flop (didn't bet)
Seat 3: Jero0987 (button) folded before Flop (didn't bet)
Seat 4: palomino02 (small blind) collected ($0.12)
Seat 5: rrvs100 (big blind) folded on the Flop
Seat 6: suetam4i20 folded before Flop (didn't bet)


PokerStars Hand #238167353938:  Hold'em No Limit ($0.01/$0.02 USD) - 2022/08/23 10:34:16 ET
Table 'Despina IV' 6-max Seat #4 is the button
Seat 1: ketomaldonado ($2.23 in chips)
Seat 2: axel030997 ($1.79 in chips)
Seat 3: Jero0987 ($1.87 in chips)
Seat 4: palomino02 ($1.92 in chips)
Seat 5: rrvs100 ($0.96 in chips)
Seat 6: suetam4i20 ($1.87 in chips)
rrvs100: posts small blind $0.01
suetam4i20: posts big blind $0.02
*** HOLE CARDS ***
ketomaldonado: folds
axel030997: folds
Jero0987: folds
palomino02: raises $0.04 to $0.06
rrvs100: calls $0.05
suetam4i20: calls $0.04
*** FLOP *** [7c 2c 7d]
rrvs100: bets $0.02
suetam4i20: raises $0.04 to $0.06
palomino02: folds
rrvs100: calls $0.04
*** TURN *** [7c 2c 7d] [8c]
rrvs100: checks
suetam4i20: bets $0.14
rrvs100: calls $0.14
*** RIVER *** [7c 2c 7d 8c] [Ac]
rrvs100: bets $0.02
suetam4i20: folds
Uncalled bet ($0.02) returned to rrvs100
rrvs100 collected $0.56 from pot
*** SUMMARY ***
Total pot $0.58 | Rake $0.02
Board [7c 2c 7d 8c Ac]
Seat 1: ketomaldonado folded before Flop (didn't bet)
Seat 2: axel030997 folded before Flop (didn't bet)
Seat 3: Jero0987 folded before Flop (didn't bet)
Seat 4: palomino02 (button) folded on the Flop
Seat 5: rrvs100 (small blind) collected ($0.56)
Seat 6: suetam4i20 (big blind) folded on the River


PokerStars Hand #238167365939:  Hold'em No Limit ($0.01/$0.02 USD) - 2022/08/23 10:35:02 ET
Table 'Despina IV' 6-max Seat #5 is the button
Seat 1: ketomaldonado ($2.23 in chips)
Seat 2: axel030997 ($1.79 in chips)
Seat 3: Jero0987 ($1.87 in chips)
Seat 4: palomino02 ($1.86 in chips)
Seat 5: rrvs100 ($1.26 in chips)
Seat 6: suetam4i20 ($1.61 in chips)
suetam4i20: posts small blind $0.01
ketomaldonado: posts big blind $0.02
*** HOLE CARDS ***
axel030997: folds
Jero0987: folds
palomino02: raises $0.04 to $0.06
rrvs100: calls $0.06
suetam4i20: raises $0.20 to $0.26
ketomaldonado: folds
palomino02: calls $0.20
rrvs100: calls $0.20
*** FLOP *** [7d 7s 6s]
suetam4i20: checks
palomino02: bets $0.38
rrvs100: calls $0.38
suetam4i20: folds
*** TURN *** [7d 7s 6s] [Ks]
palomino02: bets $0.75
rrvs100: calls $0.62 and is all-in
Uncalled bet ($0.13) returned to palomino02
*** RIVER *** [7d 7s 6s Ks] [9d]
*** SHOW DOWN ***
palomino02: shows [Ac Ah] (two pair, Aces and Sevens)
rrvs100: shows [8s 8h] (two pair, Eights and Sevens)
palomino02 collected $2.70 from pot
*** SUMMARY ***
Total pot $2.80 | Rake $0.10
Board [7d 7s 6s Ks 9d]
Seat 1: ketomaldonado (big blind) folded before Flop
Seat 2: axel030997 folded before Flop (didn't bet)
Seat 3: Jero0987 folded before Flop (didn't bet)
Seat 4: palomino02 showed [Ac Ah] and won ($2.70) with two pair, Aces and Sevens
Seat 5: rrvs100 (button) showed [8s 8h] and lost with two pair, Eights and Sevens
Seat 6: suetam4i20 (small blind) folded on the Flop


PokerStars Hand #238167382549:  Hold'em No Limit ($0.01/$0.02 USD) - 2022/08/23 10:36:04 ET
Table 'Despina IV' 6-max Seat #6 is the button
Seat 1: ketomaldonado ($2.21 in chips)
Seat 3: Jero0987 ($1.87 in chips)
Seat 4: palomino02 ($3.30 in chips)
Seat 6: suetam4i20 ($1.35 in chips)
ketomaldonado: posts small blind $0.01
axel030997: is sitting out
Jero0987: posts big blind $0.02
*** HOLE CARDS ***
palomino02: raises $0.04 to $0.06
suetam4i20: folds
ketomaldonado: folds
rrvs100 leaves the table
Quint1985 joins the table at seat #5
Jero0987: calls $0.04
*** FLOP *** [9c 8d Qh]
Jero0987: checks
palomino02: bets $0.06
Jero0987: calls $0.06
*** TURN *** [9c 8d Qh] [3d]
Jero0987: checks
axel030997 leaves the table
palomino02: checks
*** RIVER *** [9c 8d Qh 3d] [7c]
Jero0987: bets $0.20
palomino02: folds
Uncalled bet ($0.20) returned to Jero0987
Jero0987 collected $0.24 from pot
*** SUMMARY ***
Total pot $0.25 | Rake $0.01
Board [9c 8d Qh 3d 7c]
Seat 1: ketomaldonado (small blind) folded before Flop
Seat 3: Jero0987 (big blind) collected ($0.24)
Seat 4: palomino02 folded on the River
Seat 6: suetam4i20 (button) folded before Flop (didn't bet)


PokerStars Hand #238167402167:  Hold'em No Limit ($0.01/$0.02 USD) - 2022/08/23 10:37:18 ET
Table 'Despina IV' 6-max Seat #1 is the button
Seat 1: ketomaldonado ($2.20 in chips)
Seat 3: Jero0987 ($1.99 in chips)
Seat 4: palomino02 ($3.18 in chips)
Seat 6: suetam4i20 ($1.35 in chips)
Jero0987: posts small blind $0.01
palomino02: posts big blind $0.02
Quint1985: sits out
*** HOLE CARDS ***
suetam4i20: folds
ketomaldonado: folds
Jero0987: folds
Uncalled bet ($0.01) returned to palomino02
palomino02 collected $0.02 from pot
*** SUMMARY ***
Total pot $0.02 | Rake $0
Seat 1: ketomaldonado (button) folded before Flop (didn't bet)
Seat 3: Jero0987 (small blind) folded before Flop
Seat 4: palomino02 (big blind) collected ($0.02)
Seat 6: suetam4i20 folded before Flop (didn't bet)


PokerStars Hand #238167404322:  Hold'em No Limit ($0.01/$0.02 USD) - 2022/08/23 10:37:26 ET
Table 'Despina IV' 6-max Seat #3 is the button
Seat 1: ketomaldonado ($2.20 in chips)
Seat 3: Jero0987 ($1.98 in chips)
Seat 4: palomino02 ($3.19 in chips)
Seat 5: Quint1985 ($1.20 in chips)
Seat 6: suetam4i20 ($1.35 in chips)
palomino02: posts small blind $0.01
Quint1985: posts big blind $0.02
*** HOLE CARDS ***
Stasia46 joins the table at seat #2
suetam4i20: raises $0.04 to $0.06
ketomaldonado: folds
Jero0987: folds
palomino02: folds
Quint1985: calls $0.04
*** FLOP *** [9d 8d Kc]
Quint1985: bets $0.02
suetam4i20: calls $0.02
*** TURN *** [9d 8d Kc] [Ac]
Quint1985: bets $0.04
suetam4i20: raises $0.04 to $0.08
Quint1985: calls $0.04
*** RIVER *** [9d 8d Kc Ac] [Ad]
Quint1985: bets $0.08
suetam4i20: raises $0.08 to $0.16
Quint1985: raises $0.16 to $0.32
suetam4i20: calls $0.16
*** SHOW DOWN ***
Quint1985: shows [As 8c] (a full house, Aces full of Eights)
suetam4i20: mucks hand
Quint1985 collected $0.94 from pot
*** SUMMARY ***
Total pot $0.97 | Rake $0.03
Board [9d 8d Kc Ac Ad]
Seat 1: ketomaldonado folded before Flop (didn't bet)
Seat 3: Jero0987 (button) folded before Flop (didn't bet)
Seat 4: palomino02 (small blind) folded before Flop
Seat 5: Quint1985 (big blind) showed [As 8c] and won ($0.94) with a full house, Aces full of Eights
Seat 6: suetam4i20 mucked


PokerStars Hand #238167420918:  Hold'em No Limit ($0.01/$0.02 USD) - 2022/08/23 10:38:28 ET
Table 'Despina IV' 6-max Seat #4 is the button
Seat 1: ketomaldonado ($2.20 in chips)
Seat 3: Jero0987 ($1.98 in chips)
Seat 4: palomino02 ($3.18 in chips)
Seat 5: Quint1985 ($1.66 in chips)
Seat 6: suetam4i20 ($0.87 in chips)
Quint1985: posts small blind $0.01
suetam4i20: posts big blind $0.02
Stasia46: sits out
*** HOLE CARDS ***
ketomaldonado: folds
Jero0987: folds
palomino02: raises $0.04 to $0.06
Quint1985: calls $0.05
suetam4i20: calls $0.04
*** FLOP *** [Qs 3s 3h]
Quint1985: bets $0.06
suetam4i20: calls $0.06
palomino02: folds
*** TURN *** [Qs 3s 3h] [9s]
Quint1985: bets $0.06
suetam4i20: raises $0.21 to $0.27
Quint1985: raises $1.27 to $1.54 and is all-in
suetam4i20: folds
Uncalled bet ($1.27) returned to Quint1985
Quint1985 collected $0.81 from pot
Quint1985: doesn't show hand
*** SUMMARY ***
Total pot $0.84 | Rake $0.03
Board [Qs 3s 3h 9s]
Seat 1: ketomaldonado folded before Flop (didn't bet)
Seat 3: Jero0987 folded before Flop (didn't bet)
Seat 4: palomino02 (button) folded on the Flop
Seat 5: Quint1985 (small blind) collected ($0.81)
Seat 6: suetam4i20 (big blind) folded on the Turn


PokerStars Hand #238167440977:  Hold'em No Limit ($0.01/$0.02 USD) - 2022/08/23 10:39:20 ET
Table 'Despina IV' 6-max Seat #5 is the button
Seat 2: Stasia46 ($1.60 in chips)
Seat 3: Jero0987 ($1.98 in chips)
Seat 4: palomino02 ($3.12 in chips)
Seat 5: Quint1985 ($2.08 in chips)
Seat 6: suetam4i20 ($0.48 in chips)
suetam4i20: posts small blind $0.01
Stasia46: posts big blind $0.02
*** HOLE CARDS ***
Jero0987: folds
palomino02: folds
Quint1985: calls $0.02
suetam4i20: calls $0.01
Stasia46: checks
*** FLOP *** [Jc 2c 4h]
suetam4i20: checks
Stasia46: checks
Quint1985: checks
*** TURN *** [Jc 2c 4h] [Jd]
suetam4i20: checks
Stasia46: checks
Quint1985: checks
*** RIVER *** [Jc 2c 4h Jd] [Kc]
suetam4i20: checks
Stasia46: checks
Quint1985: checks
*** SHOW DOWN ***
suetam4i20: shows [9s 6d] (a pair of Jacks)
Stasia46: shows [6s 4s] (two pair, Jacks and Fours)
Quint1985: mucks hand
Stasia46 collected $0.06 from pot
*** SUMMARY ***
Total pot $0.06 | Rake $0
Board [Jc 2c 4h Jd Kc]
Seat 2: Stasia46 (big blind) showed [6s 4s] and won ($0.06) with two pair, Jacks and Fours
Seat 3: Jero0987 folded before Flop (didn't bet)
Seat 4: palomino02 folded before Flop (didn't bet)
Seat 5: Quint1985 (button) mucked
Seat 6: suetam4i20 (small blind) showed [9s 6d] and lost with a pair of Jacks


PokerStars Hand #238167451263:  Hold'em No Limit ($0.01/$0.02 USD) - 2022/08/23 10:39:58 ET
Table 'Despina IV' 6-max Seat #6 is the button
Seat 2: Stasia46 ($1.64 in chips)
Seat 3: Jero0987 ($1.98 in chips)
Seat 4: palomino02 ($3.12 in chips)
Seat 5: Quint1985 ($2.06 in chips)
Seat 6: suetam4i20 ($0.46 in chips)
Stasia46: posts small blind $0.01
Jero0987: posts big blind $0.02
*** HOLE CARDS ***
palomino02: folds
Quint1985: folds
suetam4i20: raises $0.04 to $0.06
Stasia46: folds
Jero0987: folds
Uncalled bet ($0.04) returned to suetam4i20
suetam4i20 collected $0.05 from pot
*** SUMMARY ***
Total pot $0.05 | Rake $0
Seat 2: Stasia46 (small blind) folded before Flop
Seat 3: Jero0987 (big blind) folded before Flop
Seat 4: palomino02 folded before Flop (didn't bet)
Seat 5: Quint1985 folded before Flop (didn't bet)
Seat 6: suetam4i20 (button) collected ($0.05)


PokerStars Hand #238167455973:  Hold'em No Limit ($0.01/$0.02 USD) - 2022/08/23 10:40:15 ET
Table 'Despina IV' 6-max Seat #2 is the button
Seat 2: Stasia46 ($1.63 in chips)
Seat 3: Jero0987 ($1.96 in chips)
Seat 4: palomino02 ($3.12 in chips)
Seat 5: Quint1985 ($2.06 in chips)
Seat 6: suetam4i20 ($0.49 in chips)
Jero0987: posts small blind $0.01
palomino02: posts big blind $0.02
*** HOLE CARDS ***
Quint1985: calls $0.02
suetam4i20: raises $0.04 to $0.06
Stasia46: folds
Jero0987: folds
palomino02: calls $0.04
Quint1985: calls $0.04
*** FLOP *** [Jc Th 9c]
palomino02: checks
Quint1985: checks
suetam4i20: bets $0.18
palomino02: folds
Quint1985: calls $0.18
*** TURN *** [Jc Th 9c] [2s]
Quint1985: checks
suetam4i20: bets $0.25 and is all-in
Quint1985: calls $0.25
suetam4i20 has timed out
*** RIVER *** [Jc Th 9c 2s] [2h]
*** SHOW DOWN ***
Quint1985: shows [Qd Ks] (a straight, Nine to King)
suetam4i20: shows [Qh Qs] (two pair, Queens and Deuces)
Quint1985 collected $1.01 from pot
*** SUMMARY ***
Total pot $1.05 | Rake $0.04
Board [Jc Th 9c 2s 2h]
Seat 2: Stasia46 (button) folded before Flop (didn't bet)
Seat 3: Jero0987 (small blind) folded before Flop
Seat 4: palomino02 (big blind) folded on the Flop
Seat 5: Quint1985 showed [Qd Ks] and won ($1.01) with a straight, Nine to King
Seat 6: suetam4i20 showed [Qh Qs] and lost with two pair, Queens and Deuces


PokerStars Hand #238167474485:  Hold'em No Limit ($0.01/$0.02 USD) - 2022/08/23 10:41:24 ET
Table 'Despina IV' 6-max Seat #3 is the button
Seat 2: Stasia46 ($1.63 in chips)
Seat 3: Jero0987 ($1.95 in chips)
Seat 5: Quint1985 ($2.58 in chips)
Quint1985: posts small blind $0.01
Stasia46: posts big blind $0.02
*** HOLE CARDS ***
Jero0987: folds
suetam4i20 leaves the table
Quint1985: calls $0.01
Stasia46: checks
*** FLOP *** [7d Jc 3d]
Quint1985: checks
John081069 joins the table at seat #6
Stasia46: checks
*** TURN *** [7d Jc 3d] [2d]
Quint1985: checks
Stasia46: checks
*** RIVER *** [7d Jc 3d 2d] [6h]
Quint1985: checks
Stasia46: checks
*** SHOW DOWN ***
Quint1985: shows [Qd 8c] (high card Queen)
Stasia46: shows [Ts 7c] (a pair of Sevens)
Stasia46 collected $0.04 from pot
*** SUMMARY ***
Total pot $0.04 | Rake $0
Board [7d Jc 3d 2d 6h]
Seat 2: Stasia46 (big blind) showed [Ts 7c] and won ($0.04) with a pair of Sevens
Seat 3: Jero0987 (button) folded before Flop (didn't bet)
Seat 5: Quint1985 (small blind) showed [Qd 8c] and lost with high card Queen


PokerStars Hand #238167482506:  Hold'em No Limit ($0.01/$0.02 USD) - 2022/08/23 10:41:53 ET
Table 'Despina IV' 6-max Seat #5 is the button
Seat 2: Stasia46 ($1.65 in chips)
Seat 3: Jero0987 ($1.95 in chips)
Seat 5: Quint1985 ($2.56 in chips)
Stasia46: posts small blind $0.01
Jero0987: posts big blind $0.02
*** HOLE CARDS ***
Quint1985: folds
Stasia46: folds
Uncalled bet ($0.01) returned to Jero0987
Jero0987 collected $0.02 from pot
*** SUMMARY ***
Total pot $0.02 | Rake $0
Seat 2: Stasia46 (small blind) folded before Flop
Seat 3: Jero0987 (big blind) collected ($0.02)
Seat 5: Quint1985 (button) folded before Flop (didn't bet)


PokerStars Hand #238167484024:  Hold'em No Limit ($0.01/$0.02 USD) - 2022/08/23 10:41:59 ET
Table 'Despina IV' 6-max Seat #2 is the button
Seat 2: Stasia46 ($1.64 in chips)
Seat 3: Jero0987 ($1.96 in chips)
Seat 5: Quint1985 ($2.56 in chips)
Seat 6: John081069 ($1.60 in chips)
Jero0987: posts small blind $0.01
Quint1985: posts big blind $0.02
John081069: posts big blind $0.02
*** HOLE CARDS ***
John081069: checks
Stasia46: folds
Jero0987: folds
Quint1985: checks
*** FLOP *** [As Jh Jc]
Quint1985: bets $0.02
John081069: folds
Uncalled bet ($0.02) returned to Quint1985
Quint1985 collected $0.05 from pot
Quint1985: doesn't show hand
*** SUMMARY ***
Total pot $0.05 | Rake $0
Board [As Jh Jc]
Seat 2: Stasia46 (button) folded before Flop (didn't bet)
Seat 3: Jero0987 (small blind) folded before Flop
Seat 5: Quint1985 (big blind) collected ($0.05)
Seat 6: John081069 folded on the Flop (didn't bet)


PokerStars Hand #238167488349:  Hold'em No Limit ($0.01/$0.02 USD) - 2022/08/23 10:42:16 ET
Table 'Despina IV' 6-max Seat #3 is the button
Seat 2: Stasia46 ($1.64 in chips)
Seat 3: Jero0987 ($1.95 in chips)
Seat 5: Quint1985 ($2.59 in chips)
Seat 6: John081069 ($1.58 in chips)
Quint1985: posts small blind $0.01
John081069: posts big blind $0.02
*** HOLE CARDS ***
Stasia46: folds
Jero0987: raises $0.04 to $0.06
Quint1985: folds
John081069: folds
Uncalled bet ($0.04) returned to Jero0987
Jero0987 collected $0.05 from pot
*** SUMMARY ***
Total pot $0.05 | Rake $0
Seat 2: Stasia46 folded before Flop (didn't bet)
Seat 3: Jero0987 (button) collected ($0.05)
Seat 5: Quint1985 (small blind) folded before Flop
Seat 6: John081069 (big blind) folded before Flop


PokerStars Hand #238167493360:  Hold'em No Limit ($0.01/$0.02 USD) - 2022/08/23 10:42:34 ET
Table 'Despina IV' 6-max Seat #6 is the button
Seat 2: Stasia46 ($1.65 in chips)
Seat 3: Jero0987 ($1.98 in chips)
Seat 5: Quint1985 ($2.58 in chips)
Seat 6: John081069 ($1.55 in chips)
Stasia46: posts small blind $0.01
Jero0987: posts big blind $0.02
*** HOLE CARDS ***
Quint1985: folds
John081069: folds
Stasia46: folds
Uncalled bet ($0.01) returned to Jero0987
Jero0987 collected $0.02 from pot
*** SUMMARY ***
Total pot $0.02 | Rake $0
Seat 2: Stasia46 (small blind) folded before Flop
Seat 3: Jero0987 (big blind) collected ($0.02)
Seat 5: Quint1985 folded before Flop (didn't bet)
Seat 6: John081069 (button) folded before Flop (didn't bet)


PokerStars Hand #238167491635:  Hold'em No Limit ($0.01/$0.02 USD) - 2022/08/23 10:42:28 ET
Table 'Despina IV' 6-max Seat #5 is the button
Seat 2: Stasia46 ($1.64 in chips)
Seat 3: Jero0987 ($1.98 in chips)
Seat 5: Quint1985 ($2.58 in chips)
Seat 6: John081069 ($1.56 in chips)
John081069: posts small blind $0.01
Stasia46: posts big blind $0.02
*** HOLE CARDS ***
Jero0987: folds
Quint1985: folds
John081069: folds
Uncalled bet ($0.01) returned to Stasia46
Stasia46 collected $0.02 from pot
Stasia46: doesn't show hand
*** SUMMARY ***
Total pot $0.02 | Rake $0
Seat 2: Stasia46 (big blind) collected ($0.02)
Seat 3: Jero0987 folded before Flop (didn't bet)
Seat 5: Quint1985 (button) folded before Flop (didn't bet)
Seat 6: John081069 (small blind) folded before Flop


PokerStars Hand #238167494992:  Hold'em No Limit ($0.01/$0.02 USD) - 2022/08/23 10:42:40 ET
Table 'Despina IV' 6-max Seat #2 is the button
Seat 2: Stasia46 ($1.64 in chips)
Seat 3: Jero0987 ($1.99 in chips)
Seat 5: Quint1985 ($2.58 in chips)
Seat 6: John081069 ($1.55 in chips)
Jero0987: posts small blind $0.01
Quint1985: posts big blind $0.02
*** HOLE CARDS ***
John081069: calls $0.02
Stasia46: folds
Jero0987: folds
Quint1985: checks
*** FLOP *** [9h 8s As]
Quint1985: checks
John081069: checks
*** TURN *** [9h 8s As] [5c]
Quint1985: bets $0.02
John081069: calls $0.02
*** RIVER *** [9h 8s As 5c] [9c]
Quint1985: checks
John081069: bets $0.09
Quint1985: folds
Uncalled bet ($0.09) returned to John081069
John081069 collected $0.09 from pot
John081069: doesn't show hand
*** SUMMARY ***
Total pot $0.09 | Rake $0
Board [9h 8s As 5c 9c]
Seat 2: Stasia46 (button) folded before Flop (didn't bet)
Seat 3: Jero0987 (small blind) folded before Flop
Seat 5: Quint1985 (big blind) folded on the River
Seat 6: John081069 collected ($0.09)


PokerStars Hand #238167503005:  Hold'em No Limit ($0.01/$0.02 USD) - 2022/08/23 10:43:10 ET
Table 'Despina IV' 6-max Seat #3 is the button
Seat 2: Stasia46 ($1.64 in chips)
Seat 3: Jero0987 ($1.98 in chips)
Seat 5: Quint1985 ($2.54 in chips)
Seat 6: John081069 ($1.60 in chips)
Quint1985: posts small blind $0.01
John081069: posts big blind $0.02
*** HOLE CARDS ***
Stasia46: folds
Jero0987: raises $0.04 to $0.06
Quint1985: folds
John081069: calls $0.04
*** FLOP *** [3h 3d 4d]
John081069: checks
Jero0987: bets $0.04
John081069: calls $0.04
*** TURN *** [3h 3d 4d] [Td]
John081069: checks
Jero0987: bets $0.14
John081069: folds
Uncalled bet ($0.14) returned to Jero0987
Jero0987 collected $0.20 from pot
*** SUMMARY ***
Total pot $0.21 | Rake $0.01
Board [3h 3d 4d Td]
Seat 2: Stasia46 folded before Flop (didn't bet)
Seat 3: Jero0987 (button) collected ($0.20)
Seat 5: Quint1985 (small blind) folded before Flop
Seat 6: John081069 (big blind) folded on the Turn


PokerStars Hand #238167514545:  Hold'em No Limit ($0.01/$0.02 USD) - 2022/08/23 10:43:53 ET
Table 'Despina IV' 6-max Seat #6 is the button
Seat 2: Stasia46 ($1.62 in chips)
Seat 3: Jero0987 ($2.11 in chips)
Seat 5: Quint1985 ($2.53 in chips)
Seat 6: John081069 ($1.49 in chips)
Stasia46: posts small blind $0.01
Jero0987: posts big blind $0.02
*** HOLE CARDS ***
Quint1985: folds
John081069: folds
juanrod39 joins the table at seat #1
Stasia46: folds
Uncalled bet ($0.01) returned to Jero0987
Jero0987 collected $0.02 from pot
*** SUMMARY ***
Total pot $0.02 | Rake $0
Seat 2: Stasia46 (small blind) folded before Flop
Seat 3: Jero0987 (big blind) collected ($0.02)
Seat 5: Quint1985 folded before Flop (didn't bet)
Seat 6: John081069 (button) folded before Flop (didn't bet)


PokerStars Hand #238167511246:  Hold'em No Limit ($0.01/$0.02 USD) - 2022/08/23 10:43:41 ET
Table 'Despina IV' 6-max Seat #5 is the button
Seat 2: Stasia46 ($1.64 in chips)
Seat 3: Jero0987 ($2.08 in chips)
Seat 5: Quint1985 ($2.53 in chips)
Seat 6: John081069 ($1.50 in chips)
John081069: posts small blind $0.01
Stasia46: posts big blind $0.02
*** HOLE CARDS ***
Jero0987: raises $0.04 to $0.06
Quint1985: folds
John081069: folds
Stasia46: folds
Uncalled bet ($0.04) returned to Jero0987
Jero0987 collected $0.05 from pot
ketomaldonado was removed from the table for failing to post
ketomaldonado leaves the table
*** SUMMARY ***
Total pot $0.05 | Rake $0
Seat 2: Stasia46 (big blind) folded before Flop
Seat 3: Jero0987 collected ($0.05)
Seat 5: Quint1985 (button) folded before Flop (didn't bet)
Seat 6: John081069 (small blind) folded before Flop


PokerStars Hand #238167516713:  Hold'em No Limit ($0.01/$0.02 USD) - 2022/08/23 10:44:01 ET
Table 'Despina IV' 6-max Seat #2 is the button
Seat 2: Stasia46 ($1.61 in chips)
Seat 3: Jero0987 ($2.12 in chips)
Seat 5: Quint1985 ($2.53 in chips)
Seat 6: John081069 ($1.49 in chips)
Jero0987: posts small blind $0.01
Quint1985: posts big blind $0.02
juanrod39: sits out
*** HOLE CARDS ***
John081069: calls $0.02
Stasia46: calls $0.02
Jero0987: folds
Quint1985: checks
*** FLOP *** [2s 8d Th]
Quint1985: checks
John081069: checks
Stasia46: checks
*** TURN *** [2s 8d Th] [6d]
Quint1985: checks
John081069: bets $0.07
Stasia46: folds
Quint1985: folds
Uncalled bet ($0.07) returned to John081069
John081069 collected $0.07 from pot
palomino02 was removed from the table for failing to post
palomino02 leaves the table
John081069: doesn't show hand
*** SUMMARY ***
Total pot $0.07 | Rake $0
Board [2s 8d Th 6d]
Seat 2: Stasia46 (button) folded on the Turn
Seat 3: Jero0987 (small blind) folded before Flop
Seat 5: Quint1985 (big blind) folded on the Turn
Seat 6: John081069 collected ($0.07)


PokerStars Hand #238167525469:  Hold'em No Limit ($0.01/$0.02 USD) - 2022/08/23 10:44:33 ET
Table 'Despina IV' 6-max Seat #3 is the button
Seat 2: Stasia46 ($1.59 in chips)
Seat 3: Jero0987 ($2.11 in chips)
Seat 5: Quint1985 ($2.51 in chips)
Seat 6: John081069 ($1.54 in chips)
Quint1985: posts small blind $0.01
John081069: posts big blind $0.02
juanrod39: sits out
*** HOLE CARDS ***
Stasia46: folds
Jero0987: folds
Quint1985: calls $0.01
John081069: raises $0.02 to $0.04
Quint1985: calls $0.02
*** FLOP *** [2d 5c 7s]
Quint1985: checks
John081069: checks
*** TURN *** [2d 5c 7s] [3h]
Quint1985: checks
John081069: checks
*** RIVER *** [2d 5c 7s 3h] [Qc]
Quint1985: bets $0.02
John081069: calls $0.02
*** SHOW DOWN ***
Quint1985: shows [Jd Qh] (a pair of Queens)
John081069: mucks hand
Quint1985 collected $0.12 from pot
*** SUMMARY ***
Total pot $0.12 | Rake $0
Board [2d 5c 7s 3h Qc]
Seat 2: Stasia46 folded before Flop (didn't bet)
Seat 3: Jero0987 (button) folded before Flop (didn't bet)
Seat 5: Quint1985 (small blind) showed [Jd Qh] and won ($0.12) with a pair of Queens
Seat 6: John081069 (big blind) mucked


PokerStars Hand #238167533394:  Hold'em No Limit ($0.01/$0.02 USD) - 2022/08/23 10:45:02 ET
Table 'Despina IV' 6-max Seat #5 is the button
Seat 1: juanrod39 ($2 in chips)
Seat 2: Stasia46 ($1.59 in chips)
Seat 3: Jero0987 ($2.11 in chips)
Seat 5: Quint1985 ($2.57 in chips)
Seat 6: John081069 ($1.48 in chips)
John081069: posts small blind $0.01
juanrod39: posts big blind $0.02
*** HOLE CARDS ***
Stasia46: folds
Jero0987: folds
Quint1985: calls $0.02
John081069: folds
juanrod39: checks
*** FLOP *** [5h As 6c]
juanrod39: checks
Quint1985: checks
*** TURN *** [5h As 6c] [Qs]
toleabs2022 joins the table at seat #4
juanrod39: checks
Quint1985: bets $0.02
juanrod39: folds
Uncalled bet ($0.02) returned to Quint1985
Quint1985 collected $0.05 from pot
Quint1985: doesn't show hand
*** SUMMARY ***
Total pot $0.05 | Rake $0
Board [5h As 6c Qs]
Seat 1: juanrod39 (big blind) folded on the Turn
Seat 2: Stasia46 folded before Flop (didn't bet)
Seat 3: Jero0987 folded before Flop (didn't bet)
Seat 5: Quint1985 (button) collected ($0.05)
Seat 6: John081069 (small blind) folded before Flop


PokerStars Hand #238167539801:  Hold'em No Limit ($0.01/$0.02 USD) - 2022/08/23 10:45:26 ET
Table 'Despina IV' 6-max Seat #6 is the button
Seat 1: juanrod39 ($2 in chips)
Seat 2: Stasia46 ($1.59 in chips)
Seat 3: Jero0987 ($2.11 in chips)
Seat 5: Quint1985 ($2.60 in chips)
Seat 6: John081069 ($1.47 in chips)
juanrod39: posts small blind $0.01
Stasia46: posts big blind $0.02
toleabs2022: sits out
*** HOLE CARDS ***
Jero0987: folds
Quint1985: folds
John081069: folds
juanrod39: raises $0.03 to $0.05
Stasia46: folds
Uncalled bet ($0.03) returned to juanrod39
juanrod39 collected $0.04 from pot
*** SUMMARY ***
Total pot $0.04 | Rake $0
Seat 1: juanrod39 (small blind) collected ($0.04)
Seat 2: Stasia46 (big blind) folded before Flop
Seat 3: Jero0987 folded before Flop (didn't bet)
Seat 5: Quint1985 folded before Flop (didn't bet)
Seat 6: John081069 (button) folded before Flop (didn't bet)


PokerStars Hand #238167544720:  Hold'em No Limit ($0.01/$0.02 USD) - 2022/08/23 10:45:44 ET
Table 'Despina IV' 6-max Seat #1 is the button
Seat 1: juanrod39 ($2.02 in chips)
Seat 2: Stasia46 ($1.57 in chips)
Seat 3: Jero0987 ($2.11 in chips)
Seat 4: toleabs2022 ($1.02 in chips)
Seat 5: Quint1985 ($2.60 in chips)
Seat 6: John081069 ($1.47 in chips)
Stasia46: posts small blind $0.01
Jero0987: posts big blind $0.02
toleabs2022: posts big blind $0.02
*** HOLE CARDS ***
toleabs2022: checks
Quint1985: folds
John081069: folds
juanrod39: folds
Stasia46: calls $0.01
Jero0987: checks
*** FLOP *** [Js 7c Ah]
Stasia46: checks
Jero0987: checks
toleabs2022: checks
*** TURN *** [Js 7c Ah] [9h]
Stasia46: checks
Jero0987: checks
toleabs2022: bets $0.02
Stasia46: calls $0.02
Jero0987: calls $0.02
*** RIVER *** [Js 7c Ah 9h] [9s]
Stasia46: checks
Jero0987: checks
toleabs2022: checks
*** SHOW DOWN ***
Stasia46: shows [Ts Jd] (two pair, Jacks and Nines)
Jero0987: mucks hand
toleabs2022: mucks hand
Stasia46 collected $0.12 from pot
*** SUMMARY ***
Total pot $0.12 | Rake $0
Board [Js 7c Ah 9h 9s]
Seat 1: juanrod39 (button) folded before Flop (didn't bet)
Seat 2: Stasia46 (small blind) showed [Ts Jd] and won ($0.12) with two pair, Jacks and Nines
Seat 3: Jero0987 (big blind) mucked
Seat 4: toleabs2022 mucked
Seat 5: Quint1985 folded before Flop (didn't bet)
Seat 6: John081069 folded before Flop (didn't bet)


PokerStars Hand #238167560329:  Hold'em No Limit ($0.01/$0.02 USD) - 2022/08/23 10:46:41 ET
Table 'Despina IV' 6-max Seat #2 is the button
Seat 1: juanrod39 ($2.02 in chips)
Seat 2: Stasia46 ($1.65 in chips)
Seat 3: Jero0987 ($2.07 in chips)
Seat 4: toleabs2022 ($0.98 in chips)
Seat 5: Quint1985 ($2.60 in chips)
Seat 6: John081069 ($1.47 in chips)
Jero0987: posts small blind $0.01
toleabs2022: posts big blind $0.02
*** HOLE CARDS ***
Quint1985: folds
John081069: folds
juanrod39: folds
Stasia46: folds
Jero0987: raises $0.04 to $0.06
toleabs2022: calls $0.04
*** FLOP *** [3h Jh 5c]
Jero0987: checks
toleabs2022: bets $0.12
Jero0987: folds
Uncalled bet ($0.12) returned to toleabs2022
toleabs2022 collected $0.12 from pot
*** SUMMARY ***
Total pot $0.12 | Rake $0
Board [3h Jh 5c]
Seat 1: juanrod39 folded before Flop (didn't bet)
Seat 2: Stasia46 (button) folded before Flop (didn't bet)
Seat 3: Jero0987 (small blind) folded on the Flop
Seat 4: toleabs2022 (big blind) collected ($0.12)
Seat 5: Quint1985 folded before Flop (didn't bet)
Seat 6: John081069 folded before Flop (didn't bet)


PokerStars Hand #238167571159:  Hold'em No Limit ($0.01/$0.02 USD) - 2022/08/23 10:47:21 ET
Table 'Despina IV' 6-max Seat #3 is the button
Seat 1: juanrod39 ($2.02 in chips)
Seat 2: Stasia46 ($1.65 in chips)
Seat 3: Jero0987 ($2.01 in chips)
Seat 4: toleabs2022 ($1.04 in chips)
Seat 5: Quint1985 ($2.60 in chips)
toleabs2022: posts small blind $0.01
Quint1985: posts big blind $0.02
*** HOLE CARDS ***
juanrod39: folds
Stasia46: calls $0.02
Jero0987: folds
toleabs2022: calls $0.01
Quint1985: checks
*** FLOP *** [Kh Jh Jc]
toleabs2022: checks
Quint1985: checks
Stasia46: checks
*** TURN *** [Kh Jh Jc] [Qd]
toleabs2022: checks
Quint1985: checks
Stasia46: bets $0.02
toleabs2022: calls $0.02
Quint1985: calls $0.02
*** RIVER *** [Kh Jh Jc Qd] [7h]
toleabs2022: checks
Quint1985: checks
Stasia46: checks
*** SHOW DOWN ***
toleabs2022: shows [Ad 9s] (a pair of Jacks)
Quint1985: mucks hand
Stasia46: shows [Ah Qh] (a flush, Ace high)
Stasia46 collected $0.12 from pot
*** SUMMARY ***
Total pot $0.12 | Rake $0
Board [Kh Jh Jc Qd 7h]
Seat 1: juanrod39 folded before Flop (didn't bet)
Seat 2: Stasia46 showed [Ah Qh] and won ($0.12) with a flush, Ace high
Seat 3: Jero0987 (button) folded before Flop (didn't bet)
Seat 4: toleabs2022 (small blind) showed [Ad 9s] and lost with a pair of Jacks
Seat 5: Quint1985 (big blind) mucked


PokerStars Hand #238167581418:  Hold'em No Limit ($0.01/$0.02 USD) - 2022/08/23 10:47:59 ET
Table 'Despina IV' 6-max Seat #4 is the button
Seat 1: juanrod39 ($2.02 in chips)
Seat 2: Stasia46 ($1.73 in chips)
Seat 3: Jero0987 ($2.01 in chips)
Seat 4: toleabs2022 ($1 in chips)
Seat 5: Quint1985 ($2.56 in chips)
Seat 6: John081069 ($1.47 in chips)
Quint1985: posts small blind $0.01
John081069: posts big blind $0.02
*** HOLE CARDS ***
juanrod39: folds
Stasia46: folds
Jero0987: raises $0.04 to $0.06
toleabs2022: folds
Quint1985: folds
John081069: folds
Uncalled bet ($0.04) returned to Jero0987
Jero0987 collected $0.05 from pot
*** SUMMARY ***
Total pot $0.05 | Rake $0
Seat 1: juanrod39 folded before Flop (didn't bet)
Seat 2: Stasia46 folded before Flop (didn't bet)
Seat 3: Jero0987 collected ($0.05)
Seat 4: toleabs2022 (button) folded before Flop (didn't bet)
Seat 5: Quint1985 (small blind) folded before Flop
Seat 6: John081069 (big blind) folded before Flop


PokerStars Hand #238167586489:  Hold'em No Limit ($0.01/$0.02 USD) - 2022/08/23 10:48:18 ET
Table 'Despina IV' 6-max Seat #5 is the button
Seat 1: juanrod39 ($2.02 in chips)
Seat 2: Stasia46 ($1.73 in chips)
Seat 3: Jero0987 ($2.04 in chips)
Seat 4: toleabs2022 ($1 in chips)
Seat 5: Quint1985 ($2.55 in chips)
Seat 6: John081069 ($1.45 in chips)
John081069: posts small blind $0.01
juanrod39: posts big blind $0.02
*** HOLE CARDS ***
Stasia46: folds
Jero0987 has timed out
Jero0987: folds
toleabs2022: calls $0.02
Quint1985: folds
John081069: folds
juanrod39: checks
*** FLOP *** [4c 2d As]
juanrod39: checks
toleabs2022: bets $0.05
juanrod39: folds
Uncalled bet ($0.05) returned to toleabs2022
toleabs2022 collected $0.05 from pot
*** SUMMARY ***
Total pot $0.05 | Rake $0
Board [4c 2d As]
Seat 1: juanrod39 (big blind) folded on the Flop
Seat 2: Stasia46 folded before Flop (didn't bet)
Seat 3: Jero0987 folded before Flop (didn't bet)
Seat 4: toleabs2022 collected ($0.05)
Seat 5: Quint1985 (button) folded before Flop (didn't bet)
Seat 6: John081069 (small blind) folded before Flop


PokerStars Hand #238167596072:  Hold'em No Limit ($0.01/$0.02 USD) - 2022/08/23 10:48:53 ET
Table 'Despina IV' 6-max Seat #1 is the button
Seat 1: juanrod39 ($2 in chips)
Seat 2: Stasia46 ($1.73 in chips)
Seat 3: Jero0987 ($2.04 in chips)
Seat 4: toleabs2022 ($1.03 in chips)
Seat 5: Quint1985 ($2.55 in chips)
Stasia46: posts small blind $0.01
Jero0987: posts big blind $0.02
*** HOLE CARDS ***
toleabs2022: folds
Quint1985: calls $0.02
juanrod39: folds
Stasia46: calls $0.01
Jero0987: checks
*** FLOP *** [Ad 5c 3h]
Stasia46: bets $0.04
Jero0987: calls $0.04
Quint1985: folds
*** TURN *** [Ad 5c 3h] [3d]
Stasia46: bets $0.14
Jero0987: calls $0.14
*** RIVER *** [Ad 5c 3h 3d] [Th]
Stasia46: bets $0.41
Jero0987: calls $0.41
*** SHOW DOWN ***
Stasia46: shows [3s As] (a full house, Threes full of Aces)
Jero0987: mucks hand
Stasia46 collected $1.20 from pot
*** SUMMARY ***
Total pot $1.24 | Rake $0.04
Board [Ad 5c 3h 3d Th]
Seat 1: juanrod39 (button) folded before Flop (didn't bet)
Seat 2: Stasia46 (small blind) showed [3s As] and won ($1.20) with a full house, Threes full of Aces
Seat 3: Jero0987 (big blind) mucked
Seat 4: toleabs2022 folded before Flop (didn't bet)
Seat 5: Quint1985 folded on the Flop


PokerStars Hand #238167609126:  Hold'em No Limit ($0.01/$0.02 USD) - 2022/08/23 10:49:42 ET
Table 'Despina IV' 6-max Seat #2 is the button
Seat 1: juanrod39 ($2 in chips)
Seat 2: Stasia46 ($2.32 in chips)
Seat 3: Jero0987 ($2 in chips)
Seat 4: toleabs2022 ($1.03 in chips)
Seat 5: Quint1985 ($2.53 in chips)
Jero0987: posts small blind $0.01
toleabs2022: posts big blind $0.02
*** HOLE CARDS ***
Quint1985: folds
juanrod39: folds
Stasia46: calls $0.02
Jero0987: folds
toleabs2022: checks
*** FLOP *** [2d Jd 9d]
toleabs2022: checks
Stasia46: checks
*** TURN *** [2d Jd 9d] [8d]
toleabs2022: bets $0.02
Stasia46: folds
Uncalled bet ($0.02) returned to toleabs2022
toleabs2022 collected $0.05 from pot
*** SUMMARY ***
Total pot $0.05 | Rake $0
Board [2d Jd 9d 8d]
Seat 1: juanrod39 folded before Flop (didn't bet)
Seat 2: Stasia46 (button) folded on the Turn
Seat 3: Jero0987 (small blind) folded before Flop
Seat 4: toleabs2022 (big blind) collected ($0.05)
Seat 5: Quint1985 folded before Flop (didn't bet)


PokerStars Hand #238167615188:  Hold'em No Limit ($0.01/$0.02 USD) - 2022/08/23 10:50:05 ET
Table 'Despina IV' 6-max Seat #3 is the button
Seat 1: juanrod39 ($2 in chips)
Seat 2: Stasia46 ($2.30 in chips)
Seat 3: Jero0987 ($1.99 in chips)
Seat 4: toleabs2022 ($1.06 in chips)
Seat 5: Quint1985 ($2.53 in chips)
Seat 6: John081069 ($1.44 in chips)
toleabs2022: posts small blind $0.01
Quint1985: posts big blind $0.02
*** HOLE CARDS ***
John081069: calls $0.02
juanrod39: folds
Stasia46: folds
Jero0987: calls $0.02
toleabs2022: folds
Quint1985: checks
*** FLOP *** [Js 7c Qc]
Quint1985: checks
John081069: checks
Jero0987: checks
*** TURN *** [Js 7c Qc] [3h]
Quint1985: checks
John081069: bets $0.02
Jero0987: calls $0.02
Quint1985: calls $0.02
*** RIVER *** [Js 7c Qc 3h] [4c]
Quint1985: checks
John081069: bets $0.06
Jero0987: folds
Quint1985: folds
Uncalled bet ($0.06) returned to John081069
John081069 collected $0.13 from pot
John081069: doesn't show hand
*** SUMMARY ***
Total pot $0.13 | Rake $0
Board [Js 7c Qc 3h 4c]
Seat 1: juanrod39 folded before Flop (didn't bet)
Seat 2: Stasia46 folded before Flop (didn't bet)
Seat 3: Jero0987 (button) folded on the River
Seat 4: toleabs2022 (small blind) folded before Flop
Seat 5: Quint1985 (big blind) folded on the River
Seat 6: John081069 collected ($0.13)


PokerStars Hand #238167627957:  Hold'em No Limit ($0.01/$0.02 USD) - 2022/08/23 10:50:53 ET
Table 'Despina IV' 6-max Seat #4 is the button
Seat 1: juanrod39 ($2 in chips)
Seat 2: Stasia46 ($2.30 in chips)
Seat 3: Jero0987 ($1.95 in chips)
Seat 4: toleabs2022 ($1.05 in chips)
Seat 5: Quint1985 ($2.49 in chips)
Seat 6: John081069 ($1.53 in chips)
Quint1985: posts small blind $0.01
John081069: posts big blind $0.02
*** HOLE CARDS ***
juanrod39: folds
Stasia46: raises $0.02 to $0.04
Jero0987: folds
toleabs2022: folds
Quint1985: folds
John081069: folds
Uncalled bet ($0.02) returned to Stasia46
Stasia46 collected $0.05 from pot
Stasia46: doesn't show hand
*** SUMMARY ***
Total pot $0.05 | Rake $0
Seat 1: juanrod39 folded before Flop (didn't bet)
Seat 2: Stasia46 collected ($0.05)
Seat 3: Jero0987 folded before Flop (didn't bet)
Seat 4: toleabs2022 (button) folded before Flop (didn't bet)
Seat 5: Quint1985 (small blind) folded before Flop
Seat 6: John081069 (big blind) folded before Flop


PokerStars Hand #238167630605:  Hold'em No Limit ($0.01/$0.02 USD) - 2022/08/23 10:51:02 ET
Table 'Despina IV' 6-max Seat #5 is the button
Seat 1: juanrod39 ($2 in chips)
Seat 2: Stasia46 ($2.33 in chips)
Seat 3: Jero0987 ($1.95 in chips)
Seat 4: toleabs2022 ($1.05 in chips)
Seat 5: Quint1985 ($2.48 in chips)
Seat 6: John081069 ($1.51 in chips)
John081069: posts small blind $0.01
juanrod39: posts big blind $0.02
*** HOLE CARDS ***
Stasia46: calls $0.02
Jero0987: folds
toleabs2022: calls $0.02
Quint1985: folds
John081069: calls $0.01
juanrod39: checks
*** FLOP *** [Ts Kd Ac]
John081069: bets $0.02
juanrod39: folds
Stasia46: calls $0.02
toleabs2022: folds
*** TURN *** [Ts Kd Ac] [Td]
John081069: bets $0.02
Stasia46: calls $0.02
*** RIVER *** [Ts Kd Ac Td] [Th]
John081069: bets $0.02
Stasia46: calls $0.02
*** SHOW DOWN ***
John081069: shows [4d As] (a full house, Tens full of Aces)
Stasia46: mucks hand
John081069 collected $0.19 from pot
*** SUMMARY ***
Total pot $0.20 | Rake $0.01
Board [Ts Kd Ac Td Th]
Seat 1: juanrod39 (big blind) folded on the Flop
Seat 2: Stasia46 mucked
Seat 3: Jero0987 folded before Flop (didn't bet)
Seat 4: toleabs2022 folded on the Flop
Seat 5: Quint1985 (button) folded before Flop (didn't bet)
Seat 6: John081069 (small blind) showed [4d As] and won ($0.19) with a full house, Tens full of Aces


PokerStars Hand #238167643549:  Hold'em No Limit ($0.01/$0.02 USD) - 2022/08/23 10:51:50 ET
Table 'Despina IV' 6-max Seat #6 is the button
Seat 1: juanrod39 ($2 in chips)
Seat 2: Stasia46 ($2.25 in chips)
Seat 3: Jero0987 ($1.95 in chips)
Seat 4: toleabs2022 ($1.03 in chips)
Seat 5: Quint1985 ($2.48 in chips)
Seat 6: John081069 ($1.62 in chips)
juanrod39: posts small blind $0.01
Stasia46: posts big blind $0.02
*** HOLE CARDS ***
Jero0987: folds
toleabs2022: calls $0.02
Quint1985: calls $0.02
John081069: folds
juanrod39: folds
Stasia46: checks
*** FLOP *** [9h 4s 8s]
Stasia46: checks
toleabs2022: bets $0.02
Quint1985: raises $0.04 to $0.06
Stasia46: folds
toleabs2022: calls $0.04
*** TURN *** [9h 4s 8s] [8d]
toleabs2022: bets $0.02
Quint1985: raises $0.04 to $0.06
toleabs2022: calls $0.04
*** RIVER *** [9h 4s 8s 8d] [6h]
toleabs2022: bets $0.15
Quint1985: raises $0.19 to $0.34
toleabs2022: folds
Uncalled bet ($0.19) returned to Quint1985
Quint1985 collected $0.59 from pot
Quint1985: doesn't show hand
*** SUMMARY ***
Total pot $0.61 | Rake $0.02
Board [9h 4s 8s 8d 6h]
Seat 1: juanrod39 (small blind) folded before Flop
Seat 2: Stasia46 (big blind) folded on the Flop
Seat 3: Jero0987 folded before Flop (didn't bet)
Seat 4: toleabs2022 folded on the River
Seat 5: Quint1985 collected ($0.59)
Seat 6: John081069 (button) folded before Flop (didn't bet)


PokerStars Hand #238167660649:  Hold'em No Limit ($0.01/$0.02 USD) - 2022/08/23 10:52:54 ET
Table 'Despina IV' 6-max Seat #1 is the button
Seat 1: juanrod39 ($2 in chips)
Seat 2: Stasia46 ($2.23 in chips)
Seat 3: Jero0987 ($1.95 in chips)
Seat 4: toleabs2022 ($0.74 in chips)
Seat 5: Quint1985 ($2.78 in chips)
Seat 6: John081069 ($1.62 in chips)
Stasia46: posts small blind $0.01
Jero0987: posts big blind $0.02
*** HOLE CARDS ***
toleabs2022: folds
Quint1985: folds
John081069: folds
juanrod39: folds
Stasia46: folds
Uncalled bet ($0.01) returned to Jero0987
Jero0987 collected $0.02 from pot
*** SUMMARY ***
Total pot $0.02 | Rake $0
Seat 1: juanrod39 (button) folded before Flop (didn't bet)
Seat 2: Stasia46 (small blind) folded before Flop
Seat 3: Jero0987 (big blind) collected ($0.02)
Seat 4: toleabs2022 folded before Flop (didn't bet)
Seat 5: Quint1985 folded before Flop (didn't bet)
Seat 6: John081069 folded before Flop (didn't bet)


PokerStars Hand #238167663073:  Hold'em No Limit ($0.01/$0.02 USD) - 2022/08/23 10:53:03 ET
Table 'Despina IV' 6-max Seat #2 is the button
Seat 1: juanrod39 ($2 in chips)
Seat 2: Stasia46 ($2.22 in chips)
Seat 3: Jero0987 ($1.96 in chips)
Seat 4: toleabs2022 ($0.74 in chips)
Seat 5: Quint1985 ($2.78 in chips)
Seat 6: John081069 ($1.62 in chips)
Jero0987: posts small blind $0.01
toleabs2022: posts big blind $0.02
*** HOLE CARDS ***
Quint1985: calls $0.02
John081069: calls $0.02
juanrod39: folds
Stasia46: folds
Jero0987: folds
toleabs2022: checks
*** FLOP *** [5h 5d 6h]
toleabs2022: bets $0.02
Quint1985: calls $0.02
John081069: folds
*** TURN *** [5h 5d 6h] [Ac]
toleabs2022: bets $0.05
Quint1985: calls $0.05
*** RIVER *** [5h 5d 6h Ac] [Ts]
toleabs2022: bets $0.20
Quint1985: calls $0.20
*** SHOW DOWN ***
toleabs2022: shows [5s 2d] (three of a kind, Fives)
Quint1985: mucks hand
toleabs2022 collected $0.59 from pot
*** SUMMARY ***
Total pot $0.61 | Rake $0.02
Board [5h 5d 6h Ac Ts]
Seat 1: juanrod39 folded before Flop (didn't bet)
Seat 2: Stasia46 (button) folded before Flop (didn't bet)
Seat 3: Jero0987 (small blind) folded before Flop
Seat 4: toleabs2022 (big blind) showed [5s 2d] and won ($0.59) with three of a kind, Fives
Seat 5: Quint1985 mucked
Seat 6: John081069 folded on the Flop


PokerStars Hand #238167673015:  Hold'em No Limit ($0.01/$0.02 USD) - 2022/08/23 10:53:39 ET
Table 'Despina IV' 6-max Seat #3 is the button
Seat 1: juanrod39 ($2 in chips)
Seat 2: Stasia46 ($2.22 in chips)
Seat 3: Jero0987 ($1.95 in chips)
Seat 4: toleabs2022 ($1.04 in chips)
Seat 5: Quint1985 ($2.49 in chips)
Seat 6: John081069 ($1.60 in chips)
toleabs2022: posts small blind $0.01
Quint1985: posts big blind $0.02
*** HOLE CARDS ***
John081069: folds
juanrod39: folds
Stasia46: folds
Jero0987: folds
toleabs2022: calls $0.01
Quint1985: checks
*** FLOP *** [Qs Jd 3h]
toleabs2022: checks
Quint1985: checks
*** TURN *** [Qs Jd 3h] [8d]
toleabs2022: bets $0.04
Quint1985: folds
Uncalled bet ($0.04) returned to toleabs2022
toleabs2022 collected $0.04 from pot
*** SUMMARY ***
Total pot $0.04 | Rake $0
Board [Qs Jd 3h 8d]
Seat 1: juanrod39 folded before Flop (didn't bet)
Seat 2: Stasia46 folded before Flop (didn't bet)
Seat 3: Jero0987 (button) folded before Flop (didn't bet)
Seat 4: toleabs2022 (small blind) collected ($0.04)
Seat 5: Quint1985 (big blind) folded on the Turn
Seat 6: John081069 folded before Flop (didn't bet)


PokerStars Hand #238167680170:  Hold'em No Limit ($0.01/$0.02 USD) - 2022/08/23 10:54:06 ET
Table 'Despina IV' 6-max Seat #4 is the button
Seat 1: juanrod39 ($2 in chips)
Seat 2: Stasia46 ($2.22 in chips)
Seat 3: Jero0987 ($1.95 in chips)
Seat 4: toleabs2022 ($1.06 in chips)
Seat 5: Quint1985 ($2.47 in chips)
Seat 6: John081069 ($1.60 in chips)
Quint1985: posts small blind $0.01
John081069: posts big blind $0.02
*** HOLE CARDS ***
juanrod39: folds
Stasia46: folds
Jero0987: folds
toleabs2022: folds
Quint1985: calls $0.01
John081069: checks
*** FLOP *** [3c 9s Tc]
Quint1985: checks
John081069: checks
*** TURN *** [3c 9s Tc] [Ac]
Quint1985: bets $0.02
John081069: folds
Uncalled bet ($0.02) returned to Quint1985
Quint1985 collected $0.04 from pot
Quint1985: doesn't show hand
*** SUMMARY ***
Total pot $0.04 | Rake $0
Board [3c 9s Tc Ac]
Seat 1: juanrod39 folded before Flop (didn't bet)
Seat 2: Stasia46 folded before Flop (didn't bet)
Seat 3: Jero0987 folded before Flop (didn't bet)
Seat 4: toleabs2022 (button) folded before Flop (didn't bet)
Seat 5: Quint1985 (small blind) collected ($0.04)
Seat 6: John081069 (big blind) folded on the Turn


PokerStars Hand #238167686376:  Hold'em No Limit ($0.01/$0.02 USD) - 2022/08/23 10:54:28 ET
Table 'Despina IV' 6-max Seat #5 is the button
Seat 1: juanrod39 ($2 in chips)
Seat 2: Stasia46 ($2.22 in chips)
Seat 3: Jero0987 ($1.95 in chips)
Seat 4: toleabs2022 ($1.06 in chips)
Seat 5: Quint1985 ($2.49 in chips)
Seat 6: John081069 ($1.58 in chips)
John081069: posts small blind $0.01
juanrod39: posts big blind $0.02
*** HOLE CARDS ***
Stasia46: folds
Jero0987: raises $0.04 to $0.06
toleabs2022: folds
Quint1985: folds
Stasia46 leaves the table
John081069: folds
juanrod39: folds
Uncalled bet ($0.04) returned to Jero0987
Jero0987 collected $0.05 from pot
*** SUMMARY ***
Total pot $0.05 | Rake $0
Seat 1: juanrod39 (big blind) folded before Flop
Seat 2: Stasia46 folded before Flop (didn't bet)
Seat 3: Jero0987 collected ($0.05)
Seat 4: toleabs2022 folded before Flop (didn't bet)
Seat 5: Quint1985 (button) folded before Flop (didn't bet)
Seat 6: John081069 (small blind) folded before Flop


PokerStars Hand #238167689819:  Hold'em No Limit ($0.01/$0.02 USD) - 2022/08/23 10:54:41 ET
Table 'Despina IV' 6-max Seat #6 is the button
Seat 1: juanrod39 ($2 in chips)
Seat 3: Jero0987 ($1.98 in chips)
Seat 4: toleabs2022 ($1.06 in chips)
Seat 5: Quint1985 ($2.49 in chips)
Seat 6: John081069 ($1.57 in chips)
juanrod39: posts small blind $0.01
Jero0987: posts big blind $0.02
*** HOLE CARDS ***
Nikalians joins the table at seat #2
toleabs2022: calls $0.02
Quint1985: folds
John081069: calls $0.02
juanrod39: folds
Jero0987: checks
*** FLOP *** [3s 4d 7c]
Jero0987: checks
toleabs2022: checks
John081069: checks
*** TURN *** [3s 4d 7c] [7h]
Jero0987: checks
toleabs2022: checks
John081069: bets $0.02
Jero0987: folds
toleabs2022: calls $0.02
*** RIVER *** [3s 4d 7c 7h] [Ac]
toleabs2022: bets $0.11
John081069: raises $0.11 to $0.22
toleabs2022: calls $0.11
*** SHOW DOWN ***
John081069: shows [Js 7d] (three of a kind, Sevens)
toleabs2022: mucks hand
John081069 collected $0.53 from pot
*** SUMMARY ***
Total pot $0.55 | Rake $0.02
Board [3s 4d 7c 7h Ac]
Seat 1: juanrod39 (small blind) folded before Flop
Seat 3: Jero0987 (big blind) folded on the Turn
Seat 4: toleabs2022 mucked
Seat 5: Quint1985 folded before Flop (didn't bet)
Seat 6: John081069 (button) showed [Js 7d] and won ($0.53) with three of a kind, Sevens


PokerStars Hand #238167706701:  Hold'em No Limit ($0.01/$0.02 USD) - 2022/08/23 10:55:49 ET
Table 'Despina IV' 6-max Seat #1 is the button
Seat 1: juanrod39 ($2 in chips)
Seat 3: Jero0987 ($1.96 in chips)
Seat 4: toleabs2022 ($0.80 in chips)
Seat 5: Quint1985 ($2.49 in chips)
Seat 6: John081069 ($1.84 in chips)
Jero0987: posts small blind $0.01
toleabs2022: posts big blind $0.02
*** HOLE CARDS ***
Quint1985: calls $0.02
John081069: calls $0.02
juanrod39: folds
Jero0987: raises $0.08 to $0.10
toleabs2022: folds
Quint1985: folds
John081069: calls $0.08
*** FLOP *** [Js 3h Qh]
Jero0987: bets $0.08
John081069: raises $0.08 to $0.16
Jero0987: folds
Uncalled bet ($0.08) returned to John081069
John081069 collected $0.39 from pot
John081069: doesn't show hand
*** SUMMARY ***
Total pot $0.40 | Rake $0.01
Board [Js 3h Qh]
Seat 1: juanrod39 (button) folded before Flop (didn't bet)
Seat 3: Jero0987 (small blind) folded on the Flop
Seat 4: toleabs2022 (big blind) folded before Flop
Seat 5: Quint1985 folded before Flop
Seat 6: John081069 collected ($0.39)


PokerStars Hand #238167717200:  Hold'em No Limit ($0.01/$0.02 USD) - 2022/08/23 10:56:35 ET
Table 'Despina IV' 6-max Seat #3 is the button
Seat 1: juanrod39 ($2 in chips)
Seat 3: Jero0987 ($2 in chips)
Seat 4: toleabs2022 ($0.78 in chips)
Seat 5: Quint1985 ($2.47 in chips)
Seat 6: John081069 ($2.05 in chips)
toleabs2022: posts small blind $0.01
Quint1985: posts big blind $0.02
Nikalians: sits out
*** HOLE CARDS ***
John081069: folds
juanrod39: raises $0.04 to $0.06
Jero0987: folds
toleabs2022: calls $0.05
John081069 leaves the table
Quint1985: folds
*** FLOP *** [Qh 3d Ks]
toleabs2022: checks
Quint1985 leaves the table
juanrod39: bets $0.04
toleabs2022: calls $0.04
*** TURN *** [Qh 3d Ks] [5s]
toleabs2022: checks
juanrod39: checks
*** RIVER *** [Qh 3d Ks 5s] [7c]
toleabs2022: bets $0.21
juanrod39: folds
Uncalled bet ($0.21) returned to toleabs2022
toleabs2022 collected $0.21 from pot
*** SUMMARY ***
Total pot $0.22 | Rake $0.01
Board [Qh 3d Ks 5s 7c]
Seat 1: juanrod39 folded on the River
Seat 3: Jero0987 (button) folded before Flop (didn't bet)
Seat 4: toleabs2022 (small blind) collected ($0.21)
Seat 5: Quint1985 (big blind) folded before Flop
Seat 6: John081069 folded before Flop (didn't bet)


PokerStars Hand #238167726352:  Hold'em No Limit ($0.01/$0.02 USD) - 2022/08/23 10:57:15 ET
Table 'Despina IV' 6-max Seat #4 is the button
Seat 1: juanrod39 ($2 in chips)
Seat 2: Nikalians ($1.60 in chips)
Seat 3: Jero0987 ($2 in chips)
Seat 4: toleabs2022 ($0.89 in chips)
juanrod39: posts small blind $0.01
Nikalians: posts big blind $0.02
*** HOLE CARDS ***
Jero0987: folds
toleabs2022: folds
juanrod39: raises $0.03 to $0.05
chompira27 joins the table at seat #5
Nikalians: folds
Uncalled bet ($0.03) returned to juanrod39
juanrod39 collected $0.04 from pot
*** SUMMARY ***
Total pot $0.04 | Rake $0
Seat 1: juanrod39 (small blind) collected ($0.04)
Seat 2: Nikalians (big blind) folded before Flop
Seat 3: Jero0987 folded before Flop (didn't bet)
Seat 4: toleabs2022 (button) folded before Flop (didn't bet)


PokerStars Hand #238167729728:  Hold'em No Limit ($0.01/$0.02 USD) - 2022/08/23 10:57:29 ET
Table 'Despina IV' 6-max Seat #1 is the button
Seat 1: juanrod39 ($2.02 in chips)
Seat 2: Nikalians ($1.58 in chips)
Seat 3: Jero0987 ($2 in chips)
Seat 4: toleabs2022 ($0.89 in chips)
Seat 5: chompira27 ($0.80 in chips)
Nikalians: posts small blind $0.01
Jero0987: posts big blind $0.02
Borman_msk joins the table at seat #6
chompira27: posts big blind $0.02
*** HOLE CARDS ***
toleabs2022: folds
chompira27: checks
juanrod39: folds
Nikalians: folds
Jero0987: checks
*** FLOP *** [Qh 6s 8c]
Jero0987: checks
chompira27: bets $0.04
Jero0987: calls $0.04
*** TURN *** [Qh 6s 8c] [6c]
Jero0987: checks
chompira27: checks
*** RIVER *** [Qh 6s 8c 6c] [Kc]
Jero0987: checks
chompira27: checks
*** SHOW DOWN ***
Jero0987: shows [4s Js] (a pair of Sixes)
chompira27: shows [7d As] (a pair of Sixes - Ace kicker)
chompira27 collected $0.13 from pot
*** SUMMARY ***
Total pot $0.13 | Rake $0
Board [Qh 6s 8c 6c Kc]
Seat 1: juanrod39 (button) folded before Flop (didn't bet)
Seat 2: Nikalians (small blind) folded before Flop
Seat 3: Jero0987 (big blind) showed [4s Js] and lost with a pair of Sixes
Seat 4: toleabs2022 folded before Flop (didn't bet)
Seat 5: chompira27 showed [7d As] and won ($0.13) with a pair of Sixes


PokerStars Hand #238167738649:  Hold'em No Limit ($0.01/$0.02 USD) - 2022/08/23 10:58:08 ET
Table 'Despina IV' 6-max Seat #2 is the button
Seat 1: juanrod39 ($2.02 in chips)
Seat 2: Nikalians ($1.57 in chips)
Seat 3: Jero0987 ($1.94 in chips)
Seat 4: toleabs2022 ($0.89 in chips)
Seat 5: chompira27 ($0.87 in chips)
Jero0987: posts small blind $0.01
toleabs2022: posts big blind $0.02
Borman_msk: sits out
*** HOLE CARDS ***
chompira27: folds
juanrod39: folds
Nikalians: raises $0.03 to $0.05
Jero0987: calls $0.04
toleabs2022: calls $0.03
*** FLOP *** [Jc 4d 7c]
Jero0987: bets $0.05
toleabs2022: calls $0.05
Nikalians: calls $0.05
*** TURN *** [Jc 4d 7c] [5c]
Jero0987: checks
toleabs2022: bets $0.14
Nikalians: folds
Jero0987: calls $0.14
*** RIVER *** [Jc 4d 7c 5c] [6s]
Jero0987: checks
toleabs2022: bets $0.56
Jero0987: calls $0.56
*** SHOW DOWN ***
toleabs2022: shows [Ac Qd] (high card Ace)
Jero0987: shows [Tc 9c] (a flush, Jack high)
Jero0987 collected $1.64 from pot
*** SUMMARY ***
Total pot $1.70 | Rake $0.06
Board [Jc 4d 7c 5c 6s]
Seat 1: juanrod39 folded before Flop (didn't bet)
Seat 2: Nikalians (button) folded on the Turn
Seat 3: Jero0987 (small blind) showed [Tc 9c] and won ($1.64) with a flush, Jack high
Seat 4: toleabs2022 (big blind) showed [Ac Qd] and lost with high card Ace
Seat 5: chompira27 folded before Flop (didn't bet)


PokerStars Hand #238167752731:  Hold'em No Limit ($0.01/$0.02 USD) - 2022/08/23 10:59:09 ET
Table 'Despina IV' 6-max Seat #3 is the button
Seat 1: juanrod39 ($2.02 in chips)
Seat 2: Nikalians ($1.47 in chips)
Seat 3: Jero0987 ($2.78 in chips)
Seat 4: toleabs2022 ($0.09 in chips)
Seat 5: chompira27 ($0.87 in chips)
Seat 6: Borman_msk ($1.60 in chips)
toleabs2022: posts small blind $0.01
chompira27: posts big blind $0.02
Borman_msk: posts big blind $0.02
*** HOLE CARDS ***
Borman_msk: checks
juanrod39: raises $0.06 to $0.08
Nikalians: folds
Jero0987: folds
toleabs2022: folds
chompira27: folds
Borman_msk: calls $0.06
*** FLOP *** [5s 8c Kh]
Borman_msk: checks
juanrod39: bets $0.05
Borman_msk: calls $0.05
*** TURN *** [5s 8c Kh] [7h]
Borman_msk: checks
juanrod39: checks
*** RIVER *** [5s 8c Kh 7h] [8s]
Borman_msk: bets $0.14
juanrod39: folds
Uncalled bet ($0.14) returned to Borman_msk
Borman_msk collected $0.28 from pot
Borman_msk: doesn't show hand
*** SUMMARY ***
Total pot $0.29 | Rake $0.01
Board [5s 8c Kh 7h 8s]
Seat 1: juanrod39 folded on the River
Seat 2: Nikalians folded before Flop (didn't bet)
Seat 3: Jero0987 (button) folded before Flop (didn't bet)
Seat 4: toleabs2022 (small blind) folded before Flop
Seat 5: chompira27 (big blind) folded before Flop
Seat 6: Borman_msk collected ($0.28)


PokerStars Hand #238167766682:  Hold'em No Limit ($0.01/$0.02 USD) - 2022/08/23 11:00:10 ET
Table 'Despina IV' 6-max Seat #4 is the button
Seat 1: juanrod39 ($2 in chips)
Seat 2: Nikalians ($1.47 in chips)
Seat 3: Jero0987 ($2.78 in chips)
Seat 4: toleabs2022 ($0.08 in chips)
Seat 5: chompira27 ($0.85 in chips)
Seat 6: Borman_msk ($1.75 in chips)
chompira27: posts small blind $0.01
Borman_msk: posts big blind $0.02
*** HOLE CARDS ***
juanrod39: folds
Nikalians: raises $0.03 to $0.05
Jero0987: folds
toleabs2022: folds
chompira27: calls $0.04
Borman_msk: calls $0.03
*** FLOP *** [Ah 9d 3h]
chompira27: checks
Borman_msk: checks
Nikalians: checks
*** TURN *** [Ah 9d 3h] [5h]
chompira27: checks
Borman_msk: checks
Nikalians: bets $0.07
chompira27: folds
Borman_msk: calls $0.07
*** RIVER *** [Ah 9d 3h 5h] [Kc]
Borman_msk: checks
Nikalians: bets $0.15
Borman_msk: folds
Uncalled bet ($0.15) returned to Nikalians
Nikalians collected $0.28 from pot
Nikalians: doesn't show hand
*** SUMMARY ***
Total pot $0.29 | Rake $0.01
Board [Ah 9d 3h 5h Kc]
Seat 1: juanrod39 folded before Flop (didn't bet)
Seat 2: Nikalians collected ($0.28)
Seat 3: Jero0987 folded before Flop (didn't bet)
Seat 4: toleabs2022 (button) folded before Flop (didn't bet)
Seat 5: chompira27 (small blind) folded on the Turn
Seat 6: Borman_msk (big blind) folded on the River


PokerStars Hand #238167782483:  Hold'em No Limit ($0.01/$0.02 USD) - 2022/08/23 11:01:15 ET
Table 'Despina IV' 6-max Seat #5 is the button
Seat 1: juanrod39 ($2 in chips)
Seat 2: Nikalians ($1.63 in chips)
Seat 3: Jero0987 ($2.78 in chips)
Seat 4: toleabs2022 ($0.08 in chips)
Seat 5: chompira27 ($0.80 in chips)
Seat 6: Borman_msk ($1.63 in chips)
Borman_msk: posts small blind $0.01
juanrod39: posts big blind $0.02
*** HOLE CARDS ***
Nikalians: raises $0.04 to $0.06
Jero0987: folds
toleabs2022: raises $0.02 to $0.08 and is all-in
chompira27: folds
Borman_msk: calls $0.07
juanrod39: calls $0.06
Nikalians: calls $0.02
*** FLOP *** [Ts 2s 3h]
Borman_msk: checks
juanrod39: checks
Nikalians: bets $0.16
Borman_msk: folds
juanrod39: calls $0.16
*** TURN *** [Ts 2s 3h] [9s]
juanrod39: checks
Nikalians: bets $0.46
juanrod39: calls $0.46
*** RIVER *** [Ts 2s 3h 9s] [6c]
juanrod39: checks
Nikalians: bets $0.93 and is all-in
juanrod39: calls $0.93
*** SHOW DOWN ***
Nikalians: shows [Ks Kd] (a pair of Kings)
juanrod39: shows [9c 9d] (three of a kind, Nines)
juanrod39 collected $2.99 from side pot
toleabs2022: shows [Qc Js] (high card Queen)
juanrod39 collected $0.31 from main pot
*** SUMMARY ***
Total pot $3.42 Main pot $0.31. Side pot $2.99. | Rake $0.12
Board [Ts 2s 3h 9s 6c]
Seat 1: juanrod39 (big blind) showed [9c 9d] and won ($3.30) with three of a kind, Nines
Seat 2: Nikalians showed [Ks Kd] and lost with a pair of Kings
Seat 3: Jero0987 folded before Flop (didn't bet)
Seat 4: toleabs2022 showed [Qc Js] and lost with high card Queen
Seat 5: chompira27 (button) folded before Flop (didn't bet)
Seat 6: Borman_msk (small blind) folded on the Flop


PokerStars Hand #238167810821:  Hold'em No Limit ($0.01/$0.02 USD) - 2022/08/23 11:02:36 ET
Table 'Despina IV' 6-max Seat #6 is the button
Seat 1: juanrod39 ($3.67 in chips)
Seat 3: Jero0987 ($2.78 in chips)
Seat 5: chompira27 ($0.80 in chips)
Seat 6: Borman_msk ($1.55 in chips)
juanrod39: posts small blind $0.01
Jero0987: posts big blind $0.02
*** HOLE CARDS ***
chompira27: raises $0.02 to $0.04
Borman_msk: calls $0.04
juanrod39: raises $0.16 to $0.20
toleabs2022 leaves the table
Jero0987: folds
chompira27: folds
Borman_msk: calls $0.16
*** FLOP *** [9s 8h Ks]
juanrod39: bets $0.33
Rik0u joins the table at seat #4
Borman_msk: calls $0.33
*** TURN *** [9s 8h Ks] [5h]
juanrod39: bets $1.62
Borman_msk: calls $1.02 and is all-in
Uncalled bet ($0.60) returned to juanrod39
*** RIVER *** [9s 8h Ks 5h] [7c]
*** SHOW DOWN ***
juanrod39: shows [Kc As] (a pair of Kings)
Borman_msk: shows [Jh Tc] (a straight, Seven to Jack)
Borman_msk collected $3.05 from pot
*** SUMMARY ***
Total pot $3.16 | Rake $0.11
Board [9s 8h Ks 5h 7c]
Seat 1: juanrod39 (small blind) showed [Kc As] and lost with a pair of Kings
Seat 3: Jero0987 (big blind) folded before Flop
Seat 5: chompira27 folded before Flop
Seat 6: Borman_msk (button) showed [Jh Tc] and won ($3.05) with a straight, Seven to Jack


PokerStars Hand #238167820278:  Hold'em No Limit ($0.01/$0.02 USD) - 2022/08/23 11:03:11 ET
Table 'Despina IV' 6-max Seat #1 is the button
Seat 1: juanrod39 ($2.12 in chips)
Seat 3: Jero0987 ($2.76 in chips)
Seat 4: Rik0u ($1.60 in chips)
Seat 5: chompira27 ($0.76 in chips)
Seat 6: Borman_msk ($3.05 in chips)
Jero0987: posts small blind $0.01
Rik0u: posts big blind $0.02
*** HOLE CARDS ***
chompira27: raises $0.02 to $0.04
Borman_msk: calls $0.04
juanrod39: raises $0.16 to $0.20
Jero0987: folds
Rik0u: folds
chompira27: calls $0.16
Borman_msk: calls $0.16
*** FLOP *** [8s Th Qs]
chompira27: bets $0.56 and is all-in
Borman_msk: calls $0.56
juanrod39: folds
*** TURN *** [8s Th Qs] [4s]
*** RIVER *** [8s Th Qs 4s] [9c]
*** SHOW DOWN ***
chompira27: shows [Td 7d] (a pair of Tens)
Borman_msk: shows [Qc Ah] (a pair of Queens)
Borman_msk collected $1.69 from pot
*** SUMMARY ***
Total pot $1.75 | Rake $0.06
Board [8s Th Qs 4s 9c]
Seat 1: juanrod39 (button) folded on the Flop
Seat 3: Jero0987 (small blind) folded before Flop
Seat 4: Rik0u (big blind) folded before Flop
Seat 5: chompira27 showed [Td 7d] and lost with a pair of Tens
Seat 6: Borman_msk showed [Qc Ah] and won ($1.69) with a pair of Queens


PokerStars Hand #238167829680:  Hold'em No Limit ($0.01/$0.02 USD) - 2022/08/23 11:03:46 ET
Table 'Despina IV' 6-max Seat #3 is the button
Seat 1: juanrod39 ($2 in chips)
Seat 2: Nikalians ($1.50 in chips)
Seat 3: Jero0987 ($2.75 in chips)
Seat 4: Rik0u ($2 in chips)
Seat 6: Borman_msk ($3.98 in chips)
Rik0u: posts small blind $0.01
Borman_msk: posts big blind $0.02
Nikalians: posts small & big blinds $0.03
*** HOLE CARDS ***
chompira27 leaves the table
juanrod39: folds
Nikalians: raises $0.04 to $0.06
Jero0987: folds
Rik0u: calls $0.05
Borman_msk: calls $0.04
*** FLOP *** [Tc 8c 9c]
Rik0u: checks
Borman_msk: checks
Nikalians: bets $0.06
Rik0u: calls $0.06
Borman_msk: calls $0.06
*** TURN *** [Tc 8c 9c] [2c]
Rik0u: checks
Borman_msk: checks
Nikalians: checks
*** RIVER *** [Tc 8c 9c 2c] [2d]
Rik0u: bets $0.24
Gismoll joins the table at seat #5
Borman_msk: raises $0.84 to $1.08
Nikalians: folds
Rik0u: folds
Uncalled bet ($0.84) returned to Borman_msk
Borman_msk collected $0.82 from pot
Borman_msk: doesn't show hand
*** SUMMARY ***
Total pot $0.85 | Rake $0.03
Board [Tc 8c 9c 2c 2d]
Seat 1: juanrod39 folded before Flop (didn't bet)
Seat 2: Nikalians folded on the River
Seat 3: Jero0987 (button) folded before Flop (didn't bet)
Seat 4: Rik0u (small blind) folded on the River
Seat 6: Borman_msk (big blind) collected ($0.82)


PokerStars Hand #238167845564:  Hold'em No Limit ($0.01/$0.02 USD) - 2022/08/23 11:04:45 ET
Table 'Despina IV' 6-max Seat #4 is the button
Seat 1: juanrod39 ($2 in chips)
Seat 2: Nikalians ($1.37 in chips)
Seat 3: Jero0987 ($2.75 in chips)
Seat 4: Rik0u ($1.64 in chips)
Seat 6: Borman_msk ($4.44 in chips)
Borman_msk: posts small blind $0.01
juanrod39: posts big blind $0.02
*** HOLE CARDS ***
Nikalians: folds
Jero0987: folds
Rik0u: folds
Rik0u leaves the table
Borman_msk: calls $0.01
juanrod39: checks
*** FLOP *** [4d 5c 9d]
Borman_msk: checks
juanrod39: checks
*** TURN *** [4d 5c 9d] [Th]
Borman_msk: checks
juanrod39: checks
*** RIVER *** [4d 5c 9d Th] [3s]
Borman_msk: checks
juanrod39: checks
*** SHOW DOWN ***
Borman_msk: shows [Qc Kd] (high card King)
juanrod39: shows [Ah 3c] (a pair of Threes)
juanrod39 collected $0.04 from pot
*** SUMMARY ***
Total pot $0.04 | Rake $0
Board [4d 5c 9d Th 3s]
Seat 1: juanrod39 (big blind) showed [Ah 3c] and won ($0.04) with a pair of Threes
Seat 2: Nikalians folded before Flop (didn't bet)
Seat 3: Jero0987 folded before Flop (didn't bet)
Seat 4: Rik0u (button) folded before Flop (didn't bet)
Seat 6: Borman_msk (small blind) showed [Qc Kd] and lost with high card King


PokerStars Hand #238167853063:  Hold'em No Limit ($0.01/$0.02 USD) - 2022/08/23 11:05:12 ET
Table 'Despina IV' 6-max Seat #6 is the button
Seat 1: juanrod39 ($2.02 in chips)
Seat 2: Nikalians ($1.37 in chips)
Seat 3: Jero0987 ($2.75 in chips)
Seat 6: Borman_msk ($4.42 in chips)
juanrod39: posts small blind $0.01
Nikalians: posts big blind $0.02
Gismoll: sits out
*** HOLE CARDS ***
Jero0987: folds
Borman_msk: calls $0.02
juanrod39: raises $0.06 to $0.08
Kasaty joins the table at seat #4
Nikalians: calls $0.06
Borman_msk: calls $0.06
*** FLOP *** [Tc 3c 3h]
juanrod39: checks
Nikalians: checks
Borman_msk: checks
*** TURN *** [Tc 3c 3h] [9d]
Gismoll leaves the table
MiritiFox joins the table at seat #5
juanrod39: checks
Nikalians: checks
Borman_msk: checks
*** RIVER *** [Tc 3c 3h 9d] [9s]
juanrod39: checks
Nikalians: checks
Borman_msk: checks
*** SHOW DOWN ***
juanrod39: shows [As 2s] (two pair, Nines and Threes)
Nikalians: shows [8h Ad] (two pair, Nines and Threes)
Borman_msk: mucks hand
juanrod39 collected $0.12 from pot
Nikalians collected $0.11 from pot
*** SUMMARY ***
Total pot $0.24 | Rake $0.01
Board [Tc 3c 3h 9d 9s]
Seat 1: juanrod39 (small blind) showed [As 2s] and won ($0.12) with two pair, Nines and Threes
Seat 2: Nikalians (big blind) showed [8h Ad] and won ($0.11) with two pair, Nines and Threes
Seat 3: Jero0987 folded before Flop (didn't bet)
Seat 6: Borman_msk (button) mucked


PokerStars Hand #238167865184:  Hold'em No Limit ($0.01/$0.02 USD) - 2022/08/23 11:05:55 ET
Table 'Despina IV' 6-max Seat #1 is the button
Seat 1: juanrod39 ($2.06 in chips)
Seat 2: Nikalians ($1.40 in chips)
Seat 3: Jero0987 ($2.75 in chips)
Seat 4: Kasaty ($0.80 in chips)
Seat 6: Borman_msk ($4.34 in chips)
Nikalians: posts small blind $0.01
Jero0987: posts big blind $0.02
Kasaty: posts big blind $0.02
MiritiFox: sits out
*** HOLE CARDS ***
Kasaty: checks
Borman_msk: calls $0.02
juanrod39: folds
Nikalians: raises $0.03 to $0.05
Jero0987: folds
Kasaty: calls $0.03
Borman_msk: calls $0.03
*** FLOP *** [Kh 8d 9d]
Nikalians: checks
Kasaty: checks
Borman_msk: checks
*** TURN *** [Kh 8d 9d] [3d]
Nikalians: bets $0.05
Kasaty: folds
Borman_msk: folds
Uncalled bet ($0.05) returned to Nikalians
Nikalians collected $0.16 from pot
Nikalians: doesn't show hand
*** SUMMARY ***
Total pot $0.17 | Rake $0.01
Board [Kh 8d 9d 3d]
Seat 1: juanrod39 (button) folded before Flop (didn't bet)
Seat 2: Nikalians (small blind) collected ($0.16)
Seat 3: Jero0987 (big blind) folded before Flop
Seat 4: Kasaty folded on the Turn
Seat 6: Borman_msk folded on the Turn


PokerStars Hand #238167874285:  Hold'em No Limit ($0.01/$0.02 USD) - 2022/08/23 11:06:26 ET
Table 'Despina IV' 6-max Seat #2 is the button
Seat 1: juanrod39 ($2.06 in chips)
Seat 2: Nikalians ($1.51 in chips)
Seat 3: Jero0987 ($2.73 in chips)
Seat 4: Kasaty ($0.75 in chips)
Seat 6: Borman_msk ($4.29 in chips)
Jero0987: posts small blind $0.01
Kasaty: posts big blind $0.02
MiritiFox: sits out
*** HOLE CARDS ***
Borman_msk: calls $0.02
juanrod39: folds
Nikalians: folds
Jero0987: folds
Kasaty: checks
*** FLOP *** [Kh 4c 9h]
Kasaty: checks
Borman_msk: checks
*** TURN *** [Kh 4c 9h] [2s]
Kasaty: bets $0.06
Borman_msk: folds
Uncalled bet ($0.06) returned to Kasaty
Kasaty collected $0.05 from pot
*** SUMMARY ***
Total pot $0.05 | Rake $0
Board [Kh 4c 9h 2s]
Seat 1: juanrod39 folded before Flop (didn't bet)
Seat 2: Nikalians (button) folded before Flop (didn't bet)
Seat 3: Jero0987 (small blind) folded before Flop
Seat 4: Kasaty (big blind) collected ($0.05)
Seat 6: Borman_msk folded on the Turn


PokerStars Hand #238167880946:  Hold'em No Limit ($0.01/$0.02 USD) - 2022/08/23 11:06:49 ET
Table 'Despina IV' 6-max Seat #3 is the button
Seat 1: juanrod39 ($2.06 in chips)
Seat 2: Nikalians ($1.51 in chips)
Seat 3: Jero0987 ($2.72 in chips)
Seat 4: Kasaty ($0.78 in chips)
Seat 5: MiritiFox ($2 in chips)
Seat 6: Borman_msk ($4.27 in chips)
Kasaty: posts small blind $0.01
MiritiFox: posts big blind $0.02
*** HOLE CARDS ***
Borman_msk: calls $0.02
juanrod39: folds
Nikalians: folds
Jero0987 has timed out
Jero0987: folds
Kasaty: calls $0.01
MiritiFox: checks
*** FLOP *** [2c 2h 8c]
Kasaty: bets $0.02
MiritiFox: calls $0.02
Borman_msk: folds
*** TURN *** [2c 2h 8c] [Js]
Kasaty: bets $0.02
MiritiFox: raises $0.07 to $0.09
Kasaty: calls $0.07
*** RIVER *** [2c 2h 8c Js] [3d]
Kasaty: checks
MiritiFox: bets $0.20
Kasaty: folds
Uncalled bet ($0.20) returned to MiritiFox
MiritiFox collected $0.27 from pot
MiritiFox: doesn't show hand
*** SUMMARY ***
Total pot $0.28 | Rake $0.01
Board [2c 2h 8c Js 3d]
Seat 1: juanrod39 folded before Flop (didn't bet)
Seat 2: Nikalians folded before Flop (didn't bet)
Seat 3: Jero0987 (button) folded before Flop (didn't bet)
Seat 4: Kasaty (small blind) folded on the River
Seat 5: MiritiFox (big blind) collected ($0.27)
Seat 6: Borman_msk folded on the Flop


PokerStars Hand #238167895696:  Hold'em No Limit ($0.01/$0.02 USD) - 2022/08/23 11:07:39 ET
Table 'Despina IV' 6-max Seat #4 is the button
Seat 1: juanrod39 ($2.06 in chips)
Seat 2: Nikalians ($1.51 in chips)
Seat 4: Kasaty ($0.65 in chips)
Seat 5: MiritiFox ($2.14 in chips)
Seat 6: Borman_msk ($4.25 in chips)
MiritiFox: posts small blind $0.01
Borman_msk: posts big blind $0.02
*** HOLE CARDS ***
juanrod39: folds
Nikalians: folds
Jero0987 leaves the table
Kasaty: folds
MiritiFox: raises $0.04 to $0.06
Borman_msk: calls $0.04
*** FLOP *** [Tc Kd 7h]
MiritiFox: bets $0.06
Borman_msk: folds
Uncalled bet ($0.06) returned to MiritiFox
MiritiFox collected $0.12 from pot
MiritiFox: doesn't show hand
*** SUMMARY ***
Total pot $0.12 | Rake $0
Board [Tc Kd 7h]
Seat 1: juanrod39 folded before Flop (didn't bet)
Seat 2: Nikalians folded before Flop (didn't bet)
Seat 4: Kasaty (button) folded before Flop (didn't bet)
Seat 5: MiritiFox (small blind) collected ($0.12)
Seat 6: Borman_msk (big blind) folded on the Flop


PokerStars Hand #238167907396:  Hold'em No Limit ($0.01/$0.02 USD) - 2022/08/23 11:08:19 ET
Table 'Despina IV' 6-max Seat #5 is the button
Seat 1: juanrod39 ($2.06 in chips)
Seat 2: Nikalians ($1.51 in chips)
Seat 5: MiritiFox ($2.20 in chips)
Seat 6: Borman_msk ($4.19 in chips)
Borman_msk: posts small blind $0.01
juanrod39: posts big blind $0.02
*** HOLE CARDS ***
Nikalians: folds
MiritiFox: raises $0.03 to $0.05
Borman_msk: calls $0.04
juanrod39: folds
*** FLOP *** [5s 6s Jh]
Borman_msk: checks
MiritiFox: bets $0.06
Borman_msk: folds
Uncalled bet ($0.06) returned to MiritiFox
MiritiFox collected $0.12 from pot
MiritiFox: doesn't show hand
*** SUMMARY ***
Total pot $0.12 | Rake $0
Board [5s 6s Jh]
Seat 1: juanrod39 (big blind) folded before Flop
Seat 2: Nikalians folded before Flop (didn't bet)
Seat 5: MiritiFox (button) collected ($0.12)
Seat 6: Borman_msk (small blind) folded on the Flop


PokerStars Hand #238167916896:  Hold'em No Limit ($0.01/$0.02 USD) - 2022/08/23 11:08:52 ET
Table 'Despina IV' 6-max Seat #6 is the button
Seat 1: juanrod39 ($2.04 in chips)
Seat 2: Nikalians ($1.51 in chips)
Seat 5: MiritiFox ($2.27 in chips)
Seat 6: Borman_msk ($4.14 in chips)
juanrod39: posts small blind $0.01
Nikalians: posts big blind $0.02
*** HOLE CARDS ***
stryka62 joins the table at seat #3
MiritiFox: folds
Borman_msk: calls $0.02
juanrod39: folds
Nikalians: checks
*** FLOP *** [5d 2d 7c]
Nikalians: bets $0.04
Borman_msk: calls $0.04
*** TURN *** [5d 2d 7c] [9h]
Nikalians: bets $0.07
Borman_msk: raises $0.07 to $0.14
Nikalians: calls $0.07
*** RIVER *** [5d 2d 7c 9h] [8s]
Nikalians: checks
Borman_msk: bets $0.40
Nikalians: folds
Uncalled bet ($0.40) returned to Borman_msk
Borman_msk collected $0.40 from pot
Borman_msk: doesn't show hand
*** SUMMARY ***
Total pot $0.41 | Rake $0.01
Board [5d 2d 7c 9h 8s]
Seat 1: juanrod39 (small blind) folded before Flop
Seat 2: Nikalians (big blind) folded on the River
Seat 5: MiritiFox folded before Flop (didn't bet)
Seat 6: Borman_msk (button) collected ($0.40)


PokerStars Hand #238167929675:  Hold'em No Limit ($0.01/$0.02 USD) - 2022/08/23 11:09:36 ET
Table 'Despina IV' 6-max Seat #1 is the button
Seat 1: juanrod39 ($2.03 in chips)
Seat 2: Nikalians ($1.31 in chips)
Seat 3: stryka62 ($0.80 in chips)
Seat 5: MiritiFox ($2.27 in chips)
Seat 6: Borman_msk ($4.34 in chips)
Nikalians: posts small blind $0.01
stryka62: posts big blind $0.02
*** HOLE CARDS ***
MiritiFox: folds
Borman_msk: calls $0.02
juanrod39: folds
Nikalians: raises $0.06 to $0.08
stryka62: folds
Borman_msk: raises $0.06 to $0.14
Nikalians: raises $1.17 to $1.31 and is all-in
Borman_msk: calls $1.17
*** FLOP *** [8c 2s 5h]
*** TURN *** [8c 2s 5h] [Ac]
*** RIVER *** [8c 2s 5h Ac] [Th]
*** SHOW DOWN ***
Nikalians: shows [Ad Kh] (a pair of Aces)
Borman_msk: shows [Td Jh] (a pair of Tens)
Nikalians collected $2.55 from pot
*** SUMMARY ***
Total pot $2.64 | Rake $0.09
Board [8c 2s 5h Ac Th]
Seat 1: juanrod39 (button) folded before Flop (didn't bet)
Seat 2: Nikalians (small blind) showed [Ad Kh] and won ($2.55) with a pair of Aces
Seat 3: stryka62 (big blind) folded before Flop
Seat 5: MiritiFox folded before Flop (didn't bet)
Seat 6: Borman_msk showed [Td Jh] and lost with a pair of Tens


PokerStars Hand #238167941243:  Hold'em No Limit ($0.01/$0.02 USD) - 2022/08/23 11:10:16 ET
Table 'Despina IV' 6-max Seat #2 is the button
Seat 1: juanrod39 ($2.03 in chips)
Seat 2: Nikalians ($2.55 in chips)
Seat 3: stryka62 ($0.78 in chips)
Seat 5: MiritiFox ($2.27 in chips)
Seat 6: Borman_msk ($3.03 in chips)
stryka62: posts small blind $0.01
MiritiFox: posts big blind $0.02
*** HOLE CARDS ***
Borman_msk: calls $0.02
juanrod39: folds
Nikalians: folds
stryka62: raises $0.06 to $0.08
MiritiFox: folds
Borman_msk: calls $0.06
*** FLOP *** [8s Jh 2d]
stryka62: checks
Borman_msk: bets $0.09
stryka62: calls $0.09
*** TURN *** [8s Jh 2d] [Kc]
stryka62: checks
Borman_msk: bets $1.26
stryka62: calls $0.61 and is all-in
Uncalled bet ($0.65) returned to Borman_msk
*** RIVER *** [8s Jh 2d Kc] [2h]
*** SHOW DOWN ***
stryka62: shows [Kh Qd] (two pair, Kings and Deuces)
Borman_msk: shows [Js 2s] (a full house, Deuces full of Jacks)
Borman_msk collected $1.52 from pot
*** SUMMARY ***
Total pot $1.58 | Rake $0.06
Board [8s Jh 2d Kc 2h]
Seat 1: juanrod39 folded before Flop (didn't bet)
Seat 2: Nikalians (button) folded before Flop (didn't bet)
Seat 3: stryka62 (small blind) showed [Kh Qd] and lost with two pair, Kings and Deuces
Seat 5: MiritiFox (big blind) folded before Flop
Seat 6: Borman_msk showed [Js 2s] and won ($1.52) with a full house, Deuces full of Jacks


PokerStars Hand #238167956161:  Hold'em No Limit ($0.01/$0.02 USD) - 2022/08/23 11:11:07 ET
Table 'Despina IV' 6-max Seat #5 is the button
Seat 1: juanrod39 ($2.03 in chips)
Seat 2: Nikalians ($2.55 in chips)
Seat 5: MiritiFox ($2.25 in chips)
Seat 6: Borman_msk ($3.77 in chips)
Borman_msk: posts small blind $0.01
juanrod39: posts big blind $0.02
*** HOLE CARDS ***
Nikalians: folds
MiritiFox: raises $0.03 to $0.05
Borman_msk: calls $0.04
juanrod39: folds
*** FLOP *** [6d 3h 8s]
Borman_msk: bets $0.06
MiritiFox: folds
Uncalled bet ($0.06) returned to Borman_msk
Borman_msk collected $0.12 from pot
Borman_msk: doesn't show hand
*** SUMMARY ***
Total pot $0.12 | Rake $0
Board [6d 3h 8s]
Seat 1: juanrod39 (big blind) folded before Flop
Seat 2: Nikalians folded before Flop (didn't bet)
Seat 5: MiritiFox (button) folded on the Flop
Seat 6: Borman_msk (small blind) collected ($0.12)


PokerStars Hand #238167962495:  Hold'em No Limit ($0.01/$0.02 USD) - 2022/08/23 11:11:29 ET
Table 'Despina IV' 6-max Seat #6 is the button
Seat 1: juanrod39 ($2.01 in chips)
Seat 2: Nikalians ($2.55 in chips)
Seat 3: stryka62 ($0.80 in chips)
Seat 5: MiritiFox ($2.20 in chips)
Seat 6: Borman_msk ($3.84 in chips)
juanrod39: posts small blind $0.01
Nikalians: posts big blind $0.02
*** HOLE CARDS ***
stryka62: calls $0.02
MiritiFox: folds
Borman_msk: calls $0.02
juanrod39: folds
Nikalians: checks
*** FLOP *** [Th 8c Jh]
Nikalians: checks
stryka62: checks
Borman_msk: checks
*** TURN *** [Th 8c Jh] [2d]
Nikalians: checks
stryka62: checks
Borman_msk: checks
*** RIVER *** [Th 8c Jh 2d] [6s]
Nikalians: checks
stryka62: checks
Borman_msk: checks
*** SHOW DOWN ***
Nikalians: shows [4d 7c] (high card Jack)
stryka62: shows [4h Kd] (high card King)
Borman_msk: shows [2c 3d] (a pair of Deuces)
Borman_msk collected $0.07 from pot
*** SUMMARY ***
Total pot $0.07 | Rake $0
Board [Th 8c Jh 2d 6s]
Seat 1: juanrod39 (small blind) folded before Flop
Seat 2: Nikalians (big blind) showed [4d 7c] and lost with high card Jack
Seat 3: stryka62 showed [4h Kd] and lost with high card King
Seat 5: MiritiFox folded before Flop (didn't bet)
Seat 6: Borman_msk (button) showed [2c 3d] and won ($0.07) with a pair of Deuces


PokerStars Hand #238167971825:  Hold'em No Limit ($0.01/$0.02 USD) - 2022/08/23 11:12:01 ET
Table 'Despina IV' 6-max Seat #1 is the button
Seat 1: juanrod39 ($2 in chips)
Seat 2: Nikalians ($2.53 in chips)
Seat 3: stryka62 ($0.78 in chips)
Seat 5: MiritiFox ($2.20 in chips)
Seat 6: Borman_msk ($3.89 in chips)
Nikalians: posts small blind $0.01
stryka62: posts big blind $0.02
*** HOLE CARDS ***
MiritiFox: folds
Borman_msk: raises $0.02 to $0.04
juanrod39: folds
Nikalians: folds
stryka62: folds
Uncalled bet ($0.02) returned to Borman_msk
Borman_msk collected $0.05 from pot
Borman_msk: doesn't show hand
*** SUMMARY ***
Total pot $0.05 | Rake $0
Seat 1: juanrod39 (button) folded before Flop (didn't bet)
Seat 2: Nikalians (small blind) folded before Flop
Seat 3: stryka62 (big blind) folded before Flop
Seat 5: MiritiFox folded before Flop (didn't bet)
Seat 6: Borman_msk collected ($0.05)


PokerStars Hand #238167975592:  Hold'em No Limit ($0.01/$0.02 USD) - 2022/08/23 11:12:14 ET
Table 'Despina IV' 6-max Seat #2 is the button
Seat 1: juanrod39 ($2 in chips)
Seat 2: Nikalians ($2.52 in chips)
Seat 3: stryka62 ($0.76 in chips)
Seat 5: MiritiFox ($2.20 in chips)
Seat 6: Borman_msk ($3.92 in chips)
stryka62: posts small blind $0.01
MiritiFox: posts big blind $0.02
*** HOLE CARDS ***
Borman_msk: calls $0.02
juanrod39: folds
Nikalians: raises $0.03 to $0.05
stryka62 has timed out
stryka62: folds
MiritiFox: calls $0.03
Borman_msk: calls $0.03
*** FLOP *** [2s 4d Kh]
MiritiFox: checks
Borman_msk: checks
Nikalians: checks
*** TURN *** [2s 4d Kh] [Jh]
MiritiFox: checks
stryka62 is disconnected
Borman_msk: checks
Nikalians: checks
*** RIVER *** [2s 4d Kh Jh] [6d]
MiritiFox: bets $0.10
Borman_msk: folds
Nikalians: folds
Uncalled bet ($0.10) returned to MiritiFox
MiritiFox collected $0.15 from pot
MiritiFox: doesn't show hand
*** SUMMARY ***
Total pot $0.16 | Rake $0.01
Board [2s 4d Kh Jh 6d]
Seat 1: juanrod39 folded before Flop (didn't bet)
Seat 2: Nikalians (button) folded on the River
Seat 3: stryka62 (small blind) folded before Flop
Seat 5: MiritiFox (big blind) collected ($0.15)
Seat 6: Borman_msk folded on the River


PokerStars Hand #238167996646:  Hold'em No Limit ($0.01/$0.02 USD) - 2022/08/23 11:13:27 ET
Table 'Despina IV' 6-max Seat #5 is the button
Seat 2: Nikalians ($2.47 in chips)
Seat 5: MiritiFox ($2.30 in chips)
Seat 6: Borman_msk ($3.87 in chips)
Borman_msk: posts small blind $0.01
juanrod39: is sitting out
Nikalians: posts big blind $0.02
*** HOLE CARDS ***
MiritiFox: raises $0.03 to $0.05
Borman_msk: calls $0.04
juanrod39 leaves the table
Nikalians: folds
*** FLOP *** [9d 4c Kd]
Borman_msk: checks
MiritiFox: checks
*** TURN *** [9d 4c Kd] [8h]
Borman_msk: checks
MiritiFox: checks
*** RIVER *** [9d 4c Kd 8h] [6s]
Borman_msk: checks
MiritiFox: checks
*** SHOW DOWN ***
Borman_msk: shows [7c Ac] (high card Ace)
MiritiFox: shows [2h 2c] (a pair of Deuces)
MiritiFox collected $0.12 from pot
*** SUMMARY ***
Total pot $0.12 | Rake $0
Board [9d 4c Kd 8h 6s]
Seat 2: Nikalians (big blind) folded before Flop
Seat 5: MiritiFox (button) showed [2h 2c] and won ($0.12) with a pair of Deuces
Seat 6: Borman_msk (small blind) showed [7c Ac] and lost with high card Ace


PokerStars Hand #238168002441:  Hold'em No Limit ($0.01/$0.02 USD) - 2022/08/23 11:13:47 ET
Table 'Despina IV' 6-max Seat #6 is the button
Seat 2: Nikalians ($2.45 in chips)
Seat 5: MiritiFox ($2.37 in chips)
Seat 6: Borman_msk ($3.82 in chips)
Nikalians: posts small blind $0.01
MiritiFox: posts big blind $0.02
*** HOLE CARDS ***
Borman_msk: calls $0.02
superRODRI joins the table at seat #1
Nikalians: calls $0.01
MiritiFox: checks
*** FLOP *** [Kh Jc 3h]
Nikalians: checks
MiritiFox: checks
Borman_msk: bets $0.02
Nikalians: folds
MiritiFox: calls $0.02
*** TURN *** [Kh Jc 3h] [Jh]
MiritiFox: checks
Borman_msk: bets $0.05
MiritiFox: folds
Uncalled bet ($0.05) returned to Borman_msk
Borman_msk collected $0.10 from pot
Borman_msk: doesn't show hand
*** SUMMARY ***
Total pot $0.10 | Rake $0
Board [Kh Jc 3h Jh]
Seat 2: Nikalians (small blind) folded on the Flop
Seat 5: MiritiFox (big blind) folded on the Turn
Seat 6: Borman_msk (button) collected ($0.10)


PokerStars Hand #238168012318:  Hold'em No Limit ($0.01/$0.02 USD) - 2022/08/23 11:14:21 ET
Table 'Despina IV' 6-max Seat #2 is the button
Seat 2: Nikalians ($2.43 in chips)
Seat 5: MiritiFox ($2.33 in chips)
Seat 6: Borman_msk ($3.88 in chips)
MiritiFox: posts small blind $0.01
Borman_msk: posts big blind $0.02
superRODRI: sits out
*** HOLE CARDS ***
Nikalians: folds
MiritiFox: raises $0.03 to $0.05
Borman_msk: calls $0.03
*** FLOP *** [Th Td Ks]
MiritiFox: bets $0.03
Borman_msk: folds
Uncalled bet ($0.03) returned to MiritiFox
MiritiFox collected $0.10 from pot
MiritiFox: doesn't show hand
*** SUMMARY ***
Total pot $0.10 | Rake $0
Board [Th Td Ks]
Seat 2: Nikalians (button) folded before Flop (didn't bet)
Seat 5: MiritiFox (small blind) collected ($0.10)
Seat 6: Borman_msk (big blind) folded on the Flop


PokerStars Hand #238168018619:  Hold'em No Limit ($0.01/$0.02 USD) - 2022/08/23 11:14:43 ET
Table 'Despina IV' 6-max Seat #5 is the button
Seat 1: superRODRI ($2.41 in chips)
Seat 2: Nikalians ($2.43 in chips)
Seat 5: MiritiFox ($2.38 in chips)
Seat 6: Borman_msk ($3.83 in chips)
Borman_msk: posts small blind $0.01
superRODRI: posts big blind $0.02
*** HOLE CARDS ***
Nikalians: raises $0.02 to $0.04
MiritiFox: folds
Borman_msk: calls $0.03
superRODRI: calls $0.02
*** FLOP *** [6h 5s 8s]
Borman_msk: checks
superRODRI: checks
Nikalians: checks
*** TURN *** [6h 5s 8s] [5h]
Borman_msk: checks
superRODRI: checks
Nikalians: bets $0.09
Borman_msk: folds
superRODRI: calls $0.09
*** RIVER *** [6h 5s 8s 5h] [9d]
superRODRI: checks
Nikalians: bets $0.15
superRODRI: calls $0.15
*** SHOW DOWN ***
Nikalians: shows [5d Ac] (three of a kind, Fives)
superRODRI: mucks hand
Nikalians collected $0.58 from pot
*** SUMMARY ***
Total pot $0.60 | Rake $0.02
Board [6h 5s 8s 5h 9d]
Seat 1: superRODRI (big blind) mucked
Seat 2: Nikalians showed [5d Ac] and won ($0.58) with three of a kind, Fives
Seat 5: MiritiFox (button) folded before Flop (didn't bet)
Seat 6: Borman_msk (small blind) folded on the Turn


PokerStars Hand #238168040424:  Hold'em No Limit ($0.01/$0.02 USD) - 2022/08/23 11:15:58 ET
Table 'Despina IV' 6-max Seat #6 is the button
Seat 1: superRODRI ($2.13 in chips)
Seat 2: Nikalians ($2.73 in chips)
Seat 5: MiritiFox ($2.38 in chips)
Seat 6: Borman_msk ($3.79 in chips)
superRODRI: posts small blind $0.01
Nikalians: posts big blind $0.02
*** HOLE CARDS ***
MiritiFox: raises $0.03 to $0.05
Borman_msk: folds
superRODRI: folds
Nikalians: folds
Uncalled bet ($0.03) returned to MiritiFox
MiritiFox collected $0.05 from pot
MiritiFox: doesn't show hand
*** SUMMARY ***
Total pot $0.05 | Rake $0
Seat 1: superRODRI (small blind) folded before Flop
Seat 2: Nikalians (big blind) folded before Flop
Seat 5: MiritiFox collected ($0.05)
Seat 6: Borman_msk (button) folded before Flop (didn't bet)


PokerStars Hand #238168043611:  Hold'em No Limit ($0.01/$0.02 USD) - 2022/08/23 11:16:09 ET
Table 'Despina IV' 6-max Seat #1 is the button
Seat 1: superRODRI ($2.12 in chips)
Seat 2: Nikalians ($2.71 in chips)
Seat 5: MiritiFox ($2.41 in chips)
Seat 6: Borman_msk ($3.79 in chips)
Nikalians: posts small blind $0.01
MiritiFox: posts big blind $0.02
*** HOLE CARDS ***
Borman_msk: calls $0.02
superRODRI: folds
Nikalians: folds
MiritiFox: raises $0.03 to $0.05
Borman_msk: raises $0.11 to $0.16
MiritiFox: folds
Uncalled bet ($0.11) returned to Borman_msk
Borman_msk collected $0.11 from pot
Borman_msk: doesn't show hand
*** SUMMARY ***
Total pot $0.11 | Rake $0
Seat 1: superRODRI (button) folded before Flop (didn't bet)
Seat 2: Nikalians (small blind) folded before Flop
Seat 5: MiritiFox (big blind) folded before Flop
Seat 6: Borman_msk collected ($0.11)


PokerStars Hand #238168049409:  Hold'em No Limit ($0.01/$0.02 USD) - 2022/08/23 11:16:29 ET
Table 'Despina IV' 6-max Seat #2 is the button
Seat 1: superRODRI ($2.12 in chips)
Seat 2: Nikalians ($2.70 in chips)
Seat 5: MiritiFox ($2.36 in chips)
Seat 6: Borman_msk ($3.85 in chips)
MiritiFox: posts small blind $0.01
Borman_msk: posts big blind $0.02
*** HOLE CARDS ***
superRODRI: folds
Nikalians: folds
MiritiFox: folds
Uncalled bet ($0.01) returned to Borman_msk
Borman_msk collected $0.02 from pot
Borman_msk: doesn't show hand
stryka62 is disconnected
*** SUMMARY ***
Total pot $0.02 | Rake $0
Seat 1: superRODRI folded before Flop (didn't bet)
Seat 2: Nikalians (button) folded before Flop (didn't bet)
Seat 5: MiritiFox (small blind) folded before Flop
Seat 6: Borman_msk (big blind) collected ($0.02)


PokerStars Hand #238168051357:  Hold'em No Limit ($0.01/$0.02 USD) - 2022/08/23 11:16:36 ET
Table 'Despina IV' 6-max Seat #5 is the button
Seat 1: superRODRI ($2.12 in chips)
Seat 2: Nikalians ($2.70 in chips)
Seat 5: MiritiFox ($2.35 in chips)
Seat 6: Borman_msk ($3.86 in chips)
Borman_msk: posts small blind $0.01
superRODRI: posts big blind $0.02
stryka62 has timed out while disconnected
stryka62: is sitting out
*** HOLE CARDS ***
Nikalians: folds
MiritiFox: raises $0.03 to $0.05
Borman_msk: calls $0.04
superRODRI: folds
*** FLOP *** [Kh 7s 4h]
Borman_msk: checks
MiritiFox: checks
*** TURN *** [Kh 7s 4h] [5s]
Borman_msk: bets $0.06
MiritiFox: folds
Uncalled bet ($0.06) returned to Borman_msk
Borman_msk collected $0.12 from pot
Borman_msk: doesn't show hand
*** SUMMARY ***
Total pot $0.12 | Rake $0
Board [Kh 7s 4h 5s]
Seat 1: superRODRI (big blind) folded before Flop
Seat 2: Nikalians folded before Flop (didn't bet)
Seat 5: MiritiFox (button) folded on the Turn
Seat 6: Borman_msk (small blind) collected ($0.12)


PokerStars Hand #238168061326:  Hold'em No Limit ($0.01/$0.02 USD) - 2022/08/23 11:17:11 ET
Table 'Despina IV' 6-max Seat #6 is the button
Seat 1: superRODRI ($2.10 in chips)
Seat 2: Nikalians ($2.70 in chips)
Seat 3: stryka62 ($0.75 in chips)
Seat 5: MiritiFox ($2.30 in chips)
Seat 6: Borman_msk ($3.93 in chips)
superRODRI: posts small blind $0.01
Nikalians: posts big blind $0.02
stryka62: posts small & big blinds $0.03
*** HOLE CARDS ***
stryka62: checks
MiritiFox: folds
Borman_msk: calls $0.02
superRODRI: folds
Nikalians: checks
*** FLOP *** [4h 6h 3c]
Nikalians: checks
stryka62: bets $0.04
Borman_msk: calls $0.04
Nikalians: calls $0.04
*** TURN *** [4h 6h 3c] [9c]
Nikalians: checks
stryka62: bets $0.04
Borman_msk: raises $0.08 to $0.12
Nikalians: calls $0.12
stryka62: calls $0.08
*** RIVER *** [4h 6h 3c 9c] [Jd]
Nikalians: checks
stryka62: checks
Borman_msk: bets $0.27
Nikalians: folds
stryka62: folds
Uncalled bet ($0.27) returned to Borman_msk
Borman_msk collected $0.54 from pot
Borman_msk: doesn't show hand
*** SUMMARY ***
Total pot $0.56 | Rake $0.02
Board [4h 6h 3c 9c Jd]
Seat 1: superRODRI (small blind) folded before Flop
Seat 2: Nikalians (big blind) folded on the River
Seat 3: stryka62 folded on the River
Seat 5: MiritiFox folded before Flop (didn't bet)
Seat 6: Borman_msk (button) collected ($0.54)


PokerStars Hand #238168101058:  Hold'em No Limit ($0.01/$0.02 USD) - 2022/08/23 11:19:27 ET
Table 'Despina IV' 6-max Seat #2 is the button
Seat 1: superRODRI ($2.09 in chips)
Seat 2: Nikalians ($2.51 in chips)
Seat 3: stryka62 ($1.09 in chips)
Seat 6: Borman_msk ($3.73 in chips)
stryka62: posts small blind $0.01
MiritiFox: is sitting out
Borman_msk: posts big blind $0.02
*** HOLE CARDS ***
superRODRI: folds
Nikalians: folds
stryka62: folds
Uncalled bet ($0.01) returned to Borman_msk
Borman_msk collected $0.02 from pot
Borman_msk: doesn't show hand
*** SUMMARY ***
Total pot $0.02 | Rake $0
Seat 1: superRODRI folded before Flop (didn't bet)
Seat 2: Nikalians (button) folded before Flop (didn't bet)
Seat 3: stryka62 (small blind) folded before Flop
Seat 6: Borman_msk (big blind) collected ($0.02)


PokerStars Hand #238168087203:  Hold'em No Limit ($0.01/$0.02 USD) - 2022/08/23 11:18:40 ET
Table 'Despina IV' 6-max Seat #1 is the button
Seat 1: superRODRI ($2.09 in chips)
Seat 2: Nikalians ($2.52 in chips)
Seat 3: stryka62 ($0.56 in chips)
Seat 5: MiritiFox ($2.30 in chips)
Seat 6: Borman_msk ($4.29 in chips)
Nikalians: posts small blind $0.01
stryka62: posts big blind $0.02
*** HOLE CARDS ***
MiritiFox: folds
Borman_msk: calls $0.02
superRODRI: folds
Nikalians: folds
stryka62: raises $0.08 to $0.10
Borman_msk: calls $0.08
*** FLOP *** [2s Jd 9c]
stryka62: bets $0.46 and is all-in
Kasaty is disconnected
Borman_msk: calls $0.46
*** TURN *** [2s Jd 9c] [6d]
*** RIVER *** [2s Jd 9c 6d] [7h]
*** SHOW DOWN ***
stryka62: shows [Jh Qh] (a pair of Jacks)
Borman_msk: shows [Qd 3d] (high card Queen)
stryka62 collected $1.09 from pot
*** SUMMARY ***
Total pot $1.13 | Rake $0.04
Board [2s Jd 9c 6d 7h]
Seat 1: superRODRI (button) folded before Flop (didn't bet)
Seat 2: Nikalians (small blind) folded before Flop
Seat 3: stryka62 (big blind) showed [Jh Qh] and won ($1.09) with a pair of Jacks
Seat 5: MiritiFox folded before Flop (didn't bet)
Seat 6: Borman_msk showed [Qd 3d] and lost with high card Queen


PokerStars Hand #238168103490:  Hold'em No Limit ($0.01/$0.02 USD) - 2022/08/23 11:19:36 ET
Table 'Despina IV' 6-max Seat #3 is the button
Seat 1: superRODRI ($2.09 in chips)
Seat 2: Nikalians ($2.51 in chips)
Seat 3: stryka62 ($1.08 in chips)
Seat 6: Borman_msk ($3.74 in chips)
Borman_msk: posts small blind $0.01
superRODRI: posts big blind $0.02
*** HOLE CARDS ***
Nikalians: folds
stryka62: calls $0.02
Borman_msk: calls $0.01
superRODRI: checks
*** FLOP *** [3s Js 3h]
Borman_msk: checks
superRODRI: bets $0.06
stryka62: folds
Borman_msk: calls $0.06
*** TURN *** [3s Js 3h] [5c]
Borman_msk: checks
superRODRI: bets $0.20
Borman_msk: folds
Uncalled bet ($0.20) returned to superRODRI
superRODRI collected $0.17 from pot
superRODRI: doesn't show hand
*** SUMMARY ***
Total pot $0.18 | Rake $0.01
Board [3s Js 3h 5c]
Seat 1: superRODRI (big blind) collected ($0.17)
Seat 2: Nikalians folded before Flop (didn't bet)
Seat 3: stryka62 (button) folded on the Flop
Seat 6: Borman_msk (small blind) folded on the Turn


PokerStars Hand #238168112326:  Hold'em No Limit ($0.01/$0.02 USD) - 2022/08/23 11:20:06 ET
Table 'Despina IV' 6-max Seat #6 is the button
Seat 1: superRODRI ($2.18 in chips)
Seat 2: Nikalians ($2.51 in chips)
Seat 3: stryka62 ($1.06 in chips)
Seat 6: Borman_msk ($3.66 in chips)
superRODRI: posts small blind $0.01
Nikalians: posts big blind $0.02
*** HOLE CARDS ***
stryka62: folds
Borman_msk: calls $0.02
superRODRI: raises $0.28 to $0.30
Nikalians: folds
Borman_msk: calls $0.28
*** FLOP *** [2d 8h Js]
superRODRI: bets $0.46
Borman_msk: calls $0.46
*** TURN *** [2d 8h Js] [8c]
superRODRI: bets $1.42 and is all-in
Borman_msk: calls $1.42
*** RIVER *** [2d 8h Js 8c] [Qs]
*** SHOW DOWN ***
superRODRI: shows [Kc Kd] (two pair, Kings and Eights)
Borman_msk: shows [Ah 4c] (a pair of Eights)
superRODRI cashed out the hand for $3.91 | Cash Out Fee $0.04
*** SUMMARY ***
Total pot $4.38 | Rake $0.15
Board [2d 8h Js 8c Qs]
Seat 1: superRODRI (small blind) showed [Kc Kd] and won ($4.23) with two pair, Kings and Eights (pot not awarded as player cashed out)
Seat 2: Nikalians (big blind) folded before Flop
Seat 3: stryka62 folded before Flop (didn't bet)
Seat 6: Borman_msk (button) showed [Ah 4c] and lost with a pair of Eights


PokerStars Hand #238168126460:  Hold'em No Limit ($0.01/$0.02 USD) - 2022/08/23 11:20:55 ET
Table 'Despina IV' 6-max Seat #1 is the button
Seat 1: superRODRI ($3.91 in chips)
Seat 2: Nikalians ($2.49 in chips)
Seat 3: stryka62 ($1.06 in chips)
Seat 6: Borman_msk ($1.48 in chips)
Nikalians: posts small blind $0.01
stryka62: posts big blind $0.02
*** HOLE CARDS ***
Borman_msk: calls $0.02
superRODRI: folds
Nikalians: raises $0.03 to $0.05
stryka62: calls $0.03
Borman_msk: calls $0.03
*** FLOP *** [Jd Jh 6h]
Nikalians: checks
stryka62: checks
Borman_msk: checks
*** TURN *** [Jd Jh 6h] [5s]
Nikalians: checks
stryka62: bets $0.14
Borman_msk: folds
Nikalians: folds
Uncalled bet ($0.14) returned to stryka62
stryka62 collected $0.14 from pot
*** SUMMARY ***
Total pot $0.15 | Rake $0.01
Board [Jd Jh 6h 5s]
Seat 1: superRODRI (button) folded before Flop (didn't bet)
Seat 2: Nikalians (small blind) folded on the Turn
Seat 3: stryka62 (big blind) collected ($0.14)
Seat 6: Borman_msk folded on the Turn


PokerStars Hand #238168137007:  Hold'em No Limit ($0.01/$0.02 USD) - 2022/08/23 11:21:31 ET
Table 'Despina IV' 6-max Seat #2 is the button
Seat 1: superRODRI ($3.91 in chips)
Seat 2: Nikalians ($2.44 in chips)
Seat 3: stryka62 ($1.15 in chips)
Seat 6: Borman_msk ($1.43 in chips)
stryka62: posts small blind $0.01
Borman_msk: posts big blind $0.02
*** HOLE CARDS ***
superRODRI: folds
Nikalians: folds
stryka62: calls $0.01
Borman_msk: checks
*** FLOP *** [9c Ah Th]
stryka62: bets $0.10
Borman_msk: folds
Uncalled bet ($0.10) returned to stryka62
stryka62 collected $0.04 from pot
*** SUMMARY ***
Total pot $0.04 | Rake $0
Board [9c Ah Th]
Seat 1: superRODRI folded before Flop (didn't bet)
Seat 2: Nikalians (button) folded before Flop (didn't bet)
Seat 3: stryka62 (small blind) collected ($0.04)
Seat 6: Borman_msk (big blind) folded on the Flop


PokerStars Hand #238168144066:  Hold'em No Limit ($0.01/$0.02 USD) - 2022/08/23 11:21:56 ET
Table 'Despina IV' 6-max Seat #3 is the button
Seat 1: superRODRI ($3.91 in chips)
Seat 2: Nikalians ($2.44 in chips)
Seat 3: stryka62 ($1.17 in chips)
Seat 6: Borman_msk ($1.41 in chips)
Borman_msk: posts small blind $0.01
superRODRI: posts big blind $0.02
*** HOLE CARDS ***
Nikalians: folds
stryka62: raises $1.15 to $1.17 and is all-in
Borman_msk: folds
superRODRI: folds
Uncalled bet ($1.15) returned to stryka62
stryka62 collected $0.05 from pot
*** SUMMARY ***
Total pot $0.05 | Rake $0
Seat 1: superRODRI (big blind) folded before Flop
Seat 2: Nikalians folded before Flop (didn't bet)
Seat 3: stryka62 (button) collected ($0.05)
Seat 6: Borman_msk (small blind) folded before Flop


PokerStars Hand #238168147933:  Hold'em No Limit ($0.01/$0.02 USD) - 2022/08/23 11:22:09 ET
Table 'Despina IV' 6-max Seat #6 is the button
Seat 1: superRODRI ($3.89 in chips)
Seat 2: Nikalians ($2.44 in chips)
Seat 3: stryka62 ($1.20 in chips)
Seat 4: Kasaty ($0.65 in chips)
Seat 6: Borman_msk ($1.40 in chips)
superRODRI: posts small blind $0.01
Nikalians: posts big blind $0.02
Kasaty: posts small & big blinds $0.03
*** HOLE CARDS ***
stryka62: folds
Kasaty: checks
Borman_msk: calls $0.02
superRODRI: folds
Nikalians: checks
*** FLOP *** [6d Jh 8s]
Nikalians: checks
superRODRI leaves the table
Kasaty: checks
Muszkli299 joins the table at seat #1
Borman_msk: bets $0.04
Nikalians: folds
Kasaty: calls $0.04
*** TURN *** [6d Jh 8s] [6h]
Kasaty: checks
Borman_msk: bets $0.15
Kasaty: folds
Uncalled bet ($0.15) returned to Borman_msk
Borman_msk collected $0.15 from pot
Borman_msk: doesn't show hand
*** SUMMARY ***
Total pot $0.16 | Rake $0.01
Board [6d Jh 8s 6h]
Seat 1: superRODRI (small blind) folded before Flop
Seat 2: Nikalians (big blind) folded on the Flop
Seat 3: stryka62 folded before Flop (didn't bet)
Seat 4: Kasaty folded on the Turn
Seat 6: Borman_msk (button) collected ($0.15)


PokerStars Hand #238168157242:  Hold'em No Limit ($0.01/$0.02 USD) - 2022/08/23 11:22:41 ET
Table 'Despina IV' 6-max Seat #2 is the button
Seat 1: Muszkli299 ($1.60 in chips)
Seat 2: Nikalians ($2.42 in chips)
Seat 3: stryka62 ($1.20 in chips)
Seat 4: Kasaty ($0.58 in chips)
Seat 6: Borman_msk ($1.49 in chips)
stryka62: posts small blind $0.01
Kasaty: posts big blind $0.02
Muszkli299: posts big blind $0.02
*** HOLE CARDS ***
Borman_msk: calls $0.02
Muszkli299: checks
Nikalians: folds
stryka62: calls $0.01
Kasaty: checks
*** FLOP *** [6c Kc 5h]
stryka62: checks
Kasaty has timed out
Kasaty: checks
Borman_msk: checks
Muszkli299: checks
*** TURN *** [6c Kc 5h] [8c]
stryka62: checks
Kasaty has timed out
Kasaty: checks
Borman_msk: checks
Muszkli299: checks
*** RIVER *** [6c Kc 5h 8c] [Ad]
stryka62: checks
Kasaty has timed out
Kasaty: checks
Borman_msk: bets $0.08
Muszkli299: folds
stryka62: raises $0.10 to $0.18
Kasaty: folds
Borman_msk: raises $0.44 to $0.62
stryka62: folds
Uncalled bet ($0.44) returned to Borman_msk
Borman_msk collected $0.42 from pot
Borman_msk: doesn't show hand
*** SUMMARY ***
Total pot $0.44 | Rake $0.02
Board [6c Kc 5h 8c Ad]
Seat 1: Muszkli299 folded on the River (didn't bet)
Seat 2: Nikalians (button) folded before Flop (didn't bet)
Seat 3: stryka62 (small blind) folded on the River
Seat 4: Kasaty (big blind) folded on the River
Seat 6: Borman_msk collected ($0.42)


PokerStars Hand #238168195498:  Hold'em No Limit ($0.01/$0.02 USD) - 2022/08/23 11:24:54 ET
Table 'Despina IV' 6-max Seat #3 is the button
Seat 1: Muszkli299 ($2 in chips)
Seat 2: Nikalians ($2.42 in chips)
Seat 3: stryka62 ($1 in chips)
Seat 4: Kasaty ($0.56 in chips)
Seat 6: Borman_msk ($1.71 in chips)
Kasaty: posts small blind $0.01
Borman_msk: posts big blind $0.02
*** HOLE CARDS ***
Muszkli299: calls $0.02
Nikalians: folds
stryka62: calls $0.02
Kasaty: folds
Borman_msk: raises $0.04 to $0.06
Muszkli299: raises $0.26 to $0.32
stryka62: calls $0.30
Borman_msk: calls $0.26
*** FLOP *** [9s 7h Ac]
Borman_msk: checks
Muszkli299: bets $0.10
stryka62: raises $0.58 to $0.68 and is all-in
Borman_msk: calls $0.68
Muszkli299: folds
*** TURN *** [9s 7h Ac] [6s]
*** RIVER *** [9s 7h Ac 6s] [Ah]
*** SHOW DOWN ***
Borman_msk: shows [4d 4h] (two pair, Aces and Fours)
stryka62: shows [4s Ad] (three of a kind, Aces)
stryka62 collected $2.34 from pot
*** SUMMARY ***
Total pot $2.43 | Rake $0.09
Board [9s 7h Ac 6s Ah]
Seat 1: Muszkli299 folded on the Flop
Seat 2: Nikalians folded before Flop (didn't bet)
Seat 3: stryka62 (button) showed [4s Ad] and won ($2.34) with three of a kind, Aces
Seat 4: Kasaty (small blind) folded before Flop
Seat 6: Borman_msk (big blind) showed [4d 4h] and lost with two pair, Aces and Fours


PokerStars Hand #238168210844:  Hold'em No Limit ($0.01/$0.02 USD) - 2022/08/23 11:25:47 ET
Table 'Despina IV' 6-max Seat #4 is the button
Seat 1: Muszkli299 ($2 in chips)
Seat 2: Nikalians ($2.42 in chips)
Seat 3: stryka62 ($2.34 in chips)
Seat 4: Kasaty ($0.55 in chips)
Seat 6: Borman_msk ($0.71 in chips)
Borman_msk: posts small blind $0.01
Muszkli299: posts big blind $0.02
*** HOLE CARDS ***
Nikalians: folds
stryka62: calls $0.02
Kasaty: calls $0.02
Borman_msk: calls $0.01
Muszkli299: raises $0.08 to $0.10
stryka62: calls $0.08
Kasaty: calls $0.08
Borman_msk: calls $0.08
*** FLOP *** [7s Ts As]
Borman_msk: checks
Muszkli299: checks
stryka62: checks
Kasaty: checks
*** TURN *** [7s Ts As] [5s]
Borman_msk: checks
Muszkli299: checks
stryka62: checks
Kasaty: bets $0.19
Borman_msk: calls $0.19
Muszkli299: folds
stryka62: folds
*** RIVER *** [7s Ts As 5s] [Qd]
Borman_msk: checks
Kasaty: bets $0.26 and is all-in
Borman_msk: folds
Uncalled bet ($0.26) returned to Kasaty
Kasaty collected $0.75 from pot
*** SUMMARY ***
Total pot $0.78 | Rake $0.03
Board [7s Ts As 5s Qd]
Seat 1: Muszkli299 (big blind) folded on the Turn
Seat 2: Nikalians folded before Flop (didn't bet)
Seat 3: stryka62 folded on the Turn
Seat 4: Kasaty (button) collected ($0.75)
Seat 6: Borman_msk (small blind) folded on the River


PokerStars Hand #238168232115:  Hold'em No Limit ($0.01/$0.02 USD) - 2022/08/23 11:27:00 ET
Table 'Despina IV' 6-max Seat #6 is the button
Seat 1: Muszkli299 ($2 in chips)
Seat 2: Nikalians ($2.42 in chips)
Seat 3: stryka62 ($2.24 in chips)
Seat 4: Kasaty ($1.01 in chips)
Seat 6: Borman_msk ($0.42 in chips)
Muszkli299: posts small blind $0.01
Nikalians: posts big blind $0.02
*** HOLE CARDS ***
stryka62: raises $0.04 to $0.06
Kasaty: folds
Borman_msk: raises $0.36 to $0.42 and is all-in
Muszkli299: folds
Nikalians: folds
stryka62: calls $0.36
*** FLOP *** [2c Kh Qs]
*** TURN *** [2c Kh Qs] [Jh]
*** RIVER *** [2c Kh Qs Jh] [4h]
*** SHOW DOWN ***
stryka62: shows [7s 7d] (a pair of Sevens)
Borman_msk: shows [Ah 6d] (high card Ace)
stryka62 collected $0.84 from pot
*** SUMMARY ***
Total pot $0.87 | Rake $0.03
Board [2c Kh Qs Jh 4h]
Seat 1: Muszkli299 (small blind) folded before Flop
Seat 2: Nikalians (big blind) folded before Flop
Seat 3: stryka62 showed [7s 7d] and won ($0.84) with a pair of Sevens
Seat 4: Kasaty folded before Flop (didn't bet)
Seat 6: Borman_msk (button) showed [Ah 6d] and lost with high card Ace


PokerStars Hand #238168240486:  Hold'em No Limit ($0.01/$0.02 USD) - 2022/08/23 11:27:29 ET
Table 'Despina IV' 6-max Seat #1 is the button
Seat 1: Muszkli299 ($2 in chips)
Seat 2: Nikalians ($2.40 in chips)
Seat 3: stryka62 ($2.66 in chips)
Seat 4: Kasaty ($1.01 in chips)
Nikalians: posts small blind $0.01
stryka62: posts big blind $0.02
*** HOLE CARDS ***
Kasaty: calls $0.02
Muszkli299: calls $0.02
Nikalians: calls $0.01
stryka62: checks
*** FLOP *** [8h 5d Kh]
Nikalians: checks
stryka62: bets $0.08
Kasaty: folds
Muszkli299: folds
Nikalians: folds
Uncalled bet ($0.08) returned to stryka62
stryka62 collected $0.08 from pot
*** SUMMARY ***
Total pot $0.08 | Rake $0
Board [8h 5d Kh]
Seat 1: Muszkli299 (button) folded on the Flop
Seat 2: Nikalians (small blind) folded on the Flop
Seat 3: stryka62 (big blind) collected ($0.08)
Seat 4: Kasaty folded on the Flop


PokerStars Hand #238168253636:  Hold'em No Limit ($0.01/$0.02 USD) - 2022/08/23 11:28:15 ET
Table 'Despina IV' 6-max Seat #2 is the button
Seat 1: Muszkli299 ($2 in chips)
Seat 2: Nikalians ($2.38 in chips)
Seat 3: stryka62 ($2.72 in chips)
Seat 4: Kasaty ($0.99 in chips)
Seat 6: Borman_msk ($2 in chips)
stryka62: posts small blind $0.01
Kasaty: posts big blind $0.02
*** HOLE CARDS ***
Borman_msk: calls $0.02
Muszkli299: folds
Nikalians: raises $0.04 to $0.06
stryka62: folds
Kasaty: folds
Borman_msk: calls $0.04
*** FLOP *** [8d Ac 6h]
Borman_msk: checks
Nikalians: checks
*** TURN *** [8d Ac 6h] [Kh]
Borman_msk: bets $0.14
Nikalians: calls $0.14
*** RIVER *** [8d Ac 6h Kh] [6c]
Borman_msk: bets $0.41
Nikalians: calls $0.41
*** SHOW DOWN ***
Borman_msk: shows [Jh 8s] (two pair, Eights and Sixes)
Nikalians: shows [As Ts] (two pair, Aces and Sixes)
Nikalians collected $1.21 from pot
*** SUMMARY ***
Total pot $1.25 | Rake $0.04
Board [8d Ac 6h Kh 6c]
Seat 1: Muszkli299 folded before Flop (didn't bet)
Seat 2: Nikalians (button) showed [As Ts] and won ($1.21) with two pair, Aces and Sixes
Seat 3: stryka62 (small blind) folded before Flop
Seat 4: Kasaty (big blind) folded before Flop
Seat 6: Borman_msk showed [Jh 8s] and lost with two pair, Eights and Sixes


PokerStars Hand #238168267722:  Hold'em No Limit ($0.01/$0.02 USD) - 2022/08/23 11:29:03 ET
Table 'Despina IV' 6-max Seat #3 is the button
Seat 1: Muszkli299 ($2 in chips)
Seat 2: Nikalians ($2.98 in chips)
Seat 3: stryka62 ($2.71 in chips)
Seat 4: Kasaty ($0.97 in chips)
Seat 6: Borman_msk ($1.39 in chips)
Kasaty: posts small blind $0.01
Borman_msk: posts big blind $0.02
*** HOLE CARDS ***
Muszkli299: calls $0.02
Nikalians: folds
stryka62: folds
Kasaty: folds
Borman_msk: raises $1.37 to $1.39 and is all-in
Muszkli299: folds
Uncalled bet ($1.37) returned to Borman_msk
Borman_msk collected $0.05 from pot
MiritiFox was removed from the table for failing to post
MiritiFox leaves the table
Borman_msk: doesn't show hand
*** SUMMARY ***
Total pot $0.05 | Rake $0
Seat 1: Muszkli299 folded before Flop
Seat 2: Nikalians folded before Flop (didn't bet)
Seat 3: stryka62 (button) folded before Flop (didn't bet)
Seat 4: Kasaty (small blind) folded before Flop
Seat 6: Borman_msk (big blind) collected ($0.05)


PokerStars Hand #238168274367:  Hold'em No Limit ($0.01/$0.02 USD) - 2022/08/23 11:29:26 ET
Table 'Despina IV' 6-max Seat #4 is the button
Seat 1: Muszkli299 ($2 in chips)
Seat 2: Nikalians ($2.98 in chips)
Seat 3: stryka62 ($2.71 in chips)
Seat 4: Kasaty ($0.96 in chips)
Seat 6: Borman_msk ($1.42 in chips)
Borman_msk: posts small blind $0.01
Muszkli299: posts big blind $0.02
*** HOLE CARDS ***
maslak270 joins the table at seat #5
Nikalians: raises $0.02 to $0.04
stryka62: folds
Kasaty: folds
Borman_msk: calls $0.03
Muszkli299: calls $0.02
*** FLOP *** [8s Kd 6h]
Borman_msk: bets $0.06
Muszkli299: calls $0.06
Nikalians: folds
*** TURN *** [8s Kd 6h] [Qd]
Borman_msk: checks
Muszkli299: checks
*** RIVER *** [8s Kd 6h Qd] [Ac]
Borman_msk: bets $0.23
Muszkli299: folds
Uncalled bet ($0.23) returned to Borman_msk
Borman_msk collected $0.23 from pot
Borman_msk: doesn't show hand
*** SUMMARY ***
Total pot $0.24 | Rake $0.01
Board [8s Kd 6h Qd Ac]
Seat 1: Muszkli299 (big blind) folded on the River
Seat 2: Nikalians folded on the Flop
Seat 3: stryka62 folded before Flop (didn't bet)
Seat 4: Kasaty (button) folded before Flop (didn't bet)
Seat 6: Borman_msk (small blind) collected ($0.23)


PokerStars Hand #238168292234:  Hold'em No Limit ($0.01/$0.02 USD) - 2022/08/23 11:30:27 ET
Table 'Despina IV' 6-max Seat #6 is the button
Seat 1: Muszkli299 ($2 in chips)
Seat 2: Nikalians ($2.94 in chips)
Seat 3: stryka62 ($2.71 in chips)
Seat 4: Kasaty ($0.96 in chips)
Seat 6: Borman_msk ($1.55 in chips)
Muszkli299: posts small blind $0.01
Nikalians: posts big blind $0.02
maslak270: sits out
*** HOLE CARDS ***
stryka62: folds
Kasaty: folds
Borman_msk: calls $0.02
Muszkli299: calls $0.01
Nikalians: checks
*** FLOP *** [9h 7d As]
Muszkli299: checks
Nikalians: checks
Borman_msk: checks
*** TURN *** [9h 7d As] [Ad]
Muszkli299: checks
Nikalians: checks
Borman_msk: checks
*** RIVER *** [9h 7d As Ad] [Qd]
Muszkli299: checks
Nikalians: checks
Borman_msk: bets $0.06
Muszkli299: folds
Nikalians: folds
Uncalled bet ($0.06) returned to Borman_msk
Borman_msk collected $0.06 from pot
Borman_msk: doesn't show hand
*** SUMMARY ***
Total pot $0.06 | Rake $0
Board [9h 7d As Ad Qd]
Seat 1: Muszkli299 (small blind) folded on the River
Seat 2: Nikalians (big blind) folded on the River
Seat 3: stryka62 folded before Flop (didn't bet)
Seat 4: Kasaty folded before Flop (didn't bet)
Seat 6: Borman_msk (button) collected ($0.06)


PokerStars Hand #238168307501:  Hold'em No Limit ($0.01/$0.02 USD) - 2022/08/23 11:31:19 ET
Table 'Despina IV' 6-max Seat #1 is the button
Seat 1: Muszkli299 ($2 in chips)
Seat 2: Nikalians ($2.92 in chips)
Seat 3: stryka62 ($2.71 in chips)
Seat 4: Kasaty ($0.96 in chips)
Seat 6: Borman_msk ($1.59 in chips)
Nikalians: posts small blind $0.01
stryka62: posts big blind $0.02
maslak270: sits out
*** HOLE CARDS ***
Kasaty: folds
Borman_msk: calls $0.02
Muszkli299: raises $0.07 to $0.09
Nikalians: folds
stryka62: folds
Borman_msk: calls $0.07
*** FLOP *** [As Ah 9d]
Borman_msk: checks
Muszkli299: checks
*** TURN *** [As Ah 9d] [Tc]
Borman_msk: checks
Muszkli299: checks
*** RIVER *** [As Ah 9d Tc] [Jc]
Borman_msk: checks
Muszkli299: bets $0.02
Borman_msk: folds
Uncalled bet ($0.02) returned to Muszkli299
Muszkli299 collected $0.20 from pot
*** SUMMARY ***
Total pot $0.21 | Rake $0.01
Board [As Ah 9d Tc Jc]
Seat 1: Muszkli299 (button) collected ($0.20)
Seat 2: Nikalians (small blind) folded before Flop
Seat 3: stryka62 (big blind) folded before Flop
Seat 4: Kasaty folded before Flop (didn't bet)
Seat 6: Borman_msk folded on the River


PokerStars Hand #238168316290:  Hold'em No Limit ($0.01/$0.02 USD) - 2022/08/23 11:31:49 ET
Table 'Despina IV' 6-max Seat #2 is the button
Seat 1: Muszkli299 ($2.11 in chips)
Seat 2: Nikalians ($2.91 in chips)
Seat 3: stryka62 ($2.69 in chips)
Seat 4: Kasaty ($0.96 in chips)
Seat 6: Borman_msk ($1.50 in chips)
stryka62: posts small blind $0.01
Kasaty: posts big blind $0.02
maslak270: sits out
*** HOLE CARDS ***
Borman_msk: raises $0.02 to $0.04
Muszkli299: folds
Nikalians: calls $0.04
stryka62: folds
Kasaty: folds
*** FLOP *** [5h 6c 2h]
Borman_msk: bets $0.50
Nikalians: folds
Uncalled bet ($0.50) returned to Borman_msk
Borman_msk collected $0.11 from pot
Borman_msk: doesn't show hand
*** SUMMARY ***
Total pot $0.11 | Rake $0
Board [5h 6c 2h]
Seat 1: Muszkli299 folded before Flop (didn't bet)
Seat 2: Nikalians (button) folded on the Flop
Seat 3: stryka62 (small blind) folded before Flop
Seat 4: Kasaty (big blind) folded before Flop
Seat 6: Borman_msk collected ($0.11)


PokerStars Hand #238168351191:  Hold'em No Limit ($0.01/$0.02 USD) - 2022/08/23 11:33:39 ET
Table 'Despina IV' 6-max Seat #4 is the button
Seat 1: Muszkli299 ($2.09 in chips)
Seat 2: Nikalians ($2.87 in chips)
Seat 3: stryka62 ($2.60 in chips)
Seat 4: Kasaty ($0.93 in chips)
Seat 5: maslak270 ($2.10 in chips)
maslak270: posts small blind $0.01
Muszkli299: posts big blind $0.02
*** HOLE CARDS ***
Nikalians: folds
stryka62: raises $0.05 to $0.07
Kasaty: calls $0.07
maslak270: folds
Muszkli299: calls $0.05
*** FLOP *** [4d Qs Kh]
Muszkli299: checks
stryka62: bets $0.21
Kasaty: folds
Muszkli299: calls $0.21
*** TURN *** [4d Qs Kh] [7d]
Muszkli299: checks
stryka62: checks
*** RIVER *** [4d Qs Kh 7d] [4s]
Muszkli299: checks
stryka62: checks
*** SHOW DOWN ***
Muszkli299: shows [3s Ks] (two pair, Kings and Fours)
stryka62: mucks hand
Muszkli299 collected $0.62 from pot
*** SUMMARY ***
Total pot $0.64 | Rake $0.02
Board [4d Qs Kh 7d 4s]
Seat 1: Muszkli299 (big blind) showed [3s Ks] and won ($0.62) with two pair, Kings and Fours
Seat 2: Nikalians folded before Flop (didn't bet)
Seat 3: stryka62 mucked
Seat 4: Kasaty (button) folded on the Flop
Seat 5: maslak270 (small blind) folded before Flop


PokerStars Hand #238168370666:  Hold'em No Limit ($0.01/$0.02 USD) - 2022/08/23 11:34:25 ET
Table 'Despina IV' 6-max Seat #5 is the button
Seat 1: Muszkli299 ($2.43 in chips)
Seat 2: Nikalians ($2.87 in chips)
Seat 3: stryka62 ($2.32 in chips)
Seat 4: Kasaty ($0.86 in chips)
Seat 5: maslak270 ($2.09 in chips)
Muszkli299: posts small blind $0.01
Nikalians: posts big blind $0.02
*** HOLE CARDS ***
stryka62: folds
Kasaty: calls $0.02
maslak270: raises $0.04 to $0.06
Muszkli299: folds
Nikalians: folds
Kasaty: calls $0.04
*** FLOP *** [6s 8d Js]
Kasaty: checks
maslak270: bets $0.04
Kasaty: folds
Uncalled bet ($0.04) returned to maslak270
maslak270 collected $0.14 from pot
maslak270: doesn't show hand
*** SUMMARY ***
Total pot $0.15 | Rake $0.01
Board [6s 8d Js]
Seat 1: Muszkli299 (small blind) folded before Flop
Seat 2: Nikalians (big blind) folded before Flop
Seat 3: stryka62 folded before Flop (didn't bet)
Seat 4: Kasaty folded on the Flop
Seat 5: maslak270 (button) collected ($0.14)


PokerStars Hand #238168379981:  Hold'em No Limit ($0.01/$0.02 USD) - 2022/08/23 11:34:57 ET
Table 'Despina IV' 6-max Seat #1 is the button
Seat 1: Muszkli299 ($2.42 in chips)
Seat 2: Nikalians ($2.85 in chips)
Seat 3: stryka62 ($2.32 in chips)
Seat 4: Kasaty ($0.80 in chips)
Seat 5: maslak270 ($2.17 in chips)
Nikalians: posts small blind $0.01
stryka62: posts big blind $0.02
*** HOLE CARDS ***
Kasaty: calls $0.02
maslak270: folds
Muszkli299: calls $0.02
Nikalians: folds
stryka62: checks
*** FLOP *** [7s 6c 2s]
stryka62: checks
Kasaty: checks
Muszkli299: bets $0.08
stryka62: calls $0.08
Kasaty: calls $0.08
*** TURN *** [7s 6c 2s] [Ac]
stryka62: checks
Kasaty: checks
Muszkli299: bets $0.21
stryka62: calls $0.21
Kasaty: calls $0.21
*** RIVER *** [7s 6c 2s Ac] [5d]
stryka62: checks
Kasaty: checks
Muszkli299: checks
*** SHOW DOWN ***
stryka62: shows [Kh 8h] (high card Ace)
Kasaty: shows [Jc 7c] (a pair of Sevens)
Muszkli299: shows [As 9s] (a pair of Aces)
Muszkli299 collected $0.91 from pot
*** SUMMARY ***
Total pot $0.94 | Rake $0.03
Board [7s 6c 2s Ac 5d]
Seat 1: Muszkli299 (button) showed [As 9s] and won ($0.91) with a pair of Aces
Seat 2: Nikalians (small blind) folded before Flop
Seat 3: stryka62 (big blind) showed [Kh 8h] and lost with high card Ace
Seat 4: Kasaty showed [Jc 7c] and lost with a pair of Sevens
Seat 5: maslak270 folded before Flop (didn't bet)


PokerStars Hand #238168398245:  Hold'em No Limit ($0.01/$0.02 USD) - 2022/08/23 11:35:59 ET
Table 'Despina IV' 6-max Seat #2 is the button
Seat 1: Muszkli299 ($3.02 in chips)
Seat 2: Nikalians ($2.84 in chips)
Seat 3: stryka62 ($2.01 in chips)
Seat 4: Kasaty ($0.49 in chips)
Seat 5: maslak270 ($2.17 in chips)
stryka62: posts small blind $0.01
Kasaty: posts big blind $0.02
*** HOLE CARDS ***
maslak270: folds
Muszkli299: calls $0.02
Nikalians: raises $0.04 to $0.06
stryka62: folds
Kasaty: folds
Muszkli299: calls $0.04
*** FLOP *** [9d 6c 9s]
Muszkli299: checks
Nikalians: checks
*** TURN *** [9d 6c 9s] [4h]
Muszkli299: bets $0.04
Nikalians: calls $0.04
*** RIVER *** [9d 6c 9s 4h] [8c]
Muszkli299: checks
Nikalians: checks
*** SHOW DOWN ***
Muszkli299: shows [4s Qs] (two pair, Nines and Fours)
Nikalians: mucks hand
Muszkli299 collected $0.22 from pot
*** SUMMARY ***
Total pot $0.23 | Rake $0.01
Board [9d 6c 9s 4h 8c]
Seat 1: Muszkli299 showed [4s Qs] and won ($0.22) with two pair, Nines and Fours
Seat 2: Nikalians (button) mucked
Seat 3: stryka62 (small blind) folded before Flop
Seat 4: Kasaty (big blind) folded before Flop
Seat 5: maslak270 folded before Flop (didn't bet)


PokerStars Hand #238168407016:  Hold'em No Limit ($0.01/$0.02 USD) - 2022/08/23 11:36:29 ET
Table 'Despina IV' 6-max Seat #3 is the button
Seat 1: Muszkli299 ($3.14 in chips)
Seat 2: Nikalians ($2.74 in chips)
Seat 3: stryka62 ($2 in chips)
Seat 4: Kasaty ($0.47 in chips)
Seat 5: maslak270 ($2.17 in chips)
Kasaty: posts small blind $0.01
maslak270: posts big blind $0.02
*** HOLE CARDS ***
Muszkli299: folds
Nikalians: folds
stryka62: raises $0.04 to $0.06
Kasaty: calls $0.05
maslak270: folds
*** FLOP *** [6c 9s 2c]
Kasaty: checks
stryka62: checks
*** TURN *** [6c 9s 2c] [6d]
Kasaty: checks
stryka62: checks
*** RIVER *** [6c 9s 2c 6d] [Qd]
Kasaty: checks
stryka62: checks
*** SHOW DOWN ***
Kasaty: shows [Th Jh] (a pair of Sixes)
stryka62: shows [4c As] (a pair of Sixes - Ace kicker)
stryka62 collected $0.14 from pot
*** SUMMARY ***
Total pot $0.14 | Rake $0
Board [6c 9s 2c 6d Qd]
Seat 1: Muszkli299 folded before Flop (didn't bet)
Seat 2: Nikalians folded before Flop (didn't bet)
Seat 3: stryka62 (button) showed [4c As] and won ($0.14) with a pair of Sixes
Seat 4: Kasaty (small blind) showed [Th Jh] and lost with a pair of Sixes
Seat 5: maslak270 (big blind) folded before Flop


PokerStars Hand #238168420546:  Hold'em No Limit ($0.01/$0.02 USD) - 2022/08/23 11:37:15 ET
Table 'Despina IV' 6-max Seat #4 is the button
Seat 1: Muszkli299 ($3.14 in chips)
Seat 2: Nikalians ($2.74 in chips)
Seat 3: stryka62 ($2.08 in chips)
Seat 4: Kasaty ($0.41 in chips)
Seat 5: maslak270 ($2.15 in chips)
maslak270: posts small blind $0.01
Muszkli299: posts big blind $0.02
*** HOLE CARDS ***
Nikalians: raises $0.03 to $0.05
stryka62: folds
Kasaty: folds
maslak270: folds
Muszkli299: folds
Uncalled bet ($0.03) returned to Nikalians
Nikalians collected $0.05 from pot
Nikalians: doesn't show hand
*** SUMMARY ***
Total pot $0.05 | Rake $0
Seat 1: Muszkli299 (big blind) folded before Flop
Seat 2: Nikalians collected ($0.05)
Seat 3: stryka62 folded before Flop (didn't bet)
Seat 4: Kasaty (button) folded before Flop (didn't bet)
Seat 5: maslak270 (small blind) folded before Flop


PokerStars Hand #238168426438:  Hold'em No Limit ($0.01/$0.02 USD) - 2022/08/23 11:37:35 ET
Table 'Despina IV' 6-max Seat #5 is the button
Seat 1: Muszkli299 ($3.12 in chips)
Seat 2: Nikalians ($2.77 in chips)
Seat 3: stryka62 ($2.08 in chips)
Seat 4: Kasaty ($0.41 in chips)
Seat 5: maslak270 ($2.14 in chips)
Muszkli299: posts small blind $0.01
Nikalians: posts big blind $0.02
*** HOLE CARDS ***
stryka62: folds
Kasaty: calls $0.02
maslak270: calls $0.02
Muszkli299: calls $0.01
Nikalians: checks
*** FLOP *** [Qs Qh 8c]
Muszkli299: checks
Nikalians: checks
Kasaty: bets $0.04
maslak270: folds
Muszkli299: folds
Nikalians: folds
Uncalled bet ($0.04) returned to Kasaty
Kasaty collected $0.08 from pot
*** SUMMARY ***
Total pot $0.08 | Rake $0
Board [Qs Qh 8c]
Seat 1: Muszkli299 (small blind) folded on the Flop
Seat 2: Nikalians (big blind) folded on the Flop
Seat 3: stryka62 folded before Flop (didn't bet)
Seat 4: Kasaty collected ($0.08)
Seat 5: maslak270 (button) folded on the Flop


PokerStars Hand #238168439316:  Hold'em No Limit ($0.01/$0.02 USD) - 2022/08/23 11:38:18 ET
Table 'Despina IV' 6-max Seat #1 is the button
Seat 1: Muszkli299 ($3.10 in chips)
Seat 2: Nikalians ($2.75 in chips)
Seat 3: stryka62 ($2.08 in chips)
Seat 4: Kasaty ($0.47 in chips)
Seat 5: maslak270 ($2.12 in chips)
Nikalians: posts small blind $0.01
stryka62: posts big blind $0.02
*** HOLE CARDS ***
Kasaty: folds
maslak270: calls $0.02
Muszkli299: folds
Nikalians: calls $0.01
stryka62: checks
*** FLOP *** [5c 3s 3h]
Nikalians: checks
stryka62: bets $0.03
maslak270: calls $0.03
Nikalians: calls $0.03
*** TURN *** [5c 3s 3h] [Th]
Nikalians: checks
stryka62: bets $0.06
maslak270: folds
Nikalians: folds
Uncalled bet ($0.06) returned to stryka62
stryka62 collected $0.14 from pot
*** SUMMARY ***
Total pot $0.15 | Rake $0.01
Board [5c 3s 3h Th]
Seat 1: Muszkli299 (button) folded before Flop (didn't bet)
Seat 2: Nikalians (small blind) folded on the Turn
Seat 3: stryka62 (big blind) collected ($0.14)
Seat 4: Kasaty folded before Flop (didn't bet)
Seat 5: maslak270 folded on the Turn


PokerStars Hand #238168457698:  Hold'em No Limit ($0.01/$0.02 USD) - 2022/08/23 11:39:20 ET
Table 'Despina IV' 6-max Seat #2 is the button
Seat 1: Muszkli299 ($3.10 in chips)
Seat 2: Nikalians ($2.70 in chips)
Seat 3: stryka62 ($2.17 in chips)
Seat 4: Kasaty ($0.47 in chips)
Seat 5: maslak270 ($2.07 in chips)
stryka62: posts small blind $0.01
Kasaty: posts big blind $0.02
*** HOLE CARDS ***
maslak270: calls $0.02
Muszkli299: folds
Nikalians: raises $0.03 to $0.05
stryka62: folds
Kasaty: folds
maslak270: folds
Uncalled bet ($0.03) returned to Nikalians
Nikalians collected $0.07 from pot
Nikalians: doesn't show hand
*** SUMMARY ***
Total pot $0.07 | Rake $0
Seat 1: Muszkli299 folded before Flop (didn't bet)
Seat 2: Nikalians (button) collected ($0.07)
Seat 3: stryka62 (small blind) folded before Flop
Seat 4: Kasaty (big blind) folded before Flop
Seat 5: maslak270 folded before Flop


PokerStars Hand #238168463673:  Hold'em No Limit ($0.01/$0.02 USD) - 2022/08/23 11:39:40 ET
Table 'Despina IV' 6-max Seat #3 is the button
Seat 1: Muszkli299 ($3.10 in chips)
Seat 2: Nikalians ($2.75 in chips)
Seat 3: stryka62 ($2.16 in chips)
Seat 4: Kasaty ($0.45 in chips)
Seat 5: maslak270 ($2.05 in chips)
Kasaty: posts small blind $0.01
maslak270: posts big blind $0.02
*** HOLE CARDS ***
Muszkli299: folds
Nikalians: raises $0.03 to $0.05
stryka62: raises $0.15 to $0.20
Kasaty: folds
maslak270: folds
Nikalians: folds
Uncalled bet ($0.15) returned to stryka62
stryka62 collected $0.13 from pot
*** SUMMARY ***
Total pot $0.13 | Rake $0
Seat 1: Muszkli299 folded before Flop (didn't bet)
Seat 2: Nikalians folded before Flop
Seat 3: stryka62 (button) collected ($0.13)
Seat 4: Kasaty (small blind) folded before Flop
Seat 5: maslak270 (big blind) folded before Flop


PokerStars Hand #238168481222:  Hold'em No Limit ($0.01/$0.02 USD) - 2022/08/23 11:40:22 ET
Table 'Despina IV' 6-max Seat #4 is the button
Seat 1: Muszkli299 ($3.10 in chips)
Seat 2: Nikalians ($2.70 in chips)
Seat 3: stryka62 ($2.24 in chips)
Seat 4: Kasaty ($0.44 in chips)
Seat 5: maslak270 ($2.03 in chips)
maslak270: posts small blind $0.01
Muszkli299: posts big blind $0.02
*** HOLE CARDS ***
Nikalians: folds
stryka62: calls $0.02
Kasaty: calls $0.02
maslak270: calls $0.01
Muszkli299: checks
*** FLOP *** [Jc 4d 6s]
maslak270: bets $0.02
Muszkli299: folds
stryka62: calls $0.02
Kasaty: calls $0.02
*** TURN *** [Jc 4d 6s] [2h]
maslak270: bets $0.02
stryka62: folds
Kasaty: raises $0.09 to $0.11
maslak270: folds
Uncalled bet ($0.09) returned to Kasaty
Kasaty collected $0.17 from pot
*** SUMMARY ***
Total pot $0.18 | Rake $0.01
Board [Jc 4d 6s 2h]
Seat 1: Muszkli299 (big blind) folded on the Flop
Seat 2: Nikalians folded before Flop (didn't bet)
Seat 3: stryka62 folded on the Turn
Seat 4: Kasaty (button) collected ($0.17)
Seat 5: maslak270 (small blind) folded on the Turn


PokerStars Hand #238168499251:  Hold'em No Limit ($0.01/$0.02 USD) - 2022/08/23 11:41:22 ET
Table 'Despina IV' 6-max Seat #5 is the button
Seat 1: Muszkli299 ($3.08 in chips)
Seat 2: Nikalians ($2.70 in chips)
Seat 3: stryka62 ($2.20 in chips)
Seat 4: Kasaty ($0.55 in chips)
Seat 5: maslak270 ($1.97 in chips)
Muszkli299: posts small blind $0.01
Nikalians: posts big blind $0.02
*** HOLE CARDS ***
stryka62: raises $2.18 to $2.20 and is all-in
Kasaty: folds
maslak270: folds
Muszkli299: folds
Nikalians: folds
Uncalled bet ($2.18) returned to stryka62
stryka62 collected $0.05 from pot
*** SUMMARY ***
Total pot $0.05 | Rake $0
Seat 1: Muszkli299 (small blind) folded before Flop
Seat 2: Nikalians (big blind) folded before Flop
Seat 3: stryka62 collected ($0.05)
Seat 4: Kasaty folded before Flop (didn't bet)
Seat 5: maslak270 (button) folded before Flop (didn't bet)


PokerStars Hand #238168503917:  Hold'em No Limit ($0.01/$0.02 USD) - 2022/08/23 11:41:38 ET
Table 'Despina IV' 6-max Seat #1 is the button
Seat 1: Muszkli299 ($3.07 in chips)
Seat 2: Nikalians ($2.68 in chips)
Seat 3: stryka62 ($2.23 in chips)
Seat 4: Kasaty ($0.55 in chips)
Seat 5: maslak270 ($1.97 in chips)
Nikalians: posts small blind $0.01
stryka62: posts big blind $0.02
*** HOLE CARDS ***
Kasaty: calls $0.02
maslak270: folds
Muszkli299: folds
Nikalians: raises $0.03 to $0.05
stryka62: calls $0.03
Kasaty: calls $0.03
*** FLOP *** [7c 6c 8s]
Nikalians: bets $0.05
stryka62: raises $0.05 to $0.10
Kasaty: calls $0.10
Nikalians: calls $0.05
*** TURN *** [7c 6c 8s] [9c]
Nikalians: checks
stryka62: bets $2.08 and is all-in
Kasaty: folds
Nikalians: folds
Uncalled bet ($2.08) returned to stryka62
stryka62 collected $0.43 from pot
*** SUMMARY ***
Total pot $0.45 | Rake $0.02
Board [7c 6c 8s 9c]
Seat 1: Muszkli299 (button) folded before Flop (didn't bet)
Seat 2: Nikalians (small blind) folded on the Turn
Seat 3: stryka62 (big blind) collected ($0.43)
Seat 4: Kasaty folded on the Turn
Seat 5: maslak270 folded before Flop (didn't bet)


PokerStars Hand #238168529027:  Hold'em No Limit ($0.01/$0.02 USD) - 2022/08/23 11:42:29 ET
Table 'Despina IV' 6-max Seat #2 is the button
Seat 1: Muszkli299 ($3.07 in chips)
Seat 2: Nikalians ($2.53 in chips)
Seat 3: stryka62 ($2.51 in chips)
Seat 4: Kasaty ($0.40 in chips)
Seat 5: maslak270 ($1.97 in chips)
stryka62: posts small blind $0.01
Kasaty: posts big blind $0.02
*** HOLE CARDS ***
maslak270: folds
Muszkli299: folds
Nikalians: folds
stryka62: calls $0.01
Kasaty: checks
*** FLOP *** [7c 2h Jd]
Borman_msk was removed from the table for failing to post
Borman_msk leaves the table
stryka62: bets $0.40
Kasaty: folds
Uncalled bet ($0.40) returned to stryka62
stryka62 collected $0.04 from pot
*** SUMMARY ***
Total pot $0.04 | Rake $0
Board [7c 2h Jd]
Seat 1: Muszkli299 folded before Flop (didn't bet)
Seat 2: Nikalians (button) folded before Flop (didn't bet)
Seat 3: stryka62 (small blind) collected ($0.04)
Seat 4: Kasaty (big blind) folded on the Flop
Seat 5: maslak270 folded before Flop (didn't bet)


PokerStars Hand #238168537568:  Hold'em No Limit ($0.01/$0.02 USD) - 2022/08/23 11:42:58 ET
Table 'Despina IV' 6-max Seat #3 is the button
Seat 1: Muszkli299 ($3.07 in chips)
Seat 2: Nikalians ($2.53 in chips)
Seat 3: stryka62 ($2.53 in chips)
Seat 4: Kasaty ($0.38 in chips)
Seat 5: maslak270 ($1.97 in chips)
Kasaty: posts small blind $0.01
maslak270: posts big blind $0.02
*** HOLE CARDS ***
Muszkli299: raises $0.02 to $0.04
Nikalians: calls $0.04
stryka62 has timed out
stryka62: folds
Kasaty: folds
maslak270: folds
*** FLOP *** [3s 3h 5d]
Muszkli299: bets $0.06
Nikalians: folds
Uncalled bet ($0.06) returned to Muszkli299
Muszkli299 collected $0.11 from pot
*** SUMMARY ***
Total pot $0.11 | Rake $0
Board [3s 3h 5d]
Seat 1: Muszkli299 collected ($0.11)
Seat 2: Nikalians folded on the Flop
Seat 3: stryka62 (button) folded before Flop (didn't bet)
Seat 4: Kasaty (small blind) folded before Flop
Seat 5: maslak270 (big blind) folded before Flop


PokerStars Hand #238168548705:  Hold'em No Limit ($0.01/$0.02 USD) - 2022/08/23 11:43:36 ET
Table 'Despina IV' 6-max Seat #4 is the button
Seat 1: Muszkli299 ($3.14 in chips)
Seat 2: Nikalians ($2.49 in chips)
Seat 3: stryka62 ($2.53 in chips)
Seat 4: Kasaty ($0.37 in chips)
Seat 5: maslak270 ($1.95 in chips)
maslak270: posts small blind $0.01
Muszkli299: posts big blind $0.02
*** HOLE CARDS ***
Nikalians: folds
stryka62: raises $0.05 to $0.07
Kasaty has timed out
Kasaty: folds
maslak270: folds
Muszkli299: folds
Uncalled bet ($0.05) returned to stryka62
Jake7123 joins the table at seat #6
stryka62 collected $0.05 from pot
*** SUMMARY ***
Total pot $0.05 | Rake $0
Seat 1: Muszkli299 (big blind) folded before Flop
Seat 2: Nikalians folded before Flop (didn't bet)
Seat 3: stryka62 collected ($0.05)
Seat 4: Kasaty (button) folded before Flop (didn't bet)
Seat 5: maslak270 (small blind) folded before Flop


PokerStars Hand #238168557280:  Hold'em No Limit ($0.01/$0.02 USD) - 2022/08/23 11:44:04 ET
Table 'Despina IV' 6-max Seat #5 is the button
Seat 2: Nikalians ($2.49 in chips)
Seat 3: stryka62 ($2.56 in chips)
Seat 5: maslak270 ($1.94 in chips)
Nikalians: posts small blind $0.01
stryka62: posts big blind $0.02
*** HOLE CARDS ***
maslak270: raises $0.02 to $0.04
Nikalians: folds
stryka62: raises $0.09 to $0.13
maslak270: folds
Uncalled bet ($0.09) returned to stryka62
stryka62 collected $0.09 from pot
*** SUMMARY ***
Total pot $0.09 | Rake $0
Seat 2: Nikalians (small blind) folded before Flop
Seat 3: stryka62 (big blind) collected ($0.09)
Seat 5: maslak270 (button) folded before Flop


PokerStars Hand #238168566661:  Hold'em No Limit ($0.01/$0.02 USD) - 2022/08/23 11:44:35 ET
Table 'Despina IV' 6-max Seat #2 is the button
Seat 2: Nikalians ($2.48 in chips)
Seat 3: stryka62 ($2.61 in chips)
Seat 4: Kasaty ($0.37 in chips)
Seat 5: maslak270 ($1.90 in chips)
Seat 6: Jake7123 ($2 in chips)
stryka62: posts small blind $0.01
Kasaty: posts big blind $0.02
Jake7123: posts big blind $0.02
*** HOLE CARDS ***
maslak270: folds
Muszkli299 leaves the table
Jake7123: checks
Nikalians: folds
stryka62: calls $0.01
Kasaty: checks
*** FLOP *** [5d 6d Qh]
stryka62: checks
Kasaty: checks
Jake7123: checks
*** TURN *** [5d 6d Qh] [Qs]
stryka62: checks
Kasaty: checks
Jake7123: checks
*** RIVER *** [5d 6d Qh Qs] [7s]
stryka62: checks
Kasaty: checks
Jake7123: checks
*** SHOW DOWN ***
stryka62: shows [Kd 9c] (a pair of Queens)
Kasaty: shows [2s 6s] (two pair, Queens and Sixes)
Jake7123: mucks hand
Kasaty collected $0.06 from pot
*** SUMMARY ***
Total pot $0.06 | Rake $0
Board [5d 6d Qh Qs 7s]
Seat 2: Nikalians (button) folded before Flop (didn't bet)
Seat 3: stryka62 (small blind) showed [Kd 9c] and lost with a pair of Queens
Seat 4: Kasaty (big blind) showed [2s 6s] and won ($0.06) with two pair, Queens and Sixes
Seat 5: maslak270 folded before Flop (didn't bet)
Seat 6: Jake7123 mucked


PokerStars Hand #238168591279:  Hold'em No Limit ($0.01/$0.02 USD) - 2022/08/23 11:45:56 ET
Table 'Despina IV' 6-max Seat #3 is the button
Seat 2: Nikalians ($2.48 in chips)
Seat 3: stryka62 ($2.59 in chips)
Seat 4: Kasaty ($0.41 in chips)
Seat 5: maslak270 ($1.90 in chips)
Seat 6: Jake7123 ($1.98 in chips)
Kasaty: posts small blind $0.01
maslak270: posts big blind $0.02
*** HOLE CARDS ***
SidneyCrosby8 joins the table at seat #1
Jake7123: folds
Nikalians: folds
stryka62: folds
Kasaty: calls $0.01
maslak270: checks
*** FLOP *** [6c Tc Jc]
Kasaty: checks
maslak270: checks
*** TURN *** [6c Tc Jc] [Jd]
Kasaty: bets $0.06
maslak270: folds
Uncalled bet ($0.06) returned to Kasaty
Kasaty collected $0.04 from pot
*** SUMMARY ***
Total pot $0.04 | Rake $0
Board [6c Tc Jc Jd]
Seat 2: Nikalians folded before Flop (didn't bet)
Seat 3: stryka62 (button) folded before Flop (didn't bet)
Seat 4: Kasaty (small blind) collected ($0.04)
Seat 5: maslak270 (big blind) folded on the Turn
Seat 6: Jake7123 folded before Flop (didn't bet)


PokerStars Hand #238168596879:  Hold'em No Limit ($0.01/$0.02 USD) - 2022/08/23 11:46:14 ET
Table 'Despina IV' 6-max Seat #4 is the button
Seat 2: Nikalians ($2.48 in chips)
Seat 3: stryka62 ($2.59 in chips)
Seat 4: Kasaty ($0.43 in chips)
Seat 5: maslak270 ($1.88 in chips)
Seat 6: Jake7123 ($1.98 in chips)
maslak270: posts small blind $0.01
Jake7123: posts big blind $0.02
SidneyCrosby8: sits out
*** HOLE CARDS ***
Nikalians: folds
stryka62: raises $0.04 to $0.06
Kasaty: folds
maslak270: folds
Jake7123: folds
Uncalled bet ($0.04) returned to stryka62
stryka62 collected $0.05 from pot
*** SUMMARY ***
Total pot $0.05 | Rake $0
Seat 2: Nikalians folded before Flop (didn't bet)
Seat 3: stryka62 collected ($0.05)
Seat 4: Kasaty (button) folded before Flop (didn't bet)
Seat 5: maslak270 (small blind) folded before Flop
Seat 6: Jake7123 (big blind) folded before Flop


PokerStars Hand #238168604317:  Hold'em No Limit ($0.01/$0.02 USD) - 2022/08/23 11:46:39 ET
Table 'Despina IV' 6-max Seat #5 is the button
Seat 1: SidneyCrosby8 ($2 in chips)
Seat 2: Nikalians ($2.48 in chips)
Seat 3: stryka62 ($2.62 in chips)
Seat 4: Kasaty ($0.43 in chips)
Seat 5: maslak270 ($1.87 in chips)
Seat 6: Jake7123 ($1.96 in chips)
Jake7123: posts small blind $0.01
SidneyCrosby8: posts big blind $0.02
*** HOLE CARDS ***
Nikalians: folds
stryka62: calls $0.02
Kasaty: folds
maslak270: calls $0.02
Jake7123: folds
SidneyCrosby8: checks
*** FLOP *** [3s 7h 5s]
SidneyCrosby8: checks
stryka62: checks
maslak270: checks
*** TURN *** [3s 7h 5s] [2h]
Nikalians leaves the table
SidneyCrosby8: bets $0.07
arsad725 joins the table at seat #2
stryka62: calls $0.07
maslak270: folds
*** RIVER *** [3s 7h 5s 2h] [Td]
SidneyCrosby8: checks
stryka62: checks
*** SHOW DOWN ***
SidneyCrosby8: shows [Qs 4s] (high card Queen)
stryka62: shows [Ad 5c] (a pair of Fives)
stryka62 collected $0.20 from pot
*** SUMMARY ***
Total pot $0.21 | Rake $0.01
Board [3s 7h 5s 2h Td]
Seat 1: SidneyCrosby8 (big blind) showed [Qs 4s] and lost with high card Queen
Seat 2: Nikalians folded before Flop (didn't bet)
Seat 3: stryka62 showed [Ad 5c] and won ($0.20) with a pair of Fives
Seat 4: Kasaty folded before Flop (didn't bet)
Seat 5: maslak270 (button) folded on the Turn
Seat 6: Jake7123 (small blind) folded before Flop


PokerStars Hand #238168616056:  Hold'em No Limit ($0.01/$0.02 USD) - 2022/08/23 11:47:17 ET
Table 'Despina IV' 6-max Seat #6 is the button
Seat 1: SidneyCrosby8 ($2 in chips)
Seat 2: arsad725 ($2 in chips)
Seat 3: stryka62 ($2.73 in chips)
Seat 4: Kasaty ($0.43 in chips)
Seat 5: maslak270 ($1.85 in chips)
Seat 6: Jake7123 ($1.95 in chips)
SidneyCrosby8: posts small blind $0.01
arsad725: posts big blind $0.02
*** HOLE CARDS ***
stryka62: folds
Kasaty: folds
maslak270: calls $0.02
Jake7123: folds
SidneyCrosby8: folds
arsad725: checks
*** FLOP *** [6d 5h 7d]
arsad725: checks
maslak270: bets $0.02
arsad725: folds
Uncalled bet ($0.02) returned to maslak270
maslak270 collected $0.05 from pot
maslak270: doesn't show hand
*** SUMMARY ***
Total pot $0.05 | Rake $0
Board [6d 5h 7d]
Seat 1: SidneyCrosby8 (small blind) folded before Flop
Seat 2: arsad725 (big blind) folded on the Flop
Seat 3: stryka62 folded before Flop (didn't bet)
Seat 4: Kasaty folded before Flop (didn't bet)
Seat 5: maslak270 collected ($0.05)
Seat 6: Jake7123 (button) folded before Flop (didn't bet)


PokerStars Hand #238168624680:  Hold'em No Limit ($0.01/$0.02 USD) - 2022/08/23 11:47:46 ET
Table 'Despina IV' 6-max Seat #1 is the button
Seat 1: SidneyCrosby8 ($2 in chips)
Seat 2: arsad725 ($2 in chips)
Seat 3: stryka62 ($2.73 in chips)
Seat 4: Kasaty ($0.43 in chips)
Seat 5: maslak270 ($1.88 in chips)
Seat 6: Jake7123 ($1.95 in chips)
arsad725: posts small blind $0.01
stryka62: posts big blind $0.02
*** HOLE CARDS ***
Kasaty: calls $0.02
maslak270: folds
Jake7123: folds
SidneyCrosby8: folds
arsad725: folds
stryka62: checks
*** FLOP *** [6d Qd As]
stryka62: checks
Kasaty: checks
*** TURN *** [6d Qd As] [Jh]
stryka62: checks
Kasaty: bets $0.04
stryka62: folds
Uncalled bet ($0.04) returned to Kasaty
Kasaty collected $0.05 from pot
*** SUMMARY ***
Total pot $0.05 | Rake $0
Board [6d Qd As Jh]
Seat 1: SidneyCrosby8 (button) folded before Flop (didn't bet)
Seat 2: arsad725 (small blind) folded before Flop
Seat 3: stryka62 (big blind) folded on the Turn
Seat 4: Kasaty collected ($0.05)
Seat 5: maslak270 folded before Flop (didn't bet)
Seat 6: Jake7123 folded before Flop (didn't bet)


PokerStars Hand #238168633962:  Hold'em No Limit ($0.01/$0.02 USD) - 2022/08/23 11:48:16 ET
Table 'Despina IV' 6-max Seat #2 is the button
Seat 1: SidneyCrosby8 ($2 in chips)
Seat 2: arsad725 ($2 in chips)
Seat 3: stryka62 ($2.71 in chips)
Seat 4: Kasaty ($0.46 in chips)
Seat 5: maslak270 ($1.88 in chips)
Seat 6: Jake7123 ($1.95 in chips)
stryka62: posts small blind $0.01
Kasaty: posts big blind $0.02
*** HOLE CARDS ***
maslak270: folds
maslak270 leaves the table
Jake7123: folds
SidneyCrosby8: folds
Sabaka777 joins the table at seat #5
arsad725: folds
stryka62: folds
Uncalled bet ($0.01) returned to Kasaty
Kasaty collected $0.02 from pot
*** SUMMARY ***
Total pot $0.02 | Rake $0
Seat 1: SidneyCrosby8 folded before Flop (didn't bet)
Seat 2: arsad725 (button) folded before Flop (didn't bet)
Seat 3: stryka62 (small blind) folded before Flop
Seat 4: Kasaty (big blind) collected ($0.02)
Seat 5: maslak270 folded before Flop (didn't bet)
Seat 6: Jake7123 folded before Flop (didn't bet)


PokerStars Hand #238168637882:  Hold'em No Limit ($0.01/$0.02 USD) - 2022/08/23 11:48:29 ET
Table 'Despina IV' 6-max Seat #3 is the button
Seat 1: SidneyCrosby8 ($2 in chips)
Seat 2: arsad725 ($2 in chips)
Seat 3: stryka62 ($2.70 in chips)
Seat 4: Kasaty ($0.47 in chips)
Seat 5: Sabaka777 ($2 in chips)
Seat 6: Jake7123 ($1.95 in chips)
Kasaty: posts small blind $0.01
Sabaka777: posts big blind $0.02
*** HOLE CARDS ***
Jake7123: folds
SidneyCrosby8: folds
arsad725: folds
stryka62: raises $0.13 to $0.15
Kasaty: folds
Sabaka777: folds
Uncalled bet ($0.13) returned to stryka62
stryka62 collected $0.05 from pot
*** SUMMARY ***
Total pot $0.05 | Rake $0
Seat 1: SidneyCrosby8 folded before Flop (didn't bet)
Seat 2: arsad725 folded before Flop (didn't bet)
Seat 3: stryka62 (button) collected ($0.05)
Seat 4: Kasaty (small blind) folded before Flop
Seat 5: Sabaka777 (big blind) folded before Flop
Seat 6: Jake7123 folded before Flop (didn't bet)


PokerStars Hand #238168644615:  Hold'em No Limit ($0.01/$0.02 USD) - 2022/08/23 11:48:51 ET
Table 'Despina IV' 6-max Seat #4 is the button
Seat 1: SidneyCrosby8 ($2 in chips)
Seat 2: arsad725 ($2 in chips)
Seat 3: stryka62 ($2.73 in chips)
Seat 4: Kasaty ($0.46 in chips)
Seat 5: Sabaka777 ($1.98 in chips)
Seat 6: Jake7123 ($1.95 in chips)
Sabaka777: posts small blind $0.01
Jake7123: posts big blind $0.02
*** HOLE CARDS ***
SidneyCrosby8: folds
arsad725: folds
stryka62: calls $0.02
Kasaty: folds
Sabaka777: folds
Jake7123: raises $0.02 to $0.04
stryka62: calls $0.02
*** FLOP *** [5c Th 7h]
Jake7123: bets $0.09
stryka62: calls $0.09
*** TURN *** [5c Th 7h] [9c]
Jake7123: bets $0.13
stryka62: raises $0.26 to $0.39
Jake7123: folds
Uncalled bet ($0.26) returned to stryka62
stryka62 collected $0.51 from pot
*** SUMMARY ***
Total pot $0.53 | Rake $0.02
Board [5c Th 7h 9c]
Seat 1: SidneyCrosby8 folded before Flop (didn't bet)
Seat 2: arsad725 folded before Flop (didn't bet)
Seat 3: stryka62 collected ($0.51)
Seat 4: Kasaty (button) folded before Flop (didn't bet)
Seat 5: Sabaka777 (small blind) folded before Flop
Seat 6: Jake7123 (big blind) folded on the Turn


PokerStars Hand #238168661348:  Hold'em No Limit ($0.01/$0.02 USD) - 2022/08/23 11:49:46 ET
Table 'Despina IV' 6-max Seat #5 is the button
Seat 1: SidneyCrosby8 ($2 in chips)
Seat 2: arsad725 ($2 in chips)
Seat 3: stryka62 ($2.98 in chips)
Seat 5: Sabaka777 ($1.97 in chips)
Seat 6: Jake7123 ($1.69 in chips)
Jake7123: posts small blind $0.01
SidneyCrosby8: posts big blind $0.02
*** HOLE CARDS ***
arsad725: folds
stryka62: folds
Sabaka777: folds
Jake7123: raises $0.02 to $0.04
SidneyCrosby8: folds
Uncalled bet ($0.02) returned to Jake7123
Jake7123 collected $0.04 from pot
Jake7123: doesn't show hand
*** SUMMARY ***
Total pot $0.04 | Rake $0
Seat 1: SidneyCrosby8 (big blind) folded before Flop
Seat 2: arsad725 folded before Flop (didn't bet)
Seat 3: stryka62 folded before Flop (didn't bet)
Seat 5: Sabaka777 (button) folded before Flop (didn't bet)
Seat 6: Jake7123 (small blind) collected ($0.04)


PokerStars Hand #238168665266:  Hold'em No Limit ($0.01/$0.02 USD) - 2022/08/23 11:49:59 ET
Table 'Despina IV' 6-max Seat #6 is the button
Seat 1: SidneyCrosby8 ($2 in chips)
Seat 2: arsad725 ($2 in chips)
Seat 3: stryka62 ($2.98 in chips)
Seat 5: Sabaka777 ($1.97 in chips)
Seat 6: Jake7123 ($1.71 in chips)
SidneyCrosby8: posts small blind $0.01
arsad725: posts big blind $0.02
*** HOLE CARDS ***
stryka62: calls $0.02
Sabaka777: raises $0.02 to $0.04
Jake7123: calls $0.04
SidneyCrosby8: folds
arsad725: folds
stryka62: calls $0.02
*** FLOP *** [5h Td 5d]
stryka62: checks
Sabaka777: checks
Jake7123: checks
*** TURN *** [5h Td 5d] [Ah]
stryka62: bets $0.07
Sabaka777: calls $0.07
Jake7123: raises $0.07 to $0.14
stryka62: folds
Sabaka777: folds
Uncalled bet ($0.07) returned to Jake7123
Jake7123 collected $0.35 from pot
Jake7123: doesn't show hand
*** SUMMARY ***
Total pot $0.36 | Rake $0.01
Board [5h Td 5d Ah]
Seat 1: SidneyCrosby8 (small blind) folded before Flop
Seat 2: arsad725 (big blind) folded before Flop
Seat 3: stryka62 folded on the Turn
Seat 5: Sabaka777 folded on the Turn
Seat 6: Jake7123 (button) collected ($0.35)


PokerStars Hand #238168683841:  Hold'em No Limit ($0.01/$0.02 USD) - 2022/08/23 11:51:00 ET
Table 'Despina IV' 6-max Seat #1 is the button
Seat 1: SidneyCrosby8 ($2 in chips)
Seat 2: arsad725 ($2 in chips)
Seat 3: stryka62 ($2.87 in chips)
Seat 5: Sabaka777 ($1.86 in chips)
Seat 6: Jake7123 ($2 in chips)
arsad725: posts small blind $0.01
stryka62: posts big blind $0.02
*** HOLE CARDS ***
Sabaka777: folds
Jake7123: folds
SidneyCrosby8: folds
arsad725: folds
Uncalled bet ($0.01) returned to stryka62
stryka62 collected $0.02 from pot
*** SUMMARY ***
Total pot $0.02 | Rake $0
Seat 1: SidneyCrosby8 (button) folded before Flop (didn't bet)
Seat 2: arsad725 (small blind) folded before Flop
Seat 3: stryka62 (big blind) collected ($0.02)
Seat 5: Sabaka777 folded before Flop (didn't bet)
Seat 6: Jake7123 folded before Flop (didn't bet)


PokerStars Hand #238168689920:  Hold'em No Limit ($0.01/$0.02 USD) - 2022/08/23 11:51:20 ET
Table 'Despina IV' 6-max Seat #2 is the button
Seat 1: SidneyCrosby8 ($2 in chips)
Seat 2: arsad725 ($2 in chips)
Seat 3: stryka62 ($2.88 in chips)
Seat 5: Sabaka777 ($1.86 in chips)
Seat 6: Jake7123 ($2 in chips)
stryka62: posts small blind $0.01
Sabaka777: posts big blind $0.02
*** HOLE CARDS ***
Jake7123: folds
SidneyCrosby8: folds
arsad725: folds
stryka62: calls $0.01
Sabaka777: checks
*** FLOP *** [3d As Qs]
stryka62: checks
Sabaka777: checks
*** TURN *** [3d As Qs] [Qh]
stryka62: checks
Sabaka777: checks
*** RIVER *** [3d As Qs Qh] [8c]
stryka62: bets $0.06
Sabaka777: folds
Uncalled bet ($0.06) returned to stryka62
stryka62 collected $0.04 from pot
*** SUMMARY ***
Total pot $0.04 | Rake $0
Board [3d As Qs Qh 8c]
Seat 1: SidneyCrosby8 folded before Flop (didn't bet)
Seat 2: arsad725 (button) folded before Flop (didn't bet)
Seat 3: stryka62 (small blind) collected ($0.04)
Seat 5: Sabaka777 (big blind) folded on the River
Seat 6: Jake7123 folded before Flop (didn't bet)


PokerStars Hand #238168702395:  Hold'em No Limit ($0.01/$0.02 USD) - 2022/08/23 11:52:01 ET
Table 'Despina IV' 6-max Seat #3 is the button
Seat 1: SidneyCrosby8 ($2 in chips)
Seat 2: arsad725 ($2 in chips)
Seat 3: stryka62 ($2.90 in chips)
Seat 5: Sabaka777 ($1.84 in chips)
Seat 6: Jake7123 ($2 in chips)
Sabaka777: posts small blind $0.01
Jake7123: posts big blind $0.02
*** HOLE CARDS ***
SidneyCrosby8: folds
arsad725: folds
stryka62: folds
Sabaka777: folds
Uncalled bet ($0.01) returned to Jake7123
Jake7123 collected $0.02 from pot
Jake7123: doesn't show hand
*** SUMMARY ***
Total pot $0.02 | Rake $0
Seat 1: SidneyCrosby8 folded before Flop (didn't bet)
Seat 2: arsad725 folded before Flop (didn't bet)
Seat 3: stryka62 (button) folded before Flop (didn't bet)
Seat 5: Sabaka777 (small blind) folded before Flop
Seat 6: Jake7123 (big blind) collected ($0.02)


PokerStars Hand #238168706141:  Hold'em No Limit ($0.01/$0.02 USD) - 2022/08/23 11:52:14 ET
Table 'Despina IV' 6-max Seat #5 is the button
Seat 1: SidneyCrosby8 ($2 in chips)
Seat 2: arsad725 ($2 in chips)
Seat 3: stryka62 ($2.90 in chips)
Seat 5: Sabaka777 ($1.83 in chips)
Seat 6: Jake7123 ($2.01 in chips)
Jake7123: posts small blind $0.01
SidneyCrosby8: posts big blind $0.02
*** HOLE CARDS ***
arsad725: folds
stryka62: folds
Sabaka777: folds
Jake7123: folds
Uncalled bet ($0.01) returned to SidneyCrosby8
SidneyCrosby8 collected $0.02 from pot
SidneyCrosby8: doesn't show hand
*** SUMMARY ***
Total pot $0.02 | Rake $0
Seat 1: SidneyCrosby8 (big blind) collected ($0.02)
Seat 2: arsad725 folded before Flop (didn't bet)
Seat 3: stryka62 folded before Flop (didn't bet)
Seat 5: Sabaka777 (button) folded before Flop (didn't bet)
Seat 6: Jake7123 (small blind) folded before Flop


PokerStars Hand #238168709878:  Hold'em No Limit ($0.01/$0.02 USD) - 2022/08/23 11:52:26 ET
Table 'Despina IV' 6-max Seat #6 is the button
Seat 1: SidneyCrosby8 ($2.01 in chips)
Seat 2: arsad725 ($2 in chips)
Seat 3: stryka62 ($2.90 in chips)
Seat 5: Sabaka777 ($1.83 in chips)
Seat 6: Jake7123 ($2 in chips)
SidneyCrosby8: posts small blind $0.01
arsad725: posts big blind $0.02
*** HOLE CARDS ***
stryka62: folds
Sabaka777: folds
Jake7123: raises $0.02 to $0.04
SidneyCrosby8: folds
arsad725: folds
Uncalled bet ($0.02) returned to Jake7123
Jake7123 collected $0.05 from pot
Jake7123: doesn't show hand
*** SUMMARY ***
Total pot $0.05 | Rake $0
Seat 1: SidneyCrosby8 (small blind) folded before Flop
Seat 2: arsad725 (big blind) folded before Flop
Seat 3: stryka62 folded before Flop (didn't bet)
Seat 5: Sabaka777 folded before Flop (didn't bet)
Seat 6: Jake7123 (button) collected ($0.05)


PokerStars Hand #238168714225:  Hold'em No Limit ($0.01/$0.02 USD) - 2022/08/23 11:52:41 ET
Table 'Despina IV' 6-max Seat #1 is the button
Seat 1: SidneyCrosby8 ($2 in chips)
Seat 2: arsad725 ($2 in chips)
Seat 3: stryka62 ($2.90 in chips)
Seat 5: Sabaka777 ($1.83 in chips)
Seat 6: Jake7123 ($2.03 in chips)
arsad725: posts small blind $0.01
stryka62: posts big blind $0.02
*** HOLE CARDS ***
Sabaka777: raises $0.04 to $0.06
Jake7123: folds
SidneyCrosby8: folds
arsad725: folds
stryka62: calls $0.04
*** FLOP *** [Ks 8s Kc]
stryka62: checks
Sabaka777: checks
*** TURN *** [Ks 8s Kc] [9c]
stryka62: bets $0.13
Sabaka777: folds
Uncalled bet ($0.13) returned to stryka62
stryka62 collected $0.13 from pot
*** SUMMARY ***
Total pot $0.13 | Rake $0
Board [Ks 8s Kc 9c]
Seat 1: SidneyCrosby8 (button) folded before Flop (didn't bet)
Seat 2: arsad725 (small blind) folded before Flop
Seat 3: stryka62 (big blind) collected ($0.13)
Seat 5: Sabaka777 folded on the Turn
Seat 6: Jake7123 folded before Flop (didn't bet)


PokerStars Hand #238168723885:  Hold'em No Limit ($0.01/$0.02 USD) - 2022/08/23 11:53:13 ET
Table 'Despina IV' 6-max Seat #2 is the button
Seat 1: SidneyCrosby8 ($2 in chips)
Seat 2: arsad725 ($2 in chips)
Seat 3: stryka62 ($2.97 in chips)
Seat 5: Sabaka777 ($1.77 in chips)
Seat 6: Jake7123 ($2.03 in chips)
stryka62: posts small blind $0.01
Sabaka777: posts big blind $0.02
*** HOLE CARDS ***
Jake7123: raises $0.02 to $0.04
SidneyCrosby8: folds
arsad725: folds
stryka62: folds
Sabaka777: folds
Uncalled bet ($0.02) returned to Jake7123
Jake7123 collected $0.05 from pot
Jake7123: doesn't show hand
*** SUMMARY ***
Total pot $0.05 | Rake $0
Seat 1: SidneyCrosby8 folded before Flop (didn't bet)
Seat 2: arsad725 (button) folded before Flop (didn't bet)
Seat 3: stryka62 (small blind) folded before Flop
Seat 5: Sabaka777 (big blind) folded before Flop
Seat 6: Jake7123 collected ($0.05)


PokerStars Hand #238168729567:  Hold'em No Limit ($0.01/$0.02 USD) - 2022/08/23 11:53:32 ET
Table 'Despina IV' 6-max Seat #3 is the button
Seat 1: SidneyCrosby8 ($2 in chips)
Seat 2: arsad725 ($2 in chips)
Seat 3: stryka62 ($2.96 in chips)
Seat 5: Sabaka777 ($1.75 in chips)
Seat 6: Jake7123 ($2.06 in chips)
Sabaka777: posts small blind $0.01
Jake7123: posts big blind $0.02
*** HOLE CARDS ***
SidneyCrosby8: folds
arsad725: folds
stryka62: folds
Sabaka777: folds
Uncalled bet ($0.01) returned to Jake7123
Jake7123 collected $0.02 from pot
Jake7123: doesn't show hand
*** SUMMARY ***
Total pot $0.02 | Rake $0
Seat 1: SidneyCrosby8 folded before Flop (didn't bet)
Seat 2: arsad725 folded before Flop (didn't bet)
Seat 3: stryka62 (button) folded before Flop (didn't bet)
Seat 5: Sabaka777 (small blind) folded before Flop
Seat 6: Jake7123 (big blind) collected ($0.02)


PokerStars Hand #238168733834:  Hold'em No Limit ($0.01/$0.02 USD) - 2022/08/23 11:53:46 ET
Table 'Despina IV' 6-max Seat #5 is the button
Seat 1: SidneyCrosby8 ($2 in chips)
Seat 2: arsad725 ($2 in chips)
Seat 3: stryka62 ($2.96 in chips)
Seat 5: Sabaka777 ($1.74 in chips)
Seat 6: Jake7123 ($2.07 in chips)
Jake7123: posts small blind $0.01
SidneyCrosby8: posts big blind $0.02
*** HOLE CARDS ***
arsad725: folds
stryka62: folds
Sabaka777: raises $0.02 to $0.04
Jake7123: folds
SidneyCrosby8: calls $0.02
*** FLOP *** [9h Ah Kh]
SidneyCrosby8: checks
Sabaka777: checks
*** TURN *** [9h Ah Kh] [5d]
SidneyCrosby8: checks
Sabaka777: checks
*** RIVER *** [9h Ah Kh 5d] [6d]
SidneyCrosby8: checks
Sabaka777: checks
*** SHOW DOWN ***
SidneyCrosby8: shows [Kc Jc] (a pair of Kings)
Sabaka777: mucks hand
SidneyCrosby8 collected $0.09 from pot
*** SUMMARY ***
Total pot $0.09 | Rake $0
Board [9h Ah Kh 5d 6d]
Seat 1: SidneyCrosby8 (big blind) showed [Kc Jc] and won ($0.09) with a pair of Kings
Seat 2: arsad725 folded before Flop (didn't bet)
Seat 3: stryka62 folded before Flop (didn't bet)
Seat 5: Sabaka777 (button) mucked
Seat 6: Jake7123 (small blind) folded before Flop


PokerStars Hand #238168740294:  Hold'em No Limit ($0.01/$0.02 USD) - 2022/08/23 11:54:08 ET
Table 'Despina IV' 6-max Seat #6 is the button
Seat 1: SidneyCrosby8 ($2.05 in chips)
Seat 2: arsad725 ($2 in chips)
Seat 3: stryka62 ($2.96 in chips)
Seat 5: Sabaka777 ($1.70 in chips)
Seat 6: Jake7123 ($2.06 in chips)
SidneyCrosby8: posts small blind $0.01
arsad725: posts big blind $0.02
*** HOLE CARDS ***
stryka62: folds
Sabaka777: folds
Jake7123: raises $0.02 to $0.04
SidneyCrosby8: folds
arsad725: folds
Uncalled bet ($0.02) returned to Jake7123
Jake7123 collected $0.05 from pot
Jake7123: doesn't show hand
*** SUMMARY ***
Total pot $0.05 | Rake $0
Seat 1: SidneyCrosby8 (small blind) folded before Flop
Seat 2: arsad725 (big blind) folded before Flop
Seat 3: stryka62 folded before Flop (didn't bet)
Seat 5: Sabaka777 folded before Flop (didn't bet)
Seat 6: Jake7123 (button) collected ($0.05)


PokerStars Hand #238168743344:  Hold'em No Limit ($0.01/$0.02 USD) - 2022/08/23 11:54:18 ET
Table 'Despina IV' 6-max Seat #1 is the button
Seat 1: SidneyCrosby8 ($2.04 in chips)
Seat 2: arsad725 ($2 in chips)
Seat 3: stryka62 ($2.96 in chips)
Seat 5: Sabaka777 ($1.70 in chips)
Seat 6: Jake7123 ($2.09 in chips)
arsad725: posts small blind $0.01
stryka62: posts big blind $0.02
*** HOLE CARDS ***
Sabaka777: folds
Jake7123: folds
SidneyCrosby8: folds
arsad725: folds
Uncalled bet ($0.01) returned to stryka62
stryka62 collected $0.02 from pot
*** SUMMARY ***
Total pot $0.02 | Rake $0
Seat 1: SidneyCrosby8 (button) folded before Flop (didn't bet)
Seat 2: arsad725 (small blind) folded before Flop
Seat 3: stryka62 (big blind) collected ($0.02)
Seat 5: Sabaka777 folded before Flop (didn't bet)
Seat 6: Jake7123 folded before Flop (didn't bet)


PokerStars Hand #238168746260:  Hold'em No Limit ($0.01/$0.02 USD) - 2022/08/23 11:54:28 ET
Table 'Despina IV' 6-max Seat #2 is the button
Seat 1: SidneyCrosby8 ($2.04 in chips)
Seat 2: arsad725 ($2 in chips)
Seat 3: stryka62 ($2.97 in chips)
Seat 5: Sabaka777 ($1.70 in chips)
Seat 6: Jake7123 ($2.09 in chips)
stryka62: posts small blind $0.01
Sabaka777: posts big blind $0.02
*** HOLE CARDS ***
Kasaty is disconnected
Jake7123: raises $0.02 to $0.04
SidneyCrosby8: folds
arsad725: folds
stryka62: raises $0.10 to $0.14
Sabaka777: raises $0.34 to $0.48
Jake7123: folds
stryka62: calls $0.34
*** FLOP *** [Kd 8d 4d]
stryka62: checks
Sabaka777: bets $0.96
stryka62: calls $0.96
*** TURN *** [Kd 8d 4d] [8s]
stryka62: bets $1.53 and is all-in
Sabaka777: calls $0.26 and is all-in
Uncalled bet ($1.27) returned to stryka62
*** RIVER *** [Kd 8d 4d 8s] [Kc]
*** SHOW DOWN ***
stryka62: shows [Ad 9d] (a flush, Ace high)
Sabaka777: shows [As Kh] (a full house, Kings full of Eights)
Sabaka777 collected $3.32 from pot
*** SUMMARY ***
Total pot $3.44 | Rake $0.12
Board [Kd 8d 4d 8s Kc]
Seat 1: SidneyCrosby8 folded before Flop (didn't bet)
Seat 2: arsad725 (button) folded before Flop (didn't bet)
Seat 3: stryka62 (small blind) showed [Ad 9d] and lost with a flush, Ace high
Seat 5: Sabaka777 (big blind) showed [As Kh] and won ($3.32) with a full house, Kings full of Eights
Seat 6: Jake7123 folded before Flop


PokerStars Hand #238168763523:  Hold'em No Limit ($0.01/$0.02 USD) - 2022/08/23 11:55:29 ET
Table 'Despina IV' 6-max Seat #3 is the button
Seat 1: SidneyCrosby8 ($2.04 in chips)
Seat 2: arsad725 ($2 in chips)
Seat 3: stryka62 ($1.27 in chips)
Seat 5: Sabaka777 ($3.32 in chips)
Seat 6: Jake7123 ($2.05 in chips)
Sabaka777: posts small blind $0.01
Jake7123: posts big blind $0.02
*** HOLE CARDS ***
SidneyCrosby8: folds
arsad725: folds
stryka62: folds
Sabaka777: folds
Uncalled bet ($0.01) returned to Jake7123
Jake7123 collected $0.02 from pot
Jake7123: doesn't show hand
*** SUMMARY ***
Total pot $0.02 | Rake $0
Seat 1: SidneyCrosby8 folded before Flop (didn't bet)
Seat 2: arsad725 folded before Flop (didn't bet)
Seat 3: stryka62 (button) folded before Flop (didn't bet)
Seat 5: Sabaka777 (small blind) folded before Flop
Seat 6: Jake7123 (big blind) collected ($0.02)


PokerStars Hand #238168765769:  Hold'em No Limit ($0.01/$0.02 USD) - 2022/08/23 11:55:38 ET
Table 'Despina IV' 6-max Seat #5 is the button
Seat 1: SidneyCrosby8 ($2.04 in chips)
Seat 2: arsad725 ($2 in chips)
Seat 3: stryka62 ($1.27 in chips)
Seat 5: Sabaka777 ($3.31 in chips)
Seat 6: Jake7123 ($2.06 in chips)
Jake7123: posts small blind $0.01
SidneyCrosby8: posts big blind $0.02
*** HOLE CARDS ***
arsad725: folds
stryka62: folds
Sabaka777: folds
Jake7123: raises $0.02 to $0.04
SidneyCrosby8: folds
Uncalled bet ($0.02) returned to Jake7123
Jake7123 collected $0.04 from pot
Jake7123: doesn't show hand
*** SUMMARY ***
Total pot $0.04 | Rake $0
Seat 1: SidneyCrosby8 (big blind) folded before Flop
Seat 2: arsad725 folded before Flop (didn't bet)
Seat 3: stryka62 folded before Flop (didn't bet)
Seat 5: Sabaka777 (button) folded before Flop (didn't bet)
Seat 6: Jake7123 (small blind) collected ($0.04)


PokerStars Hand #238168770232:  Hold'em No Limit ($0.01/$0.02 USD) - 2022/08/23 11:55:57 ET
Table 'Despina IV' 6-max Seat #6 is the button
Seat 1: SidneyCrosby8 ($2.02 in chips)
Seat 2: arsad725 ($2 in chips)
Seat 3: stryka62 ($1.27 in chips)
Seat 5: Sabaka777 ($3.31 in chips)
Seat 6: Jake7123 ($2.08 in chips)
SidneyCrosby8: posts small blind $0.01
arsad725: posts big blind $0.02
*** HOLE CARDS ***
stryka62: raises $0.04 to $0.06
Sabaka777: calls $0.06
Jake7123: calls $0.06
SidneyCrosby8: folds
arsad725: folds
*** FLOP *** [3d 4c Jh]
stryka62: checks
Sabaka777: bets $0.08
Jake7123: calls $0.08
stryka62: calls $0.08
*** TURN *** [3d 4c Jh] [Qd]
stryka62: checks
Sabaka777: bets $0.24
Jake7123: folds
stryka62: calls $0.24
*** RIVER *** [3d 4c Jh Qd] [5c]
stryka62: checks
Sabaka777: checks
*** SHOW DOWN ***
stryka62: shows [6d 9d] (high card Queen)
Sabaka777: shows [Qh 9h] (a pair of Queens)
Sabaka777 collected $0.90 from pot
*** SUMMARY ***
Total pot $0.93 | Rake $0.03
Board [3d 4c Jh Qd 5c]
Seat 1: SidneyCrosby8 (small blind) folded before Flop
Seat 2: arsad725 (big blind) folded before Flop
Seat 3: stryka62 showed [6d 9d] and lost with high card Queen
Seat 5: Sabaka777 showed [Qh 9h] and won ($0.90) with a pair of Queens
Seat 6: Jake7123 (button) folded on the Turn


PokerStars Hand #238168784191:  Hold'em No Limit ($0.01/$0.02 USD) - 2022/08/23 11:56:56 ET
Table 'Despina IV' 6-max Seat #1 is the button
Seat 1: SidneyCrosby8 ($2.01 in chips)
Seat 2: arsad725 ($2 in chips)
Seat 3: stryka62 ($0.89 in chips)
Seat 5: Sabaka777 ($3.83 in chips)
Seat 6: Jake7123 ($1.94 in chips)
arsad725: posts small blind $0.01
stryka62: posts big blind $0.02
*** HOLE CARDS ***
Sabaka777: raises $0.02 to $0.04
Jake7123: calls $0.04
SidneyCrosby8: calls $0.04
arsad725: folds
stryka62: calls $0.02
*** FLOP *** [Kd 9h 3c]
stryka62: checks
Sabaka777: checks
Jake7123: checks
SidneyCrosby8: checks
*** TURN *** [Kd 9h 3c] [Jc]
stryka62: checks
Sabaka777: checks
Jake7123: checks
SidneyCrosby8: checks
*** RIVER *** [Kd 9h 3c Jc] [9d]
stryka62: checks
Sabaka777: checks
Jake7123: checks
SidneyCrosby8: checks
*** SHOW DOWN ***
stryka62: shows [8h 6s] (a pair of Nines)
Sabaka777: mucks hand
Jake7123: shows [Td Ac] (a pair of Nines - Ace kicker)
SidneyCrosby8: shows [5h Ah] (a pair of Nines)
Jake7123 collected $0.08 from pot
SidneyCrosby8 collected $0.08 from pot
*** SUMMARY ***
Total pot $0.17 | Rake $0.01
Board [Kd 9h 3c Jc 9d]
Seat 1: SidneyCrosby8 (button) showed [5h Ah] and won ($0.08) with a pair of Nines
Seat 2: arsad725 (small blind) folded before Flop
Seat 3: stryka62 (big blind) showed [8h 6s] and lost with a pair of Nines
Seat 5: Sabaka777 mucked
Seat 6: Jake7123 showed [Td Ac] and won ($0.08) with a pair of Nines


PokerStars Hand #238168794168:  Hold'em No Limit ($0.01/$0.02 USD) - 2022/08/23 11:57:38 ET
Table 'Despina IV' 6-max Seat #2 is the button
Seat 1: SidneyCrosby8 ($2.05 in chips)
Seat 2: arsad725 ($2 in chips)
Seat 3: stryka62 ($0.85 in chips)
Seat 5: Sabaka777 ($3.79 in chips)
Seat 6: Jake7123 ($1.98 in chips)
stryka62: posts small blind $0.01
Sabaka777: posts big blind $0.02
*** HOLE CARDS ***
Jake7123: folds
SidneyCrosby8: folds
arsad725: folds
stryka62: folds
Uncalled bet ($0.01) returned to Sabaka777
Sabaka777 collected $0.02 from pot
Kasaty was removed from the table for failing to post
Kasaty leaves the table
Sabaka777: doesn't show hand
*** SUMMARY ***
Total pot $0.02 | Rake $0
Seat 1: SidneyCrosby8 folded before Flop (didn't bet)
Seat 2: arsad725 (button) folded before Flop (didn't bet)
Seat 3: stryka62 (small blind) folded before Flop
Seat 5: Sabaka777 (big blind) collected ($0.02)
Seat 6: Jake7123 folded before Flop (didn't bet)


PokerStars Hand #238168796479:  Hold'em No Limit ($0.01/$0.02 USD) - 2022/08/23 11:57:47 ET
Table 'Despina IV' 6-max Seat #3 is the button
Seat 1: SidneyCrosby8 ($2.05 in chips)
Seat 2: arsad725 ($2 in chips)
Seat 3: stryka62 ($0.84 in chips)
Seat 5: Sabaka777 ($3.80 in chips)
Seat 6: Jake7123 ($1.98 in chips)
Sabaka777: posts small blind $0.01
Jake7123: posts big blind $0.02
*** HOLE CARDS ***
SidneyCrosby8: folds
arsad725: raises $0.03 to $0.05
stryka62: folds
Sabaka777: folds
Jake7123: folds
Uncalled bet ($0.03) returned to arsad725
arsad725 collected $0.05 from pot
arsad725: doesn't show hand
*** SUMMARY ***
Total pot $0.05 | Rake $0
Seat 1: SidneyCrosby8 folded before Flop (didn't bet)
Seat 2: arsad725 collected ($0.05)
Seat 3: stryka62 (button) folded before Flop (didn't bet)
Seat 5: Sabaka777 (small blind) folded before Flop
Seat 6: Jake7123 (big blind) folded before Flop


PokerStars Hand #238168800077:  Hold'em No Limit ($0.01/$0.02 USD) - 2022/08/23 11:58:03 ET
Table 'Despina IV' 6-max Seat #5 is the button
Seat 1: SidneyCrosby8 ($2.05 in chips)
Seat 2: arsad725 ($2.03 in chips)
Seat 3: stryka62 ($0.84 in chips)
Seat 5: Sabaka777 ($3.79 in chips)
Seat 6: Jake7123 ($1.96 in chips)
Jake7123: posts small blind $0.01
SidneyCrosby8: posts big blind $0.02
*** HOLE CARDS ***
arsad725: folds
stryka62: folds
Sabaka777: folds
Jake7123: raises $0.02 to $0.04
SidneyCrosby8: folds
Uncalled bet ($0.02) returned to Jake7123
Jake7123 collected $0.04 from pot
Jake7123: doesn't show hand
*** SUMMARY ***
Total pot $0.04 | Rake $0
Seat 1: SidneyCrosby8 (big blind) folded before Flop
Seat 2: arsad725 folded before Flop (didn't bet)
Seat 3: stryka62 folded before Flop (didn't bet)
Seat 5: Sabaka777 (button) folded before Flop (didn't bet)
Seat 6: Jake7123 (small blind) collected ($0.04)


PokerStars Hand #238168803152:  Hold'em No Limit ($0.01/$0.02 USD) - 2022/08/23 11:58:15 ET
Table 'Despina IV' 6-max Seat #6 is the button
Seat 1: SidneyCrosby8 ($2.03 in chips)
Seat 2: arsad725 ($2.03 in chips)
Seat 3: stryka62 ($0.84 in chips)
Seat 5: Sabaka777 ($3.79 in chips)
Seat 6: Jake7123 ($1.98 in chips)
SidneyCrosby8: posts small blind $0.01
arsad725: posts big blind $0.02
*** HOLE CARDS ***
stryka62: folds
Sabaka777: folds
Jake7123: raises $0.02 to $0.04
SidneyCrosby8: folds
arsad725: folds
Uncalled bet ($0.02) returned to Jake7123
Jake7123 collected $0.05 from pot
Jake7123: doesn't show hand
*** SUMMARY ***
Total pot $0.05 | Rake $0
Seat 1: SidneyCrosby8 (small blind) folded before Flop
Seat 2: arsad725 (big blind) folded before Flop
Seat 3: stryka62 folded before Flop (didn't bet)
Seat 5: Sabaka777 folded before Flop (didn't bet)
Seat 6: Jake7123 (button) collected ($0.05)


PokerStars Hand #238168806031:  Hold'em No Limit ($0.01/$0.02 USD) - 2022/08/23 11:58:27 ET
Table 'Despina IV' 6-max Seat #1 is the button
Seat 1: SidneyCrosby8 ($2.02 in chips)
Seat 2: arsad725 ($2.01 in chips)
Seat 3: stryka62 ($0.84 in chips)
Seat 5: Sabaka777 ($3.79 in chips)
Seat 6: Jake7123 ($2.01 in chips)
arsad725: posts small blind $0.01
stryka62: posts big blind $0.02
*** HOLE CARDS ***
Sabaka777: folds
Jake7123: folds
SidneyCrosby8: raises $0.04 to $0.06
arsad725: folds
stryka62: raises $0.04 to $0.10
SidneyCrosby8: calls $0.04
*** FLOP *** [Ad Jd 8c]
sexmit joins the table at seat #4
stryka62: bets $0.10
SidneyCrosby8: calls $0.10
*** TURN *** [Ad Jd 8c] [5h]
stryka62: bets $0.40
SidneyCrosby8: raises $0.40 to $0.80
stryka62: calls $0.24 and is all-in
Uncalled bet ($0.16) returned to SidneyCrosby8
*** RIVER *** [Ad Jd 8c 5h] [2d]
*** SHOW DOWN ***
stryka62: shows [5s 2h] (two pair, Fives and Deuces)
SidneyCrosby8: shows [Ah 5d] (two pair, Aces and Fives)
SidneyCrosby8 collected $1.63 from pot
*** SUMMARY ***
Total pot $1.69 | Rake $0.06
Board [Ad Jd 8c 5h 2d]
Seat 1: SidneyCrosby8 (button) showed [Ah 5d] and won ($1.63) with two pair, Aces and Fives
Seat 2: arsad725 (small blind) folded before Flop
Seat 3: stryka62 (big blind) showed [5s 2h] and lost with two pair, Fives and Deuces
Seat 5: Sabaka777 folded before Flop (didn't bet)
Seat 6: Jake7123 folded before Flop (didn't bet)


PokerStars Hand #238168815078:  Hold'em No Limit ($0.01/$0.02 USD) - 2022/08/23 11:59:06 ET
Table 'Despina IV' 6-max Seat #2 is the button
Seat 1: SidneyCrosby8 ($2.81 in chips)
Seat 2: arsad725 ($2 in chips)
Seat 5: Sabaka777 ($3.79 in chips)
Seat 6: Jake7123 ($2.01 in chips)
Sabaka777: posts small blind $0.01
Jake7123: posts big blind $0.02
*** HOLE CARDS ***
stryka62 leaves the table
SidneyCrosby8: folds
arsad725: folds
Sabaka777: raises $0.04 to $0.06
Jake7123: folds
Uncalled bet ($0.04) returned to Sabaka777
Sabaka777 collected $0.04 from pot
Sabaka777: doesn't show hand
*** SUMMARY ***
Total pot $0.04 | Rake $0
Seat 1: SidneyCrosby8 folded before Flop (didn't bet)
Seat 2: arsad725 (button) folded before Flop (didn't bet)
Seat 5: Sabaka777 (small blind) collected ($0.04)
Seat 6: Jake7123 (big blind) folded before Flop


PokerStars Hand #238168820446:  Hold'em No Limit ($0.01/$0.02 USD) - 2022/08/23 11:59:28 ET
Table 'Despina IV' 6-max Seat #5 is the button
Seat 2: arsad725 ($2 in chips)
Seat 5: Sabaka777 ($3.81 in chips)
Seat 6: Jake7123 ($1.99 in chips)
Jake7123: posts small blind $0.01
arsad725: posts big blind $0.02
sexmit: sits out
*** HOLE CARDS ***
Sabaka777: raises $0.04 to $0.06
Jake7123: folds
arsad725: folds
Uncalled bet ($0.04) returned to Sabaka777
Sabaka777 collected $0.05 from pot
Sabaka777: doesn't show hand
*** SUMMARY ***
Total pot $0.05 | Rake $0
Seat 2: arsad725 (big blind) folded before Flop
Seat 5: Sabaka777 (button) collected ($0.05)
Seat 6: Jake7123 (small blind) folded before Flop


PokerStars Hand #238168822683:  Hold'em No Limit ($0.01/$0.02 USD) - 2022/08/23 11:59:38 ET
Table 'Despina IV' 6-max Seat #6 is the button
Seat 2: arsad725 ($2 in chips)
Seat 4: sexmit ($1 in chips)
Seat 5: Sabaka777 ($3.84 in chips)
Seat 6: Jake7123 ($1.98 in chips)
arsad725: posts small blind $0.01
sexmit: posts big blind $0.02
*** HOLE CARDS ***
Sabaka777: folds
Jake7123: folds
arsad725: folds
Uncalled bet ($0.01) returned to sexmit
sexmit collected $0.02 from pot
*** SUMMARY ***
Total pot $0.02 | Rake $0
Seat 2: arsad725 (small blind) folded before Flop
Seat 4: sexmit (big blind) collected ($0.02)
Seat 5: Sabaka777 folded before Flop (didn't bet)
Seat 6: Jake7123 (button) folded before Flop (didn't bet)


PokerStars Hand #238168825587:  Hold'em No Limit ($0.01/$0.02 USD) - 2022/08/23 11:59:50 ET
Table 'Despina IV' 6-max Seat #2 is the button
Seat 2: arsad725 ($2 in chips)
Seat 4: sexmit ($1.01 in chips)
Seat 5: Sabaka777 ($3.84 in chips)
Seat 6: Jake7123 ($1.98 in chips)
sexmit: posts small blind $0.01
Sabaka777: posts big blind $0.02
*** HOLE CARDS ***
Jake7123: folds
arsad725: folds
sexmit: calls $0.01
vezelvu1 joins the table at seat #3
Sabaka777: checks
*** FLOP *** [5d Jh 4d]
sexmit: checks
Sabaka777: checks
*** TURN *** [5d Jh 4d] [Js]
sexmit: bets $0.03
Sabaka777: folds
Uncalled bet ($0.03) returned to sexmit
sexmit collected $0.04 from pot
*** SUMMARY ***
Total pot $0.04 | Rake $0
Board [5d Jh 4d Js]
Seat 2: arsad725 (button) folded before Flop (didn't bet)
Seat 4: sexmit (small blind) collected ($0.04)
Seat 5: Sabaka777 (big blind) folded on the Turn
Seat 6: Jake7123 folded before Flop (didn't bet)


PokerStars Hand #238168835231:  Hold'em No Limit ($0.01/$0.02 USD) - 2022/08/23 12:00:30 ET
Table 'Despina IV' 6-max Seat #4 is the button
Seat 2: arsad725 ($2 in chips)
Seat 4: sexmit ($1.03 in chips)
Seat 5: Sabaka777 ($3.82 in chips)
Seat 6: Jake7123 ($1.98 in chips)
Sabaka777: posts small blind $0.01
Jake7123: posts big blind $0.02
vezelvu1: sits out
*** HOLE CARDS ***
arsad725: folds
sexmit: folds
Sabaka777: raises $0.04 to $0.06
Jake7123: calls $0.04
*** FLOP *** [9h 2h 9c]
Sabaka777: checks
Jake7123: checks
*** TURN *** [9h 2h 9c] [7c]
Sabaka777: checks
Jake7123: bets $0.12
Sabaka777: folds
Uncalled bet ($0.12) returned to Jake7123
Jake7123 collected $0.12 from pot
Jake7123: doesn't show hand
*** SUMMARY ***
Total pot $0.12 | Rake $0
Board [9h 2h 9c 7c]
Seat 2: arsad725 folded before Flop (didn't bet)
Seat 4: sexmit (button) folded before Flop (didn't bet)
Seat 5: Sabaka777 (small blind) folded on the Turn
Seat 6: Jake7123 (big blind) collected ($0.12)


PokerStars Hand #238168847681:  Hold'em No Limit ($0.01/$0.02 USD) - 2022/08/23 12:01:18 ET
Table 'Despina IV' 6-max Seat #5 is the button
Seat 1: SidneyCrosby8 ($2.81 in chips)
Seat 2: arsad725 ($2 in chips)
Seat 4: sexmit ($1.03 in chips)
Seat 5: Sabaka777 ($3.76 in chips)
Seat 6: Jake7123 ($2.04 in chips)
Jake7123: posts small blind $0.01
SidneyCrosby8: posts big blind $0.02
vezelvu1: sits out
*** HOLE CARDS ***
arsad725: folds
sexmit: raises $0.02 to $0.04
Sabaka777: folds
Jake7123: folds
SidneyCrosby8: folds
Uncalled bet ($0.02) returned to sexmit
sexmit collected $0.05 from pot
*** SUMMARY ***
Total pot $0.05 | Rake $0
Seat 1: SidneyCrosby8 (big blind) folded before Flop
Seat 2: arsad725 folded before Flop (didn't bet)
Seat 4: sexmit collected ($0.05)
Seat 5: Sabaka777 (button) folded before Flop (didn't bet)
Seat 6: Jake7123 (small blind) folded before Flop


PokerStars Hand #238168854358:  Hold'em No Limit ($0.01/$0.02 USD) - 2022/08/23 12:01:41 ET
Table 'Despina IV' 6-max Seat #6 is the button
Seat 1: SidneyCrosby8 ($2.79 in chips)
Seat 2: arsad725 ($2 in chips)
Seat 4: sexmit ($1.06 in chips)
Seat 5: Sabaka777 ($3.76 in chips)
Seat 6: Jake7123 ($2.03 in chips)
SidneyCrosby8: posts small blind $0.01
arsad725: posts big blind $0.02
vezelvu1: sits out
*** HOLE CARDS ***
sexmit: folds
Sabaka777: folds
Jake7123: folds
SidneyCrosby8: folds
Uncalled bet ($0.01) returned to arsad725
arsad725 collected $0.02 from pot
arsad725: doesn't show hand
*** SUMMARY ***
Total pot $0.02 | Rake $0
Seat 1: SidneyCrosby8 (small blind) folded before Flop
Seat 2: arsad725 (big blind) collected ($0.02)
Seat 4: sexmit folded before Flop (didn't bet)
Seat 5: Sabaka777 folded before Flop (didn't bet)
Seat 6: Jake7123 (button) folded before Flop (didn't bet)


PokerStars Hand #238168859302:  Hold'em No Limit ($0.01/$0.02 USD) - 2022/08/23 12:01:57 ET
Table 'Despina IV' 6-max Seat #1 is the button
Seat 1: SidneyCrosby8 ($2.78 in chips)
Seat 2: arsad725 ($2.01 in chips)
Seat 3: vezelvu1 ($1.60 in chips)
Seat 4: sexmit ($1.06 in chips)
Seat 5: Sabaka777 ($3.76 in chips)
Seat 6: Jake7123 ($2.03 in chips)
arsad725: posts small blind $0.01
vezelvu1: posts big blind $0.02
*** HOLE CARDS ***
sexmit: raises $0.02 to $0.04
Sabaka777: folds
Jake7123: folds
SidneyCrosby8: folds
arsad725: folds
vezelvu1: folds
Uncalled bet ($0.02) returned to sexmit
sexmit collected $0.05 from pot
*** SUMMARY ***
Total pot $0.05 | Rake $0
Seat 1: SidneyCrosby8 (button) folded before Flop (didn't bet)
Seat 2: arsad725 (small blind) folded before Flop
Seat 3: vezelvu1 (big blind) folded before Flop
Seat 4: sexmit collected ($0.05)
Seat 5: Sabaka777 folded before Flop (didn't bet)
Seat 6: Jake7123 folded before Flop (didn't bet)


PokerStars Hand #238168864899:  Hold'em No Limit ($0.01/$0.02 USD) - 2022/08/23 12:02:17 ET
Table 'Despina IV' 6-max Seat #2 is the button
Seat 1: SidneyCrosby8 ($2.78 in chips)
Seat 2: arsad725 ($2 in chips)
Seat 3: vezelvu1 ($1.58 in chips)
Seat 4: sexmit ($1.09 in chips)
Seat 5: Sabaka777 ($3.76 in chips)
Seat 6: Jake7123 ($2.03 in chips)
vezelvu1: posts small blind $0.01
sexmit: posts big blind $0.02
*** HOLE CARDS ***
Sabaka777: folds
Jake7123: folds
SidneyCrosby8: folds
arsad725: folds
vezelvu1: folds
Uncalled bet ($0.01) returned to sexmit
sexmit collected $0.02 from pot
*** SUMMARY ***
Total pot $0.02 | Rake $0
Seat 1: SidneyCrosby8 folded before Flop (didn't bet)
Seat 2: arsad725 (button) folded before Flop (didn't bet)
Seat 3: vezelvu1 (small blind) folded before Flop
Seat 4: sexmit (big blind) collected ($0.02)
Seat 5: Sabaka777 folded before Flop (didn't bet)
Seat 6: Jake7123 folded before Flop (didn't bet)


PokerStars Hand #238168867884:  Hold'em No Limit ($0.01/$0.02 USD) - 2022/08/23 12:02:28 ET
Table 'Despina IV' 6-max Seat #3 is the button
Seat 1: SidneyCrosby8 ($2.78 in chips)
Seat 2: arsad725 ($2 in chips)
Seat 3: vezelvu1 ($1.57 in chips)
Seat 4: sexmit ($1.10 in chips)
Seat 5: Sabaka777 ($3.76 in chips)
Seat 6: Jake7123 ($2.03 in chips)
sexmit: posts small blind $0.01
Sabaka777: posts big blind $0.02
*** HOLE CARDS ***
Jake7123: folds
SidneyCrosby8: folds
arsad725: folds
vezelvu1: folds
sexmit: calls $0.01
Sabaka777: checks
*** FLOP *** [3s 5d Th]
sexmit: checks
Sabaka777: checks
*** TURN *** [3s 5d Th] [2s]
sexmit: bets $0.03
Sabaka777: raises $0.03 to $0.06
sexmit: calls $0.03
*** RIVER *** [3s 5d Th 2s] [8s]
sexmit: checks
Sabaka777: checks
*** SHOW DOWN ***
sexmit: shows [Jd 4h] (high card Jack)
Sabaka777: shows [7c Td] (a pair of Tens)
Sabaka777 collected $0.15 from pot
*** SUMMARY ***
Total pot $0.16 | Rake $0.01
Board [3s 5d Th 2s 8s]
Seat 1: SidneyCrosby8 folded before Flop (didn't bet)
Seat 2: arsad725 folded before Flop (didn't bet)
Seat 3: vezelvu1 (button) folded before Flop (didn't bet)
Seat 4: sexmit (small blind) showed [Jd 4h] and lost with high card Jack
Seat 5: Sabaka777 (big blind) showed [7c Td] and won ($0.15) with a pair of Tens
Seat 6: Jake7123 folded before Flop (didn't bet)


PokerStars Hand #238168881627:  Hold'em No Limit ($0.01/$0.02 USD) - 2022/08/23 12:03:14 ET
Table 'Despina IV' 6-max Seat #4 is the button
Seat 1: SidneyCrosby8 ($2.78 in chips)
Seat 2: arsad725 ($2 in chips)
Seat 3: vezelvu1 ($1.57 in chips)
Seat 4: sexmit ($1.02 in chips)
Seat 5: Sabaka777 ($3.83 in chips)
Seat 6: Jake7123 ($2.03 in chips)
Sabaka777: posts small blind $0.01
Jake7123: posts big blind $0.02
*** HOLE CARDS ***
SidneyCrosby8: folds
arsad725: folds
vezelvu1: folds
sexmit: raises $0.02 to $0.04
Sabaka777: folds
Jake7123: calls $0.02
*** FLOP *** [5d 5c 3h]
Jake7123: bets $0.06
sexmit: calls $0.06
*** TURN *** [5d 5c 3h] [3c]
Jake7123: checks
sexmit: bets $0.13
Jake7123: calls $0.13
*** RIVER *** [5d 5c 3h 3c] [9d]
Jake7123: checks
sexmit: bets $0.30
Jake7123: folds
Uncalled bet ($0.30) returned to sexmit
sexmit collected $0.45 from pot
*** SUMMARY ***
Total pot $0.47 | Rake $0.02
Board [5d 5c 3h 3c 9d]
Seat 1: SidneyCrosby8 folded before Flop (didn't bet)
Seat 2: arsad725 folded before Flop (didn't bet)
Seat 3: vezelvu1 folded before Flop (didn't bet)
Seat 4: sexmit (button) collected ($0.45)
Seat 5: Sabaka777 (small blind) folded before Flop
Seat 6: Jake7123 (big blind) folded on the River


PokerStars Hand #238168898580:  Hold'em No Limit ($0.01/$0.02 USD) - 2022/08/23 12:04:12 ET
Table 'Despina IV' 6-max Seat #5 is the button
Seat 1: SidneyCrosby8 ($2.78 in chips)
Seat 2: arsad725 ($2 in chips)
Seat 3: vezelvu1 ($1.57 in chips)
Seat 4: sexmit ($1.24 in chips)
Seat 5: Sabaka777 ($3.82 in chips)
Seat 6: Jake7123 ($1.80 in chips)
Jake7123: posts small blind $0.01
SidneyCrosby8: posts big blind $0.02
*** HOLE CARDS ***
arsad725: folds
vezelvu1: raises $0.02 to $0.04
sexmit: folds
Sabaka777: folds
Jake7123: folds
SidneyCrosby8: calls $0.02
*** FLOP *** [5h 3c Kd]
SidneyCrosby8: checks
vezelvu1: checks
*** TURN *** [5h 3c Kd] [4s]
SidneyCrosby8: bets $0.09
vezelvu1: folds
Uncalled bet ($0.09) returned to SidneyCrosby8
SidneyCrosby8 collected $0.09 from pot
SidneyCrosby8: doesn't show hand
*** SUMMARY ***
Total pot $0.09 | Rake $0
Board [5h 3c Kd 4s]
Seat 1: SidneyCrosby8 (big blind) collected ($0.09)
Seat 2: arsad725 folded before Flop (didn't bet)
Seat 3: vezelvu1 folded on the Turn
Seat 4: sexmit folded before Flop (didn't bet)
Seat 5: Sabaka777 (button) folded before Flop (didn't bet)
Seat 6: Jake7123 (small blind) folded before Flop


PokerStars Hand #238168909067:  Hold'em No Limit ($0.01/$0.02 USD) - 2022/08/23 12:04:48 ET
Table 'Despina IV' 6-max Seat #6 is the button
Seat 1: SidneyCrosby8 ($2.83 in chips)
Seat 3: vezelvu1 ($1.53 in chips)
Seat 4: sexmit ($1.24 in chips)
Seat 5: Sabaka777 ($3.82 in chips)
Seat 6: Jake7123 ($1.99 in chips)
SidneyCrosby8: posts small blind $0.01
vezelvu1: posts big blind $0.02
*** HOLE CARDS ***
sexmit: folds
Sabaka777: folds
Jake7123: folds
SidneyCrosby8: folds
Uncalled bet ($0.01) returned to vezelvu1
vezelvu1 collected $0.02 from pot
*** SUMMARY ***
Total pot $0.02 | Rake $0
Seat 1: SidneyCrosby8 (small blind) folded before Flop
Seat 3: vezelvu1 (big blind) collected ($0.02)
Seat 4: sexmit folded before Flop (didn't bet)
Seat 5: Sabaka777 folded before Flop (didn't bet)
Seat 6: Jake7123 (button) folded before Flop (didn't bet)


PokerStars Hand #238168913076:  Hold'em No Limit ($0.01/$0.02 USD) - 2022/08/23 12:05:02 ET
Table 'Despina IV' 6-max Seat #1 is the button
Seat 1: SidneyCrosby8 ($2.82 in chips)
Seat 3: vezelvu1 ($1.54 in chips)
Seat 4: sexmit ($1.24 in chips)
Seat 5: Sabaka777 ($3.82 in chips)
Seat 6: Jake7123 ($1.99 in chips)
vezelvu1: posts small blind $0.01
sexmit: posts big blind $0.02
*** HOLE CARDS ***
Sabaka777: raises $0.02 to $0.04
Jake7123: folds
SidneyCrosby8: folds
vezelvu1: calls $0.03
sexmit: folds
*** FLOP *** [3c 7s Ad]
vezelvu1: checks
Sabaka777: bets $0.04
vezelvu1: calls $0.04
*** TURN *** [3c 7s Ad] [Ac]
vezelvu1: checks
Sabaka777: checks
*** RIVER *** [3c 7s Ad Ac] [4s]
vezelvu1: bets $0.04
Sabaka777: folds
Uncalled bet ($0.04) returned to vezelvu1
vezelvu1 collected $0.17 from pot
*** SUMMARY ***
Total pot $0.18 | Rake $0.01
Board [3c 7s Ad Ac 4s]
Seat 1: SidneyCrosby8 (button) folded before Flop (didn't bet)
Seat 3: vezelvu1 (small blind) collected ($0.17)
Seat 4: sexmit (big blind) folded before Flop
Seat 5: Sabaka777 folded on the River
Seat 6: Jake7123 folded before Flop (didn't bet)


PokerStars Hand #238168924011:  Hold'em No Limit ($0.01/$0.02 USD) - 2022/08/23 12:05:38 ET
Table 'Despina IV' 6-max Seat #3 is the button
Seat 1: SidneyCrosby8 ($2.82 in chips)
Seat 3: vezelvu1 ($1.63 in chips)
Seat 4: sexmit ($1.22 in chips)
Seat 6: Jake7123 ($1.99 in chips)
sexmit: posts small blind $0.01
Sabaka777: is sitting out
Jake7123: posts big blind $0.02
*** HOLE CARDS ***
SidneyCrosby8: raises $0.04 to $0.06
Sabaka777 leaves the table
vezelvu1: folds
sexmit: folds
Jake7123: folds
Uncalled bet ($0.04) returned to SidneyCrosby8
SidneyCrosby8 collected $0.05 from pot
SidneyCrosby8: doesn't show hand
*** SUMMARY ***
Total pot $0.05 | Rake $0
Seat 1: SidneyCrosby8 collected ($0.05)
Seat 3: vezelvu1 (button) folded before Flop (didn't bet)
Seat 4: sexmit (small blind) folded before Flop
Seat 6: Jake7123 (big blind) folded before Flop


PokerStars Hand #238168927370:  Hold'em No Limit ($0.01/$0.02 USD) - 2022/08/23 12:05:50 ET
Table 'Despina IV' 6-max Seat #4 is the button
Seat 1: SidneyCrosby8 ($2.85 in chips)
Seat 3: vezelvu1 ($1.63 in chips)
Seat 4: sexmit ($1.21 in chips)
Seat 6: Jake7123 ($1.97 in chips)
Jake7123: posts small blind $0.01
SidneyCrosby8: posts big blind $0.02
*** HOLE CARDS ***
vezelvu1: folds
sexmit: folds
Jake7123: folds
Uncalled bet ($0.01) returned to SidneyCrosby8
SidneyCrosby8 collected $0.02 from pot
SidneyCrosby8: doesn't show hand
*** SUMMARY ***
Total pot $0.02 | Rake $0
Seat 1: SidneyCrosby8 (big blind) collected ($0.02)
Seat 3: vezelvu1 folded before Flop (didn't bet)
Seat 4: sexmit (button) folded before Flop (didn't bet)
Seat 6: Jake7123 (small blind) folded before Flop


PokerStars Hand #238168932733:  Hold'em No Limit ($0.01/$0.02 USD) - 2022/08/23 12:06:08 ET
Table 'Despina IV' 6-max Seat #6 is the button
Seat 1: SidneyCrosby8 ($2.86 in chips)
Seat 3: vezelvu1 ($1.63 in chips)
Seat 4: sexmit ($1.21 in chips)
Seat 6: Jake7123 ($1.96 in chips)
SidneyCrosby8: posts small blind $0.01
vezelvu1: posts big blind $0.02
*** HOLE CARDS ***
Jh0nTravolta joins the table at seat #5
sexmit: folds
Jake7123: folds
SidneyCrosby8: folds
Uncalled bet ($0.01) returned to vezelvu1
vezelvu1 collected $0.02 from pot
*** SUMMARY ***
Total pot $0.02 | Rake $0
Seat 1: SidneyCrosby8 (small blind) folded before Flop
Seat 3: vezelvu1 (big blind) collected ($0.02)
Seat 4: sexmit folded before Flop (didn't bet)
Seat 6: Jake7123 (button) folded before Flop (didn't bet)


PokerStars Hand #238168935260:  Hold'em No Limit ($0.01/$0.02 USD) - 2022/08/23 12:06:16 ET
Table 'Despina IV' 6-max Seat #1 is the button
Seat 1: SidneyCrosby8 ($2.85 in chips)
Seat 3: vezelvu1 ($1.64 in chips)
Seat 4: sexmit ($1.21 in chips)
Seat 6: Jake7123 ($1.96 in chips)
vezelvu1: posts small blind $0.01
sexmit: posts big blind $0.02
Jh0nTravolta: sits out
*** HOLE CARDS ***
Jake7123: folds
SidneyCrosby8: folds
vezelvu1: folds
Uncalled bet ($0.01) returned to sexmit
sexmit collected $0.02 from pot
*** SUMMARY ***
Total pot $0.02 | Rake $0
Seat 1: SidneyCrosby8 (button) folded before Flop (didn't bet)
Seat 3: vezelvu1 (small blind) folded before Flop
Seat 4: sexmit (big blind) collected ($0.02)
Seat 6: Jake7123 folded before Flop (didn't bet)


PokerStars Hand #238168937828:  Hold'em No Limit ($0.01/$0.02 USD) - 2022/08/23 12:06:25 ET
Table 'Despina IV' 6-max Seat #3 is the button
Seat 1: SidneyCrosby8 ($2.85 in chips)
Seat 3: vezelvu1 ($1.63 in chips)
Seat 4: sexmit ($1.22 in chips)
Seat 5: Jh0nTravolta ($2 in chips)
Seat 6: Jake7123 ($1.96 in chips)
sexmit: posts small blind $0.01
Jh0nTravolta: posts big blind $0.02
*** HOLE CARDS ***
Jake7123: folds
SidneyCrosby8: folds
vezelvu1: folds
sexmit: raises $0.05 to $0.07
Jh0nTravolta has timed out
Jh0nTravolta: folds
Uncalled bet ($0.05) returned to sexmit
sexmit collected $0.04 from pot
*** SUMMARY ***
Total pot $0.04 | Rake $0
Seat 1: SidneyCrosby8 folded before Flop (didn't bet)
Seat 3: vezelvu1 (button) folded before Flop (didn't bet)
Seat 4: sexmit (small blind) collected ($0.04)
Seat 5: Jh0nTravolta (big blind) folded before Flop
Seat 6: Jake7123 folded before Flop (didn't bet)


PokerStars Hand #238168952661:  Hold'em No Limit ($0.01/$0.02 USD) - 2022/08/23 12:07:16 ET
Table 'Despina IV' 6-max Seat #4 is the button
Seat 1: SidneyCrosby8 ($2.85 in chips)
Seat 3: vezelvu1 ($1.63 in chips)
Seat 4: sexmit ($1.24 in chips)
Seat 5: Jh0nTravolta ($2 in chips)
Seat 6: Jake7123 ($1.96 in chips)
Jh0nTravolta: posts small blind $0.01
Jake7123: posts big blind $0.02
*** HOLE CARDS ***
SidneyCrosby8: folds
vezelvu1: folds
sexmit: folds
Jh0nTravolta: raises $0.04 to $0.06
Jake7123: calls $0.04
*** FLOP *** [9h 5c 5s]
Jh0nTravolta: bets $0.04
Jake7123: folds
Uncalled bet ($0.04) returned to Jh0nTravolta
Jh0nTravolta collected $0.12 from pot
Jh0nTravolta: doesn't show hand
*** SUMMARY ***
Total pot $0.12 | Rake $0
Board [9h 5c 5s]
Seat 1: SidneyCrosby8 folded before Flop (didn't bet)
Seat 3: vezelvu1 folded before Flop (didn't bet)
Seat 4: sexmit (button) folded before Flop (didn't bet)
Seat 5: Jh0nTravolta (small blind) collected ($0.12)
Seat 6: Jake7123 (big blind) folded on the Flop


PokerStars Hand #238168963756:  Hold'em No Limit ($0.01/$0.02 USD) - 2022/08/23 12:07:53 ET
Table 'Despina IV' 6-max Seat #5 is the button
Seat 1: SidneyCrosby8 ($2.85 in chips)
Seat 3: vezelvu1 ($1.63 in chips)
Seat 4: sexmit ($1.24 in chips)
Seat 5: Jh0nTravolta ($2.06 in chips)
Seat 6: Jake7123 ($1.90 in chips)
Jake7123: posts small blind $0.01
SidneyCrosby8: posts big blind $0.02
*** HOLE CARDS ***
vezelvu1: folds
sexmit: folds
Jh0nTravolta: folds
Jake7123: raises $0.02 to $0.04
SidneyCrosby8: folds
Uncalled bet ($0.02) returned to Jake7123
Jake7123 collected $0.04 from pot
Jake7123: doesn't show hand
*** SUMMARY ***
Total pot $0.04 | Rake $0
Seat 1: SidneyCrosby8 (big blind) folded before Flop
Seat 3: vezelvu1 folded before Flop (didn't bet)
Seat 4: sexmit folded before Flop (didn't bet)
Seat 5: Jh0nTravolta (button) folded before Flop (didn't bet)
Seat 6: Jake7123 (small blind) collected ($0.04)


PokerStars Hand #238168967801:  Hold'em No Limit ($0.01/$0.02 USD) - 2022/08/23 12:08:07 ET
Table 'Despina IV' 6-max Seat #6 is the button
Seat 1: SidneyCrosby8 ($2.83 in chips)
Seat 3: vezelvu1 ($1.63 in chips)
Seat 4: sexmit ($1.24 in chips)
Seat 5: Jh0nTravolta ($2.06 in chips)
Seat 6: Jake7123 ($1.92 in chips)
SidneyCrosby8: posts small blind $0.01
vezelvu1: posts big blind $0.02
*** HOLE CARDS ***
sexmit: folds
Jh0nTravolta: folds
Jake7123: raises $0.02 to $0.04
SidneyCrosby8: folds
vezelvu1: calls $0.02
*** FLOP *** [Kd 9d 4s]
vezelvu1: checks
Jake7123: bets $0.04
vezelvu1: folds
Uncalled bet ($0.04) returned to Jake7123
Jake7123 collected $0.09 from pot
Jake7123: doesn't show hand
*** SUMMARY ***
Total pot $0.09 | Rake $0
Board [Kd 9d 4s]
Seat 1: SidneyCrosby8 (small blind) folded before Flop
Seat 3: vezelvu1 (big blind) folded on the Flop
Seat 4: sexmit folded before Flop (didn't bet)
Seat 5: Jh0nTravolta folded before Flop (didn't bet)
Seat 6: Jake7123 (button) collected ($0.09)


PokerStars Hand #238168974636:  Hold'em No Limit ($0.01/$0.02 USD) - 2022/08/23 12:08:30 ET
Table 'Despina IV' 6-max Seat #1 is the button
Seat 1: SidneyCrosby8 ($2.82 in chips)
Seat 3: vezelvu1 ($1.59 in chips)
Seat 4: sexmit ($1.24 in chips)
Seat 5: Jh0nTravolta ($2.06 in chips)
Seat 6: Jake7123 ($1.97 in chips)
vezelvu1: posts small blind $0.01
sexmit: posts big blind $0.02
*** HOLE CARDS ***
Jh0nTravolta: raises $0.03 to $0.05
Jake7123: folds
SidneyCrosby8: folds
vezelvu1: folds
sexmit: calls $0.03
*** FLOP *** [3h 6d Jd]
sexmit: checks
Jh0nTravolta: bets $0.04
sexmit: raises $0.08 to $0.12
Jh0nTravolta: folds
Uncalled bet ($0.08) returned to sexmit
sexmit collected $0.18 from pot
*** SUMMARY ***
Total pot $0.19 | Rake $0.01
Board [3h 6d Jd]
Seat 1: SidneyCrosby8 (button) folded before Flop (didn't bet)
Seat 3: vezelvu1 (small blind) folded before Flop
Seat 4: sexmit (big blind) collected ($0.18)
Seat 5: Jh0nTravolta folded on the Flop
Seat 6: Jake7123 folded before Flop (didn't bet)


PokerStars Hand #238168985954:  Hold'em No Limit ($0.01/$0.02 USD) - 2022/08/23 12:09:08 ET
Table 'Despina IV' 6-max Seat #3 is the button
Seat 1: SidneyCrosby8 ($2.82 in chips)
Seat 3: vezelvu1 ($1.58 in chips)
Seat 4: sexmit ($1.33 in chips)
Seat 5: Jh0nTravolta ($2 in chips)
Seat 6: Jake7123 ($1.97 in chips)
sexmit: posts small blind $0.01
Jh0nTravolta: posts big blind $0.02
arsad725: sits out
*** HOLE CARDS ***
Jake7123: folds
SidneyCrosby8: folds
vezelvu1: raises $0.04 to $0.06
sexmit: folds
Jh0nTravolta: folds
Uncalled bet ($0.04) returned to vezelvu1
vezelvu1 collected $0.05 from pot
*** SUMMARY ***
Total pot $0.05 | Rake $0
Seat 1: SidneyCrosby8 folded before Flop (didn't bet)
Seat 3: vezelvu1 (button) collected ($0.05)
Seat 4: sexmit (small blind) folded before Flop
Seat 5: Jh0nTravolta (big blind) folded before Flop
Seat 6: Jake7123 folded before Flop (didn't bet)


PokerStars Hand #238168991023:  Hold'em No Limit ($0.01/$0.02 USD) - 2022/08/23 12:09:26 ET
Table 'Despina IV' 6-max Seat #4 is the button
Seat 1: SidneyCrosby8 ($2.82 in chips)
Seat 3: vezelvu1 ($1.61 in chips)
Seat 4: sexmit ($1.32 in chips)
Seat 5: Jh0nTravolta ($2 in chips)
Seat 6: Jake7123 ($1.97 in chips)
Jh0nTravolta: posts small blind $0.01
Jake7123: posts big blind $0.02
arsad725: sits out
*** HOLE CARDS ***
SidneyCrosby8: folds
vezelvu1: folds
SidneyCrosby8 leaves the table
sexmit: folds
hideo64 joins the table at seat #1
Jh0nTravolta: raises $0.04 to $0.06
Jake7123: calls $0.04
*** FLOP *** [8s 3d 4c]
Jh0nTravolta: bets $0.04
Jake7123: calls $0.04
*** TURN *** [8s 3d 4c] [2s]
Jh0nTravolta: checks
Jake7123: checks
*** RIVER *** [8s 3d 4c 2s] [5d]
Jh0nTravolta: checks
Jake7123: bets $0.09
Jh0nTravolta: calls $0.09
*** SHOW DOWN ***
Jake7123: shows [Qd Kd] (high card King)
Jh0nTravolta: shows [Qh Ks] (high card King)
Jh0nTravolta collected $0.19 from pot
Jake7123 collected $0.18 from pot
*** SUMMARY ***
Total pot $0.38 | Rake $0.01
Board [8s 3d 4c 2s 5d]
Seat 1: SidneyCrosby8 folded before Flop (didn't bet)
Seat 3: vezelvu1 folded before Flop (didn't bet)
Seat 4: sexmit (button) folded before Flop (didn't bet)
Seat 5: Jh0nTravolta (small blind) showed [Qh Ks] and won ($0.19) with high card King
Seat 6: Jake7123 (big blind) showed [Qd Kd] and won ($0.18) with high card King


PokerStars Hand #238169010317:  Hold'em No Limit ($0.01/$0.02 USD) - 2022/08/23 12:10:31 ET
Table 'Despina IV' 6-max Seat #5 is the button
Seat 1: hideo64 ($2 in chips)
Seat 3: vezelvu1 ($1.61 in chips)
Seat 4: sexmit ($1.32 in chips)
Seat 5: Jh0nTravolta ($2 in chips)
Seat 6: Jake7123 ($1.96 in chips)
Jake7123: posts small blind $0.01
hideo64: posts big blind $0.02
arsad725: sits out
*** HOLE CARDS ***
vezelvu1: folds
sexmit: folds
Jh0nTravolta: raises $0.03 to $0.05
Jake7123: folds
hideo64: calls $0.03
*** FLOP *** [6h Kd 4d]
hideo64: checks
Jh0nTravolta: bets $0.04
hideo64: calls $0.04
*** TURN *** [6h Kd 4d] [8d]
hideo64: checks
Jh0nTravolta: checks
*** RIVER *** [6h Kd 4d 8d] [Ac]
hideo64: bets $0.14
Jh0nTravolta: folds
Uncalled bet ($0.14) returned to hideo64
hideo64 collected $0.18 from pot
hideo64: doesn't show hand
*** SUMMARY ***
Total pot $0.19 | Rake $0.01
Board [6h Kd 4d 8d Ac]
Seat 1: hideo64 (big blind) collected ($0.18)
Seat 3: vezelvu1 folded before Flop (didn't bet)
Seat 4: sexmit folded before Flop (didn't bet)
Seat 5: Jh0nTravolta (button) folded on the River
Seat 6: Jake7123 (small blind) folded before Flop


PokerStars Hand #238169022230:  Hold'em No Limit ($0.01/$0.02 USD) - 2022/08/23 12:11:12 ET
Table 'Despina IV' 6-max Seat #6 is the button
Seat 1: hideo64 ($2.09 in chips)
Seat 2: arsad725 ($2 in chips)
Seat 3: vezelvu1 ($1.61 in chips)
Seat 4: sexmit ($1.32 in chips)
Seat 5: Jh0nTravolta ($2 in chips)
Seat 6: Jake7123 ($1.95 in chips)
hideo64: posts small blind $0.01
arsad725: posts big blind $0.02
*** HOLE CARDS ***
vezelvu1: folds
sexmit: folds
Jh0nTravolta has timed out
Jh0nTravolta: folds
Jake7123: raises $0.02 to $0.04
hideo64: folds
arsad725: folds
Uncalled bet ($0.02) returned to Jake7123
Jake7123 collected $0.05 from pot
Jake7123: doesn't show hand
*** SUMMARY ***
Total pot $0.05 | Rake $0
Seat 1: hideo64 (small blind) folded before Flop
Seat 2: arsad725 (big blind) folded before Flop
Seat 3: vezelvu1 folded before Flop (didn't bet)
Seat 4: sexmit folded before Flop (didn't bet)
Seat 5: Jh0nTravolta folded before Flop (didn't bet)
Seat 6: Jake7123 (button) collected ($0.05)


PokerStars Hand #238169029340:  Hold'em No Limit ($0.01/$0.02 USD) - 2022/08/23 12:11:35 ET
Table 'Despina IV' 6-max Seat #1 is the button
Seat 1: hideo64 ($2.08 in chips)
Seat 2: arsad725 ($2 in chips)
Seat 3: vezelvu1 ($1.61 in chips)
Seat 4: sexmit ($1.32 in chips)
Seat 6: Jake7123 ($1.98 in chips)
arsad725: posts small blind $0.01
vezelvu1: posts big blind $0.02
*** HOLE CARDS ***
sexmit: raises $0.02 to $0.04
Jake7123: folds
hideo64: calls $0.04
arsad725: folds
vezelvu1: folds
*** FLOP *** [Jc Td Tc]
sexmit: checks
hideo64: checks
*** TURN *** [Jc Td Tc] [Qh]
sexmit: bets $0.04
hideo64: calls $0.04
*** RIVER *** [Jc Td Tc Qh] [4d]
sexmit: checks
hideo64: bets $0.13
sexmit: raises $0.23 to $0.36
hideo64: folds
Uncalled bet ($0.23) returned to sexmit
sexmit collected $0.43 from pot
*** SUMMARY ***
Total pot $0.45 | Rake $0.02
Board [Jc Td Tc Qh 4d]
Seat 1: hideo64 (button) folded on the River
Seat 2: arsad725 (small blind) folded before Flop
Seat 3: vezelvu1 (big blind) folded before Flop
Seat 4: sexmit collected ($0.43)
Seat 6: Jake7123 folded before Flop (didn't bet)


PokerStars Hand #238169042103:  Hold'em No Limit ($0.01/$0.02 USD) - 2022/08/23 12:12:18 ET
Table 'Despina IV' 6-max Seat #2 is the button
Seat 1: hideo64 ($1.87 in chips)
Seat 2: arsad725 ($2 in chips)
Seat 3: vezelvu1 ($1.59 in chips)
Seat 4: sexmit ($1.54 in chips)
Seat 5: Jh0nTravolta ($2 in chips)
Seat 6: Jake7123 ($1.98 in chips)
vezelvu1: posts small blind $0.01
sexmit: posts big blind $0.02
*** HOLE CARDS ***
Jh0nTravolta: folds
Jake7123: folds
hideo64: folds
arsad725: folds
vezelvu1: folds
Uncalled bet ($0.01) returned to sexmit
sexmit collected $0.02 from pot
*** SUMMARY ***
Total pot $0.02 | Rake $0
Seat 1: hideo64 folded before Flop (didn't bet)
Seat 2: arsad725 (button) folded before Flop (didn't bet)
Seat 3: vezelvu1 (small blind) folded before Flop
Seat 4: sexmit (big blind) collected ($0.02)
Seat 5: Jh0nTravolta folded before Flop (didn't bet)
Seat 6: Jake7123 folded before Flop (didn't bet)


PokerStars Hand #238169046266:  Hold'em No Limit ($0.01/$0.02 USD) - 2022/08/23 12:12:32 ET
Table 'Despina IV' 6-max Seat #3 is the button
Seat 1: hideo64 ($1.87 in chips)
Seat 2: arsad725 ($2 in chips)
Seat 3: vezelvu1 ($1.58 in chips)
Seat 4: sexmit ($1.55 in chips)
Seat 5: Jh0nTravolta ($2 in chips)
Seat 6: Jake7123 ($1.98 in chips)
sexmit: posts small blind $0.01
Jh0nTravolta: posts big blind $0.02
*** HOLE CARDS ***
Jake7123: folds
hideo64: folds
arsad725: folds
vezelvu1: folds
sexmit: raises $0.05 to $0.07
Jh0nTravolta: folds
Uncalled bet ($0.05) returned to sexmit
sexmit collected $0.04 from pot
*** SUMMARY ***
Total pot $0.04 | Rake $0
Seat 1: hideo64 folded before Flop (didn't bet)
Seat 2: arsad725 folded before Flop (didn't bet)
Seat 3: vezelvu1 (button) folded before Flop (didn't bet)
Seat 4: sexmit (small blind) collected ($0.04)
Seat 5: Jh0nTravolta (big blind) folded before Flop
Seat 6: Jake7123 folded before Flop (didn't bet)


PokerStars Hand #238169050825:  Hold'em No Limit ($0.01/$0.02 USD) - 2022/08/23 12:12:47 ET
Table 'Despina IV' 6-max Seat #4 is the button
Seat 1: hideo64 ($1.87 in chips)
Seat 2: arsad725 ($2 in chips)
Seat 3: vezelvu1 ($1.58 in chips)
Seat 4: sexmit ($1.57 in chips)
Seat 5: Jh0nTravolta ($2 in chips)
Seat 6: Jake7123 ($1.98 in chips)
Jh0nTravolta: posts small blind $0.01
Jake7123: posts big blind $0.02
*** HOLE CARDS ***
hideo64: raises $0.02 to $0.04
arsad725: folds
vezelvu1: folds
sexmit: folds
Jh0nTravolta: folds
Jake7123: calls $0.02
*** FLOP *** [4s 9s 5s]
Jake7123: checks
hideo64: bets $0.09
Jake7123: raises $0.09 to $0.18
hideo64: folds
Uncalled bet ($0.09) returned to Jake7123
Jake7123 collected $0.26 from pot
Jake7123: doesn't show hand
*** SUMMARY ***
Total pot $0.27 | Rake $0.01
Board [4s 9s 5s]
Seat 1: hideo64 folded on the Flop
Seat 2: arsad725 folded before Flop (didn't bet)
Seat 3: vezelvu1 folded before Flop (didn't bet)
Seat 4: sexmit (button) folded before Flop (didn't bet)
Seat 5: Jh0nTravolta (small blind) folded before Flop
Seat 6: Jake7123 (big blind) collected ($0.26)


PokerStars Hand #238169061491:  Hold'em No Limit ($0.01/$0.02 USD) - 2022/08/23 12:13:24 ET
Table 'Despina IV' 6-max Seat #5 is the button
Seat 1: hideo64 ($1.74 in chips)
Seat 2: arsad725 ($2 in chips)
Seat 3: vezelvu1 ($1.58 in chips)
Seat 4: sexmit ($1.57 in chips)
Seat 5: Jh0nTravolta ($2 in chips)
Seat 6: Jake7123 ($2.11 in chips)
Jake7123: posts small blind $0.01
hideo64: posts big blind $0.02
*** HOLE CARDS ***
arsad725: folds
vezelvu1: folds
sexmit: raises $0.02 to $0.04
Jh0nTravolta: folds
Jake7123: calls $0.03
hideo64: calls $0.02
*** FLOP *** [Kc 3c Qs]
Jake7123: checks
hideo64: checks
sexmit: checks
*** TURN *** [Kc 3c Qs] [4s]
Jake7123: bets $0.04
hideo64: raises $0.10 to $0.14
sexmit: folds
Jake7123: folds
Uncalled bet ($0.10) returned to hideo64
hideo64 collected $0.19 from pot
*** SUMMARY ***
Total pot $0.20 | Rake $0.01
Board [Kc 3c Qs 4s]
Seat 1: hideo64 (big blind) collected ($0.19)
Seat 2: arsad725 folded before Flop (didn't bet)
Seat 3: vezelvu1 folded before Flop (didn't bet)
Seat 4: sexmit folded on the Turn
Seat 5: Jh0nTravolta (button) folded before Flop (didn't bet)
Seat 6: Jake7123 (small blind) folded on the Turn


PokerStars Hand #238169074326:  Hold'em No Limit ($0.01/$0.02 USD) - 2022/08/23 12:14:08 ET
Table 'Despina IV' 6-max Seat #6 is the button
Seat 1: hideo64 ($1.85 in chips)
Seat 2: arsad725 ($2 in chips)
Seat 3: vezelvu1 ($1.58 in chips)
Seat 4: sexmit ($1.53 in chips)
Seat 5: Jh0nTravolta ($2 in chips)
Seat 6: Jake7123 ($2.03 in chips)
hideo64: posts small blind $0.01
arsad725: posts big blind $0.02
*** HOLE CARDS ***
vezelvu1: folds
sexmit: folds
Jh0nTravolta: folds
Jake7123: raises $0.04 to $0.06
hideo64: folds
arsad725: raises $0.13 to $0.19
Jake7123: folds
Uncalled bet ($0.13) returned to arsad725
arsad725 collected $0.13 from pot
arsad725: doesn't show hand
*** SUMMARY ***
Total pot $0.13 | Rake $0
Seat 1: hideo64 (small blind) folded before Flop
Seat 2: arsad725 (big blind) collected ($0.13)
Seat 3: vezelvu1 folded before Flop (didn't bet)
Seat 4: sexmit folded before Flop (didn't bet)
Seat 5: Jh0nTravolta folded before Flop (didn't bet)
Seat 6: Jake7123 (button) folded before Flop


PokerStars Hand #238169081610:  Hold'em No Limit ($0.01/$0.02 USD) - 2022/08/23 12:14:32 ET
Table 'Despina IV' 6-max Seat #1 is the button
Seat 1: hideo64 ($1.84 in chips)
Seat 2: arsad725 ($2.07 in chips)
Seat 3: vezelvu1 ($1.58 in chips)
Seat 4: sexmit ($1.53 in chips)
Seat 5: Jh0nTravolta ($2 in chips)
Seat 6: Jake7123 ($1.97 in chips)
arsad725: posts small blind $0.01
vezelvu1: posts big blind $0.02
*** HOLE CARDS ***
sexmit: folds
Jh0nTravolta: calls $0.02
Jake7123: raises $0.02 to $0.04
hideo64: folds
arsad725: folds
vezelvu1: folds
Jh0nTravolta: calls $0.02
*** FLOP *** [6s Kd 4s]
Jh0nTravolta: checks
Jake7123: bets $0.05
Jh0nTravolta: folds
Uncalled bet ($0.05) returned to Jake7123
Jake7123 collected $0.11 from pot
Jake7123: doesn't show hand
*** SUMMARY ***
Total pot $0.11 | Rake $0
Board [6s Kd 4s]
Seat 1: hideo64 (button) folded before Flop (didn't bet)
Seat 2: arsad725 (small blind) folded before Flop
Seat 3: vezelvu1 (big blind) folded before Flop
Seat 4: sexmit folded before Flop (didn't bet)
Seat 5: Jh0nTravolta folded on the Flop
Seat 6: Jake7123 collected ($0.11)


PokerStars Hand #238169090567:  Hold'em No Limit ($0.01/$0.02 USD) - 2022/08/23 12:15:03 ET
Table 'Despina IV' 6-max Seat #2 is the button
Seat 1: hideo64 ($1.84 in chips)
Seat 2: arsad725 ($2.06 in chips)
Seat 3: vezelvu1 ($1.56 in chips)
Seat 4: sexmit ($1.53 in chips)
Seat 5: Jh0nTravolta ($2 in chips)
Seat 6: Jake7123 ($2.04 in chips)
vezelvu1: posts small blind $0.01
sexmit: posts big blind $0.02
*** HOLE CARDS ***
Jh0nTravolta: folds
Jake7123: folds
hideo64: folds
arsad725: folds
vezelvu1: folds
Uncalled bet ($0.01) returned to sexmit
sexmit collected $0.02 from pot
*** SUMMARY ***
Total pot $0.02 | Rake $0
Seat 1: hideo64 folded before Flop (didn't bet)
Seat 2: arsad725 (button) folded before Flop (didn't bet)
Seat 3: vezelvu1 (small blind) folded before Flop
Seat 4: sexmit (big blind) collected ($0.02)
Seat 5: Jh0nTravolta folded before Flop (didn't bet)
Seat 6: Jake7123 folded before Flop (didn't bet)


PokerStars Hand #238169093890:  Hold'em No Limit ($0.01/$0.02 USD) - 2022/08/23 12:15:14 ET
Table 'Despina IV' 6-max Seat #3 is the button
Seat 1: hideo64 ($1.84 in chips)
Seat 2: arsad725 ($2.06 in chips)
Seat 3: vezelvu1 ($1.55 in chips)
Seat 4: sexmit ($1.54 in chips)
Seat 5: Jh0nTravolta ($2 in chips)
Seat 6: Jake7123 ($2.04 in chips)
sexmit: posts small blind $0.01
Jh0nTravolta: posts big blind $0.02
*** HOLE CARDS ***
Jake7123: raises $0.02 to $0.04
hideo64: folds
arsad725: folds
vezelvu1: folds
sexmit: folds
Jh0nTravolta: folds
Uncalled bet ($0.02) returned to Jake7123
Jake7123 collected $0.05 from pot
Jake7123: doesn't show hand
*** SUMMARY ***
Total pot $0.05 | Rake $0
Seat 1: hideo64 folded before Flop (didn't bet)
Seat 2: arsad725 folded before Flop (didn't bet)
Seat 3: vezelvu1 (button) folded before Flop (didn't bet)
Seat 4: sexmit (small blind) folded before Flop
Seat 5: Jh0nTravolta (big blind) folded before Flop
Seat 6: Jake7123 collected ($0.05)


PokerStars Hand #238169099403:  Hold'em No Limit ($0.01/$0.02 USD) - 2022/08/23 12:15:33 ET
Table 'Despina IV' 6-max Seat #4 is the button
Seat 1: hideo64 ($1.84 in chips)
Seat 2: arsad725 ($2.06 in chips)
Seat 3: vezelvu1 ($1.55 in chips)
Seat 4: sexmit ($1.53 in chips)
Seat 5: Jh0nTravolta ($2 in chips)
Seat 6: Jake7123 ($2.07 in chips)
Jh0nTravolta: posts small blind $0.01
Jake7123: posts big blind $0.02
*** HOLE CARDS ***
hideo64: calls $0.02
arsad725: folds
vezelvu1: folds
sexmit: folds
Jh0nTravolta: folds
Jake7123: raises $0.02 to $0.04
hideo64: calls $0.02
*** FLOP *** [4s Jd 3h]
Jake7123: checks
hideo64: bets $0.09
Jake7123: folds
Uncalled bet ($0.09) returned to hideo64
hideo64 collected $0.09 from pot
*** SUMMARY ***
Total pot $0.09 | Rake $0
Board [4s Jd 3h]
Seat 1: hideo64 collected ($0.09)
Seat 2: arsad725 folded before Flop (didn't bet)
Seat 3: vezelvu1 folded before Flop (didn't bet)
Seat 4: sexmit (button) folded before Flop (didn't bet)
Seat 5: Jh0nTravolta (small blind) folded before Flop
Seat 6: Jake7123 (big blind) folded on the Flop


PokerStars Hand #238169116182:  Hold'em No Limit ($0.01/$0.02 USD) - 2022/08/23 12:16:30 ET
Table 'Despina IV' 6-max Seat #5 is the button
Seat 1: hideo64 ($1.89 in chips)
Seat 2: arsad725 ($2.06 in chips)
Seat 3: vezelvu1 ($1.55 in chips)
Seat 4: sexmit ($1.53 in chips)
Seat 5: Jh0nTravolta ($2 in chips)
Seat 6: Jake7123 ($2.03 in chips)
Jake7123: posts small blind $0.01
hideo64: posts big blind $0.02
*** HOLE CARDS ***
arsad725: folds
vezelvu1: folds
sexmit: raises $0.02 to $0.04
Jh0nTravolta: folds
Jake7123: calls $0.03
hideo64: calls $0.02
*** FLOP *** [8s 3c 4h]
Jake7123: checks
hideo64: checks
sexmit: checks
*** TURN *** [8s 3c 4h] [Jc]
Jake7123: checks
hideo64: checks
sexmit: checks
*** RIVER *** [8s 3c 4h Jc] [8c]
Jake7123: checks
hideo64: bets $0.06
sexmit: calls $0.06
Jake7123: folds
*** SHOW DOWN ***
hideo64: shows [6c 3h] (two pair, Eights and Threes)
sexmit: mucks hand
hideo64 collected $0.23 from pot
*** SUMMARY ***
Total pot $0.24 | Rake $0.01
Board [8s 3c 4h Jc 8c]
Seat 1: hideo64 (big blind) showed [6c 3h] and won ($0.23) with two pair, Eights and Threes
Seat 2: arsad725 folded before Flop (didn't bet)
Seat 3: vezelvu1 folded before Flop (didn't bet)
Seat 4: sexmit mucked
Seat 5: Jh0nTravolta (button) folded before Flop (didn't bet)
Seat 6: Jake7123 (small blind) folded on the River


PokerStars Hand #238169131682:  Hold'em No Limit ($0.01/$0.02 USD) - 2022/08/23 12:17:23 ET
Table 'Despina IV' 6-max Seat #6 is the button
Seat 1: hideo64 ($2.02 in chips)
Seat 2: arsad725 ($2.06 in chips)
Seat 3: vezelvu1 ($1.55 in chips)
Seat 4: sexmit ($1.43 in chips)
Seat 5: Jh0nTravolta ($2 in chips)
Seat 6: Jake7123 ($1.99 in chips)
hideo64: posts small blind $0.01
arsad725: posts big blind $0.02
*** HOLE CARDS ***
vezelvu1: raises $0.02 to $0.04
sexmit: folds
Jh0nTravolta: folds
Jake7123: folds
hideo64: folds
arsad725: folds
Uncalled bet ($0.02) returned to vezelvu1
vezelvu1 collected $0.05 from pot
*** SUMMARY ***
Total pot $0.05 | Rake $0
Seat 1: hideo64 (small blind) folded before Flop
Seat 2: arsad725 (big blind) folded before Flop
Seat 3: vezelvu1 collected ($0.05)
Seat 4: sexmit folded before Flop (didn't bet)
Seat 5: Jh0nTravolta folded before Flop (didn't bet)
Seat 6: Jake7123 (button) folded before Flop (didn't bet)


PokerStars Hand #238169135708:  Hold'em No Limit ($0.01/$0.02 USD) - 2022/08/23 12:17:37 ET
Table 'Despina IV' 6-max Seat #1 is the button
Seat 1: hideo64 ($2.01 in chips)
Seat 2: arsad725 ($2.04 in chips)
Seat 3: vezelvu1 ($1.58 in chips)
Seat 4: sexmit ($1.43 in chips)
Seat 5: Jh0nTravolta ($2 in chips)
Seat 6: Jake7123 ($1.99 in chips)
arsad725: posts small blind $0.01
vezelvu1: posts big blind $0.02
*** HOLE CARDS ***
sexmit: raises $0.02 to $0.04
Jh0nTravolta: folds
Jake7123: folds
hideo64: calls $0.04
arsad725: folds
vezelvu1: calls $0.02
*** FLOP *** [4c 7d 5c]
vezelvu1: checks
sexmit: checks
hideo64: bets $0.10
vezelvu1: folds
sexmit: folds
Uncalled bet ($0.10) returned to hideo64
hideo64 collected $0.13 from pot
*** SUMMARY ***
Total pot $0.13 | Rake $0
Board [4c 7d 5c]
Seat 1: hideo64 (button) collected ($0.13)
Seat 2: arsad725 (small blind) folded before Flop
Seat 3: vezelvu1 (big blind) folded on the Flop
Seat 4: sexmit folded on the Flop
Seat 5: Jh0nTravolta folded before Flop (didn't bet)
Seat 6: Jake7123 folded before Flop (didn't bet)


PokerStars Hand #238169146245:  Hold'em No Limit ($0.01/$0.02 USD) - 2022/08/23 12:18:12 ET
Table 'Despina IV' 6-max Seat #2 is the button
Seat 1: hideo64 ($2.10 in chips)
Seat 2: arsad725 ($2.03 in chips)
Seat 3: vezelvu1 ($1.54 in chips)
Seat 4: sexmit ($1.39 in chips)
Seat 5: Jh0nTravolta ($2 in chips)
Seat 6: Jake7123 ($1.99 in chips)
vezelvu1: posts small blind $0.01
sexmit: posts big blind $0.02
*** HOLE CARDS ***
Jh0nTravolta: folds
Jake7123: raises $0.02 to $0.04
hideo64: calls $0.04
arsad725: folds
vezelvu1: folds
sexmit: folds
*** FLOP *** [6s Qd 7s]
Jake7123: checks
hideo64: bets $0.05
Jake7123: calls $0.05
*** TURN *** [6s Qd 7s] [2c]
Jake7123: bets $0.07
hideo64: folds
Uncalled bet ($0.07) returned to Jake7123
Jake7123 collected $0.20 from pot
Jake7123: doesn't show hand
*** SUMMARY ***
Total pot $0.21 | Rake $0.01
Board [6s Qd 7s 2c]
Seat 1: hideo64 folded on the Turn
Seat 2: arsad725 (button) folded before Flop (didn't bet)
Seat 3: vezelvu1 (small blind) folded before Flop
Seat 4: sexmit (big blind) folded before Flop
Seat 5: Jh0nTravolta folded before Flop (didn't bet)
Seat 6: Jake7123 collected ($0.20)


PokerStars Hand #238169156531:  Hold'em No Limit ($0.01/$0.02 USD) - 2022/08/23 12:18:46 ET
Table 'Despina IV' 6-max Seat #3 is the button
Seat 1: hideo64 ($2.01 in chips)
Seat 2: arsad725 ($2.03 in chips)
Seat 3: vezelvu1 ($1.53 in chips)
Seat 4: sexmit ($1.37 in chips)
Seat 5: Jh0nTravolta ($2 in chips)
Seat 6: Jake7123 ($2.10 in chips)
sexmit: posts small blind $0.01
Jh0nTravolta: posts big blind $0.02
*** HOLE CARDS ***
Jake7123: folds
hideo64: calls $0.02
arsad725: folds
vezelvu1: folds
sexmit: calls $0.01
Jh0nTravolta: checks
*** FLOP *** [6c Qc Jc]
sexmit: checks
Jh0nTravolta: checks
hideo64: checks
*** TURN *** [6c Qc Jc] [As]
sexmit: checks
Jh0nTravolta: checks
hideo64: bets $0.06
sexmit: folds
Jh0nTravolta: folds
Uncalled bet ($0.06) returned to hideo64
hideo64 collected $0.06 from pot
*** SUMMARY ***
Total pot $0.06 | Rake $0
Board [6c Qc Jc As]
Seat 1: hideo64 collected ($0.06)
Seat 2: arsad725 folded before Flop (didn't bet)
Seat 3: vezelvu1 (button) folded before Flop (didn't bet)
Seat 4: sexmit (small blind) folded on the Turn
Seat 5: Jh0nTravolta (big blind) folded on the Turn
Seat 6: Jake7123 folded before Flop (didn't bet)


PokerStars Hand #238169170556:  Hold'em No Limit ($0.01/$0.02 USD) - 2022/08/23 12:19:34 ET
Table 'Despina IV' 6-max Seat #4 is the button
Seat 1: hideo64 ($2.05 in chips)
Seat 2: arsad725 ($2.03 in chips)
Seat 3: vezelvu1 ($1.53 in chips)
Seat 4: sexmit ($1.35 in chips)
Seat 5: Jh0nTravolta ($2 in chips)
Seat 6: Jake7123 ($2.10 in chips)
Jh0nTravolta: posts small blind $0.01
Jake7123: posts big blind $0.02
*** HOLE CARDS ***
hideo64: folds
arsad725: raises $0.03 to $0.05
hideo64 leaves the table
vezelvu1: folds
sexmit: calls $0.05
Jh0nTravolta: folds
Jake7123: calls $0.03
*** FLOP *** [Ac Ah 5d]
eskulap911 joins the table at seat #1
Jake7123: checks
arsad725: checks
sexmit: checks
*** TURN *** [Ac Ah 5d] [6c]
Jake7123: checks
arsad725: checks
sexmit: bets $0.10
Jake7123: calls $0.10
arsad725: folds
*** RIVER *** [Ac Ah 5d 6c] [2s]
Jake7123: checks
sexmit: checks
*** SHOW DOWN ***
Jake7123: shows [8h 8c] (two pair, Aces and Eights)
sexmit: mucks hand
Jake7123 collected $0.35 from pot
*** SUMMARY ***
Total pot $0.36 | Rake $0.01
Board [Ac Ah 5d 6c 2s]
Seat 1: hideo64 folded before Flop (didn't bet)
Seat 2: arsad725 folded on the Turn
Seat 3: vezelvu1 folded before Flop (didn't bet)
Seat 4: sexmit (button) mucked
Seat 5: Jh0nTravolta (small blind) folded before Flop
Seat 6: Jake7123 (big blind) showed [8h 8c] and won ($0.35) with two pair, Aces and Eights


PokerStars Hand #238169192296:  Hold'em No Limit ($0.01/$0.02 USD) - 2022/08/23 12:20:32 ET
Table 'Despina IV' 6-max Seat #5 is the button
Seat 1: eskulap911 ($1.60 in chips)
Seat 2: arsad725 ($2 in chips)
Seat 3: vezelvu1 ($1.53 in chips)
Seat 4: sexmit ($1.20 in chips)
Seat 5: Jh0nTravolta ($2 in chips)
Seat 6: Jake7123 ($2.30 in chips)
Jake7123: posts small blind $0.01
eskulap911: posts big blind $0.02
*** HOLE CARDS ***
arsad725: folds
vezelvu1: folds
sexmit: folds
Jh0nTravolta: folds
Jake7123: folds
Uncalled bet ($0.01) returned to eskulap911
eskulap911 collected $0.02 from pot
*** SUMMARY ***
Total pot $0.02 | Rake $0
Seat 1: eskulap911 (big blind) collected ($0.02)
Seat 2: arsad725 folded before Flop (didn't bet)
Seat 3: vezelvu1 folded before Flop (didn't bet)
Seat 4: sexmit folded before Flop (didn't bet)
Seat 5: Jh0nTravolta (button) folded before Flop (didn't bet)
Seat 6: Jake7123 (small blind) folded before Flop


PokerStars Hand #238169195666:  Hold'em No Limit ($0.01/$0.02 USD) - 2022/08/23 12:20:44 ET
Table 'Despina IV' 6-max Seat #6 is the button
Seat 1: eskulap911 ($1.61 in chips)
Seat 2: arsad725 ($2 in chips)
Seat 3: vezelvu1 ($1.53 in chips)
Seat 4: sexmit ($1.20 in chips)
Seat 5: Jh0nTravolta ($2 in chips)
Seat 6: Jake7123 ($2.29 in chips)
eskulap911: posts small blind $0.01
arsad725: posts big blind $0.02
*** HOLE CARDS ***
vezelvu1: folds
sexmit: raises $0.02 to $0.04
Jh0nTravolta: folds
Jake7123: folds
eskulap911: folds
arsad725: raises $0.14 to $0.18
sexmit: calls $0.14
*** FLOP *** [5h 4s Qh]
arsad725: bets $0.18
sexmit: folds
Uncalled bet ($0.18) returned to arsad725
arsad725 collected $0.36 from pot
arsad725: doesn't show hand
*** SUMMARY ***
Total pot $0.37 | Rake $0.01
Board [5h 4s Qh]
Seat 1: eskulap911 (small blind) folded before Flop
Seat 2: arsad725 (big blind) collected ($0.36)
Seat 3: vezelvu1 folded before Flop (didn't bet)
Seat 4: sexmit folded on the Flop
Seat 5: Jh0nTravolta folded before Flop (didn't bet)
Seat 6: Jake7123 (button) folded before Flop (didn't bet)


PokerStars Hand #238169204284:  Hold'em No Limit ($0.01/$0.02 USD) - 2022/08/23 12:21:12 ET
Table 'Despina IV' 6-max Seat #1 is the button
Seat 1: eskulap911 ($1.60 in chips)
Seat 2: arsad725 ($2.18 in chips)
Seat 3: vezelvu1 ($1.53 in chips)
Seat 4: sexmit ($1.02 in chips)
Seat 5: Jh0nTravolta ($2 in chips)
Seat 6: Jake7123 ($2.29 in chips)
arsad725: posts small blind $0.01
vezelvu1: posts big blind $0.02
*** HOLE CARDS ***
sexmit: raises $0.02 to $0.04
Jh0nTravolta: raises $0.12 to $0.16
Jake7123: folds
eskulap911: folds
arsad725: folds
vezelvu1: folds
sexmit: calls $0.12
*** FLOP *** [7c 2c Ts]
sexmit: checks
Jh0nTravolta: bets $0.11
sexmit: calls $0.11
*** TURN *** [7c 2c Ts] [4c]
sexmit: checks
Jh0nTravolta: bets $0.55
sexmit: raises $0.20 to $0.75 and is all-in
Jh0nTravolta: calls $0.20
*** RIVER *** [7c 2c Ts 4c] [6h]
*** SHOW DOWN ***
sexmit: shows [As Tc] (a pair of Tens)
Jh0nTravolta: shows [Ac Ad] (a pair of Aces)
Jh0nTravolta cashed out the hand for $1.88 | Cash Out Fee $0.02
*** SUMMARY ***
Total pot $2.07 | Rake $0.07
Board [7c 2c Ts 4c 6h]
Seat 1: eskulap911 (button) folded before Flop (didn't bet)
Seat 2: arsad725 (small blind) folded before Flop
Seat 3: vezelvu1 (big blind) folded before Flop
Seat 4: sexmit showed [As Tc] and lost with a pair of Tens
Seat 5: Jh0nTravolta showed [Ac Ad] and won ($2) with a pair of Aces (pot not awarded as player cashed out)
Seat 6: Jake7123 folded before Flop (didn't bet)


PokerStars Hand #238169216510:  Hold'em No Limit ($0.01/$0.02 USD) - 2022/08/23 12:21:52 ET
Table 'Despina IV' 6-max Seat #2 is the button
Seat 1: eskulap911 ($1.60 in chips)
Seat 2: arsad725 ($2.17 in chips)
Seat 3: vezelvu1 ($1.51 in chips)
Seat 5: Jh0nTravolta ($2.86 in chips)
Seat 6: Jake7123 ($2.29 in chips)
vezelvu1: posts small blind $0.01
Jh0nTravolta: posts big blind $0.02
*** HOLE CARDS ***
Jake7123: folds
eskulap911: raises $0.02 to $0.04
arsad725: folds
vezelvu1: folds
Jh0nTravolta: raises $0.09 to $0.13
eskulap911: calls $0.09
*** FLOP *** [7s 3s 7c]
Jh0nTravolta: bets $0.08
eskulap911: folds
Uncalled bet ($0.08) returned to Jh0nTravolta
Jh0nTravolta collected $0.26 from pot
Jh0nTravolta: doesn't show hand
*** SUMMARY ***
Total pot $0.27 | Rake $0.01
Board [7s 3s 7c]
Seat 1: eskulap911 folded on the Flop
Seat 2: arsad725 (button) folded before Flop (didn't bet)
Seat 3: vezelvu1 (small blind) folded before Flop
Seat 5: Jh0nTravolta (big blind) collected ($0.26)
Seat 6: Jake7123 folded before Flop (didn't bet)


PokerStars Hand #238169230307:  Hold'em No Limit ($0.01/$0.02 USD) - 2022/08/23 12:22:38 ET
Table 'Despina IV' 6-max Seat #3 is the button
Seat 1: eskulap911 ($1.47 in chips)
Seat 2: arsad725 ($2.17 in chips)
Seat 3: vezelvu1 ($1.50 in chips)
Seat 5: Jh0nTravolta ($2.99 in chips)
Seat 6: Jake7123 ($2.29 in chips)
Jh0nTravolta: posts small blind $0.01
Jake7123: posts big blind $0.02
*** HOLE CARDS ***
eskulap911: folds
arsad725: folds
vezelvu1: folds
Jh0nTravolta: folds
Uncalled bet ($0.01) returned to Jake7123
Jake7123 collected $0.02 from pot
Jake7123: doesn't show hand
*** SUMMARY ***
Total pot $0.02 | Rake $0
Seat 1: eskulap911 folded before Flop (didn't bet)
Seat 2: arsad725 folded before Flop (didn't bet)
Seat 3: vezelvu1 (button) folded before Flop (didn't bet)
Seat 5: Jh0nTravolta (small blind) folded before Flop
Seat 6: Jake7123 (big blind) collected ($0.02)


PokerStars Hand #238169237224:  Hold'em No Limit ($0.01/$0.02 USD) - 2022/08/23 12:23:02 ET
Table 'Despina IV' 6-max Seat #5 is the button
Seat 1: eskulap911 ($1.47 in chips)
Seat 2: arsad725 ($2.17 in chips)
Seat 3: vezelvu1 ($1.50 in chips)
Seat 4: sexmit ($2 in chips)
Seat 5: Jh0nTravolta ($2.98 in chips)
Seat 6: Jake7123 ($2.30 in chips)
Jake7123: posts small blind $0.01
eskulap911: posts big blind $0.02
sexmit: posts small & big blinds $0.03
*** HOLE CARDS ***
arsad725: folds
vezelvu1: folds
sexmit: checks
Jh0nTravolta: folds
Jake7123: calls $0.01
eskulap911: checks
*** FLOP *** [Ts Jh 6c]
Jake7123: checks
eskulap911: checks
sexmit: checks
*** TURN *** [Ts Jh 6c] [Tc]
Jake7123: checks
eskulap911: bets $0.08
sexmit: calls $0.08
Jake7123: folds
*** RIVER *** [Ts Jh 6c Tc] [Jd]
eskulap911: bets $1.37 and is all-in
sexmit: folds
Uncalled bet ($1.37) returned to eskulap911
eskulap911 collected $0.22 from pot
*** SUMMARY ***
Total pot $0.23 | Rake $0.01
Board [Ts Jh 6c Tc Jd]
Seat 1: eskulap911 (big blind) collected ($0.22)
Seat 2: arsad725 folded before Flop (didn't bet)
Seat 3: vezelvu1 folded before Flop (didn't bet)
Seat 4: sexmit folded on the River
Seat 5: Jh0nTravolta (button) folded before Flop (didn't bet)
Seat 6: Jake7123 (small blind) folded on the Turn


PokerStars Hand #238169255693:  Hold'em No Limit ($0.01/$0.02 USD) - 2022/08/23 12:24:03 ET
Table 'Despina IV' 6-max Seat #6 is the button
Seat 1: eskulap911 ($1.59 in chips)
Seat 2: arsad725 ($2.17 in chips)
Seat 3: vezelvu1 ($1.50 in chips)
Seat 4: sexmit ($1.89 in chips)
Seat 5: Jh0nTravolta ($2.98 in chips)
Seat 6: Jake7123 ($2.28 in chips)
eskulap911: posts small blind $0.01
arsad725: posts big blind $0.02
*** HOLE CARDS ***
vezelvu1: raises $0.02 to $0.04
sexmit: folds
Jh0nTravolta: folds
Jake7123: folds
eskulap911: folds
arsad725: calls $0.02
*** FLOP *** [3c Kd 2s]
arsad725: checks
vezelvu1: checks
*** TURN *** [3c Kd 2s] [Js]
arsad725: bets $0.04
vezelvu1: folds
Uncalled bet ($0.04) returned to arsad725
arsad725 collected $0.09 from pot
arsad725: doesn't show hand
*** SUMMARY ***
Total pot $0.09 | Rake $0
Board [3c Kd 2s Js]
Seat 1: eskulap911 (small blind) folded before Flop
Seat 2: arsad725 (big blind) collected ($0.09)
Seat 3: vezelvu1 folded on the Turn
Seat 4: sexmit folded before Flop (didn't bet)
Seat 5: Jh0nTravolta folded before Flop (didn't bet)
Seat 6: Jake7123 (button) folded before Flop (didn't bet)


PokerStars Hand #238169266890:  Hold'em No Limit ($0.01/$0.02 USD) - 2022/08/23 12:24:41 ET
Table 'Despina IV' 6-max Seat #1 is the button
Seat 1: eskulap911 ($1.58 in chips)
Seat 2: arsad725 ($2.22 in chips)
Seat 3: vezelvu1 ($1.46 in chips)
Seat 4: sexmit ($1.89 in chips)
Seat 5: Jh0nTravolta ($2.98 in chips)
Seat 6: Jake7123 ($2.28 in chips)
arsad725: posts small blind $0.01
vezelvu1: posts big blind $0.02
*** HOLE CARDS ***
sexmit: raises $0.02 to $0.04
Jh0nTravolta: folds
Jake7123: folds
eskulap911: folds
arsad725: folds
vezelvu1: folds
Uncalled bet ($0.02) returned to sexmit
sexmit collected $0.05 from pot
*** SUMMARY ***
Total pot $0.05 | Rake $0
Seat 1: eskulap911 (button) folded before Flop (didn't bet)
Seat 2: arsad725 (small blind) folded before Flop
Seat 3: vezelvu1 (big blind) folded before Flop
Seat 4: sexmit collected ($0.05)
Seat 5: Jh0nTravolta folded before Flop (didn't bet)
Seat 6: Jake7123 folded before Flop (didn't bet)


PokerStars Hand #238169272717:  Hold'em No Limit ($0.01/$0.02 USD) - 2022/08/23 12:25:00 ET
Table 'Despina IV' 6-max Seat #2 is the button
Seat 1: eskulap911 ($1.58 in chips)
Seat 2: arsad725 ($2.21 in chips)
Seat 3: vezelvu1 ($1.44 in chips)
Seat 4: sexmit ($1.92 in chips)
Seat 5: Jh0nTravolta ($2.98 in chips)
Seat 6: Jake7123 ($2.28 in chips)
vezelvu1: posts small blind $0.01
sexmit: posts big blind $0.02
*** HOLE CARDS ***
Jh0nTravolta: folds
Jake7123: folds
eskulap911: calls $0.02
arsad725: folds
vezelvu1: folds
sexmit: checks
*** FLOP *** [3h Tc 7d]
sexmit: checks
eskulap911: checks
*** TURN *** [3h Tc 7d] [Ks]
sexmit: checks
eskulap911: bets $0.18
sexmit: folds
Uncalled bet ($0.18) returned to eskulap911
eskulap911 collected $0.05 from pot
*** SUMMARY ***
Total pot $0.05 | Rake $0
Board [3h Tc 7d Ks]
Seat 1: eskulap911 collected ($0.05)
Seat 2: arsad725 (button) folded before Flop (didn't bet)
Seat 3: vezelvu1 (small blind) folded before Flop
Seat 4: sexmit (big blind) folded on the Turn
Seat 5: Jh0nTravolta folded before Flop (didn't bet)
Seat 6: Jake7123 folded before Flop (didn't bet)


PokerStars Hand #238169291289:  Hold'em No Limit ($0.01/$0.02 USD) - 2022/08/23 12:25:43 ET
Table 'Despina IV' 6-max Seat #3 is the button
Seat 1: eskulap911 ($1.61 in chips)
Seat 2: arsad725 ($2.21 in chips)
Seat 3: vezelvu1 ($1.43 in chips)
Seat 4: sexmit ($1.90 in chips)
Seat 5: Jh0nTravolta ($2.98 in chips)
Seat 6: Jake7123 ($2.28 in chips)
sexmit: posts small blind $0.01
Jh0nTravolta: posts big blind $0.02
*** HOLE CARDS ***
Jake7123: folds
eskulap911: folds
arsad725: folds
vezelvu1: folds
sexmit: folds
Uncalled bet ($0.01) returned to Jh0nTravolta
Jh0nTravolta collected $0.02 from pot
Jh0nTravolta: doesn't show hand
*** SUMMARY ***
Total pot $0.02 | Rake $0
Seat 1: eskulap911 folded before Flop (didn't bet)
Seat 2: arsad725 folded before Flop (didn't bet)
Seat 3: vezelvu1 (button) folded before Flop (didn't bet)
Seat 4: sexmit (small blind) folded before Flop
Seat 5: Jh0nTravolta (big blind) collected ($0.02)
Seat 6: Jake7123 folded before Flop (didn't bet)


PokerStars Hand #238169294996:  Hold'em No Limit ($0.01/$0.02 USD) - 2022/08/23 12:25:55 ET
Table 'Despina IV' 6-max Seat #4 is the button
Seat 1: eskulap911 ($1.61 in chips)
Seat 2: arsad725 ($2.21 in chips)
Seat 3: vezelvu1 ($1.43 in chips)
Seat 4: sexmit ($1.89 in chips)
Seat 5: Jh0nTravolta ($2.99 in chips)
Seat 6: Jake7123 ($2.28 in chips)
Jh0nTravolta: posts small blind $0.01
Jake7123: posts big blind $0.02
*** HOLE CARDS ***
eskulap911: folds
arsad725: folds
vezelvu1: folds
sexmit: raises $0.02 to $0.04
Jh0nTravolta: folds
Jake7123: folds
Uncalled bet ($0.02) returned to sexmit
sexmit collected $0.05 from pot
*** SUMMARY ***
Total pot $0.05 | Rake $0
Seat 1: eskulap911 folded before Flop (didn't bet)
Seat 2: arsad725 folded before Flop (didn't bet)
Seat 3: vezelvu1 folded before Flop (didn't bet)
Seat 4: sexmit (button) collected ($0.05)
Seat 5: Jh0nTravolta (small blind) folded before Flop
Seat 6: Jake7123 (big blind) folded before Flop


PokerStars Hand #238169303134:  Hold'em No Limit ($0.01/$0.02 USD) - 2022/08/23 12:26:21 ET
Table 'Despina IV' 6-max Seat #5 is the button
Seat 1: eskulap911 ($1.61 in chips)
Seat 2: arsad725 ($2.21 in chips)
Seat 3: vezelvu1 ($1.43 in chips)
Seat 4: sexmit ($1.92 in chips)
Seat 5: Jh0nTravolta ($2.98 in chips)
Seat 6: Jake7123 ($2.26 in chips)
Jake7123: posts small blind $0.01
eskulap911: posts big blind $0.02
*** HOLE CARDS ***
arsad725: folds
vezelvu1: folds
sexmit: folds
Jh0nTravolta: folds
Jake7123: folds
Uncalled bet ($0.01) returned to eskulap911
eskulap911 collected $0.02 from pot
*** SUMMARY ***
Total pot $0.02 | Rake $0
Seat 1: eskulap911 (big blind) collected ($0.02)
Seat 2: arsad725 folded before Flop (didn't bet)
Seat 3: vezelvu1 folded before Flop (didn't bet)
Seat 4: sexmit folded before Flop (didn't bet)
Seat 5: Jh0nTravolta (button) folded before Flop (didn't bet)
Seat 6: Jake7123 (small blind) folded before Flop


PokerStars Hand #238169306473:  Hold'em No Limit ($0.01/$0.02 USD) - 2022/08/23 12:26:32 ET
Table 'Despina IV' 6-max Seat #6 is the button
Seat 1: eskulap911 ($1.62 in chips)
Seat 2: arsad725 ($2.21 in chips)
Seat 3: vezelvu1 ($1.43 in chips)
Seat 4: sexmit ($1.92 in chips)
Seat 5: Jh0nTravolta ($2.98 in chips)
Seat 6: Jake7123 ($2.25 in chips)
eskulap911: posts small blind $0.01
arsad725: posts big blind $0.02
*** HOLE CARDS ***
vezelvu1: folds
sexmit: raises $0.02 to $0.04
Jh0nTravolta: folds
Jake7123: folds
eskulap911: folds
arsad725: folds
Uncalled bet ($0.02) returned to sexmit
sexmit collected $0.05 from pot
*** SUMMARY ***
Total pot $0.05 | Rake $0
Seat 1: eskulap911 (small blind) folded before Flop
Seat 2: arsad725 (big blind) folded before Flop
Seat 3: vezelvu1 folded before Flop (didn't bet)
Seat 4: sexmit collected ($0.05)
Seat 5: Jh0nTravolta folded before Flop (didn't bet)
Seat 6: Jake7123 (button) folded before Flop (didn't bet)


PokerStars Hand #238169311346:  Hold'em No Limit ($0.01/$0.02 USD) - 2022/08/23 12:26:48 ET
Table 'Despina IV' 6-max Seat #1 is the button
Seat 1: eskulap911 ($1.61 in chips)
Seat 2: arsad725 ($2.19 in chips)
Seat 3: vezelvu1 ($1.43 in chips)
Seat 4: sexmit ($1.95 in chips)
Seat 5: Jh0nTravolta ($2.98 in chips)
Seat 6: Jake7123 ($2.25 in chips)
arsad725: posts small blind $0.01
vezelvu1: posts big blind $0.02
*** HOLE CARDS ***
sexmit has timed out
sexmit: folds
Jh0nTravolta: folds
Jake7123: folds
eskulap911: raises $0.04 to $0.06
arsad725: folds
vezelvu1: folds
Uncalled bet ($0.04) returned to eskulap911
eskulap911 collected $0.05 from pot
*** SUMMARY ***
Total pot $0.05 | Rake $0
Seat 1: eskulap911 (button) collected ($0.05)
Seat 2: arsad725 (small blind) folded before Flop
Seat 3: vezelvu1 (big blind) folded before Flop
Seat 4: sexmit folded before Flop (didn't bet)
Seat 5: Jh0nTravolta folded before Flop (didn't bet)
Seat 6: Jake7123 folded before Flop (didn't bet)


PokerStars Hand #238169319513:  Hold'em No Limit ($0.01/$0.02 USD) - 2022/08/23 12:27:13 ET
Table 'Despina IV' 6-max Seat #2 is the button
Seat 1: eskulap911 ($1.64 in chips)
Seat 2: arsad725 ($2.18 in chips)
Seat 3: vezelvu1 ($1.41 in chips)
Seat 4: sexmit ($1.95 in chips)
Seat 5: Jh0nTravolta ($2.98 in chips)
Seat 6: Jake7123 ($2.25 in chips)
vezelvu1: posts small blind $0.01
sexmit: posts big blind $0.02
*** HOLE CARDS ***
Jh0nTravolta: folds
Jake7123: folds
eskulap911: calls $0.02
arsad725: folds
vezelvu1: raises $0.12 to $0.14
sexmit: folds
eskulap911: folds
Uncalled bet ($0.12) returned to vezelvu1
vezelvu1 collected $0.06 from pot
*** SUMMARY ***
Total pot $0.06 | Rake $0
Seat 1: eskulap911 folded before Flop
Seat 2: arsad725 (button) folded before Flop (didn't bet)
Seat 3: vezelvu1 (small blind) collected ($0.06)
Seat 4: sexmit (big blind) folded before Flop
Seat 5: Jh0nTravolta folded before Flop (didn't bet)
Seat 6: Jake7123 folded before Flop (didn't bet)


PokerStars Hand #238169327058:  Hold'em No Limit ($0.01/$0.02 USD) - 2022/08/23 12:27:38 ET
Table 'Despina IV' 6-max Seat #3 is the button
Seat 1: eskulap911 ($1.62 in chips)
Seat 2: arsad725 ($2.18 in chips)
Seat 3: vezelvu1 ($1.45 in chips)
Seat 4: sexmit ($1.93 in chips)
Seat 5: Jh0nTravolta ($2.98 in chips)
Seat 6: Jake7123 ($2.25 in chips)
sexmit: posts small blind $0.01
Jh0nTravolta: posts big blind $0.02
*** HOLE CARDS ***
Jake7123: folds
eskulap911: folds
arsad725: folds
vezelvu1: folds
sexmit: calls $0.01
Jh0nTravolta: checks
*** FLOP *** [6s 6d 7h]
sexmit: checks
Jh0nTravolta: checks
*** TURN *** [6s 6d 7h] [9h]
sexmit: bets $0.04
Jh0nTravolta: calls $0.04
*** RIVER *** [6s 6d 7h 9h] [8d]
sexmit: checks
Jh0nTravolta: checks
*** SHOW DOWN ***
sexmit: shows [6c Td] (a straight, Six to Ten)
Jh0nTravolta: mucks hand
sexmit collected $0.12 from pot
*** SUMMARY ***
Total pot $0.12 | Rake $0
Board [6s 6d 7h 9h 8d]
Seat 1: eskulap911 folded before Flop (didn't bet)
Seat 2: arsad725 folded before Flop (didn't bet)
Seat 3: vezelvu1 (button) folded before Flop (didn't bet)
Seat 4: sexmit (small blind) showed [6c Td] and won ($0.12) with a straight, Six to Ten
Seat 5: Jh0nTravolta (big blind) mucked
Seat 6: Jake7123 folded before Flop (didn't bet)


PokerStars Hand #238169349726:  Hold'em No Limit ($0.01/$0.02 USD) - 2022/08/23 12:28:51 ET
Table 'Despina IV' 6-max Seat #4 is the button
Seat 1: eskulap911 ($1.62 in chips)
Seat 2: arsad725 ($2.18 in chips)
Seat 3: vezelvu1 ($1.45 in chips)
Seat 4: sexmit ($1.99 in chips)
Seat 5: Jh0nTravolta ($2.92 in chips)
Seat 6: Jake7123 ($2.25 in chips)
Jh0nTravolta: posts small blind $0.01
Jake7123: posts big blind $0.02
*** HOLE CARDS ***
eskulap911: calls $0.02
arsad725: folds
vezelvu1: raises $0.16 to $0.18
sexmit: folds
Jh0nTravolta: folds
Jake7123: folds
eskulap911: raises $0.30 to $0.48
vezelvu1: raises $0.97 to $1.45 and is all-in
eskulap911: calls $0.97
*** FLOP *** [9h 4s Tc]
*** TURN *** [9h 4s Tc] [3h]
*** RIVER *** [9h 4s Tc 3h] [6s]
*** SHOW DOWN ***
eskulap911: shows [Qd Kh] (high card King)
vezelvu1: shows [Ks Ac] (high card Ace)
vezelvu1 collected $2.83 from pot
*** SUMMARY ***
Total pot $2.93 | Rake $0.10
Board [9h 4s Tc 3h 6s]
Seat 1: eskulap911 showed [Qd Kh] and lost with high card King
Seat 2: arsad725 folded before Flop (didn't bet)
Seat 3: vezelvu1 showed [Ks Ac] and won ($2.83) with high card Ace
Seat 4: sexmit (button) folded before Flop (didn't bet)
Seat 5: Jh0nTravolta (small blind) folded before Flop
Seat 6: Jake7123 (big blind) folded before Flop


PokerStars Hand #238169363871:  Hold'em No Limit ($0.01/$0.02 USD) - 2022/08/23 12:29:36 ET
Table 'Despina IV' 6-max Seat #5 is the button
Seat 1: eskulap911 ($0.17 in chips)
Seat 2: arsad725 ($2.18 in chips)
Seat 3: vezelvu1 ($2.83 in chips)
Seat 4: sexmit ($1.99 in chips)
Seat 5: Jh0nTravolta ($2.91 in chips)
Seat 6: Jake7123 ($2.23 in chips)
Jake7123: posts small blind $0.01
eskulap911: posts big blind $0.02
*** HOLE CARDS ***
arsad725: folds
vezelvu1: folds
sexmit: raises $0.02 to $0.04
Jh0nTravolta: folds
Jake7123: folds
eskulap911: folds
Uncalled bet ($0.02) returned to sexmit
sexmit collected $0.05 from pot
*** SUMMARY ***
Total pot $0.05 | Rake $0
Seat 1: eskulap911 (big blind) folded before Flop
Seat 2: arsad725 folded before Flop (didn't bet)
Seat 3: vezelvu1 folded before Flop (didn't bet)
Seat 4: sexmit collected ($0.05)
Seat 5: Jh0nTravolta (button) folded before Flop (didn't bet)
Seat 6: Jake7123 (small blind) folded before Flop


PokerStars Hand #238169371005:  Hold'em No Limit ($0.01/$0.02 USD) - 2022/08/23 12:29:59 ET
Table 'Despina IV' 6-max Seat #6 is the button
Seat 1: eskulap911 ($0.15 in chips)
Seat 2: arsad725 ($2.18 in chips)
Seat 3: vezelvu1 ($2.83 in chips)
Seat 4: sexmit ($2.02 in chips)
Seat 5: Jh0nTravolta ($2.91 in chips)
Seat 6: Jake7123 ($2.22 in chips)
eskulap911: posts small blind $0.01
arsad725: posts big blind $0.02
*** HOLE CARDS ***
vezelvu1: folds
sexmit: raises $0.02 to $0.04
Jh0nTravolta: folds
Jake7123: calls $0.04
eskulap911: folds
arsad725: calls $0.02
*** FLOP *** [2s 3s Jh]
arsad725: checks
sexmit: checks
Jake7123: bets $0.06
arsad725: folds
sexmit: calls $0.06
*** TURN *** [2s 3s Jh] [4c]
sexmit: checks
Jake7123: bets $0.12
sexmit: folds
Uncalled bet ($0.12) returned to Jake7123
Jake7123 collected $0.24 from pot
Jake7123: doesn't show hand
*** SUMMARY ***
Total pot $0.25 | Rake $0.01
Board [2s 3s Jh 4c]
Seat 1: eskulap911 (small blind) folded before Flop
Seat 2: arsad725 (big blind) folded on the Flop
Seat 3: vezelvu1 folded before Flop (didn't bet)
Seat 4: sexmit folded on the Turn
Seat 5: Jh0nTravolta folded before Flop (didn't bet)
Seat 6: Jake7123 (button) collected ($0.24)


PokerStars Hand #238169381776:  Hold'em No Limit ($0.01/$0.02 USD) - 2022/08/23 12:30:32 ET
Table 'Despina IV' 6-max Seat #1 is the button
Seat 1: eskulap911 ($0.14 in chips)
Seat 2: arsad725 ($2.14 in chips)
Seat 3: vezelvu1 ($2.83 in chips)
Seat 4: sexmit ($1.92 in chips)
Seat 5: Jh0nTravolta ($2.91 in chips)
Seat 6: Jake7123 ($2.36 in chips)
arsad725: posts small blind $0.01
vezelvu1: posts big blind $0.02
*** HOLE CARDS ***
sexmit: folds
Jh0nTravolta: folds
Jake7123: raises $0.02 to $0.04
eskulap911: calls $0.04
arsad725: calls $0.03
vezelvu1: folds
*** FLOP *** [9s 7d 3d]
arsad725: checks
Jake7123: checks
eskulap911: checks
*** TURN *** [9s 7d 3d] [3s]
arsad725: checks
Jake7123: checks
eskulap911: checks
*** RIVER *** [9s 7d 3d 3s] [4c]
arsad725: checks
Jake7123: checks
eskulap911: bets $0.10 and is all-in
arsad725: folds
Jake7123: folds
Uncalled bet ($0.10) returned to eskulap911
eskulap911 collected $0.14 from pot
*** SUMMARY ***
Total pot $0.14 | Rake $0
Board [9s 7d 3d 3s 4c]
Seat 1: eskulap911 (button) collected ($0.14)
Seat 2: arsad725 (small blind) folded on the River
Seat 3: vezelvu1 (big blind) folded before Flop
Seat 4: sexmit folded before Flop (didn't bet)
Seat 5: Jh0nTravolta folded before Flop (didn't bet)
Seat 6: Jake7123 folded on the River


PokerStars Hand #238169394410:  Hold'em No Limit ($0.01/$0.02 USD) - 2022/08/23 12:31:13 ET
Table 'Despina IV' 6-max Seat #2 is the button
Seat 1: eskulap911 ($0.24 in chips)
Seat 2: arsad725 ($2.10 in chips)
Seat 3: vezelvu1 ($2.81 in chips)
Seat 4: sexmit ($1.92 in chips)
Seat 5: Jh0nTravolta ($2.91 in chips)
Seat 6: Jake7123 ($2.32 in chips)
vezelvu1: posts small blind $0.01
sexmit: posts big blind $0.02
*** HOLE CARDS ***
Jh0nTravolta: folds
Jake7123: raises $0.02 to $0.04
eskulap911: raises $0.20 to $0.24 and is all-in
arsad725: folds
vezelvu1: folds
sexmit: folds
Jake7123: folds
Uncalled bet ($0.20) returned to eskulap911
eskulap911 collected $0.11 from pot
*** SUMMARY ***
Total pot $0.11 | Rake $0
Seat 1: eskulap911 collected ($0.11)
Seat 2: arsad725 (button) folded before Flop (didn't bet)
Seat 3: vezelvu1 (small blind) folded before Flop
Seat 4: sexmit (big blind) folded before Flop
Seat 5: Jh0nTravolta folded before Flop (didn't bet)
Seat 6: Jake7123 folded before Flop


PokerStars Hand #238169400962:  Hold'em No Limit ($0.01/$0.02 USD) - 2022/08/23 12:31:34 ET
Table 'Despina IV' 6-max Seat #3 is the button
Seat 1: eskulap911 ($0.31 in chips)
Seat 2: arsad725 ($2.10 in chips)
Seat 3: vezelvu1 ($2.80 in chips)
Seat 4: sexmit ($1.90 in chips)
Seat 5: Jh0nTravolta ($2.91 in chips)
Seat 6: Jake7123 ($2.28 in chips)
sexmit: posts small blind $0.01
Jh0nTravolta: posts big blind $0.02
*** HOLE CARDS ***
Jake7123: folds
eskulap911: folds
arsad725: folds
vezelvu1: folds
sexmit: calls $0.01
Jh0nTravolta: raises $0.06 to $0.08
sexmit: calls $0.06
*** FLOP *** [Jh 6c Th]
sexmit: checks
Jh0nTravolta: bets $0.05
sexmit: raises $0.15 to $0.20
Jh0nTravolta: folds
Uncalled bet ($0.15) returned to sexmit
sexmit collected $0.25 from pot
*** SUMMARY ***
Total pot $0.26 | Rake $0.01
Board [Jh 6c Th]
Seat 1: eskulap911 folded before Flop (didn't bet)
Seat 2: arsad725 folded before Flop (didn't bet)
Seat 3: vezelvu1 (button) folded before Flop (didn't bet)
Seat 4: sexmit (small blind) collected ($0.25)
Seat 5: Jh0nTravolta (big blind) folded on the Flop
Seat 6: Jake7123 folded before Flop (didn't bet)


PokerStars Hand #238169414950:  Hold'em No Limit ($0.01/$0.02 USD) - 2022/08/23 12:32:18 ET
Table 'Despina IV' 6-max Seat #4 is the button
Seat 1: eskulap911 ($0.31 in chips)
Seat 2: arsad725 ($2.10 in chips)
Seat 3: vezelvu1 ($2.80 in chips)
Seat 4: sexmit ($2.02 in chips)
Seat 5: Jh0nTravolta ($2.78 in chips)
Seat 6: Jake7123 ($2.28 in chips)
Jh0nTravolta: posts small blind $0.01
Jake7123: posts big blind $0.02
*** HOLE CARDS ***
eskulap911: raises $0.29 to $0.31 and is all-in
arsad725: folds
vezelvu1: folds
sexmit: folds
Jh0nTravolta: folds
Jake7123: folds
Uncalled bet ($0.29) returned to eskulap911
eskulap911 collected $0.05 from pot
*** SUMMARY ***
Total pot $0.05 | Rake $0
Seat 1: eskulap911 collected ($0.05)
Seat 2: arsad725 folded before Flop (didn't bet)
Seat 3: vezelvu1 folded before Flop (didn't bet)
Seat 4: sexmit (button) folded before Flop (didn't bet)
Seat 5: Jh0nTravolta (small blind) folded before Flop
Seat 6: Jake7123 (big blind) folded before Flop


PokerStars Hand #238169419458:  Hold'em No Limit ($0.01/$0.02 USD) - 2022/08/23 12:32:33 ET
Table 'Despina IV' 6-max Seat #5 is the button
Seat 1: eskulap911 ($0.34 in chips)
Seat 2: arsad725 ($2.10 in chips)
Seat 3: vezelvu1 ($2.80 in chips)
Seat 4: sexmit ($2.02 in chips)
Seat 5: Jh0nTravolta ($2.77 in chips)
Seat 6: Jake7123 ($2.26 in chips)
Jake7123: posts small blind $0.01
eskulap911: posts big blind $0.02
*** HOLE CARDS ***
arsad725: raises $0.03 to $0.05
vezelvu1: folds
sexmit: calls $0.05
Jh0nTravolta: folds
Jake7123: folds
eskulap911: raises $0.29 to $0.34 and is all-in
arsad725: folds
sexmit: folds
Uncalled bet ($0.29) returned to eskulap911
eskulap911 collected $0.16 from pot
*** SUMMARY ***
Total pot $0.16 | Rake $0
Seat 1: eskulap911 (big blind) collected ($0.16)
Seat 2: arsad725 folded before Flop
Seat 3: vezelvu1 folded before Flop (didn't bet)
Seat 4: sexmit folded before Flop
Seat 5: Jh0nTravolta (button) folded before Flop (didn't bet)
Seat 6: Jake7123 (small blind) folded before Flop


PokerStars Hand #238169425609:  Hold'em No Limit ($0.01/$0.02 USD) - 2022/08/23 12:32:52 ET
Table 'Despina IV' 6-max Seat #6 is the button
Seat 1: eskulap911 ($0.45 in chips)
Seat 2: arsad725 ($2.05 in chips)
Seat 3: vezelvu1 ($2.80 in chips)
Seat 4: sexmit ($1.97 in chips)
Seat 5: Jh0nTravolta ($2.77 in chips)
Seat 6: Jake7123 ($2.25 in chips)
eskulap911: posts small blind $0.01
arsad725: posts big blind $0.02
*** HOLE CARDS ***
vezelvu1: folds
sexmit: folds
Jh0nTravolta: folds
Jake7123: folds
eskulap911: calls $0.01
arsad725: checks
*** FLOP *** [Ac 7h 4c]
eskulap911: checks
arsad725: checks
*** TURN *** [Ac 7h 4c] [6c]
eskulap911: bets $0.43 and is all-in
arsad725: folds
Uncalled bet ($0.43) returned to eskulap911
eskulap911 collected $0.04 from pot
*** SUMMARY ***
Total pot $0.04 | Rake $0
Board [Ac 7h 4c 6c]
Seat 1: eskulap911 (small blind) collected ($0.04)
Seat 2: arsad725 (big blind) folded on the Turn
Seat 3: vezelvu1 folded before Flop (didn't bet)
Seat 4: sexmit folded before Flop (didn't bet)
Seat 5: Jh0nTravolta folded before Flop (didn't bet)
Seat 6: Jake7123 (button) folded before Flop (didn't bet)


PokerStars Hand #238169433810:  Hold'em No Limit ($0.01/$0.02 USD) - 2022/08/23 12:33:17 ET
Table 'Despina IV' 6-max Seat #1 is the button
Seat 1: eskulap911 ($0.47 in chips)
Seat 2: arsad725 ($2.03 in chips)
Seat 3: vezelvu1 ($2.80 in chips)
Seat 4: sexmit ($1.97 in chips)
Seat 5: Jh0nTravolta ($2.77 in chips)
Seat 6: Jake7123 ($2.25 in chips)
arsad725: posts small blind $0.01
vezelvu1: posts big blind $0.02
*** HOLE CARDS ***
sexmit: folds
Jh0nTravolta: folds
Jake7123: folds
eskulap911: folds
arsad725: folds
Uncalled bet ($0.01) returned to vezelvu1
vezelvu1 collected $0.02 from pot
*** SUMMARY ***
Total pot $0.02 | Rake $0
Seat 1: eskulap911 (button) folded before Flop (didn't bet)
Seat 2: arsad725 (small blind) folded before Flop
Seat 3: vezelvu1 (big blind) collected ($0.02)
Seat 4: sexmit folded before Flop (didn't bet)
Seat 5: Jh0nTravolta folded before Flop (didn't bet)
Seat 6: Jake7123 folded before Flop (didn't bet)


PokerStars Hand #238169438318:  Hold'em No Limit ($0.01/$0.02 USD) - 2022/08/23 12:33:32 ET
Table 'Despina IV' 6-max Seat #2 is the button
Seat 1: eskulap911 ($0.47 in chips)
Seat 2: arsad725 ($2.02 in chips)
Seat 3: vezelvu1 ($2.81 in chips)
Seat 4: sexmit ($1.97 in chips)
Seat 5: Jh0nTravolta ($2.77 in chips)
Seat 6: Jake7123 ($2.25 in chips)
vezelvu1: posts small blind $0.01
sexmit: posts big blind $0.02
*** HOLE CARDS ***
Jh0nTravolta: folds
Jake7123: folds
eskulap911: folds
arsad725: folds
vezelvu1: raises $0.04 to $0.06
sexmit: calls $0.04
*** FLOP *** [Jh 6c 3h]
vezelvu1: checks
sexmit: bets $0.08
vezelvu1: folds
Uncalled bet ($0.08) returned to sexmit
sexmit collected $0.12 from pot
*** SUMMARY ***
Total pot $0.12 | Rake $0
Board [Jh 6c 3h]
Seat 1: eskulap911 folded before Flop (didn't bet)
Seat 2: arsad725 (button) folded before Flop (didn't bet)
Seat 3: vezelvu1 (small blind) folded on the Flop
Seat 4: sexmit (big blind) collected ($0.12)
Seat 5: Jh0nTravolta folded before Flop (didn't bet)
Seat 6: Jake7123 folded before Flop (didn't bet)


PokerStars Hand #238169448098:  Hold'em No Limit ($0.01/$0.02 USD) - 2022/08/23 12:34:03 ET
Table 'Despina IV' 6-max Seat #3 is the button
Seat 1: eskulap911 ($0.47 in chips)
Seat 2: arsad725 ($2.02 in chips)
Seat 3: vezelvu1 ($2.75 in chips)
Seat 4: sexmit ($2.03 in chips)
Seat 5: Jh0nTravolta ($2.77 in chips)
Seat 6: Jake7123 ($2.25 in chips)
sexmit: posts small blind $0.01
Jh0nTravolta: posts big blind $0.02
*** HOLE CARDS ***
Jake7123: folds
eskulap911: raises $0.45 to $0.47 and is all-in
arsad725: folds
vezelvu1: folds
sexmit: folds
Jh0nTravolta: folds
Uncalled bet ($0.45) returned to eskulap911
eskulap911 collected $0.05 from pot
*** SUMMARY ***
Total pot $0.05 | Rake $0
Seat 1: eskulap911 collected ($0.05)
Seat 2: arsad725 folded before Flop (didn't bet)
Seat 3: vezelvu1 (button) folded before Flop (didn't bet)
Seat 4: sexmit (small blind) folded before Flop
Seat 5: Jh0nTravolta (big blind) folded before Flop
Seat 6: Jake7123 folded before Flop (didn't bet)


PokerStars Hand #238169453149:  Hold'em No Limit ($0.01/$0.02 USD) - 2022/08/23 12:34:19 ET
Table 'Despina IV' 6-max Seat #4 is the button
Seat 1: eskulap911 ($0.50 in chips)
Seat 2: arsad725 ($2.02 in chips)
Seat 3: vezelvu1 ($2.75 in chips)
Seat 4: sexmit ($2.02 in chips)
Seat 5: Jh0nTravolta ($2.75 in chips)
Seat 6: Jake7123 ($2.25 in chips)
Jh0nTravolta: posts small blind $0.01
Jake7123: posts big blind $0.02
*** HOLE CARDS ***
eskulap911: raises $0.06 to $0.08
arsad725: folds
vezelvu1: folds
sexmit: folds
Jh0nTravolta: folds
Jake7123: folds
Uncalled bet ($0.06) returned to eskulap911
eskulap911 collected $0.05 from pot
*** SUMMARY ***
Total pot $0.05 | Rake $0
Seat 1: eskulap911 collected ($0.05)
Seat 2: arsad725 folded before Flop (didn't bet)
Seat 3: vezelvu1 folded before Flop (didn't bet)
Seat 4: sexmit (button) folded before Flop (didn't bet)
Seat 5: Jh0nTravolta (small blind) folded before Flop
Seat 6: Jake7123 (big blind) folded before Flop


PokerStars Hand #238169457282:  Hold'em No Limit ($0.01/$0.02 USD) - 2022/08/23 12:34:31 ET
Table 'Despina IV' 6-max Seat #5 is the button
Seat 1: eskulap911 ($0.53 in chips)
Seat 2: arsad725 ($2.02 in chips)
Seat 3: vezelvu1 ($2.75 in chips)
Seat 4: sexmit ($2.02 in chips)
Seat 5: Jh0nTravolta ($2.74 in chips)
Seat 6: Jake7123 ($2.23 in chips)
Jake7123: posts small blind $0.01
eskulap911: posts big blind $0.02
*** HOLE CARDS ***
arsad725: folds
vezelvu1: raises $0.04 to $0.06
sexmit: folds
Jh0nTravolta: raises $0.12 to $0.18
Jake7123: folds
eskulap911: folds
vezelvu1: calls $0.12
*** FLOP *** [4h 3d 3h]
vezelvu1: checks
Jh0nTravolta: bets $0.18
vezelvu1: folds
Uncalled bet ($0.18) returned to Jh0nTravolta
Jh0nTravolta collected $0.38 from pot
Jh0nTravolta: doesn't show hand
*** SUMMARY ***
Total pot $0.39 | Rake $0.01
Board [4h 3d 3h]
Seat 1: eskulap911 (big blind) folded before Flop
Seat 2: arsad725 folded before Flop (didn't bet)
Seat 3: vezelvu1 folded on the Flop
Seat 4: sexmit folded before Flop (didn't bet)
Seat 5: Jh0nTravolta (button) collected ($0.38)
Seat 6: Jake7123 (small blind) folded before Flop


PokerStars Hand #238169470464:  Hold'em No Limit ($0.01/$0.02 USD) - 2022/08/23 12:35:12 ET
Table 'Despina IV' 6-max Seat #6 is the button
Seat 1: eskulap911 ($0.51 in chips)
Seat 2: arsad725 ($2.02 in chips)
Seat 3: vezelvu1 ($2.57 in chips)
Seat 4: sexmit ($2.02 in chips)
Seat 5: Jh0nTravolta ($2.94 in chips)
Seat 6: Jake7123 ($2.22 in chips)
eskulap911: posts small blind $0.01
arsad725: posts big blind $0.02
*** HOLE CARDS ***
vezelvu1: folds
sexmit: folds
Jh0nTravolta: raises $0.03 to $0.05
Jake7123: folds
eskulap911: folds
arsad725: folds
Uncalled bet ($0.03) returned to Jh0nTravolta
Jh0nTravolta collected $0.05 from pot
Jh0nTravolta: doesn't show hand
*** SUMMARY ***
Total pot $0.05 | Rake $0
Seat 1: eskulap911 (small blind) folded before Flop
Seat 2: arsad725 (big blind) folded before Flop
Seat 3: vezelvu1 folded before Flop (didn't bet)
Seat 4: sexmit folded before Flop (didn't bet)
Seat 5: Jh0nTravolta collected ($0.05)
Seat 6: Jake7123 (button) folded before Flop (didn't bet)


PokerStars Hand #238169475980:  Hold'em No Limit ($0.01/$0.02 USD) - 2022/08/23 12:35:29 ET
Table 'Despina IV' 6-max Seat #1 is the button
Seat 1: eskulap911 ($0.50 in chips)
Seat 2: arsad725 ($2 in chips)
Seat 3: vezelvu1 ($2.57 in chips)
Seat 4: sexmit ($2.02 in chips)
Seat 5: Jh0nTravolta ($2.97 in chips)
Seat 6: Jake7123 ($2.22 in chips)
arsad725: posts small blind $0.01
vezelvu1: posts big blind $0.02
*** HOLE CARDS ***
sexmit: folds
Jh0nTravolta: folds
Jake7123: folds
eskulap911: raises $0.08 to $0.10
arsad725: folds
vezelvu1: folds
Uncalled bet ($0.08) returned to eskulap911
eskulap911 collected $0.05 from pot
*** SUMMARY ***
Total pot $0.05 | Rake $0
Seat 1: eskulap911 (button) collected ($0.05)
Seat 2: arsad725 (small blind) folded before Flop
Seat 3: vezelvu1 (big blind) folded before Flop
Seat 4: sexmit folded before Flop (didn't bet)
Seat 5: Jh0nTravolta folded before Flop (didn't bet)
Seat 6: Jake7123 folded before Flop (didn't bet)


PokerStars Hand #238169480663:  Hold'em No Limit ($0.01/$0.02 USD) - 2022/08/23 12:35:44 ET
Table 'Despina IV' 6-max Seat #2 is the button
Seat 1: eskulap911 ($0.53 in chips)
Seat 2: arsad725 ($2 in chips)
Seat 3: vezelvu1 ($2.55 in chips)
Seat 4: sexmit ($2.02 in chips)
Seat 5: Jh0nTravolta ($2.97 in chips)
Seat 6: Jake7123 ($2.22 in chips)
vezelvu1: posts small blind $0.01
sexmit: posts big blind $0.02
*** HOLE CARDS ***
Jh0nTravolta: folds
Jh0nTravolta leaves the table
Jake7123: folds
eskulap911: raises $0.08 to $0.10
arsad725: folds
vezelvu1: folds
toleabs2022 joins the table at seat #5
sexmit: folds
Uncalled bet ($0.08) returned to eskulap911
eskulap911 collected $0.05 from pot
*** SUMMARY ***
Total pot $0.05 | Rake $0
Seat 1: eskulap911 collected ($0.05)
Seat 2: arsad725 (button) folded before Flop (didn't bet)
Seat 3: vezelvu1 (small blind) folded before Flop
Seat 4: sexmit (big blind) folded before Flop
Seat 5: Jh0nTravolta folded before Flop (didn't bet)
Seat 6: Jake7123 folded before Flop (didn't bet)


PokerStars Hand #238169487881:  Hold'em No Limit ($0.01/$0.02 USD) - 2022/08/23 12:36:06 ET
Table 'Despina IV' 6-max Seat #3 is the button
Seat 1: eskulap911 ($0.56 in chips)
Seat 2: arsad725 ($2 in chips)
Seat 3: vezelvu1 ($2.54 in chips)
Seat 4: sexmit ($2 in chips)
Seat 5: toleabs2022 ($0.80 in chips)
Seat 6: Jake7123 ($2.22 in chips)
sexmit: posts small blind $0.01
toleabs2022: posts big blind $0.02
*** HOLE CARDS ***
Jake7123: folds
eskulap911: raises $0.08 to $0.10
arsad725: folds
vezelvu1: folds
sexmit: folds
toleabs2022: folds
Uncalled bet ($0.08) returned to eskulap911
eskulap911 collected $0.05 from pot
*** SUMMARY ***
Total pot $0.05 | Rake $0
Seat 1: eskulap911 collected ($0.05)
Seat 2: arsad725 folded before Flop (didn't bet)
Seat 3: vezelvu1 (button) folded before Flop (didn't bet)
Seat 4: sexmit (small blind) folded before Flop
Seat 5: toleabs2022 (big blind) folded before Flop
Seat 6: Jake7123 folded before Flop (didn't bet)


PokerStars Hand #238169492784:  Hold'em No Limit ($0.01/$0.02 USD) - 2022/08/23 12:36:22 ET
Table 'Despina IV' 6-max Seat #4 is the button
Seat 1: eskulap911 ($0.59 in chips)
Seat 2: arsad725 ($2 in chips)
Seat 3: vezelvu1 ($2.54 in chips)
Seat 4: sexmit ($1.99 in chips)
Seat 5: toleabs2022 ($0.78 in chips)
Seat 6: Jake7123 ($2.22 in chips)
toleabs2022: posts small blind $0.01
Jake7123: posts big blind $0.02
*** HOLE CARDS ***
eskulap911: folds
arsad725: folds
vezelvu1: folds
sexmit: raises $0.02 to $0.04
toleabs2022: folds
Jake7123: folds
Uncalled bet ($0.02) returned to sexmit
sexmit collected $0.05 from pot
*** SUMMARY ***
Total pot $0.05 | Rake $0
Seat 1: eskulap911 folded before Flop (didn't bet)
Seat 2: arsad725 folded before Flop (didn't bet)
Seat 3: vezelvu1 folded before Flop (didn't bet)
Seat 4: sexmit (button) collected ($0.05)
Seat 5: toleabs2022 (small blind) folded before Flop
Seat 6: Jake7123 (big blind) folded before Flop


PokerStars Hand #238169497666:  Hold'em No Limit ($0.01/$0.02 USD) - 2022/08/23 12:36:37 ET
Table 'Despina IV' 6-max Seat #5 is the button
Seat 1: eskulap911 ($0.59 in chips)
Seat 2: arsad725 ($2 in chips)
Seat 3: vezelvu1 ($2.54 in chips)
Seat 4: sexmit ($2.02 in chips)
Seat 5: toleabs2022 ($0.77 in chips)
Seat 6: Jake7123 ($2.20 in chips)
Jake7123: posts small blind $0.01
eskulap911: posts big blind $0.02
*** HOLE CARDS ***
arsad725: folds
vezelvu1: folds
sexmit: folds
toleabs2022: calls $0.02
Jake7123: raises $0.04 to $0.06
eskulap911: calls $0.04
toleabs2022: calls $0.04
*** FLOP *** [Jd 5s Td]
Jake7123: bets $0.08
eskulap911: folds
toleabs2022: folds
Uncalled bet ($0.08) returned to Jake7123
Jake7123 collected $0.17 from pot
Jake7123: doesn't show hand
*** SUMMARY ***
Total pot $0.18 | Rake $0.01
Board [Jd 5s Td]
Seat 1: eskulap911 (big blind) folded on the Flop
Seat 2: arsad725 folded before Flop (didn't bet)
Seat 3: vezelvu1 folded before Flop (didn't bet)
Seat 4: sexmit folded before Flop (didn't bet)
Seat 5: toleabs2022 (button) folded on the Flop
Seat 6: Jake7123 (small blind) collected ($0.17)


PokerStars Hand #238169508877:  Hold'em No Limit ($0.01/$0.02 USD) - 2022/08/23 12:37:12 ET
Table 'Despina IV' 6-max Seat #6 is the button
Seat 1: eskulap911 ($0.53 in chips)
Seat 2: arsad725 ($2 in chips)
Seat 3: vezelvu1 ($2.54 in chips)
Seat 4: sexmit ($2.02 in chips)
Seat 5: toleabs2022 ($0.71 in chips)
Seat 6: Jake7123 ($2.31 in chips)
eskulap911: posts small blind $0.01
arsad725: posts big blind $0.02
*** HOLE CARDS ***
vezelvu1: folds
sexmit: raises $0.02 to $0.04
toleabs2022: raises $0.02 to $0.06
Jake7123: folds
eskulap911: raises $0.14 to $0.20
arsad725: folds
sexmit: folds
toleabs2022: folds
Uncalled bet ($0.14) returned to eskulap911
eskulap911 collected $0.18 from pot
*** SUMMARY ***
Total pot $0.18 | Rake $0
Seat 1: eskulap911 (small blind) collected ($0.18)
Seat 2: arsad725 (big blind) folded before Flop
Seat 3: vezelvu1 folded before Flop (didn't bet)
Seat 4: sexmit folded before Flop
Seat 5: toleabs2022 folded before Flop
Seat 6: Jake7123 (button) folded before Flop (didn't bet)


PokerStars Hand #238169518410:  Hold'em No Limit ($0.01/$0.02 USD) - 2022/08/23 12:37:41 ET
Table 'Despina IV' 6-max Seat #1 is the button
Seat 1: eskulap911 ($0.65 in chips)
Seat 2: arsad725 ($2 in chips)
Seat 3: vezelvu1 ($2.54 in chips)
Seat 4: sexmit ($1.98 in chips)
Seat 5: toleabs2022 ($0.65 in chips)
Seat 6: Jake7123 ($2.31 in chips)
arsad725: posts small blind $0.01
vezelvu1: posts big blind $0.02
*** HOLE CARDS ***
sexmit: raises $0.02 to $0.04
toleabs2022: calls $0.04
Jake7123: folds
eskulap911: calls $0.04
arsad725: folds
vezelvu1: folds
*** FLOP *** [8c 6c Th]
sexmit: checks
toleabs2022: bets $0.07
eskulap911: raises $0.54 to $0.61 and is all-in
sexmit: folds
toleabs2022: folds
Uncalled bet ($0.54) returned to eskulap911
eskulap911 collected $0.28 from pot
*** SUMMARY ***
Total pot $0.29 | Rake $0.01
Board [8c 6c Th]
Seat 1: eskulap911 (button) collected ($0.28)
Seat 2: arsad725 (small blind) folded before Flop
Seat 3: vezelvu1 (big blind) folded before Flop
Seat 4: sexmit folded on the Flop
Seat 5: toleabs2022 folded on the Flop
Seat 6: Jake7123 folded before Flop (didn't bet)


PokerStars Hand #238169529208:  Hold'em No Limit ($0.01/$0.02 USD) - 2022/08/23 12:38:14 ET
Table 'Despina IV' 6-max Seat #2 is the button
Seat 1: eskulap911 ($0.82 in chips)
Seat 2: arsad725 ($2 in chips)
Seat 3: vezelvu1 ($2.52 in chips)
Seat 4: sexmit ($1.94 in chips)
Seat 5: toleabs2022 ($0.54 in chips)
Seat 6: Jake7123 ($2.31 in chips)
vezelvu1: posts small blind $0.01
sexmit: posts big blind $0.02
*** HOLE CARDS ***
toleabs2022: calls $0.02
Jake7123: folds
eskulap911: calls $0.02
arsad725: folds
vezelvu1: calls $0.01
sexmit: checks
*** FLOP *** [Js 2s 2c]
vezelvu1: checks
sexmit: checks
toleabs2022: checks
eskulap911: bets $0.10
vezelvu1: folds
sexmit: folds
toleabs2022: calls $0.10
*** TURN *** [Js 2s 2c] [3s]
toleabs2022: checks
eskulap911: bets $0.70 and is all-in
toleabs2022: calls $0.42 and is all-in
Uncalled bet ($0.28) returned to eskulap911
*** RIVER *** [Js 2s 2c 3s] [Kc]
*** SHOW DOWN ***
toleabs2022: shows [Jc 9s] (two pair, Jacks and Deuces)
eskulap911: shows [8h Kd] (two pair, Kings and Deuces)
eskulap911 collected $1.08 from pot
*** SUMMARY ***
Total pot $1.12 | Rake $0.04
Board [Js 2s 2c 3s Kc]
Seat 1: eskulap911 showed [8h Kd] and won ($1.08) with two pair, Kings and Deuces
Seat 2: arsad725 (button) folded before Flop (didn't bet)
Seat 3: vezelvu1 (small blind) folded on the Flop
Seat 4: sexmit (big blind) folded on the Flop
Seat 5: toleabs2022 showed [Jc 9s] and lost with two pair, Jacks and Deuces
Seat 6: Jake7123 folded before Flop (didn't bet)


PokerStars Hand #238169553246:  Hold'em No Limit ($0.01/$0.02 USD) - 2022/08/23 12:39:28 ET
Table 'Despina IV' 6-max Seat #3 is the button
Seat 1: eskulap911 ($1.36 in chips)
Seat 2: arsad725 ($2 in chips)
Seat 3: vezelvu1 ($2.50 in chips)
Seat 4: sexmit ($1.92 in chips)
Seat 6: Jake7123 ($2.31 in chips)
sexmit: posts small blind $0.01
Jake7123: posts big blind $0.02
*** HOLE CARDS ***
eskulap911: calls $0.02
arsad725: folds
vezelvu1: folds
sexmit: calls $0.01
Jake7123: checks
*** FLOP *** [Ad Qs 5s]
sexmit: checks
Jake7123: checks
eskulap911: bets $0.20
sexmit: folds
Jake7123: folds
Uncalled bet ($0.20) returned to eskulap911
eskulap911 collected $0.06 from pot
*** SUMMARY ***
Total pot $0.06 | Rake $0
Board [Ad Qs 5s]
Seat 1: eskulap911 collected ($0.06)
Seat 2: arsad725 folded before Flop (didn't bet)
Seat 3: vezelvu1 (button) folded before Flop (didn't bet)
Seat 4: sexmit (small blind) folded on the Flop
Seat 6: Jake7123 (big blind) folded on the Flop


PokerStars Hand #238169563625:  Hold'em No Limit ($0.01/$0.02 USD) - 2022/08/23 12:39:59 ET
Table 'Despina IV' 6-max Seat #4 is the button
Seat 1: eskulap911 ($1.40 in chips)
Seat 2: arsad725 ($2 in chips)
Seat 3: vezelvu1 ($2.50 in chips)
Seat 4: sexmit ($1.90 in chips)
Seat 6: Jake7123 ($2.29 in chips)
Jake7123: posts small blind $0.01
eskulap911: posts big blind $0.02
*** HOLE CARDS ***
arsad725: folds
vezelvu1: raises $0.04 to $0.06
sexmit: folds
Jake7123: folds
eskulap911: folds
Uncalled bet ($0.04) returned to vezelvu1
vezelvu1 collected $0.05 from pot
*** SUMMARY ***
Total pot $0.05 | Rake $0
Seat 1: eskulap911 (big blind) folded before Flop
Seat 2: arsad725 folded before Flop (didn't bet)
Seat 3: vezelvu1 collected ($0.05)
Seat 4: sexmit (button) folded before Flop (didn't bet)
Seat 6: Jake7123 (small blind) folded before Flop


PokerStars Hand #238169569107:  Hold'em No Limit ($0.01/$0.02 USD) - 2022/08/23 12:40:16 ET
Table 'Despina IV' 6-max Seat #6 is the button
Seat 1: eskulap911 ($1.38 in chips)
Seat 2: arsad725 ($2 in chips)
Seat 3: vezelvu1 ($2.53 in chips)
Seat 4: sexmit ($1.90 in chips)
Seat 6: Jake7123 ($2.28 in chips)
eskulap911: posts small blind $0.01
arsad725: posts big blind $0.02
*** HOLE CARDS ***
vezelvu1: folds
sexmit: folds
Jake7123: folds
eskulap911: folds
Uncalled bet ($0.01) returned to arsad725
arsad725 collected $0.02 from pot
arsad725: doesn't show hand
*** SUMMARY ***
Total pot $0.02 | Rake $0
Seat 1: eskulap911 (small blind) folded before Flop
Seat 2: arsad725 (big blind) collected ($0.02)
Seat 3: vezelvu1 folded before Flop (didn't bet)
Seat 4: sexmit folded before Flop (didn't bet)
Seat 6: Jake7123 (button) folded before Flop (didn't bet)


PokerStars Hand #238169572622:  Hold'em No Limit ($0.01/$0.02 USD) - 2022/08/23 12:40:27 ET
Table 'Despina IV' 6-max Seat #1 is the button
Seat 1: eskulap911 ($1.37 in chips)
Seat 2: arsad725 ($2.01 in chips)
Seat 3: vezelvu1 ($2.53 in chips)
Seat 4: sexmit ($1.90 in chips)
Seat 6: Jake7123 ($2.28 in chips)
arsad725: posts small blind $0.01
vezelvu1: posts big blind $0.02
*** HOLE CARDS ***
sexmit: folds
Jake7123: folds
eskulap911: folds
arsad725: folds
Uncalled bet ($0.01) returned to vezelvu1
vezelvu1 collected $0.02 from pot
*** SUMMARY ***
Total pot $0.02 | Rake $0
Seat 1: eskulap911 (button) folded before Flop (didn't bet)
Seat 2: arsad725 (small blind) folded before Flop
Seat 3: vezelvu1 (big blind) collected ($0.02)
Seat 4: sexmit folded before Flop (didn't bet)
Seat 6: Jake7123 folded before Flop (didn't bet)


PokerStars Hand #238169574864:  Hold'em No Limit ($0.01/$0.02 USD) - 2022/08/23 12:40:34 ET
Table 'Despina IV' 6-max Seat #2 is the button
Seat 1: eskulap911 ($1.37 in chips)
Seat 2: arsad725 ($2 in chips)
Seat 3: vezelvu1 ($2.54 in chips)
Seat 4: sexmit ($1.90 in chips)
Seat 6: Jake7123 ($2.28 in chips)
vezelvu1: posts small blind $0.01
sexmit: posts big blind $0.02
*** HOLE CARDS ***
Jake7123: folds
eskulap911: folds
arsad725: folds
vezelvu1: folds
Uncalled bet ($0.01) returned to sexmit
sexmit collected $0.02 from pot
*** SUMMARY ***
Total pot $0.02 | Rake $0
Seat 1: eskulap911 folded before Flop (didn't bet)
Seat 2: arsad725 (button) folded before Flop (didn't bet)
Seat 3: vezelvu1 (small blind) folded before Flop
Seat 4: sexmit (big blind) collected ($0.02)
Seat 6: Jake7123 folded before Flop (didn't bet)


PokerStars Hand #238169577992:  Hold'em No Limit ($0.01/$0.02 USD) - 2022/08/23 12:40:44 ET
Table 'Despina IV' 6-max Seat #3 is the button
Seat 1: eskulap911 ($1.37 in chips)
Seat 2: arsad725 ($2 in chips)
Seat 3: vezelvu1 ($2.53 in chips)
Seat 4: sexmit ($1.91 in chips)
Seat 6: Jake7123 ($2.28 in chips)
sexmit: posts small blind $0.01
Jake7123: posts big blind $0.02
*** HOLE CARDS ***
eskulap911: folds
arsad725: folds
vezelvu1: folds
sexmit: raises $0.05 to $0.07
Jake7123: calls $0.05
*** FLOP *** [Td 8c Kh]
sexmit: checks
Jake7123: bets $0.07
sexmit: calls $0.07
*** TURN *** [Td 8c Kh] [7s]
sexmit: checks
Jake7123: bets $0.27
sexmit: folds
Uncalled bet ($0.27) returned to Jake7123
Jake7123 collected $0.27 from pot
Jake7123: doesn't show hand
*** SUMMARY ***
Total pot $0.28 | Rake $0.01
Board [Td 8c Kh 7s]
Seat 1: eskulap911 folded before Flop (didn't bet)
Seat 2: arsad725 folded before Flop (didn't bet)
Seat 3: vezelvu1 (button) folded before Flop (didn't bet)
Seat 4: sexmit (small blind) folded on the Turn
Seat 6: Jake7123 (big blind) collected ($0.27)


PokerStars Hand #238169590896:  Hold'em No Limit ($0.01/$0.02 USD) - 2022/08/23 12:41:23 ET
Table 'Despina IV' 6-max Seat #4 is the button
Seat 1: eskulap911 ($1.37 in chips)
Seat 2: arsad725 ($2 in chips)
Seat 3: vezelvu1 ($2.53 in chips)
Seat 4: sexmit ($1.77 in chips)
Seat 6: Jake7123 ($2.41 in chips)
Jake7123: posts small blind $0.01
eskulap911: posts big blind $0.02
*** HOLE CARDS ***
arsad725: folds
vezelvu1: folds
sexmit: folds
Jake7123: folds
Uncalled bet ($0.01) returned to eskulap911
eskulap911 collected $0.02 from pot
*** SUMMARY ***
Total pot $0.02 | Rake $0
Seat 1: eskulap911 (big blind) collected ($0.02)
Seat 2: arsad725 folded before Flop (didn't bet)
Seat 3: vezelvu1 folded before Flop (didn't bet)
Seat 4: sexmit (button) folded before Flop (didn't bet)
Seat 6: Jake7123 (small blind) folded before Flop


PokerStars Hand #238169595064:  Hold'em No Limit ($0.01/$0.02 USD) - 2022/08/23 12:41:36 ET
Table 'Despina IV' 6-max Seat #6 is the button
Seat 1: eskulap911 ($1.38 in chips)
Seat 2: arsad725 ($2 in chips)
Seat 3: vezelvu1 ($2.53 in chips)
Seat 4: sexmit ($1.77 in chips)
Seat 6: Jake7123 ($2.40 in chips)
eskulap911: posts small blind $0.01
arsad725: posts big blind $0.02
*** HOLE CARDS ***
vezelvu1: raises $0.02 to $0.04
sexmit: folds
Jake7123: folds
eskulap911: calls $0.03
arsad725: folds
*** FLOP *** [Js Kd Th]
eskulap911: checks
vezelvu1: checks
*** TURN *** [Js Kd Th] [2d]
eskulap911: checks
vezelvu1: bets $0.06
eskulap911: raises $0.06 to $0.12
vezelvu1: calls $0.06
*** RIVER *** [Js Kd Th 2d] [5d]
eskulap911: checks
vezelvu1: bets $0.46
eskulap911: folds
Uncalled bet ($0.46) returned to vezelvu1
vezelvu1 collected $0.33 from pot
*** SUMMARY ***
Total pot $0.34 | Rake $0.01
Board [Js Kd Th 2d 5d]
Seat 1: eskulap911 (small blind) folded on the River
Seat 2: arsad725 (big blind) folded before Flop
Seat 3: vezelvu1 collected ($0.33)
Seat 4: sexmit folded before Flop (didn't bet)
Seat 6: Jake7123 (button) folded before Flop (didn't bet)


PokerStars Hand #238169614345:  Hold'em No Limit ($0.01/$0.02 USD) - 2022/08/23 12:42:37 ET
Table 'Despina IV' 6-max Seat #1 is the button
Seat 1: eskulap911 ($1.22 in chips)
Seat 2: arsad725 ($2 in chips)
Seat 3: vezelvu1 ($2.70 in chips)
Seat 4: sexmit ($1.77 in chips)
Seat 6: Jake7123 ($2.40 in chips)
arsad725: posts small blind $0.01
vezelvu1: posts big blind $0.02
*** HOLE CARDS ***
sexmit: folds
Jake7123: folds
eskulap911: calls $0.02
arsad725: folds
vezelvu1: checks
*** FLOP *** [Kc 4h 6d]
vezelvu1: checks
eskulap911: bets $0.08
vezelvu1: folds
Uncalled bet ($0.08) returned to eskulap911
eskulap911 collected $0.05 from pot
*** SUMMARY ***
Total pot $0.05 | Rake $0
Board [Kc 4h 6d]
Seat 1: eskulap911 (button) collected ($0.05)
Seat 2: arsad725 (small blind) folded before Flop
Seat 3: vezelvu1 (big blind) folded on the Flop
Seat 4: sexmit folded before Flop (didn't bet)
Seat 6: Jake7123 folded before Flop (didn't bet)


PokerStars Hand #238169624240:  Hold'em No Limit ($0.01/$0.02 USD) - 2022/08/23 12:43:07 ET
Table 'Despina IV' 6-max Seat #2 is the button
Seat 1: eskulap911 ($1.25 in chips)
Seat 2: arsad725 ($2 in chips)
Seat 3: vezelvu1 ($2.68 in chips)
Seat 4: sexmit ($1.77 in chips)
Seat 6: Jake7123 ($2.40 in chips)
vezelvu1: posts small blind $0.01
sexmit: posts big blind $0.02
*** HOLE CARDS ***
Jake7123: folds
eskulap911: calls $0.02
arsad725: folds
vezelvu1: folds
sexmit: checks
*** FLOP *** [6h Tc 5d]
sexmit: checks
eskulap911: bets $1.23 and is all-in
sexmit: folds
Uncalled bet ($1.23) returned to eskulap911
eskulap911 collected $0.05 from pot
*** SUMMARY ***
Total pot $0.05 | Rake $0
Board [6h Tc 5d]
Seat 1: eskulap911 collected ($0.05)
Seat 2: arsad725 (button) folded before Flop (didn't bet)
Seat 3: vezelvu1 (small blind) folded before Flop
Seat 4: sexmit (big blind) folded on the Flop
Seat 6: Jake7123 folded before Flop (didn't bet)


PokerStars Hand #238169631559:  Hold'em No Limit ($0.01/$0.02 USD) - 2022/08/23 12:43:30 ET
Table 'Despina IV' 6-max Seat #3 is the button
Seat 1: eskulap911 ($1.28 in chips)
Seat 2: arsad725 ($2 in chips)
Seat 3: vezelvu1 ($2.67 in chips)
Seat 4: sexmit ($1.75 in chips)
Seat 6: Jake7123 ($2.40 in chips)
sexmit: posts small blind $0.01
Jake7123: posts big blind $0.02
*** HOLE CARDS ***
eskulap911: folds
arsad725: raises $0.03 to $0.05
vezelvu1: folds
toleabs2022 is disconnected
sexmit: calls $0.04
Jake7123: calls $0.03
*** FLOP *** [2d 3c Ks]
sexmit: checks
Jake7123: bets $0.07
arsad725: raises $0.14 to $0.21
sexmit: folds
Jake7123: folds
Uncalled bet ($0.14) returned to arsad725
arsad725 collected $0.28 from pot
arsad725: doesn't show hand
*** SUMMARY ***
Total pot $0.29 | Rake $0.01
Board [2d 3c Ks]
Seat 1: eskulap911 folded before Flop (didn't bet)
Seat 2: arsad725 collected ($0.28)
Seat 3: vezelvu1 (button) folded before Flop (didn't bet)
Seat 4: sexmit (small blind) folded on the Flop
Seat 6: Jake7123 (big blind) folded on the Flop


PokerStars Hand #238169644066:  Hold'em No Limit ($0.01/$0.02 USD) - 2022/08/23 12:44:09 ET
Table 'Despina IV' 6-max Seat #4 is the button
Seat 1: eskulap911 ($1.28 in chips)
Seat 2: arsad725 ($2.16 in chips)
Seat 3: vezelvu1 ($2.67 in chips)
Seat 4: sexmit ($1.70 in chips)
Seat 6: Jake7123 ($2.28 in chips)
Jake7123: posts small blind $0.01
eskulap911: posts big blind $0.02
*** HOLE CARDS ***
arsad725: folds
vezelvu1: folds
sexmit: folds
Jake7123: folds
Uncalled bet ($0.01) returned to eskulap911
eskulap911 collected $0.02 from pot
*** SUMMARY ***
Total pot $0.02 | Rake $0
Seat 1: eskulap911 (big blind) collected ($0.02)
Seat 2: arsad725 folded before Flop (didn't bet)
Seat 3: vezelvu1 folded before Flop (didn't bet)
Seat 4: sexmit (button) folded before Flop (didn't bet)
Seat 6: Jake7123 (small blind) folded before Flop


PokerStars Hand #238169647819:  Hold'em No Limit ($0.01/$0.02 USD) - 2022/08/23 12:44:21 ET
Table 'Despina IV' 6-max Seat #6 is the button
Seat 1: eskulap911 ($1.29 in chips)
Seat 2: arsad725 ($2.16 in chips)
Seat 3: vezelvu1 ($2.67 in chips)
Seat 4: sexmit ($1.70 in chips)
Seat 6: Jake7123 ($2.27 in chips)
eskulap911: posts small blind $0.01
arsad725: posts big blind $0.02
*** HOLE CARDS ***
vezelvu1: folds
sexmit: raises $0.02 to $0.04
Jake7123: folds
eskulap911: folds
arsad725: folds
Uncalled bet ($0.02) returned to sexmit
sexmit collected $0.05 from pot
*** SUMMARY ***
Total pot $0.05 | Rake $0
Seat 1: eskulap911 (small blind) folded before Flop
Seat 2: arsad725 (big blind) folded before Flop
Seat 3: vezelvu1 folded before Flop (didn't bet)
Seat 4: sexmit collected ($0.05)
Seat 6: Jake7123 (button) folded before Flop (didn't bet)


PokerStars Hand #238169651028:  Hold'em No Limit ($0.01/$0.02 USD) - 2022/08/23 12:44:31 ET
Table 'Despina IV' 6-max Seat #1 is the button
Seat 1: eskulap911 ($1.28 in chips)
Seat 2: arsad725 ($2.14 in chips)
Seat 3: vezelvu1 ($2.67 in chips)
Seat 4: sexmit ($1.73 in chips)
Seat 6: Jake7123 ($2.27 in chips)
arsad725: posts small blind $0.01
vezelvu1: posts big blind $0.02
*** HOLE CARDS ***
sexmit: folds
Jake7123: folds
eskulap911: raises $0.08 to $0.10
arsad725: folds
vezelvu1: folds
Uncalled bet ($0.08) returned to eskulap911
eskulap911 collected $0.05 from pot
*** SUMMARY ***
Total pot $0.05 | Rake $0
Seat 1: eskulap911 (button) collected ($0.05)
Seat 2: arsad725 (small blind) folded before Flop
Seat 3: vezelvu1 (big blind) folded before Flop
Seat 4: sexmit folded before Flop (didn't bet)
Seat 6: Jake7123 folded before Flop (didn't bet)


PokerStars Hand #238169656118:  Hold'em No Limit ($0.01/$0.02 USD) - 2022/08/23 12:44:46 ET
Table 'Despina IV' 6-max Seat #2 is the button
Seat 1: eskulap911 ($1.31 in chips)
Seat 2: arsad725 ($2.13 in chips)
Seat 3: vezelvu1 ($2.65 in chips)
Seat 4: sexmit ($1.73 in chips)
Seat 6: Jake7123 ($2.27 in chips)
vezelvu1: posts small blind $0.01
sexmit: posts big blind $0.02
*** HOLE CARDS ***
Jake7123: folds
eskulap911: folds
arsad725: folds
vezelvu1: folds
Uncalled bet ($0.01) returned to sexmit
sexmit collected $0.02 from pot
*** SUMMARY ***
Total pot $0.02 | Rake $0
Seat 1: eskulap911 folded before Flop (didn't bet)
Seat 2: arsad725 (button) folded before Flop (didn't bet)
Seat 3: vezelvu1 (small blind) folded before Flop
Seat 4: sexmit (big blind) collected ($0.02)
Seat 6: Jake7123 folded before Flop (didn't bet)


PokerStars Hand #238169658347:  Hold'em No Limit ($0.01/$0.02 USD) - 2022/08/23 12:44:53 ET
Table 'Despina IV' 6-max Seat #3 is the button
Seat 1: eskulap911 ($1.31 in chips)
Seat 2: arsad725 ($2.13 in chips)
Seat 3: vezelvu1 ($2.64 in chips)
Seat 4: sexmit ($1.74 in chips)
Seat 6: Jake7123 ($2.27 in chips)
sexmit: posts small blind $0.01
Jake7123: posts big blind $0.02
*** HOLE CARDS ***
eskulap911: folds
arsad725: folds
vezelvu1: folds
sexmit: folds
Uncalled bet ($0.01) returned to Jake7123
Jake7123 collected $0.02 from pot
toleabs2022 was removed from the table for failing to post
toleabs2022 leaves the table
Jake7123: doesn't show hand
*** SUMMARY ***
Total pot $0.02 | Rake $0
Seat 1: eskulap911 folded before Flop (didn't bet)
Seat 2: arsad725 folded before Flop (didn't bet)
Seat 3: vezelvu1 (button) folded before Flop (didn't bet)
Seat 4: sexmit (small blind) folded before Flop
Seat 6: Jake7123 (big blind) collected ($0.02)


PokerStars Hand #238169661617:  Hold'em No Limit ($0.01/$0.02 USD) - 2022/08/23 12:45:04 ET
Table 'Despina IV' 6-max Seat #4 is the button
Seat 1: eskulap911 ($1.31 in chips)
Seat 2: arsad725 ($2.13 in chips)
Seat 3: vezelvu1 ($2.64 in chips)
Seat 4: sexmit ($1.73 in chips)
Seat 6: Jake7123 ($2.28 in chips)
Jake7123: posts small blind $0.01
eskulap911: posts big blind $0.02
*** HOLE CARDS ***
arsad725: folds
vezelvu1: folds
sexmit: raises $0.02 to $0.04
Jake7123: folds
eskulap911: raises $0.04 to $0.08
sexmit: calls $0.04
*** FLOP *** [3c Ts Qd]
eskulap911: bets $1.23 and is all-in
sexmit: folds
Uncalled bet ($1.23) returned to eskulap911
eskulap911 collected $0.16 from pot
*** SUMMARY ***
Total pot $0.17 | Rake $0.01
Board [3c Ts Qd]
Seat 1: eskulap911 (big blind) collected ($0.16)
Seat 2: arsad725 folded before Flop (didn't bet)
Seat 3: vezelvu1 folded before Flop (didn't bet)
Seat 4: sexmit (button) folded on the Flop
Seat 6: Jake7123 (small blind) folded before Flop


PokerStars Hand #238169668698:  Hold'em No Limit ($0.01/$0.02 USD) - 2022/08/23 12:45:26 ET
Table 'Despina IV' 6-max Seat #6 is the button
Seat 1: eskulap911 ($1.39 in chips)
Seat 2: arsad725 ($2.13 in chips)
Seat 3: vezelvu1 ($2.64 in chips)
Seat 4: sexmit ($1.65 in chips)
Seat 6: Jake7123 ($2.27 in chips)
eskulap911: posts small blind $0.01
arsad725: posts big blind $0.02
*** HOLE CARDS ***
vezelvu1: folds
sexmit: folds
Jake7123: folds
eskulap911: folds
Uncalled bet ($0.01) returned to arsad725
arsad725 collected $0.02 from pot
arsad725: doesn't show hand
*** SUMMARY ***
Total pot $0.02 | Rake $0
Seat 1: eskulap911 (small blind) folded before Flop
Seat 2: arsad725 (big blind) collected ($0.02)
Seat 3: vezelvu1 folded before Flop (didn't bet)
Seat 4: sexmit folded before Flop (didn't bet)
Seat 6: Jake7123 (button) folded before Flop (didn't bet)


PokerStars Hand #238169672694:  Hold'em No Limit ($0.01/$0.02 USD) - 2022/08/23 12:45:38 ET
Table 'Despina IV' 6-max Seat #1 is the button
Seat 1: eskulap911 ($1.38 in chips)
Seat 2: arsad725 ($2.14 in chips)
Seat 3: vezelvu1 ($2.64 in chips)
Seat 4: sexmit ($1.65 in chips)
Seat 6: Jake7123 ($2.27 in chips)
arsad725: posts small blind $0.01
vezelvu1: posts big blind $0.02
*** HOLE CARDS ***
sexmit: raises $0.02 to $0.04
Jake7123: folds
eskulap911: folds
arsad725: folds
vezelvu1: folds
Uncalled bet ($0.02) returned to sexmit
sexmit collected $0.05 from pot
*** SUMMARY ***
Total pot $0.05 | Rake $0
Seat 1: eskulap911 (button) folded before Flop (didn't bet)
Seat 2: arsad725 (small blind) folded before Flop
Seat 3: vezelvu1 (big blind) folded before Flop
Seat 4: sexmit collected ($0.05)
Seat 6: Jake7123 folded before Flop (didn't bet)


PokerStars Hand #238169677073:  Hold'em No Limit ($0.01/$0.02 USD) - 2022/08/23 12:45:51 ET
Table 'Despina IV' 6-max Seat #2 is the button
Seat 1: eskulap911 ($1.38 in chips)
Seat 2: arsad725 ($2.13 in chips)
Seat 3: vezelvu1 ($2.62 in chips)
Seat 4: sexmit ($1.68 in chips)
Seat 6: Jake7123 ($2.27 in chips)
vezelvu1: posts small blind $0.01
sexmit: posts big blind $0.02
*** HOLE CARDS ***
Jake7123: folds
eskulap911: raises $0.08 to $0.10
arsad725: folds
vezelvu1: folds
takaharaMaru joins the table at seat #5
sexmit: calls $0.08
*** FLOP *** [7c 3d 4c]
sexmit: checks
eskulap911: checks
*** TURN *** [7c 3d 4c] [Th]
sexmit: checks
eskulap911: checks
*** RIVER *** [7c 3d 4c Th] [Kc]
sexmit: checks
eskulap911: checks
*** SHOW DOWN ***
sexmit: shows [8h 6h] (high card King)
eskulap911: shows [9c Ad] (high card Ace)
eskulap911 collected $0.20 from pot
*** SUMMARY ***
Total pot $0.21 | Rake $0.01
Board [7c 3d 4c Th Kc]
Seat 1: eskulap911 showed [9c Ad] and won ($0.20) with high card Ace
Seat 2: arsad725 (button) folded before Flop (didn't bet)
Seat 3: vezelvu1 (small blind) folded before Flop
Seat 4: sexmit (big blind) showed [8h 6h] and lost with high card King
Seat 6: Jake7123 folded before Flop (didn't bet)


PokerStars Hand #238169690355:  Hold'em No Limit ($0.01/$0.02 USD) - 2022/08/23 12:46:33 ET
Table 'Despina IV' 6-max Seat #3 is the button
Seat 1: eskulap911 ($1.48 in chips)
Seat 2: arsad725 ($2.13 in chips)
Seat 3: vezelvu1 ($2.61 in chips)
Seat 4: sexmit ($1.58 in chips)
Seat 5: takaharaMaru ($1.60 in chips)
Seat 6: Jake7123 ($2.27 in chips)
sexmit: posts small blind $0.01
takaharaMaru: posts big blind $0.02
*** HOLE CARDS ***
Jake7123: folds
eskulap911: folds
arsad725: folds
vezelvu1: folds
sexmit: raises $0.05 to $0.07
takaharaMaru: folds
Uncalled bet ($0.05) returned to sexmit
sexmit collected $0.04 from pot
*** SUMMARY ***
Total pot $0.04 | Rake $0
Seat 1: eskulap911 folded before Flop (didn't bet)
Seat 2: arsad725 folded before Flop (didn't bet)
Seat 3: vezelvu1 (button) folded before Flop (didn't bet)
Seat 4: sexmit (small blind) collected ($0.04)
Seat 5: takaharaMaru (big blind) folded before Flop
Seat 6: Jake7123 folded before Flop (didn't bet)


PokerStars Hand #238169694284:  Hold'em No Limit ($0.01/$0.02 USD) - 2022/08/23 12:46:45 ET
Table 'Despina IV' 6-max Seat #4 is the button
Seat 1: eskulap911 ($1.48 in chips)
Seat 2: arsad725 ($2.13 in chips)
Seat 3: vezelvu1 ($2.61 in chips)
Seat 4: sexmit ($1.60 in chips)
Seat 5: takaharaMaru ($1.58 in chips)
Seat 6: Jake7123 ($2.27 in chips)
takaharaMaru: posts small blind $0.01
Jake7123: posts big blind $0.02
*** HOLE CARDS ***
eskulap911: folds
arsad725: folds
vezelvu1: folds
sexmit: raises $0.02 to $0.04
takaharaMaru: folds
Jake7123: calls $0.02
*** FLOP *** [8c 8h Jh]
Jake7123: checks
sexmit: checks
*** TURN *** [8c 8h Jh] [2s]
Jake7123: checks
sexmit: bets $0.03
Jake7123: calls $0.03
*** RIVER *** [8c 8h Jh 2s] [6h]
Jake7123: checks
sexmit: bets $0.04
Jake7123: folds
Uncalled bet ($0.04) returned to sexmit
sexmit collected $0.14 from pot
*** SUMMARY ***
Total pot $0.15 | Rake $0.01
Board [8c 8h Jh 2s 6h]
Seat 1: eskulap911 folded before Flop (didn't bet)
Seat 2: arsad725 folded before Flop (didn't bet)
Seat 3: vezelvu1 folded before Flop (didn't bet)
Seat 4: sexmit (button) collected ($0.14)
Seat 5: takaharaMaru (small blind) folded before Flop
Seat 6: Jake7123 (big blind) folded on the River


PokerStars Hand #238169712276:  Hold'em No Limit ($0.01/$0.02 USD) - 2022/08/23 12:47:19 ET
Table 'Despina IV' 6-max Seat #5 is the button
Seat 1: eskulap911 ($1.48 in chips)
Seat 2: arsad725 ($2.13 in chips)
Seat 3: vezelvu1 ($2.61 in chips)
Seat 4: sexmit ($1.67 in chips)
Seat 5: takaharaMaru ($1.57 in chips)
Seat 6: Jake7123 ($2.20 in chips)
Jake7123: posts small blind $0.01
eskulap911: posts big blind $0.02
*** HOLE CARDS ***
arsad725: folds
vezelvu1: raises $0.04 to $0.06
sexmit: folds
takaharaMaru: folds
Jake7123: folds
eskulap911: folds
Uncalled bet ($0.04) returned to vezelvu1
vezelvu1 collected $0.05 from pot
*** SUMMARY ***
Total pot $0.05 | Rake $0
Seat 1: eskulap911 (big blind) folded before Flop
Seat 2: arsad725 folded before Flop (didn't bet)
Seat 3: vezelvu1 collected ($0.05)
Seat 4: sexmit folded before Flop (didn't bet)
Seat 5: takaharaMaru (button) folded before Flop (didn't bet)
Seat 6: Jake7123 (small blind) folded before Flop


PokerStars Hand #238169717163:  Hold'em No Limit ($0.01/$0.02 USD) - 2022/08/23 12:47:34 ET
Table 'Despina IV' 6-max Seat #6 is the button
Seat 1: eskulap911 ($1.46 in chips)
Seat 2: arsad725 ($2.13 in chips)
Seat 3: vezelvu1 ($2.64 in chips)
Seat 4: sexmit ($1.67 in chips)
Seat 5: takaharaMaru ($1.57 in chips)
Seat 6: Jake7123 ($2.19 in chips)
eskulap911: posts small blind $0.01
arsad725: posts big blind $0.02
*** HOLE CARDS ***
vezelvu1: folds
sexmit: raises $0.02 to $0.04
takaharaMaru: folds
Jake7123: folds
eskulap911: folds
arsad725: folds
Uncalled bet ($0.02) returned to sexmit
sexmit collected $0.05 from pot
*** SUMMARY ***
Total pot $0.05 | Rake $0
Seat 1: eskulap911 (small blind) folded before Flop
Seat 2: arsad725 (big blind) folded before Flop
Seat 3: vezelvu1 folded before Flop (didn't bet)
Seat 4: sexmit collected ($0.05)
Seat 5: takaharaMaru folded before Flop (didn't bet)
Seat 6: Jake7123 (button) folded before Flop (didn't bet)


PokerStars Hand #238169721746:  Hold'em No Limit ($0.01/$0.02 USD) - 2022/08/23 12:47:48 ET
Table 'Despina IV' 6-max Seat #1 is the button
Seat 1: eskulap911 ($1.45 in chips)
Seat 2: arsad725 ($2.11 in chips)
Seat 3: vezelvu1 ($2.64 in chips)
Seat 4: sexmit ($1.70 in chips)
Seat 5: takaharaMaru ($1.57 in chips)
Seat 6: Jake7123 ($2.19 in chips)
arsad725: posts small blind $0.01
vezelvu1: posts big blind $0.02
*** HOLE CARDS ***
sexmit: folds
takaharaMaru: folds
Jake7123: folds
eskulap911: raises $0.04 to $0.06
arsad725: folds
vezelvu1: folds
Uncalled bet ($0.04) returned to eskulap911
eskulap911 collected $0.05 from pot
*** SUMMARY ***
Total pot $0.05 | Rake $0
Seat 1: eskulap911 (button) collected ($0.05)
Seat 2: arsad725 (small blind) folded before Flop
Seat 3: vezelvu1 (big blind) folded before Flop
Seat 4: sexmit folded before Flop (didn't bet)
Seat 5: takaharaMaru folded before Flop (didn't bet)
Seat 6: Jake7123 folded before Flop (didn't bet)


PokerStars Hand #238169727680:  Hold'em No Limit ($0.01/$0.02 USD) - 2022/08/23 12:48:07 ET
Table 'Despina IV' 6-max Seat #2 is the button
Seat 1: eskulap911 ($1.48 in chips)
Seat 2: arsad725 ($2.10 in chips)
Seat 3: vezelvu1 ($2.62 in chips)
Seat 4: sexmit ($1.70 in chips)
Seat 5: takaharaMaru ($1.57 in chips)
Seat 6: Jake7123 ($2.19 in chips)
vezelvu1: posts small blind $0.01
sexmit: posts big blind $0.02
*** HOLE CARDS ***
takaharaMaru: folds
Jake7123: folds
eskulap911: raises $0.04 to $0.06
arsad725: folds
vezelvu1: folds
sexmit: folds
Uncalled bet ($0.04) returned to eskulap911
eskulap911 collected $0.05 from pot
*** SUMMARY ***
Total pot $0.05 | Rake $0
Seat 1: eskulap911 collected ($0.05)
Seat 2: arsad725 (button) folded before Flop (didn't bet)
Seat 3: vezelvu1 (small blind) folded before Flop
Seat 4: sexmit (big blind) folded before Flop
Seat 5: takaharaMaru folded before Flop (didn't bet)
Seat 6: Jake7123 folded before Flop (didn't bet)


PokerStars Hand #238169731557:  Hold'em No Limit ($0.01/$0.02 USD) - 2022/08/23 12:48:19 ET
Table 'Despina IV' 6-max Seat #3 is the button
Seat 1: eskulap911 ($1.51 in chips)
Seat 2: arsad725 ($2.10 in chips)
Seat 3: vezelvu1 ($2.61 in chips)
Seat 4: sexmit ($1.68 in chips)
Seat 5: takaharaMaru ($1.57 in chips)
Seat 6: Jake7123 ($2.19 in chips)
sexmit: posts small blind $0.01
takaharaMaru: posts big blind $0.02
*** HOLE CARDS ***
Jake7123: folds
eskulap911: folds
arsad725: folds
vezelvu1: folds
sexmit: raises $0.05 to $0.07
takaharaMaru: folds
Uncalled bet ($0.05) returned to sexmit
sexmit collected $0.04 from pot
*** SUMMARY ***
Total pot $0.04 | Rake $0
Seat 1: eskulap911 folded before Flop (didn't bet)
Seat 2: arsad725 folded before Flop (didn't bet)
Seat 3: vezelvu1 (button) folded before Flop (didn't bet)
Seat 4: sexmit (small blind) collected ($0.04)
Seat 5: takaharaMaru (big blind) folded before Flop
Seat 6: Jake7123 folded before Flop (didn't bet)


PokerStars Hand #238169737867:  Hold'em No Limit ($0.01/$0.02 USD) - 2022/08/23 12:48:39 ET
Table 'Despina IV' 6-max Seat #4 is the button
Seat 1: eskulap911 ($1.51 in chips)
Seat 2: arsad725 ($2.10 in chips)
Seat 3: vezelvu1 ($2.61 in chips)
Seat 4: sexmit ($1.70 in chips)
Seat 5: takaharaMaru ($1.55 in chips)
Seat 6: Jake7123 ($2.19 in chips)
takaharaMaru: posts small blind $0.01
Jake7123: posts big blind $0.02
*** HOLE CARDS ***
eskulap911: calls $0.02
arsad725: folds
vezelvu1: folds
sexmit: raises $0.05 to $0.07
takaharaMaru: folds
Jake7123: folds
eskulap911: calls $0.05
*** FLOP *** [9s 5h Ah]
eskulap911: checks
sexmit: checks
*** TURN *** [9s 5h Ah] [2s]
eskulap911: checks
sexmit: bets $0.11
eskulap911: folds
Uncalled bet ($0.11) returned to sexmit
sexmit collected $0.16 from pot
*** SUMMARY ***
Total pot $0.17 | Rake $0.01
Board [9s 5h Ah 2s]
Seat 1: eskulap911 folded on the Turn
Seat 2: arsad725 folded before Flop (didn't bet)
Seat 3: vezelvu1 folded before Flop (didn't bet)
Seat 4: sexmit (button) collected ($0.16)
Seat 5: takaharaMaru (small blind) folded before Flop
Seat 6: Jake7123 (big blind) folded before Flop


PokerStars Hand #238169747681:  Hold'em No Limit ($0.01/$0.02 USD) - 2022/08/23 12:49:09 ET
Table 'Despina IV' 6-max Seat #5 is the button
Seat 1: eskulap911 ($1.44 in chips)
Seat 2: arsad725 ($2.10 in chips)
Seat 3: vezelvu1 ($2.61 in chips)
Seat 4: sexmit ($1.79 in chips)
Seat 5: takaharaMaru ($1.54 in chips)
Seat 6: Jake7123 ($2.17 in chips)
Jake7123: posts small blind $0.01
eskulap911: posts big blind $0.02
*** HOLE CARDS ***
arsad725: folds
vezelvu1: folds
sexmit: raises $0.02 to $0.04
takaharaMaru: calls $0.04
Jake7123: folds
eskulap911: folds
*** FLOP *** [9d Kd 3h]
sexmit: bets $0.04
takaharaMaru: calls $0.04
*** TURN *** [9d Kd 3h] [Kc]
sexmit: checks
takaharaMaru: checks
*** RIVER *** [9d Kd 3h Kc] [4c]
sexmit: checks
takaharaMaru: bets $0.12
sexmit: folds
Uncalled bet ($0.12) returned to takaharaMaru
takaharaMaru collected $0.18 from pot
*** SUMMARY ***
Total pot $0.19 | Rake $0.01
Board [9d Kd 3h Kc 4c]
Seat 1: eskulap911 (big blind) folded before Flop
Seat 2: arsad725 folded before Flop (didn't bet)
Seat 3: vezelvu1 folded before Flop (didn't bet)
Seat 4: sexmit folded on the River
Seat 5: takaharaMaru (button) collected ($0.18)
Seat 6: Jake7123 (small blind) folded before Flop


PokerStars Hand #238169761628:  Hold'em No Limit ($0.01/$0.02 USD) - 2022/08/23 12:49:53 ET
Table 'Despina IV' 6-max Seat #6 is the button
Seat 1: eskulap911 ($1.42 in chips)
Seat 3: vezelvu1 ($2.61 in chips)
Seat 4: sexmit ($1.71 in chips)
Seat 5: takaharaMaru ($1.64 in chips)
Seat 6: Jake7123 ($2.16 in chips)
eskulap911: posts small blind $0.01
vezelvu1: posts big blind $0.02
*** HOLE CARDS ***
sexmit: raises $0.02 to $0.04
takaharaMaru: folds
Jake7123: folds
eskulap911: calls $0.03
vezelvu1: folds
*** FLOP *** [Jc 8s 7c]
eskulap911: bets $0.42
sexmit: folds
Uncalled bet ($0.42) returned to eskulap911
eskulap911 collected $0.10 from pot
*** SUMMARY ***
Total pot $0.10 | Rake $0
Board [Jc 8s 7c]
Seat 1: eskulap911 (small blind) collected ($0.10)
Seat 3: vezelvu1 (big blind) folded before Flop
Seat 4: sexmit folded on the Flop
Seat 5: takaharaMaru folded before Flop (didn't bet)
Seat 6: Jake7123 (button) folded before Flop (didn't bet)


PokerStars Hand #238169770023:  Hold'em No Limit ($0.01/$0.02 USD) - 2022/08/23 12:50:20 ET
Table 'Despina IV' 6-max Seat #1 is the button
Seat 1: eskulap911 ($1.48 in chips)
Seat 3: vezelvu1 ($2.59 in chips)
Seat 4: sexmit ($1.67 in chips)
Seat 5: takaharaMaru ($1.64 in chips)
Seat 6: Jake7123 ($2.16 in chips)
vezelvu1: posts small blind $0.01
sexmit: posts big blind $0.02
*** HOLE CARDS ***
takaharaMaru: folds
Jake7123: folds
eskulap911: folds
vezelvu1: folds
Uncalled bet ($0.01) returned to sexmit
sexmit collected $0.02 from pot
*** SUMMARY ***
Total pot $0.02 | Rake $0
Seat 1: eskulap911 (button) folded before Flop (didn't bet)
Seat 3: vezelvu1 (small blind) folded before Flop
Seat 4: sexmit (big blind) collected ($0.02)
Seat 5: takaharaMaru folded before Flop (didn't bet)
Seat 6: Jake7123 folded before Flop (didn't bet)


PokerStars Hand #238169772747:  Hold'em No Limit ($0.01/$0.02 USD) - 2022/08/23 12:50:28 ET
Table 'Despina IV' 6-max Seat #3 is the button
Seat 1: eskulap911 ($1.48 in chips)
Seat 3: vezelvu1 ($2.58 in chips)
Seat 4: sexmit ($1.68 in chips)
Seat 5: takaharaMaru ($1.64 in chips)
Seat 6: Jake7123 ($2.16 in chips)
sexmit: posts small blind $0.01
takaharaMaru: posts big blind $0.02
*** HOLE CARDS ***
Jake7123: folds
eskulap911: folds
vezelvu1: folds
sexmit: raises $0.05 to $0.07
takaharaMaru: folds
Uncalled bet ($0.05) returned to sexmit
sexmit collected $0.04 from pot
*** SUMMARY ***
Total pot $0.04 | Rake $0
Seat 1: eskulap911 folded before Flop (didn't bet)
Seat 3: vezelvu1 (button) folded before Flop (didn't bet)
Seat 4: sexmit (small blind) collected ($0.04)
Seat 5: takaharaMaru (big blind) folded before Flop
Seat 6: Jake7123 folded before Flop (didn't bet)


PokerStars Hand #238169777560:  Hold'em No Limit ($0.01/$0.02 USD) - 2022/08/23 12:50:43 ET
Table 'Despina IV' 6-max Seat #4 is the button
Seat 1: eskulap911 ($1.48 in chips)
Seat 3: vezelvu1 ($2.58 in chips)
Seat 4: sexmit ($1.70 in chips)
Seat 5: takaharaMaru ($1.62 in chips)
Seat 6: Jake7123 ($2.16 in chips)
takaharaMaru: posts small blind $0.01
Jake7123: posts big blind $0.02
*** HOLE CARDS ***
eskulap911: raises $0.06 to $0.08
vezelvu1: folds
sexmit: folds
takaharaMaru: folds
Jake7123: folds
Uncalled bet ($0.06) returned to eskulap911
eskulap911 collected $0.05 from pot
*** SUMMARY ***
Total pot $0.05 | Rake $0
Seat 1: eskulap911 collected ($0.05)
Seat 3: vezelvu1 folded before Flop (didn't bet)
Seat 4: sexmit (button) folded before Flop (didn't bet)
Seat 5: takaharaMaru (small blind) folded before Flop
Seat 6: Jake7123 (big blind) folded before Flop


PokerStars Hand #238169790781:  Hold'em No Limit ($0.01/$0.02 USD) - 2022/08/23 12:50:55 ET
Table 'Despina IV' 6-max Seat #5 is the button
Seat 1: eskulap911 ($1.51 in chips)
Seat 3: vezelvu1 ($2.58 in chips)
Seat 4: sexmit ($1.70 in chips)
Seat 5: takaharaMaru ($1.61 in chips)
Seat 6: Jake7123 ($2.14 in chips)
Jake7123: posts small blind $0.01
eskulap911: posts big blind $0.02
*** HOLE CARDS ***
vezelvu1: folds
sexmit: raises $0.02 to $0.04
takaharaMaru: folds
Jake7123: folds
eskulap911: calls $0.02
*** FLOP *** [8h 9d Ah]
eskulap911: checks
sexmit: bets $0.03
eskulap911: folds
Uncalled bet ($0.03) returned to sexmit
sexmit collected $0.09 from pot
*** SUMMARY ***
Total pot $0.09 | Rake $0
Board [8h 9d Ah]
Seat 1: eskulap911 (big blind) folded on the Flop
Seat 3: vezelvu1 folded before Flop (didn't bet)
Seat 4: sexmit collected ($0.09)
Seat 5: takaharaMaru (button) folded before Flop (didn't bet)
Seat 6: Jake7123 (small blind) folded before Flop


PokerStars Hand #238169799247:  Hold'em No Limit ($0.01/$0.02 USD) - 2022/08/23 12:51:22 ET
Table 'Despina IV' 6-max Seat #6 is the button
Seat 1: eskulap911 ($1.47 in chips)
Seat 3: vezelvu1 ($2.58 in chips)
Seat 4: sexmit ($1.75 in chips)
Seat 5: takaharaMaru ($1.61 in chips)
Seat 6: Jake7123 ($2.13 in chips)
eskulap911: posts small blind $0.01
vezelvu1: posts big blind $0.02
*** HOLE CARDS ***
sexmit: folds
takaharaMaru: raises $0.04 to $0.06
Jake7123: folds
eskulap911: folds
vezelvu1: calls $0.04
*** FLOP *** [Ah 3d 9h]
vezelvu1: checks
takaharaMaru: checks
*** TURN *** [Ah 3d 9h] [As]
vezelvu1: bets $0.02
takaharaMaru: folds
Uncalled bet ($0.02) returned to vezelvu1
vezelvu1 collected $0.13 from pot
*** SUMMARY ***
Total pot $0.13 | Rake $0
Board [Ah 3d 9h As]
Seat 1: eskulap911 (small blind) folded before Flop
Seat 3: vezelvu1 (big blind) collected ($0.13)
Seat 4: sexmit folded before Flop (didn't bet)
Seat 5: takaharaMaru folded on the Turn
Seat 6: Jake7123 (button) folded before Flop (didn't bet)


PokerStars Hand #238169810200:  Hold'em No Limit ($0.01/$0.02 USD) - 2022/08/23 12:51:56 ET
Table 'Despina IV' 6-max Seat #1 is the button
Seat 1: eskulap911 ($1.46 in chips)
Seat 3: vezelvu1 ($2.65 in chips)
Seat 4: sexmit ($1.75 in chips)
Seat 5: takaharaMaru ($1.55 in chips)
Seat 6: Jake7123 ($2.13 in chips)
vezelvu1: posts small blind $0.01
sexmit: posts big blind $0.02
*** HOLE CARDS ***
takaharaMaru: folds
Jake7123: raises $0.02 to $0.04
eskulap911: folds
vezelvu1: folds
takaharaMaru leaves the table
sexmit: calls $0.02
*** FLOP *** [3h Ac Js]
sexmit: checks
Agustín Suárez joins the table at seat #5
Jake7123: checks
*** TURN *** [3h Ac Js] [Jc]
sexmit: bets $0.03
Jake7123: calls $0.03
*** RIVER *** [3h Ac Js Jc] [Qc]
sexmit: checks
Jake7123: checks
*** SHOW DOWN ***
sexmit: shows [5s Ad] (two pair, Aces and Jacks)
Jake7123: mucks hand
sexmit collected $0.14 from pot
*** SUMMARY ***
Total pot $0.15 | Rake $0.01
Board [3h Ac Js Jc Qc]
Seat 1: eskulap911 (button) folded before Flop (didn't bet)
Seat 3: vezelvu1 (small blind) folded before Flop
Seat 4: sexmit (big blind) showed [5s Ad] and won ($0.14) with two pair, Aces and Jacks
Seat 5: takaharaMaru folded before Flop (didn't bet)
Seat 6: Jake7123 mucked


PokerStars Hand #238169819297:  Hold'em No Limit ($0.01/$0.02 USD) - 2022/08/23 12:52:25 ET
Table 'Despina IV' 6-max Seat #3 is the button
Seat 1: eskulap911 ($1.46 in chips)
Seat 3: vezelvu1 ($2.64 in chips)
Seat 4: sexmit ($1.82 in chips)
Seat 5: Agustín Suárez ($2 in chips)
Seat 6: Jake7123 ($2.06 in chips)
sexmit: posts small blind $0.01
Agustín Suárez: posts big blind $0.02
*** HOLE CARDS ***
Jake7123: folds
eskulap911: folds
vezelvu1: folds
sexmit: raises $0.05 to $0.07
Agustín Suárez: calls $0.05
*** FLOP *** [2d Kh 3s]
sexmit: checks
Agustín Suárez: checks
*** TURN *** [2d Kh 3s] [6h]
sexmit: checks
Agustín Suárez: bets $0.07
sexmit: folds
Uncalled bet ($0.07) returned to Agustín Suárez
Agustín Suárez collected $0.14 from pot
Agustín Suárez: doesn't show hand
*** SUMMARY ***
Total pot $0.14 | Rake $0
Board [2d Kh 3s 6h]
Seat 1: eskulap911 folded before Flop (didn't bet)
Seat 3: vezelvu1 (button) folded before Flop (didn't bet)
Seat 4: sexmit (small blind) folded on the Turn
Seat 5: Agustín Suárez (big blind) collected ($0.14)
Seat 6: Jake7123 folded before Flop (didn't bet)


PokerStars Hand #238169831742:  Hold'em No Limit ($0.01/$0.02 USD) - 2022/08/23 12:53:04 ET
Table 'Despina IV' 6-max Seat #4 is the button
Seat 1: eskulap911 ($1.46 in chips)
Seat 3: vezelvu1 ($2.64 in chips)
Seat 4: sexmit ($1.75 in chips)
Seat 5: Agustín Suárez ($2.07 in chips)
Seat 6: Jake7123 ($2.06 in chips)
Agustín Suárez: posts small blind $0.01
Jake7123: posts big blind $0.02
*** HOLE CARDS ***
eskulap911: folds
vezelvu1: folds
sexmit: folds
Agustín Suárez: raises $0.04 to $0.06
Jake7123: folds
Uncalled bet ($0.04) returned to Agustín Suárez
Agustín Suárez collected $0.04 from pot
Agustín Suárez: doesn't show hand
*** SUMMARY ***
Total pot $0.04 | Rake $0
Seat 1: eskulap911 folded before Flop (didn't bet)
Seat 3: vezelvu1 folded before Flop (didn't bet)
Seat 4: sexmit (button) folded before Flop (didn't bet)
Seat 5: Agustín Suárez (small blind) collected ($0.04)
Seat 6: Jake7123 (big blind) folded before Flop


PokerStars Hand #238169837603:  Hold'em No Limit ($0.01/$0.02 USD) - 2022/08/23 12:53:22 ET
Table 'Despina IV' 6-max Seat #5 is the button
Seat 1: eskulap911 ($1.46 in chips)
Seat 3: vezelvu1 ($2.64 in chips)
Seat 4: sexmit ($1.75 in chips)
Seat 5: Agustín Suárez ($2.09 in chips)
Seat 6: Jake7123 ($2.04 in chips)
Jake7123: posts small blind $0.01
eskulap911: posts big blind $0.02
*** HOLE CARDS ***
vezelvu1: folds
sexmit: raises $0.02 to $0.04
Agustín Suárez: folds
Jake7123: folds
eskulap911: folds
Uncalled bet ($0.02) returned to sexmit
sexmit collected $0.05 from pot
*** SUMMARY ***
Total pot $0.05 | Rake $0
Seat 1: eskulap911 (big blind) folded before Flop
Seat 3: vezelvu1 folded before Flop (didn't bet)
Seat 4: sexmit collected ($0.05)
Seat 5: Agustín Suárez (button) folded before Flop (didn't bet)
Seat 6: Jake7123 (small blind) folded before Flop


PokerStars Hand #238169843439:  Hold'em No Limit ($0.01/$0.02 USD) - 2022/08/23 12:53:40 ET
Table 'Despina IV' 6-max Seat #6 is the button
Seat 1: eskulap911 ($1.44 in chips)
Seat 3: vezelvu1 ($2.64 in chips)
Seat 4: sexmit ($1.78 in chips)
Seat 5: Agustín Suárez ($2.09 in chips)
Seat 6: Jake7123 ($2.03 in chips)
eskulap911: posts small blind $0.01
vezelvu1: posts big blind $0.02
*** HOLE CARDS ***
sexmit: raises $0.02 to $0.04
Agustín Suárez: folds
Jake7123: folds
eskulap911: folds
vezelvu1: calls $0.02
*** FLOP *** [As 4d 6c]
vezelvu1: bets $0.04
sexmit: folds
Uncalled bet ($0.04) returned to vezelvu1
vezelvu1 collected $0.09 from pot
*** SUMMARY ***
Total pot $0.09 | Rake $0
Board [As 4d 6c]
Seat 1: eskulap911 (small blind) folded before Flop
Seat 3: vezelvu1 (big blind) collected ($0.09)
Seat 4: sexmit folded on the Flop
Seat 5: Agustín Suárez folded before Flop (didn't bet)
Seat 6: Jake7123 (button) folded before Flop (didn't bet)


PokerStars Hand #238169853070:  Hold'em No Limit ($0.01/$0.02 USD) - 2022/08/23 12:54:11 ET
Table 'Despina IV' 6-max Seat #1 is the button
Seat 1: eskulap911 ($1.43 in chips)
Seat 3: vezelvu1 ($2.69 in chips)
Seat 4: sexmit ($1.74 in chips)
Seat 5: Agustín Suárez ($2.09 in chips)
Seat 6: Jake7123 ($2.03 in chips)
vezelvu1: posts small blind $0.01
sexmit: posts big blind $0.02
*** HOLE CARDS ***
Agustín Suárez: folds
Jake7123: folds
eskulap911: raises $0.08 to $0.10
vezelvu1: folds
sexmit: calls $0.08
*** FLOP *** [2d Td 6d]
sexmit: checks
eskulap911: bets $1.33 and is all-in
sexmit: folds
Uncalled bet ($1.33) returned to eskulap911
eskulap911 collected $0.20 from pot
*** SUMMARY ***
Total pot $0.21 | Rake $0.01
Board [2d Td 6d]
Seat 1: eskulap911 (button) collected ($0.20)
Seat 3: vezelvu1 (small blind) folded before Flop
Seat 4: sexmit (big blind) folded on the Flop
Seat 5: Agustín Suárez folded before Flop (didn't bet)
Seat 6: Jake7123 folded before Flop (didn't bet)


PokerStars Hand #238169858975:  Hold'em No Limit ($0.01/$0.02 USD) - 2022/08/23 12:54:30 ET
Table 'Despina IV' 6-max Seat #3 is the button
Seat 1: eskulap911 ($1.53 in chips)
Seat 3: vezelvu1 ($2.68 in chips)
Seat 4: sexmit ($1.64 in chips)
Seat 5: Agustín Suárez ($2.09 in chips)
Seat 6: Jake7123 ($2.03 in chips)
sexmit: posts small blind $0.01
Agustín Suárez: posts big blind $0.02
*** HOLE CARDS ***
Jake7123: folds
eskulap911: folds
vezelvu1: folds
sexmit: raises $0.05 to $0.07
Agustín Suárez: folds
Uncalled bet ($0.05) returned to sexmit
sexmit collected $0.04 from pot
*** SUMMARY ***
Total pot $0.04 | Rake $0
Seat 1: eskulap911 folded before Flop (didn't bet)
Seat 3: vezelvu1 (button) folded before Flop (didn't bet)
Seat 4: sexmit (small blind) collected ($0.04)
Seat 5: Agustín Suárez (big blind) folded before Flop
Seat 6: Jake7123 folded before Flop (didn't bet)


PokerStars Hand #238169861831:  Hold'em No Limit ($0.01/$0.02 USD) - 2022/08/23 12:54:39 ET
Table 'Despina IV' 6-max Seat #4 is the button
Seat 1: eskulap911 ($1.53 in chips)
Seat 3: vezelvu1 ($2.68 in chips)
Seat 4: sexmit ($1.66 in chips)
Seat 5: Agustín Suárez ($2.07 in chips)
Seat 6: Jake7123 ($2.03 in chips)
Agustín Suárez: posts small blind $0.01
Jake7123: posts big blind $0.02
*** HOLE CARDS ***
eskulap911: folds
vezelvu1: folds
sexmit: raises $0.02 to $0.04
Agustín Suárez: calls $0.03
Jake7123: folds
*** FLOP *** [9d Qd Th]
Agustín Suárez: checks
sexmit: bets $0.07
Agustín Suárez: calls $0.07
*** TURN *** [9d Qd Th] [4s]
Agustín Suárez: checks
sexmit: bets $0.25
Agustín Suárez: calls $0.25
*** RIVER *** [9d Qd Th 4s] [4d]
Agustín Suárez: checks
sexmit: checks
*** SHOW DOWN ***
Agustín Suárez: shows [Ad 9h] (two pair, Nines and Fours)
sexmit: shows [Qs Ac] (two pair, Queens and Fours)
sexmit collected $0.71 from pot
*** SUMMARY ***
Total pot $0.74 | Rake $0.03
Board [9d Qd Th 4s 4d]
Seat 1: eskulap911 folded before Flop (didn't bet)
Seat 3: vezelvu1 folded before Flop (didn't bet)
Seat 4: sexmit (button) showed [Qs Ac] and won ($0.71) with two pair, Queens and Fours
Seat 5: Agustín Suárez (small blind) showed [Ad 9h] and lost with two pair, Nines and Fours
Seat 6: Jake7123 (big blind) folded before Flop


PokerStars Hand #238169871745:  Hold'em No Limit ($0.01/$0.02 USD) - 2022/08/23 12:55:10 ET
Table 'Despina IV' 6-max Seat #5 is the button
Seat 1: eskulap911 ($1.53 in chips)
Seat 3: vezelvu1 ($2.68 in chips)
Seat 4: sexmit ($2.01 in chips)
Seat 5: Agustín Suárez ($1.71 in chips)
Seat 6: Jake7123 ($2.01 in chips)
Jake7123: posts small blind $0.01
eskulap911: posts big blind $0.02
*** HOLE CARDS ***
vezelvu1: folds
sexmit: folds
Agustín Suárez: folds
Jake7123: raises $0.02 to $0.04
eskulap911: raises $0.06 to $0.10
Jake7123: folds
Uncalled bet ($0.06) returned to eskulap911
eskulap911 collected $0.08 from pot
*** SUMMARY ***
Total pot $0.08 | Rake $0
Seat 1: eskulap911 (big blind) collected ($0.08)
Seat 3: vezelvu1 folded before Flop (didn't bet)
Seat 4: sexmit folded before Flop (didn't bet)
Seat 5: Agustín Suárez (button) folded before Flop (didn't bet)
Seat 6: Jake7123 (small blind) folded before Flop


PokerStars Hand #238169875553:  Hold'em No Limit ($0.01/$0.02 USD) - 2022/08/23 12:55:24 ET
Table 'Despina IV' 6-max Seat #6 is the button
Seat 1: eskulap911 ($1.57 in chips)
Seat 3: vezelvu1 ($2.68 in chips)
Seat 4: sexmit ($2.01 in chips)
Seat 5: Agustín Suárez ($1.71 in chips)
Seat 6: Jake7123 ($1.97 in chips)
eskulap911: posts small blind $0.01
vezelvu1: posts big blind $0.02
*** HOLE CARDS ***
sexmit: folds
Agustín Suárez: folds
Jake7123: folds
eskulap911: raises $0.08 to $0.10
vezelvu1: folds
Uncalled bet ($0.08) returned to eskulap911
eskulap911 collected $0.04 from pot
arsad725 was removed from the table for failing to post
arsad725 leaves the table
*** SUMMARY ***
Total pot $0.04 | Rake $0
Seat 1: eskulap911 (small blind) collected ($0.04)
Seat 3: vezelvu1 (big blind) folded before Flop
Seat 4: sexmit folded before Flop (didn't bet)
Seat 5: Agustín Suárez folded before Flop (didn't bet)
Seat 6: Jake7123 (button) folded before Flop (didn't bet)


PokerStars Hand #238169878945:  Hold'em No Limit ($0.01/$0.02 USD) - 2022/08/23 12:55:38 ET
Table 'Despina IV' 6-max Seat #1 is the button
Seat 1: eskulap911 ($1.59 in chips)
Seat 3: vezelvu1 ($2.66 in chips)
Seat 4: sexmit ($2.01 in chips)
Seat 5: Agustín Suárez ($1.71 in chips)
Seat 6: Jake7123 ($1.97 in chips)
vezelvu1: posts small blind $0.01
sexmit: posts big blind $0.02
*** HOLE CARDS ***
Agustín Suárez: folds
Jake7123: folds
eskulap911: raises $0.08 to $0.10
vezelvu1: folds
sexmit: calls $0.08
*** FLOP *** [5h Th 9s]
sexmit: checks
eskulap911: bets $0.26
sexmit: calls $0.26
*** TURN *** [5h Th 9s] [Tc]
sexmit: checks
eskulap911: checks
*** RIVER *** [5h Th 9s Tc] [2d]
sexmit: bets $0.46
eskulap911: folds
Uncalled bet ($0.46) returned to sexmit
sexmit collected $0.70 from pot
Rsimi5 joins the table at seat #2
*** SUMMARY ***
Total pot $0.73 | Rake $0.03
Board [5h Th 9s Tc 2d]
Seat 1: eskulap911 (button) folded on the River
Seat 3: vezelvu1 (small blind) folded before Flop
Seat 4: sexmit (big blind) collected ($0.70)
Seat 5: Agustín Suárez folded before Flop (didn't bet)
Seat 6: Jake7123 folded before Flop (didn't bet)


PokerStars Hand #238169889023:  Hold'em No Limit ($0.01/$0.02 USD) - 2022/08/23 12:56:18 ET
Table 'Despina IV' 6-max Seat #3 is the button
Seat 1: eskulap911 ($1.23 in chips)
Seat 3: vezelvu1 ($2.65 in chips)
Seat 4: sexmit ($2.35 in chips)
Seat 5: Agustín Suárez ($1.71 in chips)
Seat 6: Jake7123 ($1.97 in chips)
sexmit: posts small blind $0.01
Agustín Suárez: posts big blind $0.02
Rsimi5: sits out
*** HOLE CARDS ***
Jake7123: folds
eskulap911: folds
eskulap911 leaves the table
vezelvu1: folds
sexmit: raises $0.05 to $0.07
Agustín Suárez: calls $0.05
*** FLOP *** [7d 9d 2s]
sexmit: bets $0.09
Agustín Suárez: folds
Uncalled bet ($0.09) returned to sexmit
sexmit collected $0.14 from pot
*** SUMMARY ***
Total pot $0.14 | Rake $0
Board [7d 9d 2s]
Seat 1: eskulap911 folded before Flop (didn't bet)
Seat 3: vezelvu1 (button) folded before Flop (didn't bet)
Seat 4: sexmit (small blind) collected ($0.14)
Seat 5: Agustín Suárez (big blind) folded on the Flop
Seat 6: Jake7123 folded before Flop (didn't bet)


PokerStars Hand #238169894570:  Hold'em No Limit ($0.01/$0.02 USD) - 2022/08/23 12:56:40 ET
Table 'Despina IV' 6-max Seat #4 is the button
Seat 2: Rsimi5 ($0.80 in chips)
Seat 3: vezelvu1 ($2.65 in chips)
Seat 4: sexmit ($2.42 in chips)
Seat 5: Agustín Suárez ($1.64 in chips)
Seat 6: Jake7123 ($1.97 in chips)
Agustín Suárez: posts small blind $0.01
Jake7123: posts big blind $0.02
Rsimi5: posts big blind $0.02
*** HOLE CARDS ***
Rsimi5: checks
vezelvu1: folds
sexmit: raises $0.05 to $0.07
Agustín Suárez: folds
dayo77625 joins the table at seat #1
Jake7123: calls $0.05
Rsimi5: calls $0.05
*** FLOP *** [Th Ts 5s]
Jake7123: checks
Rsimi5: checks
sexmit: bets $0.07
Jake7123: folds
Rsimi5: calls $0.07
*** TURN *** [Th Ts 5s] [Kc]
Rsimi5: bets $0.12
sexmit: raises $0.66 to $0.78
Rsimi5: calls $0.54 and is all-in
Uncalled bet ($0.12) returned to sexmit
*** RIVER *** [Th Ts 5s Kc] [As]
*** SHOW DOWN ***
Rsimi5: shows [Ks 2s] (a flush, Ace high)
sexmit: shows [Td Ad] (a full house, Tens full of Aces)
sexmit collected $1.62 from pot
Rsimi5 cashed out the hand for $0.37
*** SUMMARY ***
Total pot $1.68 | Rake $0.06
Board [Th Ts 5s Kc As]
Seat 2: Rsimi5 showed [Ks 2s] and lost with a flush, Ace high (cashed out).
Seat 3: vezelvu1 folded before Flop (didn't bet)
Seat 4: sexmit (button) showed [Td Ad] and won ($1.62) with a full house, Tens full of Aces
Seat 5: Agustín Suárez (small blind) folded before Flop
Seat 6: Jake7123 (big blind) folded on the Flop


PokerStars Hand #238169906927:  Hold'em No Limit ($0.01/$0.02 USD) - 2022/08/23 12:57:29 ET
Table 'Despina IV' 6-max Seat #5 is the button
Seat 1: dayo77625 ($1.60 in chips)
Seat 2: Rsimi5 ($0.37 in chips)
Seat 3: vezelvu1 ($2.65 in chips)
Seat 4: sexmit ($3.24 in chips)
Seat 5: Agustín Suárez ($1.63 in chips)
Seat 6: Jake7123 ($1.90 in chips)
Jake7123: posts small blind $0.01
dayo77625: posts big blind $0.02
*** HOLE CARDS ***
Rsimi5: calls $0.02
vezelvu1: folds
sexmit: folds
Agustín Suárez: folds
Jake7123: folds
dayo77625: raises $0.02 to $0.04
Rsimi5: calls $0.02
*** FLOP *** [9s 8s Qs]
dayo77625: bets $0.09
Rsimi5: folds
Uncalled bet ($0.09) returned to dayo77625
dayo77625 collected $0.09 from pot
*** SUMMARY ***
Total pot $0.09 | Rake $0
Board [9s 8s Qs]
Seat 1: dayo77625 (big blind) collected ($0.09)
Seat 2: Rsimi5 folded on the Flop
Seat 3: vezelvu1 folded before Flop (didn't bet)
Seat 4: sexmit folded before Flop (didn't bet)
Seat 5: Agustín Suárez (button) folded before Flop (didn't bet)
Seat 6: Jake7123 (small blind) folded before Flop


PokerStars Hand #238169915061:  Hold'em No Limit ($0.01/$0.02 USD) - 2022/08/23 12:58:01 ET
Table 'Despina IV' 6-max Seat #6 is the button
Seat 1: dayo77625 ($1.65 in chips)
Seat 2: Rsimi5 ($0.33 in chips)
Seat 3: vezelvu1 ($2.65 in chips)
Seat 4: sexmit ($3.24 in chips)
Seat 5: Agustín Suárez ($1.63 in chips)
Seat 6: Jake7123 ($1.89 in chips)
dayo77625: posts small blind $0.01
Rsimi5: posts big blind $0.02
*** HOLE CARDS ***
vezelvu1: raises $0.02 to $0.04
sexmit: folds
Agustín Suárez: folds
Jake7123: folds
dayo77625: calls $0.03
Rsimi5: calls $0.02
*** FLOP *** [Kh Qd 4s]
dayo77625: bets $0.12
Rsimi5: folds
vezelvu1: folds
Uncalled bet ($0.12) returned to dayo77625
dayo77625 collected $0.12 from pot
*** SUMMARY ***
Total pot $0.12 | Rake $0
Board [Kh Qd 4s]
Seat 1: dayo77625 (small blind) collected ($0.12)
Seat 2: Rsimi5 (big blind) folded on the Flop
Seat 3: vezelvu1 folded on the Flop
Seat 4: sexmit folded before Flop (didn't bet)
Seat 5: Agustín Suárez folded before Flop (didn't bet)
Seat 6: Jake7123 (button) folded before Flop (didn't bet)


PokerStars Hand #238169921558:  Hold'em No Limit ($0.01/$0.02 USD) - 2022/08/23 12:58:28 ET
Table 'Despina IV' 6-max Seat #1 is the button
Seat 1: dayo77625 ($1.73 in chips)
Seat 2: Rsimi5 ($0.29 in chips)
Seat 3: vezelvu1 ($2.61 in chips)
Seat 4: sexmit ($3.24 in chips)
Seat 5: Agustín Suárez ($1.63 in chips)
Seat 6: Jake7123 ($1.89 in chips)
Rsimi5: posts small blind $0.01
vezelvu1: posts big blind $0.02
*** HOLE CARDS ***
sexmit: folds
Agustín Suárez: folds
Jake7123: folds
dayo77625: folds
Rsimi5: calls $0.01
vezelvu1: checks
*** FLOP *** [Th 9c 7c]
Rsimi5: bets $0.27 and is all-in
vezelvu1: folds
Uncalled bet ($0.27) returned to Rsimi5
Rsimi5 collected $0.04 from pot
*** SUMMARY ***
Total pot $0.04 | Rake $0
Board [Th 9c 7c]
Seat 1: dayo77625 (button) folded before Flop (didn't bet)
Seat 2: Rsimi5 (small blind) collected ($0.04)
Seat 3: vezelvu1 (big blind) folded on the Flop
Seat 4: sexmit folded before Flop (didn't bet)
Seat 5: Agustín Suárez folded before Flop (didn't bet)
Seat 6: Jake7123 folded before Flop (didn't bet)


PokerStars Hand #238169927263:  Hold'em No Limit ($0.01/$0.02 USD) - 2022/08/23 12:58:50 ET
Table 'Despina IV' 6-max Seat #2 is the button
Seat 1: dayo77625 ($1.73 in chips)
Seat 2: Rsimi5 ($0.31 in chips)
Seat 3: vezelvu1 ($2.59 in chips)
Seat 4: sexmit ($3.24 in chips)
Seat 5: Agustín Suárez ($1.63 in chips)
Seat 6: Jake7123 ($1.89 in chips)
vezelvu1: posts small blind $0.01
sexmit: posts big blind $0.02
*** HOLE CARDS ***
Agustín Suárez: raises $0.02 to $0.04
Jake7123: folds
dayo77625: folds
Rsimi5: folds
vezelvu1: folds
sexmit: calls $0.02
*** FLOP *** [Jd 4c 8d]
sexmit: checks
Agustín Suárez: bets $0.03
sexmit: folds
Uncalled bet ($0.03) returned to Agustín Suárez
Agustín Suárez collected $0.09 from pot
Agustín Suárez: doesn't show hand
*** SUMMARY ***
Total pot $0.09 | Rake $0
Board [Jd 4c 8d]
Seat 1: dayo77625 folded before Flop (didn't bet)
Seat 2: Rsimi5 (button) folded before Flop (didn't bet)
Seat 3: vezelvu1 (small blind) folded before Flop
Seat 4: sexmit (big blind) folded on the Flop
Seat 5: Agustín Suárez collected ($0.09)
Seat 6: Jake7123 folded before Flop (didn't bet)


PokerStars Hand #238169932286:  Hold'em No Limit ($0.01/$0.02 USD) - 2022/08/23 12:59:10 ET
Table 'Despina IV' 6-max Seat #3 is the button
Seat 1: dayo77625 ($1.73 in chips)
Seat 2: Rsimi5 ($0.31 in chips)
Seat 3: vezelvu1 ($2.58 in chips)
Seat 4: sexmit ($3.20 in chips)
Seat 5: Agustín Suárez ($1.68 in chips)
Seat 6: Jake7123 ($1.89 in chips)
sexmit: posts small blind $0.01
Agustín Suárez: posts big blind $0.02
*** HOLE CARDS ***
Jake7123: folds
dayo77625: folds
Rsimi5: calls $0.02
vezelvu1: folds
sexmit: folds
Agustín Suárez: checks
*** FLOP *** [Js 8s Qh]
Agustín Suárez: checks
Rsimi5: bets $0.04
Agustín Suárez: folds
Uncalled bet ($0.04) returned to Rsimi5
Rsimi5 collected $0.05 from pot
*** SUMMARY ***
Total pot $0.05 | Rake $0
Board [Js 8s Qh]
Seat 1: dayo77625 folded before Flop (didn't bet)
Seat 2: Rsimi5 collected ($0.05)
Seat 3: vezelvu1 (button) folded before Flop (didn't bet)
Seat 4: sexmit (small blind) folded before Flop
Seat 5: Agustín Suárez (big blind) folded on the Flop
Seat 6: Jake7123 folded before Flop (didn't bet)


PokerStars Hand #238169938258:  Hold'em No Limit ($0.01/$0.02 USD) - 2022/08/23 12:59:35 ET
Table 'Despina IV' 6-max Seat #4 is the button
Seat 1: dayo77625 ($1.73 in chips)
Seat 2: Rsimi5 ($0.34 in chips)
Seat 3: vezelvu1 ($2.58 in chips)
Seat 4: sexmit ($3.19 in chips)
Seat 5: Agustín Suárez ($1.66 in chips)
Seat 6: Jake7123 ($1.89 in chips)
Agustín Suárez: posts small blind $0.01
Jake7123: posts big blind $0.02
*** HOLE CARDS ***
dayo77625: calls $0.02
Rsimi5: calls $0.02
vezelvu1: folds
sexmit: folds
Agustín Suárez: folds
Jake7123: raises $0.02 to $0.04
dayo77625: calls $0.02
Rsimi5: calls $0.02
*** FLOP *** [Ac Kd 4d]
Jake7123: checks
dayo77625: checks
Rsimi5: checks
*** TURN *** [Ac Kd 4d] [Jc]
Jake7123: checks
dayo77625: checks
Rsimi5: bets $0.12
Jake7123: folds
dayo77625: folds
Uncalled bet ($0.12) returned to Rsimi5
Rsimi5 collected $0.13 from pot
*** SUMMARY ***
Total pot $0.13 | Rake $0
Board [Ac Kd 4d Jc]
Seat 1: dayo77625 folded on the Turn
Seat 2: Rsimi5 collected ($0.13)
Seat 3: vezelvu1 folded before Flop (didn't bet)
Seat 4: sexmit (button) folded before Flop (didn't bet)
Seat 5: Agustín Suárez (small blind) folded before Flop
Seat 6: Jake7123 (big blind) folded on the Turn


PokerStars Hand #238169950357:  Hold'em No Limit ($0.01/$0.02 USD) - 2022/08/23 13:00:22 ET
Table 'Despina IV' 6-max Seat #5 is the button
Seat 1: dayo77625 ($1.69 in chips)
Seat 2: Rsimi5 ($0.43 in chips)
Seat 3: vezelvu1 ($2.58 in chips)
Seat 4: sexmit ($3.19 in chips)
Seat 5: Agustín Suárez ($1.65 in chips)
Seat 6: Jake7123 ($1.85 in chips)
Jake7123: posts small blind $0.01
dayo77625: posts big blind $0.02
*** HOLE CARDS ***
Rsimi5: calls $0.02
vezelvu1: folds
sexmit: folds
Agustín Suárez: raises $0.04 to $0.06
Jake7123: folds
dayo77625: folds
Rsimi5: calls $0.04
*** FLOP *** [Ad Ts 3d]
Rsimi5: checks
Agustín Suárez: checks
*** TURN *** [Ad Ts 3d] [7c]
Rsimi5: bets $0.08
Agustín Suárez: calls $0.08
*** RIVER *** [Ad Ts 3d 7c] [5c]
Rsimi5: bets $0.06
Agustín Suárez: folds
Uncalled bet ($0.06) returned to Rsimi5
Rsimi5 collected $0.30 from pot
*** SUMMARY ***
Total pot $0.31 | Rake $0.01
Board [Ad Ts 3d 7c 5c]
Seat 1: dayo77625 (big blind) folded before Flop
Seat 2: Rsimi5 collected ($0.30)
Seat 3: vezelvu1 folded before Flop (didn't bet)
Seat 4: sexmit folded before Flop (didn't bet)
Seat 5: Agustín Suárez (button) folded on the River
Seat 6: Jake7123 (small blind) folded before Flop


PokerStars Hand #238169970723:  Hold'em No Limit ($0.01/$0.02 USD) - 2022/08/23 13:01:11 ET
Table 'Despina IV' 6-max Seat #6 is the button
Seat 1: dayo77625 ($1.67 in chips)
Seat 2: Rsimi5 ($0.59 in chips)
Seat 3: vezelvu1 ($2.58 in chips)
Seat 4: sexmit ($3.19 in chips)
Seat 5: Agustín Suárez ($1.51 in chips)
Seat 6: Jake7123 ($1.84 in chips)
dayo77625: posts small blind $0.01
Rsimi5: posts big blind $0.02
*** HOLE CARDS ***
vezelvu1: folds
sexmit: folds
Agustín Suárez: folds
Jake7123: folds
dayo77625: calls $0.01
Rsimi5: raises $0.04 to $0.06
dayo77625: raises $0.04 to $0.10
Rsimi5: calls $0.04
*** FLOP *** [Ks 4h Kd]
dayo77625: checks
Rsimi5: checks
*** TURN *** [Ks 4h Kd] [Js]
dayo77625: bets $0.19
Rsimi5: folds [Ah]
Uncalled bet ($0.19) returned to dayo77625
dayo77625 collected $0.19 from pot
*** SUMMARY ***
Total pot $0.20 | Rake $0.01
Board [Ks 4h Kd Js]
Seat 1: dayo77625 (small blind) collected ($0.19)
Seat 2: Rsimi5 (big blind) folded on the Turn
Seat 3: vezelvu1 folded before Flop (didn't bet)
Seat 4: sexmit folded before Flop (didn't bet)
Seat 5: Agustín Suárez folded before Flop (didn't bet)
Seat 6: Jake7123 (button) folded before Flop (didn't bet)


PokerStars Hand #238169982820:  Hold'em No Limit ($0.01/$0.02 USD) - 2022/08/23 13:01:52 ET
Table 'Despina IV' 6-max Seat #1 is the button
Seat 1: dayo77625 ($1.76 in chips)
Seat 2: Rsimi5 ($0.49 in chips)
Seat 3: vezelvu1 ($2.58 in chips)
Seat 4: sexmit ($3.19 in chips)
Seat 5: Agustín Suárez ($1.51 in chips)
Seat 6: Jake7123 ($1.84 in chips)
Rsimi5: posts small blind $0.01
vezelvu1: posts big blind $0.02
*** HOLE CARDS ***
sexmit: folds
Agustín Suárez: folds
Jake7123: folds
dayo77625: calls $0.02
Rsimi5: calls $0.01
vezelvu1: checks
*** FLOP *** [5c Jh Kc]
Rsimi5: checks
vezelvu1: checks
dayo77625: checks
*** TURN *** [5c Jh Kc] [9c]
Rsimi5: checks
vezelvu1: checks
dayo77625: bets $0.06
Rsimi5: folds
vezelvu1: folds
Uncalled bet ($0.06) returned to dayo77625
dayo77625 collected $0.06 from pot
*** SUMMARY ***
Total pot $0.06 | Rake $0
Board [5c Jh Kc 9c]
Seat 1: dayo77625 (button) collected ($0.06)
Seat 2: Rsimi5 (small blind) folded on the Turn
Seat 3: vezelvu1 (big blind) folded on the Turn
Seat 4: sexmit folded before Flop (didn't bet)
Seat 5: Agustín Suárez folded before Flop (didn't bet)
Seat 6: Jake7123 folded before Flop (didn't bet)


PokerStars Hand #238169994381:  Hold'em No Limit ($0.01/$0.02 USD) - 2022/08/23 13:02:29 ET
Table 'Despina IV' 6-max Seat #2 is the button
Seat 1: dayo77625 ($1.80 in chips)
Seat 2: Rsimi5 ($0.47 in chips)
Seat 3: vezelvu1 ($2.56 in chips)
Seat 4: sexmit ($3.19 in chips)
Seat 5: Agustín Suárez ($1.51 in chips)
Seat 6: Jake7123 ($1.84 in chips)
vezelvu1: posts small blind $0.01
sexmit: posts big blind $0.02
*** HOLE CARDS ***
Agustín Suárez: folds
Jake7123: folds
dayo77625: raises $0.02 to $0.04
Rsimi5: folds
vezelvu1: raises $0.10 to $0.14
sexmit: folds
dayo77625: calls $0.10
*** FLOP *** [9d 2s 4h]
vezelvu1: bets $0.18
dayo77625: calls $0.18
*** TURN *** [9d 2s 4h] [6d]
vezelvu1: bets $2.24 and is all-in
dayo77625: folds
Uncalled bet ($2.24) returned to vezelvu1
vezelvu1 collected $0.64 from pot
*** SUMMARY ***
Total pot $0.66 | Rake $0.02
Board [9d 2s 4h 6d]
Seat 1: dayo77625 folded on the Turn
Seat 2: Rsimi5 (button) folded before Flop (didn't bet)
Seat 3: vezelvu1 (small blind) collected ($0.64)
Seat 4: sexmit (big blind) folded before Flop
Seat 5: Agustín Suárez folded before Flop (didn't bet)
Seat 6: Jake7123 folded before Flop (didn't bet)


PokerStars Hand #238170005905:  Hold'em No Limit ($0.01/$0.02 USD) - 2022/08/23 13:03:06 ET
Table 'Despina IV' 6-max Seat #3 is the button
Seat 1: dayo77625 ($1.48 in chips)
Seat 2: Rsimi5 ($0.47 in chips)
Seat 3: vezelvu1 ($2.88 in chips)
Seat 4: sexmit ($3.17 in chips)
Seat 5: Agustín Suárez ($1.51 in chips)
Seat 6: Jake7123 ($1.84 in chips)
sexmit: posts small blind $0.01
Agustín Suárez: posts big blind $0.02
*** HOLE CARDS ***
Jake7123: folds
dayo77625: folds
Rsimi5: calls $0.02
vezelvu1: folds
sexmit: calls $0.01
Agustín Suárez: raises $0.06 to $0.08
Rsimi5: calls $0.06
sexmit: folds
*** FLOP *** [Kh 4c 9c]
Agustín Suárez: bets $0.13
Rsimi5: folds
Uncalled bet ($0.13) returned to Agustín Suárez
Agustín Suárez collected $0.17 from pot
Agustín Suárez: doesn't show hand
*** SUMMARY ***
Total pot $0.18 | Rake $0.01
Board [Kh 4c 9c]
Seat 1: dayo77625 folded before Flop (didn't bet)
Seat 2: Rsimi5 folded on the Flop
Seat 3: vezelvu1 (button) folded before Flop (didn't bet)
Seat 4: sexmit (small blind) folded before Flop
Seat 5: Agustín Suárez (big blind) collected ($0.17)
Seat 6: Jake7123 folded before Flop (didn't bet)


PokerStars Hand #238170016497:  Hold'em No Limit ($0.01/$0.02 USD) - 2022/08/23 13:03:39 ET
Table 'Despina IV' 6-max Seat #4 is the button
Seat 1: dayo77625 ($1.48 in chips)
Seat 2: Rsimi5 ($0.39 in chips)
Seat 3: vezelvu1 ($2.88 in chips)
Seat 4: sexmit ($3.15 in chips)
Seat 5: Agustín Suárez ($1.60 in chips)
Seat 6: Jake7123 ($1.84 in chips)
Agustín Suárez: posts small blind $0.01
Jake7123: posts big blind $0.02
*** HOLE CARDS ***
dayo77625: folds
Rsimi5: calls $0.02
vezelvu1 is connected
vezelvu1: folds
sexmit: calls $0.02
Agustín Suárez: raises $0.04 to $0.06
Jake7123: folds
Rsimi5: calls $0.04
sexmit: calls $0.04
*** FLOP *** [Jd 5c Jh]
Agustín Suárez: checks
Rsimi5: checks
sexmit: checks
*** TURN *** [Jd 5c Jh] [Qd]
Agustín Suárez: bets $0.06
Rsimi5: calls $0.06
sexmit: calls $0.06
*** RIVER *** [Jd 5c Jh Qd] [3s]
Agustín Suárez: bets $0.12
Rsimi5: folds
sexmit: folds
Uncalled bet ($0.12) returned to Agustín Suárez
Agustín Suárez collected $0.37 from pot
Agustín Suárez: doesn't show hand
*** SUMMARY ***
Total pot $0.38 | Rake $0.01
Board [Jd 5c Jh Qd 3s]
Seat 1: dayo77625 folded before Flop (didn't bet)
Seat 2: Rsimi5 folded on the River
Seat 3: vezelvu1 folded before Flop (didn't bet)
Seat 4: sexmit (button) folded on the River
Seat 5: Agustín Suárez (small blind) collected ($0.37)
Seat 6: Jake7123 (big blind) folded before Flop


PokerStars Hand #238170032540:  Hold'em No Limit ($0.01/$0.02 USD) - 2022/08/23 13:04:29 ET
Table 'Despina IV' 6-max Seat #5 is the button
Seat 1: dayo77625 ($1.48 in chips)
Seat 2: Rsimi5 ($0.27 in chips)
Seat 3: vezelvu1 ($2.88 in chips)
Seat 4: sexmit ($3.03 in chips)
Seat 5: Agustín Suárez ($1.85 in chips)
Seat 6: Jake7123 ($1.82 in chips)
Jake7123: posts small blind $0.01
dayo77625: posts big blind $0.02
*** HOLE CARDS ***
Rsimi5: folds
vezelvu1: folds
sexmit: raises $0.02 to $0.04
Agustín Suárez: folds
Jake7123: folds
dayo77625: calls $0.02
*** FLOP *** [Ac 6h Ks]
dayo77625: bets $0.09
sexmit: calls $0.09
*** TURN *** [Ac 6h Ks] [8h]
dayo77625: bets $0.02
sexmit: calls $0.02
*** RIVER *** [Ac 6h Ks 8h] [9c]
dayo77625: bets $0.02
sexmit: raises $0.22 to $0.24
dayo77625: folds
Uncalled bet ($0.22) returned to sexmit
sexmit collected $0.34 from pot
*** SUMMARY ***
Total pot $0.35 | Rake $0.01
Board [Ac 6h Ks 8h 9c]
Seat 1: dayo77625 (big blind) folded on the River
Seat 2: Rsimi5 folded before Flop (didn't bet)
Seat 3: vezelvu1 folded before Flop (didn't bet)
Seat 4: sexmit collected ($0.34)
Seat 5: Agustín Suárez (button) folded before Flop (didn't bet)
Seat 6: Jake7123 (small blind) folded before Flop


PokerStars Hand #238170052318:  Hold'em No Limit ($0.01/$0.02 USD) - 2022/08/23 13:05:31 ET
Table 'Despina IV' 6-max Seat #6 is the button
Seat 1: dayo77625 ($1.31 in chips)
Seat 2: Rsimi5 ($0.27 in chips)
Seat 3: vezelvu1 ($2.88 in chips)
Seat 4: sexmit ($3.20 in chips)
Seat 5: Agustín Suárez ($1.85 in chips)
Seat 6: Jake7123 ($1.81 in chips)
dayo77625: posts small blind $0.01
Rsimi5: posts big blind $0.02
*** HOLE CARDS ***
vezelvu1: raises $0.02 to $0.04
sexmit: folds
Agustín Suárez: folds
Jake7123: folds
dayo77625: folds
Rsimi5: raises $0.23 to $0.27 and is all-in
vezelvu1: folds
Uncalled bet ($0.23) returned to Rsimi5
Rsimi5 collected $0.09 from pot
*** SUMMARY ***
Total pot $0.09 | Rake $0
Seat 1: dayo77625 (small blind) folded before Flop
Seat 2: Rsimi5 (big blind) collected ($0.09)
Seat 3: vezelvu1 folded before Flop
Seat 4: sexmit folded before Flop (didn't bet)
Seat 5: Agustín Suárez folded before Flop (didn't bet)
Seat 6: Jake7123 (button) folded before Flop (didn't bet)


PokerStars Hand #238170058221:  Hold'em No Limit ($0.01/$0.02 USD) - 2022/08/23 13:05:49 ET
Table 'Despina IV' 6-max Seat #1 is the button
Seat 1: dayo77625 ($1.30 in chips)
Seat 2: Rsimi5 ($0.32 in chips)
Seat 3: vezelvu1 ($2.84 in chips)
Seat 4: sexmit ($3.20 in chips)
Seat 5: Agustín Suárez ($1.85 in chips)
Seat 6: Jake7123 ($1.81 in chips)
Rsimi5: posts small blind $0.01
vezelvu1: posts big blind $0.02
*** HOLE CARDS ***
sexmit: folds
Agustín Suárez: raises $0.02 to $0.04
Jake7123: folds
dayo77625: calls $0.04
Rsimi5: raises $0.28 to $0.32 and is all-in
vezelvu1: folds
Agustín Suárez: folds
dayo77625: calls $0.28
*** FLOP *** [5h Ts 4d]
*** TURN *** [5h Ts 4d] [6c]
*** RIVER *** [5h Ts 4d 6c] [8d]
*** SHOW DOWN ***
Rsimi5: shows [Ah 9h] (high card Ace)
dayo77625: shows [Kh 8h] (a pair of Eights)
dayo77625 collected $0.68 from pot
*** SUMMARY ***
Total pot $0.70 | Rake $0.02
Board [5h Ts 4d 6c 8d]
Seat 1: dayo77625 (button) showed [Kh 8h] and won ($0.68) with a pair of Eights
Seat 2: Rsimi5 (small blind) showed [Ah 9h] and lost with high card Ace
Seat 3: vezelvu1 (big blind) folded before Flop
Seat 4: sexmit folded before Flop (didn't bet)
Seat 5: Agustín Suárez folded before Flop
Seat 6: Jake7123 folded before Flop (didn't bet)


PokerStars Hand #238170071433:  Hold'em No Limit ($0.01/$0.02 USD) - 2022/08/23 13:06:30 ET
Table 'Despina IV' 6-max Seat #3 is the button
Seat 1: dayo77625 ($1.66 in chips)
Seat 3: vezelvu1 ($2.82 in chips)
Seat 4: sexmit ($3.20 in chips)
Seat 5: Agustín Suárez ($1.81 in chips)
Seat 6: Jake7123 ($1.81 in chips)
sexmit: posts small blind $0.01
Agustín Suárez: posts big blind $0.02
*** HOLE CARDS ***
Jake7123: folds
dayo77625: calls $0.02
vezelvu1: folds
sexmit: raises $0.06 to $0.08
Agustín Suárez: folds
dayo77625: calls $0.06
*** FLOP *** [4c Ad 6h]
sexmit: bets $0.05
dayo77625: raises $0.05 to $0.10
sexmit: calls $0.05
*** TURN *** [4c Ad 6h] [8s]
sexmit: checks
dayo77625: bets $0.37
sexmit: raises $0.61 to $0.98
dayo77625: calls $0.61
*** RIVER *** [4c Ad 6h 8s] [Qh]
sexmit: bets $2.04 and is all-in
dayo77625: calls $0.50 and is all-in
Uncalled bet ($1.54) returned to sexmit
*** SHOW DOWN ***
sexmit: shows [8c 8d] (three of a kind, Eights)
dayo77625: shows [Ac Jc] (a pair of Aces)
sexmit collected $3.22 from pot
*** SUMMARY ***
Total pot $3.34 | Rake $0.12
Board [4c Ad 6h 8s Qh]
Seat 1: dayo77625 showed [Ac Jc] and lost with a pair of Aces
Seat 3: vezelvu1 (button) folded before Flop (didn't bet)
Seat 4: sexmit (small blind) showed [8c 8d] and won ($3.22) with three of a kind, Eights
Seat 5: Agustín Suárez (big blind) folded before Flop
Seat 6: Jake7123 folded before Flop (didn't bet)


PokerStars Hand #238170089359:  Hold'em No Limit ($0.01/$0.02 USD) - 2022/08/23 13:07:26 ET
Table 'Despina IV' 6-max Seat #4 is the button
Seat 2: Rsimi5 ($1 in chips)
Seat 3: vezelvu1 ($2.82 in chips)
Seat 4: sexmit ($4.76 in chips)
Seat 5: Agustín Suárez ($1.79 in chips)
Seat 6: Jake7123 ($2 in chips)
Agustín Suárez: posts small blind $0.01
Jake7123: posts big blind $0.02
*** HOLE CARDS ***
Rsimi5: folds
vezelvu1: folds
sexmit: raises $0.02 to $0.04
Agustín Suárez: calls $0.03
Jake7123: folds
*** FLOP *** [Ah Ac 6c]
Agustín Suárez: checks
sexmit: bets $0.03
Agustín Suárez: calls $0.03
*** TURN *** [Ah Ac 6c] [7c]
Agustín Suárez: checks
sexmit: bets $0.10
Agustín Suárez: calls $0.10
*** RIVER *** [Ah Ac 6c 7c] [8h]
Agustín Suárez: checks
sexmit: bets $0.39
Agustín Suárez: raises $1.23 to $1.62 and is all-in
sexmit: folds [5s 4s]
Uncalled bet ($1.23) returned to Agustín Suárez
Agustín Suárez collected $1.10 from pot
Agustín Suárez: doesn't show hand
*** SUMMARY ***
Total pot $1.14 | Rake $0.04
Board [Ah Ac 6c 7c 8h]
Seat 2: Rsimi5 folded before Flop (didn't bet)
Seat 3: vezelvu1 folded before Flop (didn't bet)
Seat 4: sexmit (button) folded on the River
Seat 5: Agustín Suárez (small blind) collected ($1.10)
Seat 6: Jake7123 (big blind) folded before Flop


PokerStars Hand #238170107240:  Hold'em No Limit ($0.01/$0.02 USD) - 2022/08/23 13:08:21 ET
Table 'Despina IV' 6-max Seat #5 is the button
Seat 1: dayo77625 ($2 in chips)
Seat 2: Rsimi5 ($1 in chips)
Seat 3: vezelvu1 ($2.82 in chips)
Seat 4: sexmit ($4.20 in chips)
Seat 5: Agustín Suárez ($2.33 in chips)
Seat 6: Jake7123 ($1.98 in chips)
Jake7123: posts small blind $0.01
dayo77625: posts big blind $0.02
*** HOLE CARDS ***
Rsimi5: calls $0.02
vezelvu1: folds
sexmit: folds
Agustín Suárez: folds
Jake7123: folds
dayo77625: checks
*** FLOP *** [As 2c 4c]
dayo77625: checks
Rsimi5: checks
*** TURN *** [As 2c 4c] [Ad]
dayo77625: checks
Rsimi5: bets $0.04
dayo77625: calls $0.04
*** RIVER *** [As 2c 4c Ad] [4h]
dayo77625: checks
Rsimi5: bets $0.30
sexmit leaves the table
leprekon71 joins the table at seat #4
dayo77625: folds
Uncalled bet ($0.30) returned to Rsimi5
Rsimi5 collected $0.13 from pot
*** SUMMARY ***
Total pot $0.13 | Rake $0
Board [As 2c 4c Ad 4h]
Seat 1: dayo77625 (big blind) folded on the River
Seat 2: Rsimi5 collected ($0.13)
Seat 3: vezelvu1 folded before Flop (didn't bet)
Seat 4: sexmit folded before Flop (didn't bet)
Seat 5: Agustín Suárez (button) folded before Flop (didn't bet)
Seat 6: Jake7123 (small blind) folded before Flop


PokerStars Hand #238170123073:  Hold'em No Limit ($0.01/$0.02 USD) - 2022/08/23 13:09:10 ET
Table 'Despina IV' 6-max Seat #6 is the button
Seat 1: dayo77625 ($1.94 in chips)
Seat 2: Rsimi5 ($1.07 in chips)
Seat 3: vezelvu1 ($2.82 in chips)
Seat 5: Agustín Suárez ($2.33 in chips)
Seat 6: Jake7123 ($1.97 in chips)
dayo77625: posts small blind $0.01
Rsimi5: posts big blind $0.02
leprekon71: sits out
*** HOLE CARDS ***
vezelvu1: folds
Agustín Suárez: folds
Jake7123: folds
dayo77625: calls $0.01
Rsimi5: checks
*** FLOP *** [2d Tc Kc]
dayo77625: checks
Rsimi5: checks
*** TURN *** [2d Tc Kc] [2s]
dayo77625: checks
Rsimi5: checks
*** RIVER *** [2d Tc Kc 2s] [7h]
dayo77625: checks
Rsimi5: checks
*** SHOW DOWN ***
dayo77625: shows [9s Ah] (a pair of Deuces)
Rsimi5: mucks hand
dayo77625 collected $0.04 from pot
*** SUMMARY ***
Total pot $0.04 | Rake $0
Board [2d Tc Kc 2s 7h]
Seat 1: dayo77625 (small blind) showed [9s Ah] and won ($0.04) with a pair of Deuces
Seat 2: Rsimi5 (big blind) mucked
Seat 3: vezelvu1 folded before Flop (didn't bet)
Seat 5: Agustín Suárez folded before Flop (didn't bet)
Seat 6: Jake7123 (button) folded before Flop (didn't bet)


PokerStars Hand #238170133800:  Hold'em No Limit ($0.01/$0.02 USD) - 2022/08/23 13:09:44 ET
Table 'Despina IV' 6-max Seat #1 is the button
Seat 1: dayo77625 ($1.96 in chips)
Seat 2: Rsimi5 ($1.05 in chips)
Seat 3: vezelvu1 ($2.82 in chips)
Seat 5: Agustín Suárez ($2.33 in chips)
Seat 6: Jake7123 ($1.97 in chips)
Rsimi5: posts small blind $0.01
vezelvu1: posts big blind $0.02
leprekon71: sits out
*** HOLE CARDS ***
Agustín Suárez: folds
Jake7123: folds
dayo77625: folds
Rsimi5: calls $0.01
vezelvu1: checks
*** FLOP *** [8s 9h Ac]
Rsimi5: bets $0.04
vezelvu1: folds
Uncalled bet ($0.04) returned to Rsimi5
Rsimi5 collected $0.04 from pot
*** SUMMARY ***
Total pot $0.04 | Rake $0
Board [8s 9h Ac]
Seat 1: dayo77625 (button) folded before Flop (didn't bet)
Seat 2: Rsimi5 (small blind) collected ($0.04)
Seat 3: vezelvu1 (big blind) folded on the Flop
Seat 5: Agustín Suárez folded before Flop (didn't bet)
Seat 6: Jake7123 folded before Flop (didn't bet)


PokerStars Hand #238170140535:  Hold'em No Limit ($0.01/$0.02 USD) - 2022/08/23 13:10:05 ET
Table 'Despina IV' 6-max Seat #2 is the button
Seat 1: dayo77625 ($1.96 in chips)
Seat 2: Rsimi5 ($1.07 in chips)
Seat 3: vezelvu1 ($2.80 in chips)
Seat 4: leprekon71 ($1.60 in chips)
Seat 5: Agustín Suárez ($2.33 in chips)
Seat 6: Jake7123 ($1.97 in chips)
vezelvu1: posts small blind $0.01
leprekon71: posts big blind $0.02
*** HOLE CARDS ***
Agustín Suárez: raises $0.04 to $0.06
Jake7123: folds
dayo77625: calls $0.06
Rsimi5: calls $0.06
vezelvu1: folds
leprekon71: folds
*** FLOP *** [Th 6s 3d]
Agustín Suárez: bets $0.07
dayo77625: calls $0.07
Rsimi5: calls $0.07
*** TURN *** [Th 6s 3d] [4h]
Agustín Suárez: bets $0.31
dayo77625: folds
Rsimi5: folds
Uncalled bet ($0.31) returned to Agustín Suárez
Agustín Suárez collected $0.41 from pot
Agustín Suárez: doesn't show hand
*** SUMMARY ***
Total pot $0.42 | Rake $0.01
Board [Th 6s 3d 4h]
Seat 1: dayo77625 folded on the Turn
Seat 2: Rsimi5 (button) folded on the Turn
Seat 3: vezelvu1 (small blind) folded before Flop
Seat 4: leprekon71 (big blind) folded before Flop
Seat 5: Agustín Suárez collected ($0.41)
Seat 6: Jake7123 folded before Flop (didn't bet)


PokerStars Hand #238170160823:  Hold'em No Limit ($0.01/$0.02 USD) - 2022/08/23 13:11:08 ET
Table 'Despina IV' 6-max Seat #3 is the button
Seat 1: dayo77625 ($1.83 in chips)
Seat 2: Rsimi5 ($0.94 in chips)
Seat 3: vezelvu1 ($2.79 in chips)
Seat 4: leprekon71 ($1.58 in chips)
Seat 5: Agustín Suárez ($2.61 in chips)
Seat 6: Jake7123 ($1.97 in chips)
leprekon71: posts small blind $0.01
Agustín Suárez: posts big blind $0.02
*** HOLE CARDS ***
Jake7123: folds
dayo77625: calls $0.02
Rsimi5: folds
vezelvu1: folds
leprekon71: folds
Agustín Suárez: raises $0.05 to $0.07
dayo77625: calls $0.05
*** FLOP *** [6d As Kd]
Agustín Suárez: checks
dayo77625: checks
*** TURN *** [6d As Kd] [Th]
Agustín Suárez: bets $0.07
dayo77625: calls $0.07
*** RIVER *** [6d As Kd Th] [9h]
Agustín Suárez: checks
dayo77625: checks
*** SHOW DOWN ***
Agustín Suárez: shows [Ts Ad] (two pair, Aces and Tens)
dayo77625: mucks hand
Agustín Suárez collected $0.28 from pot
*** SUMMARY ***
Total pot $0.29 | Rake $0.01
Board [6d As Kd Th 9h]
Seat 1: dayo77625 mucked
Seat 2: Rsimi5 folded before Flop (didn't bet)
Seat 3: vezelvu1 (button) folded before Flop (didn't bet)
Seat 4: leprekon71 (small blind) folded before Flop
Seat 5: Agustín Suárez (big blind) showed [Ts Ad] and won ($0.28) with two pair, Aces and Tens
Seat 6: Jake7123 folded before Flop (didn't bet)


PokerStars Hand #238170171478:  Hold'em No Limit ($0.01/$0.02 USD) - 2022/08/23 13:11:41 ET
Table 'Despina IV' 6-max Seat #4 is the button
Seat 1: dayo77625 ($1.69 in chips)
Seat 2: Rsimi5 ($0.94 in chips)
Seat 3: vezelvu1 ($2.79 in chips)
Seat 4: leprekon71 ($1.57 in chips)
Seat 5: Agustín Suárez ($2.75 in chips)
Seat 6: Jake7123 ($1.97 in chips)
Agustín Suárez: posts small blind $0.01
Jake7123: posts big blind $0.02
*** HOLE CARDS ***
dayo77625: folds
Rsimi5: folds
vezelvu1: folds
leprekon71: raises $0.02 to $0.04
Agustín Suárez: calls $0.03
Jake7123: calls $0.02
*** FLOP *** [Tc 3h 2h]
Agustín Suárez: checks
Jake7123: checks
leprekon71: bets $0.08
Agustín Suárez: calls $0.08
Jake7123: folds
*** TURN *** [Tc 3h 2h] [Qs]
Agustín Suárez: checks
Rsimi5 is disconnected
leprekon71: bets $0.18
Agustín Suárez: folds
Uncalled bet ($0.18) returned to leprekon71
leprekon71 collected $0.27 from pot
leprekon71: doesn't show hand
*** SUMMARY ***
Total pot $0.28 | Rake $0.01
Board [Tc 3h 2h Qs]
Seat 1: dayo77625 folded before Flop (didn't bet)
Seat 2: Rsimi5 folded before Flop (didn't bet)
Seat 3: vezelvu1 folded before Flop (didn't bet)
Seat 4: leprekon71 (button) collected ($0.27)
Seat 5: Agustín Suárez (small blind) folded on the Turn
Seat 6: Jake7123 (big blind) folded on the Flop


PokerStars Hand #238170185025:  Hold'em No Limit ($0.01/$0.02 USD) - 2022/08/23 13:12:24 ET
Table 'Despina IV' 6-max Seat #5 is the button
Seat 1: dayo77625 ($1.69 in chips)
Seat 2: Rsimi5 ($0.94 in chips)
Seat 3: vezelvu1 ($2.79 in chips)
Seat 4: leprekon71 ($1.72 in chips)
Seat 5: Agustín Suárez ($2.63 in chips)
Seat 6: Jake7123 ($1.93 in chips)
Jake7123: posts small blind $0.01
dayo77625: posts big blind $0.02
*** HOLE CARDS ***
Rsimi5 has timed out while disconnected
Rsimi5: folds
vezelvu1: folds
leprekon71: folds
Agustín Suárez: raises $0.04 to $0.06
Jake7123: folds
dayo77625: calls $0.04
*** FLOP *** [5h 4d Qd]
dayo77625: checks
Agustín Suárez: bets $0.04
dayo77625: calls $0.04
*** TURN *** [5h 4d Qd] [7h]
dayo77625: checks
Agustín Suárez: bets $0.15
dayo77625: folds
Uncalled bet ($0.15) returned to Agustín Suárez
Agustín Suárez collected $0.20 from pot
Agustín Suárez: doesn't show hand
*** SUMMARY ***
Total pot $0.21 | Rake $0.01
Board [5h 4d Qd 7h]
Seat 1: dayo77625 (big blind) folded on the Turn
Seat 2: Rsimi5 folded before Flop (didn't bet)
Seat 3: vezelvu1 folded before Flop (didn't bet)
Seat 4: leprekon71 folded before Flop (didn't bet)
Seat 5: Agustín Suárez (button) collected ($0.20)
Seat 6: Jake7123 (small blind) folded before Flop


PokerStars Hand #238170197345:  Hold'em No Limit ($0.01/$0.02 USD) - 2022/08/23 13:13:03 ET
Table 'Despina IV' 6-max Seat #6 is the button
Seat 1: dayo77625 ($1.59 in chips)
Seat 3: vezelvu1 ($2.79 in chips)
Seat 4: leprekon71 ($1.72 in chips)
Seat 5: Agustín Suárez ($2.73 in chips)
Seat 6: Jake7123 ($1.92 in chips)
dayo77625: posts small blind $0.01
vezelvu1: posts big blind $0.02
*** HOLE CARDS ***
leprekon71: folds
Agustín Suárez: folds
Jake7123: folds
dayo77625: folds
Uncalled bet ($0.01) returned to vezelvu1
vezelvu1 collected $0.02 from pot
*** SUMMARY ***
Total pot $0.02 | Rake $0
Seat 1: dayo77625 (small blind) folded before Flop
Seat 3: vezelvu1 (big blind) collected ($0.02)
Seat 4: leprekon71 folded before Flop (didn't bet)
Seat 5: Agustín Suárez folded before Flop (didn't bet)
Seat 6: Jake7123 (button) folded before Flop (didn't bet)


PokerStars Hand #238170200843:  Hold'em No Limit ($0.01/$0.02 USD) - 2022/08/23 13:13:14 ET
Table 'Despina IV' 6-max Seat #1 is the button
Seat 1: dayo77625 ($1.58 in chips)
Seat 3: vezelvu1 ($2.80 in chips)
Seat 4: leprekon71 ($1.72 in chips)
Seat 5: Agustín Suárez ($2.73 in chips)
Seat 6: Jake7123 ($1.92 in chips)
vezelvu1: posts small blind $0.01
leprekon71: posts big blind $0.02
*** HOLE CARDS ***
Agustín Suárez: folds
Jake7123: folds
dayo77625: calls $0.02
vezelvu1: folds
leprekon71: checks
*** FLOP *** [Jc 8c 5d]
leprekon71: bets $0.04
dayo77625: folds
Uncalled bet ($0.04) returned to leprekon71
leprekon71 collected $0.05 from pot
leprekon71: doesn't show hand
*** SUMMARY ***
Total pot $0.05 | Rake $0
Board [Jc 8c 5d]
Seat 1: dayo77625 (button) folded on the Flop
Seat 3: vezelvu1 (small blind) folded before Flop
Seat 4: leprekon71 (big blind) collected ($0.05)
Seat 5: Agustín Suárez folded before Flop (didn't bet)
Seat 6: Jake7123 folded before Flop (didn't bet)


PokerStars Hand #238170208660:  Hold'em No Limit ($0.01/$0.02 USD) - 2022/08/23 13:13:38 ET
Table 'Despina IV' 6-max Seat #3 is the button
Seat 1: dayo77625 ($1.56 in chips)
Seat 3: vezelvu1 ($2.79 in chips)
Seat 4: leprekon71 ($1.75 in chips)
Seat 5: Agustín Suárez ($2.73 in chips)
Seat 6: Jake7123 ($1.92 in chips)
leprekon71: posts small blind $0.01
Agustín Suárez: posts big blind $0.02
*** HOLE CARDS ***
Jake7123: raises $0.04 to $0.06
dayo77625: folds
vezelvu1: folds
leprekon71: folds
Agustín Suárez: folds
Uncalled bet ($0.04) returned to Jake7123
Jake7123 collected $0.05 from pot
Jake7123: doesn't show hand
*** SUMMARY ***
Total pot $0.05 | Rake $0
Seat 1: dayo77625 folded before Flop (didn't bet)
Seat 3: vezelvu1 (button) folded before Flop (didn't bet)
Seat 4: leprekon71 (small blind) folded before Flop
Seat 5: Agustín Suárez (big blind) folded before Flop
Seat 6: Jake7123 collected ($0.05)


PokerStars Hand #238170213033:  Hold'em No Limit ($0.01/$0.02 USD) - 2022/08/23 13:13:52 ET
Table 'Despina IV' 6-max Seat #4 is the button
Seat 1: dayo77625 ($1.56 in chips)
Seat 3: vezelvu1 ($2.79 in chips)
Seat 4: leprekon71 ($1.74 in chips)
Seat 5: Agustín Suárez ($2.71 in chips)
Seat 6: Jake7123 ($1.95 in chips)
Agustín Suárez: posts small blind $0.01
Jake7123: posts big blind $0.02
*** HOLE CARDS ***
dayo77625: calls $0.02
vezelvu1: folds
leprekon71: folds
Agustín Suárez: folds
Jake7123: checks
*** FLOP *** [3s Jc 2c]
Jake7123: checks
dayo77625: checks
*** TURN *** [3s Jc 2c] [9c]
Jake7123: checks
dayo77625: checks
*** RIVER *** [3s Jc 2c 9c] [Ad]
Jake7123: checks
dayo77625: checks
*** SHOW DOWN ***
Jake7123: shows [7s 3d] (a pair of Threes)
dayo77625: mucks hand
Jake7123 collected $0.05 from pot
*** SUMMARY ***
Total pot $0.05 | Rake $0
Board [3s Jc 2c 9c Ad]
Seat 1: dayo77625 mucked
Seat 3: vezelvu1 folded before Flop (didn't bet)
Seat 4: leprekon71 (button) folded before Flop (didn't bet)
Seat 5: Agustín Suárez (small blind) folded before Flop
Seat 6: Jake7123 (big blind) showed [7s 3d] and won ($0.05) with a pair of Threes


PokerStars Hand #238170222986:  Hold'em No Limit ($0.01/$0.02 USD) - 2022/08/23 13:14:23 ET
Table 'Despina IV' 6-max Seat #5 is the button
Seat 1: dayo77625 ($1.54 in chips)
Seat 3: vezelvu1 ($2.79 in chips)
Seat 4: leprekon71 ($1.74 in chips)
Seat 5: Agustín Suárez ($2.70 in chips)
Seat 6: Jake7123 ($1.98 in chips)
Jake7123: posts small blind $0.01
dayo77625: posts big blind $0.02
*** HOLE CARDS ***
vezelvu1: raises $0.04 to $0.06
leprekon71: folds
Agustín Suárez: folds
Jake7123: calls $0.05
dayo77625: calls $0.04
*** FLOP *** [9s 4c 8h]
Jake7123: checks
dayo77625: checks
vezelvu1: bets $0.17
Jake7123: folds
dayo77625: folds
Uncalled bet ($0.17) returned to vezelvu1
vezelvu1 collected $0.17 from pot
*** SUMMARY ***
Total pot $0.18 | Rake $0.01
Board [9s 4c 8h]
Seat 1: dayo77625 (big blind) folded on the Flop
Seat 3: vezelvu1 collected ($0.17)
Seat 4: leprekon71 folded before Flop (didn't bet)
Seat 5: Agustín Suárez (button) folded before Flop (didn't bet)
Seat 6: Jake7123 (small blind) folded on the Flop


PokerStars Hand #238170231863:  Hold'em No Limit ($0.01/$0.02 USD) - 2022/08/23 13:14:51 ET
Table 'Despina IV' 6-max Seat #6 is the button
Seat 1: dayo77625 ($1.48 in chips)
Seat 3: vezelvu1 ($2.90 in chips)
Seat 4: leprekon71 ($1.74 in chips)
Seat 5: Agustín Suárez ($2.70 in chips)
Seat 6: Jake7123 ($1.92 in chips)
dayo77625: posts small blind $0.01
vezelvu1: posts big blind $0.02
*** HOLE CARDS ***
leprekon71: folds
Agustín Suárez: folds
Jake7123: raises $0.02 to $0.04
dayo77625: calls $0.03
vezelvu1: folds
*** FLOP *** [2c Qs 8d]
dayo77625: checks
Jake7123: bets $0.05
dayo77625: folds
Uncalled bet ($0.05) returned to Jake7123
Jake7123 collected $0.10 from pot
Jake7123: doesn't show hand
*** SUMMARY ***
Total pot $0.10 | Rake $0
Board [2c Qs 8d]
Seat 1: dayo77625 (small blind) folded on the Flop
Seat 3: vezelvu1 (big blind) folded before Flop
Seat 4: leprekon71 folded before Flop (didn't bet)
Seat 5: Agustín Suárez folded before Flop (didn't bet)
Seat 6: Jake7123 (button) collected ($0.10)


PokerStars Hand #238170240918:  Hold'em No Limit ($0.01/$0.02 USD) - 2022/08/23 13:15:20 ET
Table 'Despina IV' 6-max Seat #1 is the button
Seat 1: dayo77625 ($1.44 in chips)
Seat 3: vezelvu1 ($2.88 in chips)
Seat 4: leprekon71 ($1.74 in chips)
Seat 5: Agustín Suárez ($2.70 in chips)
Seat 6: Jake7123 ($1.98 in chips)
vezelvu1: posts small blind $0.01
leprekon71: posts big blind $0.02
*** HOLE CARDS ***
Agustín Suárez: folds
Jake7123: folds
dayo77625: calls $0.02
vezelvu1: folds
leprekon71: checks
*** FLOP *** [6s 6c Kh]
leprekon71: checks
dayo77625: checks
*** TURN *** [6s 6c Kh] [2s]
leprekon71: checks
dayo77625: checks
*** RIVER *** [6s 6c Kh 2s] [9d]
leprekon71: checks
dayo77625: checks
*** SHOW DOWN ***
leprekon71: shows [7d Tc] (a pair of Sixes)
dayo77625: shows [Ah Qd] (a pair of Sixes - Ace kicker)
dayo77625 collected $0.05 from pot
*** SUMMARY ***
Total pot $0.05 | Rake $0
Board [6s 6c Kh 2s 9d]
Seat 1: dayo77625 (button) showed [Ah Qd] and won ($0.05) with a pair of Sixes
Seat 3: vezelvu1 (small blind) folded before Flop
Seat 4: leprekon71 (big blind) showed [7d Tc] and lost with a pair of Sixes
Seat 5: Agustín Suárez folded before Flop (didn't bet)
Seat 6: Jake7123 folded before Flop (didn't bet)


PokerStars Hand #238170249226:  Hold'em No Limit ($0.01/$0.02 USD) - 2022/08/23 13:15:46 ET
Table 'Despina IV' 6-max Seat #3 is the button
Seat 1: dayo77625 ($1.47 in chips)
Seat 3: vezelvu1 ($2.87 in chips)
Seat 4: leprekon71 ($1.72 in chips)
Seat 5: Agustín Suárez ($2.70 in chips)
Seat 6: Jake7123 ($1.98 in chips)
leprekon71: posts small blind $0.01
Agustín Suárez: posts big blind $0.02
*** HOLE CARDS ***
Jake7123: raises $0.02 to $0.04
dayo77625: calls $0.04
vezelvu1: folds
leprekon71: folds
Agustín Suárez: folds
*** FLOP *** [9s 7s 4c]
Jake7123: checks
dayo77625: bets $0.02
Jake7123: calls $0.02
*** TURN *** [9s 7s 4c] [3c]
Jake7123: checks
dayo77625: checks
*** RIVER *** [9s 7s 4c 3c] [3h]
Jake7123: checks
dayo77625: checks
*** SHOW DOWN ***
Jake7123: shows [Jd Ad] (a pair of Threes)
dayo77625: shows [4s As] (two pair, Fours and Threes)
dayo77625 collected $0.14 from pot
*** SUMMARY ***
Total pot $0.15 | Rake $0.01
Board [9s 7s 4c 3c 3h]
Seat 1: dayo77625 showed [4s As] and won ($0.14) with two pair, Fours and Threes
Seat 3: vezelvu1 (button) folded before Flop (didn't bet)
Seat 4: leprekon71 (small blind) folded before Flop
Seat 5: Agustín Suárez (big blind) folded before Flop
Seat 6: Jake7123 showed [Jd Ad] and lost with a pair of Threes


PokerStars Hand #238170258058:  Hold'em No Limit ($0.01/$0.02 USD) - 2022/08/23 13:16:13 ET
Table 'Despina IV' 6-max Seat #4 is the button
Seat 1: dayo77625 ($1.55 in chips)
Seat 3: vezelvu1 ($2.87 in chips)
Seat 4: leprekon71 ($1.71 in chips)
Seat 5: Agustín Suárez ($2.68 in chips)
Seat 6: Jake7123 ($1.92 in chips)
Agustín Suárez: posts small blind $0.01
Jake7123: posts big blind $0.02
*** HOLE CARDS ***
dayo77625: calls $0.02
vezelvu1: folds
leprekon71: folds
Agustín Suárez: folds
Jake7123: checks
*** FLOP *** [Jc Th 5h]
Jake7123: checks
dayo77625: bets $0.02
Jake7123: folds
Uncalled bet ($0.02) returned to dayo77625
dayo77625 collected $0.05 from pot
*** SUMMARY ***
Total pot $0.05 | Rake $0
Board [Jc Th 5h]
Seat 1: dayo77625 collected ($0.05)
Seat 3: vezelvu1 folded before Flop (didn't bet)
Seat 4: leprekon71 (button) folded before Flop (didn't bet)
Seat 5: Agustín Suárez (small blind) folded before Flop
Seat 6: Jake7123 (big blind) folded on the Flop


PokerStars Hand #238170263318:  Hold'em No Limit ($0.01/$0.02 USD) - 2022/08/23 13:16:29 ET
Table 'Despina IV' 6-max Seat #5 is the button
Seat 1: dayo77625 ($1.58 in chips)
Seat 3: vezelvu1 ($2.87 in chips)
Seat 4: leprekon71 ($1.71 in chips)
Seat 5: Agustín Suárez ($2.67 in chips)
Seat 6: Jake7123 ($1.90 in chips)
Jake7123: posts small blind $0.01
dayo77625: posts big blind $0.02
*** HOLE CARDS ***
vezelvu1: folds
leprekon71: folds
Agustín Suárez: folds
Jake7123: folds
Uncalled bet ($0.01) returned to dayo77625
dayo77625 collected $0.02 from pot
*** SUMMARY ***
Total pot $0.02 | Rake $0
Seat 1: dayo77625 (big blind) collected ($0.02)
Seat 3: vezelvu1 folded before Flop (didn't bet)
Seat 4: leprekon71 folded before Flop (didn't bet)
Seat 5: Agustín Suárez (button) folded before Flop (didn't bet)
Seat 6: Jake7123 (small blind) folded before Flop


PokerStars Hand #238170265873:  Hold'em No Limit ($0.01/$0.02 USD) - 2022/08/23 13:16:38 ET
Table 'Despina IV' 6-max Seat #6 is the button
Seat 1: dayo77625 ($1.59 in chips)
Seat 3: vezelvu1 ($2.87 in chips)
Seat 4: leprekon71 ($1.71 in chips)
Seat 5: Agustín Suárez ($2.67 in chips)
Seat 6: Jake7123 ($1.89 in chips)
dayo77625: posts small blind $0.01
vezelvu1: posts big blind $0.02
*** HOLE CARDS ***
leprekon71: folds
Agustín Suárez: folds
Jake7123: folds
dayo77625: calls $0.01
vezelvu1: checks
*** FLOP *** [8s 2s 7d]
dayo77625: checks
vezelvu1: checks
*** TURN *** [8s 2s 7d] [6h]
dayo77625: checks
vezelvu1: bets $0.06
dayo77625: folds
Uncalled bet ($0.06) returned to vezelvu1
vezelvu1 collected $0.04 from pot
*** SUMMARY ***
Total pot $0.04 | Rake $0
Board [8s 2s 7d 6h]
Seat 1: dayo77625 (small blind) folded on the Turn
Seat 3: vezelvu1 (big blind) collected ($0.04)
Seat 4: leprekon71 folded before Flop (didn't bet)
Seat 5: Agustín Suárez folded before Flop (didn't bet)
Seat 6: Jake7123 (button) folded before Flop (didn't bet)


PokerStars Hand #238170275057:  Hold'em No Limit ($0.01/$0.02 USD) - 2022/08/23 13:17:07 ET
Table 'Despina IV' 6-max Seat #1 is the button
Seat 1: dayo77625 ($1.57 in chips)
Seat 3: vezelvu1 ($2.89 in chips)
Seat 4: leprekon71 ($1.71 in chips)
Seat 5: Agustín Suárez ($2.67 in chips)
Seat 6: Jake7123 ($1.89 in chips)
vezelvu1: posts small blind $0.01
leprekon71: posts big blind $0.02
*** HOLE CARDS ***
Agustín Suárez: raises $0.02 to $0.04
Jake7123: folds
dayo77625: calls $0.04
vezelvu1: raises $0.14 to $0.18
leprekon71: folds
Agustín Suárez: folds
dayo77625: calls $0.14
*** FLOP *** [As 5c 2d]
vezelvu1 is connected
vezelvu1: bets $0.20
dayo77625: folds
Uncalled bet ($0.20) returned to vezelvu1
vezelvu1 collected $0.41 from pot
*** SUMMARY ***
Total pot $0.42 | Rake $0.01
Board [As 5c 2d]
Seat 1: dayo77625 (button) folded on the Flop
Seat 3: vezelvu1 (small blind) collected ($0.41)
Seat 4: leprekon71 (big blind) folded before Flop
Seat 5: Agustín Suárez folded before Flop
Seat 6: Jake7123 folded before Flop (didn't bet)


PokerStars Hand #238170306264:  Hold'em No Limit ($0.01/$0.02 USD) - 2022/08/23 13:18:14 ET
Table 'Despina IV' 6-max Seat #3 is the button
Seat 1: dayo77625 ($1.39 in chips)
Seat 3: vezelvu1 ($3.12 in chips)
Seat 4: leprekon71 ($1.69 in chips)
Seat 5: Agustín Suárez ($2.63 in chips)
Seat 6: Jake7123 ($1.89 in chips)
leprekon71: posts small blind $0.01
Agustín Suárez: posts big blind $0.02
*** HOLE CARDS ***
Jake7123: folds
dayo77625: calls $0.02
vezelvu1: folds
leprekon71: folds
Agustín Suárez: raises $0.05 to $0.07
dayo77625: calls $0.05
*** FLOP *** [6h 9c Ad]
Agustín Suárez: checks
dayo77625: bets $0.14
Agustín Suárez: calls $0.14
*** TURN *** [6h 9c Ad] [8s]
Agustín Suárez: checks
dayo77625: checks
*** RIVER *** [6h 9c Ad 8s] [3h]
Agustín Suárez: bets $0.31
dayo77625: folds
Uncalled bet ($0.31) returned to Agustín Suárez
Agustín Suárez collected $0.41 from pot
Agustín Suárez: doesn't show hand
*** SUMMARY ***
Total pot $0.43 | Rake $0.02
Board [6h 9c Ad 8s 3h]
Seat 1: dayo77625 folded on the River
Seat 3: vezelvu1 (button) folded before Flop (didn't bet)
Seat 4: leprekon71 (small blind) folded before Flop
Seat 5: Agustín Suárez (big blind) collected ($0.41)
Seat 6: Jake7123 folded before Flop (didn't bet)


PokerStars Hand #238170321107:  Hold'em No Limit ($0.01/$0.02 USD) - 2022/08/23 13:18:59 ET
Table 'Despina IV' 6-max Seat #4 is the button
Seat 1: dayo77625 ($1.18 in chips)
Seat 3: vezelvu1 ($3.12 in chips)
Seat 4: leprekon71 ($1.68 in chips)
Seat 5: Agustín Suárez ($2.83 in chips)
Seat 6: Jake7123 ($1.89 in chips)
Agustín Suárez: posts small blind $0.01
Jake7123: posts big blind $0.02
*** HOLE CARDS ***
dayo77625: calls $0.02
vezelvu1: raises $0.02 to $0.04
leprekon71: calls $0.04
Agustín Suárez: folds
Jake7123: folds
dayo77625: calls $0.02
*** FLOP *** [Ad Ac 2s]
dayo77625: checks
vezelvu1: checks
leprekon71: bets $0.08
dayo77625: calls $0.08
vezelvu1: folds
*** TURN *** [Ad Ac 2s] [Qh]
dayo77625: checks
leprekon71: bets $0.08
dayo77625: calls $0.08
*** RIVER *** [Ad Ac 2s Qh] [9s]
dayo77625: checks
leprekon71: checks
*** SHOW DOWN ***
dayo77625: shows [4h 3h] (a pair of Aces)
leprekon71: shows [Th Ts] (two pair, Aces and Tens)
leprekon71 collected $0.45 from pot
*** SUMMARY ***
Total pot $0.47 | Rake $0.02
Board [Ad Ac 2s Qh 9s]
Seat 1: dayo77625 showed [4h 3h] and lost with a pair of Aces
Seat 3: vezelvu1 folded on the Flop
Seat 4: leprekon71 (button) showed [Th Ts] and won ($0.45) with two pair, Aces and Tens
Seat 5: Agustín Suárez (small blind) folded before Flop
Seat 6: Jake7123 (big blind) folded before Flop


PokerStars Hand #238170336393:  Hold'em No Limit ($0.01/$0.02 USD) - 2022/08/23 13:19:47 ET
Table 'Despina IV' 6-max Seat #5 is the button
Seat 1: dayo77625 ($0.98 in chips)
Seat 3: vezelvu1 ($3.08 in chips)
Seat 4: leprekon71 ($1.93 in chips)
Seat 5: Agustín Suárez ($2.82 in chips)
Seat 6: Jake7123 ($1.87 in chips)
Jake7123: posts small blind $0.01
dayo77625: posts big blind $0.02
*** HOLE CARDS ***
vezelvu1: folds
leprekon71: folds
Agustín Suárez: folds
Jake7123: raises $0.02 to $0.04
dayo77625: folds
Uncalled bet ($0.02) returned to Jake7123
Jake7123 collected $0.04 from pot
Jake7123: doesn't show hand
*** SUMMARY ***
Total pot $0.04 | Rake $0
Seat 1: dayo77625 (big blind) folded before Flop
Seat 3: vezelvu1 folded before Flop (didn't bet)
Seat 4: leprekon71 folded before Flop (didn't bet)
Seat 5: Agustín Suárez (button) folded before Flop (didn't bet)
Seat 6: Jake7123 (small blind) collected ($0.04)


PokerStars Hand #238170339725:  Hold'em No Limit ($0.01/$0.02 USD) - 2022/08/23 13:19:57 ET
Table 'Despina IV' 6-max Seat #6 is the button
Seat 1: dayo77625 ($0.96 in chips)
Seat 3: vezelvu1 ($3.08 in chips)
Seat 4: leprekon71 ($1.93 in chips)
Seat 5: Agustín Suárez ($2.82 in chips)
Seat 6: Jake7123 ($1.89 in chips)
dayo77625: posts small blind $0.01
vezelvu1: posts big blind $0.02
*** HOLE CARDS ***
leprekon71: folds
Agustín Suárez: raises $0.04 to $0.06
Jake7123: folds
dayo77625: folds
vezelvu1: calls $0.04
*** FLOP *** [Kd 9d Ts]
vezelvu1: checks
Agustín Suárez: checks
*** TURN *** [Kd 9d Ts] [4d]
vezelvu1: checks
Agustín Suárez: bets $0.04
vezelvu1: folds
Uncalled bet ($0.04) returned to Agustín Suárez
Agustín Suárez collected $0.13 from pot
Rsimi5 was removed from the table for failing to post
Rsimi5 leaves the table
Agustín Suárez: doesn't show hand
*** SUMMARY ***
Total pot $0.13 | Rake $0
Board [Kd 9d Ts 4d]
Seat 1: dayo77625 (small blind) folded before Flop
Seat 3: vezelvu1 (big blind) folded on the Turn
Seat 4: leprekon71 folded before Flop (didn't bet)
Seat 5: Agustín Suárez collected ($0.13)
Seat 6: Jake7123 (button) folded before Flop (didn't bet)


PokerStars Hand #238170347526:  Hold'em No Limit ($0.01/$0.02 USD) - 2022/08/23 13:20:22 ET
Table 'Despina IV' 6-max Seat #1 is the button
Seat 1: dayo77625 ($0.95 in chips)
Seat 3: vezelvu1 ($3.02 in chips)
Seat 4: leprekon71 ($1.93 in chips)
Seat 5: Agustín Suárez ($2.89 in chips)
Seat 6: Jake7123 ($1.89 in chips)
vezelvu1: posts small blind $0.01
leprekon71: posts big blind $0.02
*** HOLE CARDS ***
Agustín Suárez: folds
Jake7123 has timed out
Jake7123: folds
dayo77625: calls $0.02
vezelvu1: calls $0.01
leprekon71: checks
*** FLOP *** [2c As 6c]
Rossi 060778 joins the table at seat #2
vezelvu1: checks
leprekon71: checks
Rossi 060778 leaves the table
dayo77625: checks
*** TURN *** [2c As 6c] [7s]
vezelvu1: checks
leprekon71: checks
dayo77625: checks
*** RIVER *** [2c As 6c 7s] [4c]
vezelvu1: checks
AxCent8 joins the table at seat #2
leprekon71: checks
dayo77625: checks
*** SHOW DOWN ***
vezelvu1: shows [3h Ah] (a pair of Aces)
leprekon71: mucks hand
dayo77625: shows [Qd Ac] (a pair of Aces - Queen kicker)
dayo77625 collected $0.06 from pot
*** SUMMARY ***
Total pot $0.06 | Rake $0
Board [2c As 6c 7s 4c]
Seat 1: dayo77625 (button) showed [Qd Ac] and won ($0.06) with a pair of Aces
Seat 3: vezelvu1 (small blind) showed [3h Ah] and lost with a pair of Aces
Seat 4: leprekon71 (big blind) mucked
Seat 5: Agustín Suárez folded before Flop (didn't bet)
Seat 6: Jake7123 folded before Flop (didn't bet)


PokerStars Hand #238170363728:  Hold'em No Limit ($0.01/$0.02 USD) - 2022/08/23 13:21:13 ET
Table 'Despina IV' 6-max Seat #3 is the button
Seat 1: dayo77625 ($0.99 in chips)
Seat 3: vezelvu1 ($3 in chips)
Seat 4: leprekon71 ($1.91 in chips)
Seat 5: Agustín Suárez ($2.89 in chips)
Seat 6: Jake7123 ($1.89 in chips)
leprekon71: posts small blind $0.01
Agustín Suárez: posts big blind $0.02
AxCent8: sits out
*** HOLE CARDS ***
Jake7123: folds
dayo77625: calls $0.02
vezelvu1: folds
leprekon71: folds
Agustín Suárez: checks
*** FLOP *** [3h Ac 5h]
Agustín Suárez: checks
dayo77625: checks
*** TURN *** [3h Ac 5h] [6s]
Agustín Suárez: checks
dayo77625: checks
*** RIVER *** [3h Ac 5h 6s] [2h]
Agustín Suárez: checks
dayo77625: checks
*** SHOW DOWN ***
Agustín Suárez: shows [8d 4h] (a straight, Deuce to Six)
dayo77625: mucks hand
Agustín Suárez collected $0.05 from pot
*** SUMMARY ***
Total pot $0.05 | Rake $0
Board [3h Ac 5h 6s 2h]
Seat 1: dayo77625 mucked
Seat 3: vezelvu1 (button) folded before Flop (didn't bet)
Seat 4: leprekon71 (small blind) folded before Flop
Seat 5: Agustín Suárez (big blind) showed [8d 4h] and won ($0.05) with a straight, Deuce to Six
Seat 6: Jake7123 folded before Flop (didn't bet)


PokerStars Hand #238170376759:  Hold'em No Limit ($0.01/$0.02 USD) - 2022/08/23 13:21:53 ET
Table 'Despina IV' 6-max Seat #4 is the button
Seat 1: dayo77625 ($0.97 in chips)
Seat 3: vezelvu1 ($3 in chips)
Seat 4: leprekon71 ($1.90 in chips)
Seat 5: Agustín Suárez ($2.92 in chips)
Seat 6: Jake7123 ($1.89 in chips)
Agustín Suárez: posts small blind $0.01
Jake7123: posts big blind $0.02
AxCent8: sits out
*** HOLE CARDS ***
dayo77625: folds
vezelvu1: folds
leprekon71: folds
Agustín Suárez: raises $0.04 to $0.06
Jake7123: folds
Uncalled bet ($0.04) returned to Agustín Suárez
Agustín Suárez collected $0.04 from pot
Agustín Suárez: doesn't show hand
*** SUMMARY ***
Total pot $0.04 | Rake $0
Seat 1: dayo77625 folded before Flop (didn't bet)
Seat 3: vezelvu1 folded before Flop (didn't bet)
Seat 4: leprekon71 (button) folded before Flop (didn't bet)
Seat 5: Agustín Suárez (small blind) collected ($0.04)
Seat 6: Jake7123 (big blind) folded before Flop


PokerStars Hand #238170379478:  Hold'em No Limit ($0.01/$0.02 USD) - 2022/08/23 13:22:02 ET
Table 'Despina IV' 6-max Seat #5 is the button
Seat 1: dayo77625 ($0.97 in chips)
Seat 3: vezelvu1 ($3 in chips)
Seat 4: leprekon71 ($1.90 in chips)
Seat 5: Agustín Suárez ($2.94 in chips)
Seat 6: Jake7123 ($1.87 in chips)
Jake7123: posts small blind $0.01
dayo77625: posts big blind $0.02
AxCent8: sits out
*** HOLE CARDS ***
vezelvu1: folds
leprekon71: folds
Agustín Suárez: raises $0.04 to $0.06
Jake7123: folds
dayo77625: calls $0.04
*** FLOP *** [5h Ah 4d]
dayo77625: checks
Agustín Suárez: checks
*** TURN *** [5h Ah 4d] [8h]
dayo77625: checks
Agustín Suárez: bets $0.04
dayo77625: folds
Uncalled bet ($0.04) returned to Agustín Suárez
Agustín Suárez collected $0.13 from pot
Agustín Suárez: doesn't show hand
*** SUMMARY ***
Total pot $0.13 | Rake $0
Board [5h Ah 4d 8h]
Seat 1: dayo77625 (big blind) folded on the Turn
Seat 3: vezelvu1 folded before Flop (didn't bet)
Seat 4: leprekon71 folded before Flop (didn't bet)
Seat 5: Agustín Suárez (button) collected ($0.13)
Seat 6: Jake7123 (small blind) folded before Flop


PokerStars Hand #238170391898:  Hold'em No Limit ($0.01/$0.02 USD) - 2022/08/23 13:22:40 ET
Table 'Despina IV' 6-max Seat #6 is the button
Seat 1: dayo77625 ($0.91 in chips)
Seat 2: AxCent8 ($0.80 in chips)
Seat 3: vezelvu1 ($3 in chips)
Seat 4: leprekon71 ($1.90 in chips)
Seat 5: Agustín Suárez ($3.01 in chips)
Seat 6: Jake7123 ($1.86 in chips)
dayo77625: posts small blind $0.01
AxCent8: posts big blind $0.02
*** HOLE CARDS ***
vezelvu1: folds
leprekon71: folds
Agustín Suárez: folds
Jake7123: folds
dayo77625: calls $0.01
AxCent8: checks
*** FLOP *** [Kh 9s Jh]
dayo77625: checks
AxCent8: checks
*** TURN *** [Kh 9s Jh] [4h]
dayo77625: checks
AxCent8: checks
*** RIVER *** [Kh 9s Jh 4h] [Ts]
dayo77625: checks
AxCent8: checks
*** SHOW DOWN ***
dayo77625: shows [Qc 7c] (a straight, Nine to King)
AxCent8: mucks hand
dayo77625 collected $0.04 from pot
*** SUMMARY ***
Total pot $0.04 | Rake $0
Board [Kh 9s Jh 4h Ts]
Seat 1: dayo77625 (small blind) showed [Qc 7c] and won ($0.04) with a straight, Nine to King
Seat 2: AxCent8 (big blind) mucked
Seat 3: vezelvu1 folded before Flop (didn't bet)
Seat 4: leprekon71 folded before Flop (didn't bet)
Seat 5: Agustín Suárez folded before Flop (didn't bet)
Seat 6: Jake7123 (button) folded before Flop (didn't bet)


PokerStars Hand #238170408089:  Hold'em No Limit ($0.01/$0.02 USD) - 2022/08/23 13:23:30 ET
Table 'Despina IV' 6-max Seat #1 is the button
Seat 1: dayo77625 ($0.93 in chips)
Seat 2: AxCent8 ($0.78 in chips)
Seat 3: vezelvu1 ($3 in chips)
Seat 4: leprekon71 ($1.90 in chips)
Seat 5: Agustín Suárez ($3.01 in chips)
Seat 6: Jake7123 ($1.86 in chips)
AxCent8: posts small blind $0.01
vezelvu1: posts big blind $0.02
*** HOLE CARDS ***
leprekon71: raises $0.04 to $0.06
Agustín Suárez: folds
Jake7123: folds
dayo77625: calls $0.06
AxCent8: folds
vezelvu1: folds
*** FLOP *** [8d Ts 2c]
leprekon71: checks
dayo77625: bets $0.02
leprekon71: calls $0.02
*** TURN *** [8d Ts 2c] [Qc]
leprekon71: checks
dayo77625: bets $0.02
leprekon71: calls $0.02
*** RIVER *** [8d Ts 2c Qc] [5d]
leprekon71: checks
dayo77625: checks
*** SHOW DOWN ***
leprekon71: shows [Kc As] (high card Ace)
dayo77625: shows [9c Qh] (a pair of Queens)
dayo77625 collected $0.22 from pot
*** SUMMARY ***
Total pot $0.23 | Rake $0.01
Board [8d Ts 2c Qc 5d]
Seat 1: dayo77625 (button) showed [9c Qh] and won ($0.22) with a pair of Queens
Seat 2: AxCent8 (small blind) folded before Flop
Seat 3: vezelvu1 (big blind) folded before Flop
Seat 4: leprekon71 showed [Kc As] and lost with high card Ace
Seat 5: Agustín Suárez folded before Flop (didn't bet)
Seat 6: Jake7123 folded before Flop (didn't bet)


PokerStars Hand #238170420071:  Hold'em No Limit ($0.01/$0.02 USD) - 2022/08/23 13:24:08 ET
Table 'Despina IV' 6-max Seat #2 is the button
Seat 1: dayo77625 ($1.05 in chips)
Seat 2: AxCent8 ($0.77 in chips)
Seat 3: vezelvu1 ($2.98 in chips)
Seat 4: leprekon71 ($1.80 in chips)
Seat 5: Agustín Suárez ($3.01 in chips)
Seat 6: Jake7123 ($1.86 in chips)
vezelvu1: posts small blind $0.01
leprekon71: posts big blind $0.02
*** HOLE CARDS ***
Agustín Suárez: folds
Jake7123: folds
dayo77625: calls $0.02
AxCent8: folds
vezelvu1: calls $0.01
leprekon71: checks
*** FLOP *** [2s 3h Ad]
vezelvu1: checks
leprekon71: checks
dayo77625: checks
*** TURN *** [2s 3h Ad] [Jd]
vezelvu1: checks
leprekon71: checks
dayo77625: checks
*** RIVER *** [2s 3h Ad Jd] [2d]
vezelvu1: checks
leprekon71: bets $0.14
dayo77625: folds
vezelvu1: folds
Uncalled bet ($0.14) returned to leprekon71
leprekon71 collected $0.06 from pot
leprekon71: doesn't show hand
*** SUMMARY ***
Total pot $0.06 | Rake $0
Board [2s 3h Ad Jd 2d]
Seat 1: dayo77625 folded on the River
Seat 2: AxCent8 (button) folded before Flop (didn't bet)
Seat 3: vezelvu1 (small blind) folded on the River
Seat 4: leprekon71 (big blind) collected ($0.06)
Seat 5: Agustín Suárez folded before Flop (didn't bet)
Seat 6: Jake7123 folded before Flop (didn't bet)


PokerStars Hand #238170441415:  Hold'em No Limit ($0.01/$0.02 USD) - 2022/08/23 13:25:14 ET
Table 'Despina IV' 6-max Seat #3 is the button
Seat 1: dayo77625 ($1.03 in chips)
Seat 2: AxCent8 ($0.77 in chips)
Seat 3: vezelvu1 ($2.96 in chips)
Seat 4: leprekon71 ($1.84 in chips)
Seat 5: Agustín Suárez ($3.01 in chips)
Seat 6: Jake7123 ($1.86 in chips)
leprekon71: posts small blind $0.01
Agustín Suárez: posts big blind $0.02
*** HOLE CARDS ***
Jake7123: folds
dayo77625: raises $0.02 to $0.04
AxCent8: folds
vezelvu1: folds
leprekon71: folds
Agustín Suárez: folds
Uncalled bet ($0.02) returned to dayo77625
dayo77625 collected $0.05 from pot
*** SUMMARY ***
Total pot $0.05 | Rake $0
Seat 1: dayo77625 collected ($0.05)
Seat 2: AxCent8 folded before Flop (didn't bet)
Seat 3: vezelvu1 (button) folded before Flop (didn't bet)
Seat 4: leprekon71 (small blind) folded before Flop
Seat 5: Agustín Suárez (big blind) folded before Flop
Seat 6: Jake7123 folded before Flop (didn't bet)


PokerStars Hand #238170446269:  Hold'em No Limit ($0.01/$0.02 USD) - 2022/08/23 13:25:29 ET
Table 'Despina IV' 6-max Seat #4 is the button
Seat 1: dayo77625 ($1.06 in chips)
Seat 2: AxCent8 ($0.77 in chips)
Seat 3: vezelvu1 ($2.96 in chips)
Seat 4: leprekon71 ($1.83 in chips)
Seat 5: Agustín Suárez ($2.99 in chips)
Seat 6: Jake7123 ($1.86 in chips)
Agustín Suárez: posts small blind $0.01
Jake7123: posts big blind $0.02
*** HOLE CARDS ***
dayo77625: calls $0.02
AxCent8: folds
vezelvu1: folds
leprekon71: calls $0.02
Agustín Suárez: folds
Jake7123: checks
*** FLOP *** [2h 7d 8c]
Jake7123: checks
dayo77625: checks
leprekon71: checks
*** TURN *** [2h 7d 8c] [8s]
Jake7123: checks
dayo77625: checks
leprekon71: checks
*** RIVER *** [2h 7d 8c 8s] [9c]
Jake7123: checks
dayo77625: checks
leprekon71: checks
*** SHOW DOWN ***
Jake7123: shows [Jh 3c] (a pair of Eights)
dayo77625: shows [Ks 4c] (a pair of Eights - King kicker)
leprekon71: shows [Ah 4h] (a pair of Eights - Ace kicker)
leprekon71 collected $0.07 from pot
*** SUMMARY ***
Total pot $0.07 | Rake $0
Board [2h 7d 8c 8s 9c]
Seat 1: dayo77625 showed [Ks 4c] and lost with a pair of Eights
Seat 2: AxCent8 folded before Flop (didn't bet)
Seat 3: vezelvu1 folded before Flop (didn't bet)
Seat 4: leprekon71 (button) showed [Ah 4h] and won ($0.07) with a pair of Eights
Seat 5: Agustín Suárez (small blind) folded before Flop
Seat 6: Jake7123 (big blind) showed [Jh 3c] and lost with a pair of Eights


PokerStars Hand #238170458724:  Hold'em No Limit ($0.01/$0.02 USD) - 2022/08/23 13:26:07 ET
Table 'Despina IV' 6-max Seat #5 is the button
Seat 1: dayo77625 ($1.04 in chips)
Seat 2: AxCent8 ($0.77 in chips)
Seat 3: vezelvu1 ($2.96 in chips)
Seat 4: leprekon71 ($1.88 in chips)
Seat 5: Agustín Suárez ($2.98 in chips)
Seat 6: Jake7123 ($1.84 in chips)
Jake7123: posts small blind $0.01
dayo77625: posts big blind $0.02
*** HOLE CARDS ***
AxCent8: folds
vezelvu1: folds
leprekon71: folds
Agustín Suárez: folds
Jake7123: raises $0.02 to $0.04
dayo77625: folds
Uncalled bet ($0.02) returned to Jake7123
Jake7123 collected $0.04 from pot
Jake7123: doesn't show hand
*** SUMMARY ***
Total pot $0.04 | Rake $0
Seat 1: dayo77625 (big blind) folded before Flop
Seat 2: AxCent8 folded before Flop (didn't bet)
Seat 3: vezelvu1 folded before Flop (didn't bet)
Seat 4: leprekon71 folded before Flop (didn't bet)
Seat 5: Agustín Suárez (button) folded before Flop (didn't bet)
Seat 6: Jake7123 (small blind) collected ($0.04)


PokerStars Hand #238170463863:  Hold'em No Limit ($0.01/$0.02 USD) - 2022/08/23 13:26:24 ET
Table 'Despina IV' 6-max Seat #6 is the button
Seat 1: dayo77625 ($1.02 in chips)
Seat 2: AxCent8 ($0.77 in chips)
Seat 3: vezelvu1 ($2.96 in chips)
Seat 4: leprekon71 ($1.88 in chips)
Seat 5: Agustín Suárez ($2.98 in chips)
Seat 6: Jake7123 ($1.86 in chips)
dayo77625: posts small blind $0.01
AxCent8: posts big blind $0.02
*** HOLE CARDS ***
vezelvu1: folds
leprekon71: folds
Agustín Suárez: raises $0.04 to $0.06
Jake7123: calls $0.06
dayo77625: raises $0.04 to $0.10
AxCent8: folds
Agustín Suárez: calls $0.04
Jake7123: calls $0.04
*** FLOP *** [6h 7h 2h]
dayo77625: bets $0.92 and is all-in
Agustín Suárez: calls $0.92
Jake7123: folds
*** TURN *** [6h 7h 2h] [6d]
*** RIVER *** [6h 7h 2h 6d] [5c]
*** SHOW DOWN ***
dayo77625: shows [Js Jc] (two pair, Jacks and Sixes)
Agustín Suárez: shows [Th Jh] (a flush, Jack high)
Agustín Suárez collected $2.08 from pot
*** SUMMARY ***
Total pot $2.16 | Rake $0.08
Board [6h 7h 2h 6d 5c]
Seat 1: dayo77625 (small blind) showed [Js Jc] and lost with two pair, Jacks and Sixes
Seat 2: AxCent8 (big blind) folded before Flop
Seat 3: vezelvu1 folded before Flop (didn't bet)
Seat 4: leprekon71 folded before Flop (didn't bet)
Seat 5: Agustín Suárez showed [Th Jh] and won ($2.08) with a flush, Jack high
Seat 6: Jake7123 (button) folded on the Flop


PokerStars Hand #238170480136:  Hold'em No Limit ($0.01/$0.02 USD) - 2022/08/23 13:27:14 ET
Table 'Despina IV' 6-max Seat #2 is the button
Seat 2: AxCent8 ($0.75 in chips)
Seat 3: vezelvu1 ($2.96 in chips)
Seat 4: leprekon71 ($1.88 in chips)
Seat 5: Agustín Suárez ($4.04 in chips)
Seat 6: Jake7123 ($1.76 in chips)
vezelvu1: posts small blind $0.01
leprekon71: posts big blind $0.02
*** HOLE CARDS ***
Agustín Suárez: folds
Jake7123: raises $0.02 to $0.04
AxCent8: folds
vezelvu1: folds
leprekon71: calls $0.02
*** FLOP *** [8s 6d 4h]
leprekon71: checks
Jake7123: checks
*** TURN *** [8s 6d 4h] [2s]
leprekon71: bets $0.06
Jake7123: calls $0.06
*** RIVER *** [8s 6d 4h 2s] [3d]
leprekon71: checks
Jake7123: bets $0.10
leprekon71: folds
Uncalled bet ($0.10) returned to Jake7123
Jake7123 collected $0.20 from pot
Jake7123: doesn't show hand
*** SUMMARY ***
Total pot $0.21 | Rake $0.01
Board [8s 6d 4h 2s 3d]
Seat 2: AxCent8 (button) folded before Flop (didn't bet)
Seat 3: vezelvu1 (small blind) folded before Flop
Seat 4: leprekon71 (big blind) folded on the River
Seat 5: Agustín Suárez folded before Flop (didn't bet)
Seat 6: Jake7123 collected ($0.20)


PokerStars Hand #238170490184:  Hold'em No Limit ($0.01/$0.02 USD) - 2022/08/23 13:27:46 ET
Table 'Despina IV' 6-max Seat #3 is the button
Seat 1: dayo77625 ($2 in chips)
Seat 2: AxCent8 ($0.75 in chips)
Seat 3: vezelvu1 ($2.95 in chips)
Seat 4: leprekon71 ($1.78 in chips)
Seat 5: Agustín Suárez ($4.04 in chips)
Seat 6: Jake7123 ($1.86 in chips)
leprekon71: posts small blind $0.01
Agustín Suárez: posts big blind $0.02
*** HOLE CARDS ***
Jake7123: folds
dayo77625: calls $0.02
AxCent8: folds
vezelvu1: folds
leprekon71: folds
Agustín Suárez: checks
*** FLOP *** [2d 9s 2h]
Agustín Suárez: checks
dayo77625: checks
*** TURN *** [2d 9s 2h] [As]
Agustín Suárez: checks
dayo77625: checks
*** RIVER *** [2d 9s 2h As] [Td]
Agustín Suárez: checks
dayo77625: checks
*** SHOW DOWN ***
Agustín Suárez: shows [4s 3d] (a pair of Deuces)
dayo77625: shows [7c 6h] (a pair of Deuces)
Agustín Suárez collected $0.03 from pot
dayo77625 collected $0.02 from pot
*** SUMMARY ***
Total pot $0.05 | Rake $0
Board [2d 9s 2h As Td]
Seat 1: dayo77625 showed [7c 6h] and won ($0.02) with a pair of Deuces
Seat 2: AxCent8 folded before Flop (didn't bet)
Seat 3: vezelvu1 (button) folded before Flop (didn't bet)
Seat 4: leprekon71 (small blind) folded before Flop
Seat 5: Agustín Suárez (big blind) showed [4s 3d] and won ($0.03) with a pair of Deuces
Seat 6: Jake7123 folded before Flop (didn't bet)


PokerStars Hand #238170499398:  Hold'em No Limit ($0.01/$0.02 USD) - 2022/08/23 13:28:14 ET
Table 'Despina IV' 6-max Seat #4 is the button
Seat 1: dayo77625 ($2 in chips)
Seat 2: AxCent8 ($0.75 in chips)
Seat 3: vezelvu1 ($2.95 in chips)
Seat 4: leprekon71 ($1.77 in chips)
Seat 5: Agustín Suárez ($4.05 in chips)
Seat 6: Jake7123 ($1.86 in chips)
Agustín Suárez: posts small blind $0.01
Jake7123: posts big blind $0.02
*** HOLE CARDS ***
dayo77625: calls $0.02
AxCent8: folds
vezelvu1: folds
leprekon71: folds
Agustín Suárez: folds
Jake7123: checks
*** FLOP *** [6s 2c 4d]
Jake7123: checks
dayo77625: checks
*** TURN *** [6s 2c 4d] [5c]
Jake7123: bets $0.05
dayo77625: folds
Uncalled bet ($0.05) returned to Jake7123
Jake7123 collected $0.05 from pot
Jake7123: doesn't show hand
*** SUMMARY ***
Total pot $0.05 | Rake $0
Board [6s 2c 4d 5c]
Seat 1: dayo77625 folded on the Turn
Seat 2: AxCent8 folded before Flop (didn't bet)
Seat 3: vezelvu1 folded before Flop (didn't bet)
Seat 4: leprekon71 (button) folded before Flop (didn't bet)
Seat 5: Agustín Suárez (small blind) folded before Flop
Seat 6: Jake7123 (big blind) collected ($0.05)


PokerStars Hand #238170506705:  Hold'em No Limit ($0.01/$0.02 USD) - 2022/08/23 13:28:37 ET
Table 'Despina IV' 6-max Seat #5 is the button
Seat 1: dayo77625 ($1.98 in chips)
Seat 2: AxCent8 ($0.75 in chips)
Seat 3: vezelvu1 ($2.95 in chips)
Seat 4: leprekon71 ($1.77 in chips)
Seat 5: Agustín Suárez ($4.04 in chips)
Seat 6: Jake7123 ($1.89 in chips)
Jake7123: posts small blind $0.01
dayo77625: posts big blind $0.02
*** HOLE CARDS ***
AxCent8: folds
vezelvu1: folds
leprekon71: folds
Agustín Suárez: folds
Jake7123: folds
Uncalled bet ($0.01) returned to dayo77625
dayo77625 collected $0.02 from pot
*** SUMMARY ***
Total pot $0.02 | Rake $0
Seat 1: dayo77625 (big blind) collected ($0.02)
Seat 2: AxCent8 folded before Flop (didn't bet)
Seat 3: vezelvu1 folded before Flop (didn't bet)
Seat 4: leprekon71 folded before Flop (didn't bet)
Seat 5: Agustín Suárez (button) folded before Flop (didn't bet)
Seat 6: Jake7123 (small blind) folded before Flop


PokerStars Hand #238170510774:  Hold'em No Limit ($0.01/$0.02 USD) - 2022/08/23 13:28:50 ET
Table 'Despina IV' 6-max Seat #6 is the button
Seat 1: dayo77625 ($1.99 in chips)
Seat 2: AxCent8 ($0.75 in chips)
Seat 3: vezelvu1 ($2.95 in chips)
Seat 4: leprekon71 ($1.77 in chips)
Seat 5: Agustín Suárez ($4.04 in chips)
Seat 6: Jake7123 ($1.88 in chips)
dayo77625: posts small blind $0.01
AxCent8: posts big blind $0.02
*** HOLE CARDS ***
vezelvu1: folds
leprekon71: folds
Agustín Suárez: raises $0.04 to $0.06
Jake7123: folds
dayo77625: calls $0.05
AxCent8: folds
*** FLOP *** [6c Jh 7d]
dayo77625: bets $0.14
Agustín Suárez: folds
Uncalled bet ($0.14) returned to dayo77625
dayo77625 collected $0.14 from pot
*** SUMMARY ***
Total pot $0.14 | Rake $0
Board [6c Jh 7d]
Seat 1: dayo77625 (small blind) collected ($0.14)
Seat 2: AxCent8 (big blind) folded before Flop
Seat 3: vezelvu1 folded before Flop (didn't bet)
Seat 4: leprekon71 folded before Flop (didn't bet)
Seat 5: Agustín Suárez folded on the Flop
Seat 6: Jake7123 (button) folded before Flop (didn't bet)


PokerStars Hand #238170521859:  Hold'em No Limit ($0.01/$0.02 USD) - 2022/08/23 13:29:25 ET
Table 'Despina IV' 6-max Seat #1 is the button
Seat 1: dayo77625 ($2.07 in chips)
Seat 2: AxCent8 ($0.73 in chips)
Seat 3: vezelvu1 ($2.95 in chips)
Seat 4: leprekon71 ($1.77 in chips)
Seat 5: Agustín Suárez ($3.98 in chips)
Seat 6: Jake7123 ($1.88 in chips)
AxCent8: posts small blind $0.01
vezelvu1: posts big blind $0.02
*** HOLE CARDS ***
leprekon71: folds
Agustín Suárez: raises $0.02 to $0.04
Jake7123: folds
dayo77625: calls $0.04
AxCent8: folds
vezelvu1: folds
*** FLOP *** [3s 8h 6c]
Agustín Suárez: checks
dayo77625: bets $0.11
Agustín Suárez: folds
Uncalled bet ($0.11) returned to dayo77625
dayo77625 collected $0.11 from pot
*** SUMMARY ***
Total pot $0.11 | Rake $0
Board [3s 8h 6c]
Seat 1: dayo77625 (button) collected ($0.11)
Seat 2: AxCent8 (small blind) folded before Flop
Seat 3: vezelvu1 (big blind) folded before Flop
Seat 4: leprekon71 folded before Flop (didn't bet)
Seat 5: Agustín Suárez folded on the Flop
Seat 6: Jake7123 folded before Flop (didn't bet)


PokerStars Hand #238170532090:  Hold'em No Limit ($0.01/$0.02 USD) - 2022/08/23 13:29:56 ET
Table 'Despina IV' 6-max Seat #2 is the button
Seat 1: dayo77625 ($2.14 in chips)
Seat 2: AxCent8 ($0.72 in chips)
Seat 3: vezelvu1 ($2.93 in chips)
Seat 4: leprekon71 ($1.77 in chips)
Seat 5: Agustín Suárez ($3.94 in chips)
Seat 6: Jake7123 ($1.88 in chips)
vezelvu1: posts small blind $0.01
leprekon71: posts big blind $0.02
*** HOLE CARDS ***
Agustín Suárez: folds
Jake7123: raises $0.02 to $0.04
dayo77625: calls $0.04
AxCent8: folds
vezelvu1: folds
leprekon71: folds
*** FLOP *** [2d 8s 8c]
Jake7123: checks
dayo77625: checks
*** TURN *** [2d 8s 8c] [Td]
Jake7123: checks
dayo77625: bets $0.02
Jake7123: calls $0.02
*** RIVER *** [2d 8s 8c Td] [4d]
Jake7123: checks
dayo77625: bets $0.14
Jake7123: folds
Uncalled bet ($0.14) returned to dayo77625
dayo77625 collected $0.14 from pot
*** SUMMARY ***
Total pot $0.15 | Rake $0.01
Board [2d 8s 8c Td 4d]
Seat 1: dayo77625 collected ($0.14)
Seat 2: AxCent8 (button) folded before Flop (didn't bet)
Seat 3: vezelvu1 (small blind) folded before Flop
Seat 4: leprekon71 (big blind) folded before Flop
Seat 5: Agustín Suárez folded before Flop (didn't bet)
Seat 6: Jake7123 folded on the River


PokerStars Hand #238170546694:  Hold'em No Limit ($0.01/$0.02 USD) - 2022/08/23 13:30:40 ET
Table 'Despina IV' 6-max Seat #3 is the button
Seat 1: dayo77625 ($2.22 in chips)
Seat 2: AxCent8 ($0.72 in chips)
Seat 3: vezelvu1 ($2.92 in chips)
Seat 4: leprekon71 ($1.75 in chips)
Seat 5: Agustín Suárez ($3.94 in chips)
Seat 6: Jake7123 ($1.82 in chips)
leprekon71: posts small blind $0.01
Agustín Suárez: posts big blind $0.02
*** HOLE CARDS ***
Jake7123: folds
dayo77625: calls $0.02
AxCent8: folds
vezelvu1: folds
leprekon71: folds
Agustín Suárez: checks
*** FLOP *** [Kh Kd 7s]
Agustín Suárez: checks
dayo77625: checks
*** TURN *** [Kh Kd 7s] [6d]
Agustín Suárez: checks
dayo77625: checks
*** RIVER *** [Kh Kd 7s 6d] [Th]
Agustín Suárez: checks
dayo77625: checks
*** SHOW DOWN ***
Agustín Suárez: shows [3h 8h] (a pair of Kings)
dayo77625: shows [3c 3d] (two pair, Kings and Threes)
dayo77625 collected $0.05 from pot
*** SUMMARY ***
Total pot $0.05 | Rake $0
Board [Kh Kd 7s 6d Th]
Seat 1: dayo77625 showed [3c 3d] and won ($0.05) with two pair, Kings and Threes
Seat 2: AxCent8 folded before Flop (didn't bet)
Seat 3: vezelvu1 (button) folded before Flop (didn't bet)
Seat 4: leprekon71 (small blind) folded before Flop
Seat 5: Agustín Suárez (big blind) showed [3h 8h] and lost with a pair of Kings
Seat 6: Jake7123 folded before Flop (didn't bet)


PokerStars Hand #238170555635:  Hold'em No Limit ($0.01/$0.02 USD) - 2022/08/23 13:31:07 ET
Table 'Despina IV' 6-max Seat #4 is the button
Seat 1: dayo77625 ($2.25 in chips)
Seat 2: AxCent8 ($0.72 in chips)
Seat 3: vezelvu1 ($2.92 in chips)
Seat 4: leprekon71 ($1.74 in chips)
Seat 5: Agustín Suárez ($3.92 in chips)
Seat 6: Jake7123 ($1.82 in chips)
Agustín Suárez: posts small blind $0.01
Jake7123: posts big blind $0.02
*** HOLE CARDS ***
dayo77625: calls $0.02
AxCent8: calls $0.02
vezelvu1: folds
leprekon71: folds
Agustín Suárez: folds
Jake7123: checks
*** FLOP *** [Js Jd 8c]
Jake7123: checks
dayo77625: checks
AxCent8: bets $0.04
Jake7123: folds
dayo77625: folds
Uncalled bet ($0.04) returned to AxCent8
AxCent8 collected $0.07 from pot
*** SUMMARY ***
Total pot $0.07 | Rake $0
Board [Js Jd 8c]
Seat 1: dayo77625 folded on the Flop
Seat 2: AxCent8 collected ($0.07)
Seat 3: vezelvu1 folded before Flop (didn't bet)
Seat 4: leprekon71 (button) folded before Flop (didn't bet)
Seat 5: Agustín Suárez (small blind) folded before Flop
Seat 6: Jake7123 (big blind) folded on the Flop


PokerStars Hand #238170572869:  Hold'em No Limit ($0.01/$0.02 USD) - 2022/08/23 13:31:59 ET
Table 'Despina IV' 6-max Seat #5 is the button
Seat 1: dayo77625 ($2.23 in chips)
Seat 2: AxCent8 ($0.77 in chips)
Seat 3: vezelvu1 ($2.92 in chips)
Seat 4: leprekon71 ($1.74 in chips)
Seat 5: Agustín Suárez ($3.91 in chips)
Seat 6: Jake7123 ($1.80 in chips)
Jake7123: posts small blind $0.01
dayo77625: posts big blind $0.02
*** HOLE CARDS ***
AxCent8: folds
vezelvu1: folds
leprekon71: folds
Agustín Suárez: folds
Jake7123: folds
Uncalled bet ($0.01) returned to dayo77625
dayo77625 collected $0.02 from pot
*** SUMMARY ***
Total pot $0.02 | Rake $0
Seat 1: dayo77625 (big blind) collected ($0.02)
Seat 2: AxCent8 folded before Flop (didn't bet)
Seat 3: vezelvu1 folded before Flop (didn't bet)
Seat 4: leprekon71 folded before Flop (didn't bet)
Seat 5: Agustín Suárez (button) folded before Flop (didn't bet)
Seat 6: Jake7123 (small blind) folded before Flop


PokerStars Hand #238170579062:  Hold'em No Limit ($0.01/$0.02 USD) - 2022/08/23 13:32:17 ET
Table 'Despina IV' 6-max Seat #6 is the button
Seat 1: dayo77625 ($2.24 in chips)
Seat 2: AxCent8 ($0.77 in chips)
Seat 3: vezelvu1 ($2.92 in chips)
Seat 4: leprekon71 ($1.74 in chips)
Seat 5: Agustín Suárez ($3.91 in chips)
Seat 6: Jake7123 ($1.79 in chips)
dayo77625: posts small blind $0.01
AxCent8: posts big blind $0.02
*** HOLE CARDS ***
vezelvu1: folds
leprekon71: folds
Agustín Suárez: folds
Jake7123: folds
dayo77625: calls $0.01
AxCent8: checks
*** FLOP *** [Ks 3h 7s]
dayo77625: checks
AxCent8: checks
*** TURN *** [Ks 3h 7s] [2s]
dayo77625: checks
AxCent8: checks
*** RIVER *** [Ks 3h 7s 2s] [Th]
dayo77625: checks
AxCent8: checks
*** SHOW DOWN ***
dayo77625: shows [4d 4h] (a pair of Fours)
AxCent8: mucks hand
dayo77625 collected $0.04 from pot
*** SUMMARY ***
Total pot $0.04 | Rake $0
Board [Ks 3h 7s 2s Th]
Seat 1: dayo77625 (small blind) showed [4d 4h] and won ($0.04) with a pair of Fours
Seat 2: AxCent8 (big blind) mucked
Seat 3: vezelvu1 folded before Flop (didn't bet)
Seat 4: leprekon71 folded before Flop (didn't bet)
Seat 5: Agustín Suárez folded before Flop (didn't bet)
Seat 6: Jake7123 (button) folded before Flop (didn't bet)


PokerStars Hand #238170587836:  Hold'em No Limit ($0.01/$0.02 USD) - 2022/08/23 13:32:44 ET
Table 'Despina IV' 6-max Seat #1 is the button
Seat 1: dayo77625 ($2.26 in chips)
Seat 2: AxCent8 ($0.75 in chips)
Seat 3: vezelvu1 ($2.92 in chips)
Seat 4: leprekon71 ($1.74 in chips)
Seat 5: Agustín Suárez ($3.91 in chips)
Seat 6: Jake7123 ($1.79 in chips)
AxCent8: posts small blind $0.01
vezelvu1: posts big blind $0.02
*** HOLE CARDS ***
leprekon71: folds
Agustín Suárez: folds
Jake7123: folds
dayo77625: calls $0.02
AxCent8: calls $0.01
vezelvu1: checks
*** FLOP *** [2c Qd 4s]
AxCent8: checks
vezelvu1: checks
dayo77625: checks
*** TURN *** [2c Qd 4s] [4d]
AxCent8: checks
vezelvu1: bets $0.04
dayo77625: folds
AxCent8: folds
Uncalled bet ($0.04) returned to vezelvu1
vezelvu1 collected $0.06 from pot
*** SUMMARY ***
Total pot $0.06 | Rake $0
Board [2c Qd 4s 4d]
Seat 1: dayo77625 (button) folded on the Turn
Seat 2: AxCent8 (small blind) folded on the Turn
Seat 3: vezelvu1 (big blind) collected ($0.06)
Seat 4: leprekon71 folded before Flop (didn't bet)
Seat 5: Agustín Suárez folded before Flop (didn't bet)
Seat 6: Jake7123 folded before Flop (didn't bet)


PokerStars Hand #238170600369:  Hold'em No Limit ($0.01/$0.02 USD) - 2022/08/23 13:33:21 ET
Table 'Despina IV' 6-max Seat #2 is the button
Seat 1: dayo77625 ($2.24 in chips)
Seat 2: AxCent8 ($0.73 in chips)
Seat 3: vezelvu1 ($2.96 in chips)
Seat 4: leprekon71 ($1.74 in chips)
Seat 5: Agustín Suárez ($3.91 in chips)
Seat 6: Jake7123 ($1.79 in chips)
vezelvu1: posts small blind $0.01
leprekon71: posts big blind $0.02
*** HOLE CARDS ***
Agustín Suárez: folds
Jake7123: folds
dayo77625: calls $0.02
AxCent8: folds
vezelvu1: folds
leprekon71: checks
*** FLOP *** [9d 4h 2d]
leprekon71: bets $0.03
dayo77625: calls $0.03
*** TURN *** [9d 4h 2d] [Ts]
leprekon71: bets $0.06
dayo77625: folds
Uncalled bet ($0.06) returned to leprekon71
leprekon71 collected $0.11 from pot
leprekon71: doesn't show hand
*** SUMMARY ***
Total pot $0.11 | Rake $0
Board [9d 4h 2d Ts]
Seat 1: dayo77625 folded on the Turn
Seat 2: AxCent8 (button) folded before Flop (didn't bet)
Seat 3: vezelvu1 (small blind) folded before Flop
Seat 4: leprekon71 (big blind) collected ($0.11)
Seat 5: Agustín Suárez folded before Flop (didn't bet)
Seat 6: Jake7123 folded before Flop (didn't bet)


PokerStars Hand #238170610351:  Hold'em No Limit ($0.01/$0.02 USD) - 2022/08/23 13:33:50 ET
Table 'Despina IV' 6-max Seat #3 is the button
Seat 1: dayo77625 ($2.19 in chips)
Seat 2: AxCent8 ($0.73 in chips)
Seat 3: vezelvu1 ($2.95 in chips)
Seat 4: leprekon71 ($1.80 in chips)
Seat 5: Agustín Suárez ($3.91 in chips)
Seat 6: Jake7123 ($1.79 in chips)
leprekon71: posts small blind $0.01
Agustín Suárez: posts big blind $0.02
*** HOLE CARDS ***
Jake7123 has timed out
Jake7123: folds
dayo77625: calls $0.02
AxCent8: folds
vezelvu1: calls $0.02
leprekon71: calls $0.01
Agustín Suárez: checks
*** FLOP *** [7d 3c 7s]
leprekon71: checks
Agustín Suárez: checks
dayo77625: checks
vezelvu1: checks
*** TURN *** [7d 3c 7s] [6s]
leprekon71: checks
Agustín Suárez: checks
dayo77625: checks
vezelvu1: checks
*** RIVER *** [7d 3c 7s 6s] [Ts]
leprekon71: bets $0.04
Agustín Suárez: folds
dayo77625: folds
vezelvu1: calls $0.04
*** SHOW DOWN ***
leprekon71: shows [8c 9c] (a straight, Six to Ten)
dayo77625 leaves the table
vezelvu1: mucks hand
leprekon71 collected $0.15 from pot
*** SUMMARY ***
Total pot $0.16 | Rake $0.01
Board [7d 3c 7s 6s Ts]
Seat 1: dayo77625 folded on the River
Seat 2: AxCent8 folded before Flop (didn't bet)
Seat 3: vezelvu1 (button) mucked
Seat 4: leprekon71 (small blind) showed [8c 9c] and won ($0.15) with a straight, Six to Ten
Seat 5: Agustín Suárez (big blind) folded on the River
Seat 6: Jake7123 folded before Flop (didn't bet)


PokerStars Hand #238170630271:  Hold'em No Limit ($0.01/$0.02 USD) - 2022/08/23 13:34:48 ET
Table 'Despina IV' 6-max Seat #4 is the button
Seat 2: AxCent8 ($0.73 in chips)
Seat 3: vezelvu1 ($2.89 in chips)
Seat 4: leprekon71 ($1.89 in chips)
Seat 5: Agustín Suárez ($3.89 in chips)
Seat 6: Jake7123 ($1.79 in chips)
Agustín Suárez: posts small blind $0.01
Jake7123: posts big blind $0.02
*** HOLE CARDS ***
AxCent8: folds
vezelvu1: folds
leprekon71: raises $0.02 to $0.04
Agustín Suárez: calls $0.03
Jake7123: calls $0.02
*** FLOP *** [4h 7s Kd]
Agustín Suárez: checks
Jake7123: checks
leprekon71: checks
*** TURN *** [4h 7s Kd] [5d]
Agustín Suárez: checks
Jake7123: checks
leprekon71: bets $0.14
Agustín Suárez: folds
Jake7123: folds
Uncalled bet ($0.14) returned to leprekon71
leprekon71 collected $0.12 from pot
leprekon71: doesn't show hand
*** SUMMARY ***
Total pot $0.12 | Rake $0
Board [4h 7s Kd 5d]
Seat 2: AxCent8 folded before Flop (didn't bet)
Seat 3: vezelvu1 folded before Flop (didn't bet)
Seat 4: leprekon71 (button) collected ($0.12)
Seat 5: Agustín Suárez (small blind) folded on the Turn
Seat 6: Jake7123 (big blind) folded on the Turn


PokerStars Hand #238170650902:  Hold'em No Limit ($0.01/$0.02 USD) - 2022/08/23 13:35:49 ET
Table 'Despina IV' 6-max Seat #5 is the button
Seat 2: AxCent8 ($0.73 in chips)
Seat 3: vezelvu1 ($2.89 in chips)
Seat 4: leprekon71 ($1.97 in chips)
Seat 5: Agustín Suárez ($3.85 in chips)
Seat 6: Jake7123 ($1.75 in chips)
rogerel5 joins the table at seat #1
Jake7123: posts small blind $0.01
AxCent8: posts big blind $0.02
*** HOLE CARDS ***
vezelvu1: folds
leprekon71: folds
Agustín Suárez: folds
Jake7123: folds
Uncalled bet ($0.01) returned to AxCent8
AxCent8 collected $0.02 from pot
*** SUMMARY ***
Total pot $0.02 | Rake $0
Seat 2: AxCent8 (big blind) collected ($0.02)
Seat 3: vezelvu1 folded before Flop (didn't bet)
Seat 4: leprekon71 folded before Flop (didn't bet)
Seat 5: Agustín Suárez (button) folded before Flop (didn't bet)
Seat 6: Jake7123 (small blind) folded before Flop


PokerStars Hand #238170653761:  Hold'em No Limit ($0.01/$0.02 USD) - 2022/08/23 13:35:58 ET
Table 'Despina IV' 6-max Seat #6 is the button
Seat 2: AxCent8 ($0.74 in chips)
Seat 3: vezelvu1 ($2.89 in chips)
Seat 4: leprekon71 ($1.97 in chips)
Seat 5: Agustín Suárez ($3.85 in chips)
Seat 6: Jake7123 ($1.74 in chips)
AxCent8: posts small blind $0.01
vezelvu1: posts big blind $0.02
*** HOLE CARDS ***
leprekon71: raises $0.02 to $0.04
Agustín Suárez: calls $0.04
Jake7123: folds
AxCent8: folds
vezelvu1: folds
*** FLOP *** [2c 4c 8d]
leprekon71: bets $0.04
Agustín Suárez: calls $0.04
*** TURN *** [2c 4c 8d] [Jc]
leprekon71: bets $0.10
Agustín Suárez: folds
Uncalled bet ($0.10) returned to leprekon71
leprekon71 collected $0.18 from pot
leprekon71: doesn't show hand
*** SUMMARY ***
Total pot $0.19 | Rake $0.01
Board [2c 4c 8d Jc]
Seat 2: AxCent8 (small blind) folded before Flop
Seat 3: vezelvu1 (big blind) folded before Flop
Seat 4: leprekon71 collected ($0.18)
Seat 5: Agustín Suárez folded on the Turn
Seat 6: Jake7123 (button) folded before Flop (didn't bet)


PokerStars Hand #238170663350:  Hold'em No Limit ($0.01/$0.02 USD) - 2022/08/23 13:36:26 ET
Table 'Despina IV' 6-max Seat #2 is the button
Seat 2: AxCent8 ($0.73 in chips)
Seat 3: vezelvu1 ($2.87 in chips)
Seat 4: leprekon71 ($2.07 in chips)
Seat 5: Agustín Suárez ($3.77 in chips)
Seat 6: Jake7123 ($1.74 in chips)
vezelvu1: posts small blind $0.01
leprekon71: posts big blind $0.02
rogerel5: sits out
*** HOLE CARDS ***
Agustín Suárez: raises $0.02 to $0.04
Jake7123: folds
AxCent8: folds
vezelvu1: folds
leprekon71: folds
Uncalled bet ($0.02) returned to Agustín Suárez
Agustín Suárez collected $0.05 from pot
Agustín Suárez: doesn't show hand
*** SUMMARY ***
Total pot $0.05 | Rake $0
Seat 2: AxCent8 (button) folded before Flop (didn't bet)
Seat 3: vezelvu1 (small blind) folded before Flop
Seat 4: leprekon71 (big blind) folded before Flop
Seat 5: Agustín Suárez collected ($0.05)
Seat 6: Jake7123 folded before Flop (didn't bet)


PokerStars Hand #238170666799:  Hold'em No Limit ($0.01/$0.02 USD) - 2022/08/23 13:36:36 ET
Table 'Despina IV' 6-max Seat #3 is the button
Seat 2: AxCent8 ($0.73 in chips)
Seat 3: vezelvu1 ($2.86 in chips)
Seat 4: leprekon71 ($2.05 in chips)
Seat 5: Agustín Suárez ($3.80 in chips)
Seat 6: Jake7123 ($1.74 in chips)
leprekon71: posts small blind $0.01
Agustín Suárez: posts big blind $0.02
rogerel5: sits out
*** HOLE CARDS ***
Jake7123: raises $0.02 to $0.04
AxCent8: folds
vezelvu1: calls $0.04
leprekon71: folds
Agustín Suárez: folds
*** FLOP *** [Ah Qh 3d]
Jake7123: checks
vezelvu1: checks
*** TURN *** [Ah Qh 3d] [Jh]
Jake7123: checks
vezelvu1: checks
*** RIVER *** [Ah Qh 3d Jh] [Ks]
Jake7123: checks
vezelvu1: checks
*** SHOW DOWN ***
Jake7123: shows [7h 7d] (a pair of Sevens)
vezelvu1: mucks hand
Jake7123 collected $0.11 from pot
*** SUMMARY ***
Total pot $0.11 | Rake $0
Board [Ah Qh 3d Jh Ks]
Seat 2: AxCent8 folded before Flop (didn't bet)
Seat 3: vezelvu1 (button) mucked
Seat 4: leprekon71 (small blind) folded before Flop
Seat 5: Agustín Suárez (big blind) folded before Flop
Seat 6: Jake7123 showed [7h 7d] and won ($0.11) with a pair of Sevens


PokerStars Hand #238170685262:  Hold'em No Limit ($0.01/$0.02 USD) - 2022/08/23 13:37:31 ET
Table 'Despina IV' 6-max Seat #4 is the button
Seat 2: AxCent8 ($0.73 in chips)
Seat 3: vezelvu1 ($2.82 in chips)
Seat 4: leprekon71 ($2.04 in chips)
Seat 5: Agustín Suárez ($3.78 in chips)
Seat 6: Jake7123 ($1.81 in chips)
Agustín Suárez: posts small blind $0.01
Jake7123: posts big blind $0.02
rogerel5: sits out
*** HOLE CARDS ***
AxCent8: folds
vezelvu1: folds
leprekon71: folds
Agustín Suárez: raises $0.02 to $0.04
Jake7123: folds
Uncalled bet ($0.02) returned to Agustín Suárez
Jake7123 leaves the table
Agustín Suárez collected $0.04 from pot
Agustín Suárez: doesn't show hand
*** SUMMARY ***
Total pot $0.04 | Rake $0
Seat 2: AxCent8 folded before Flop (didn't bet)
Seat 3: vezelvu1 folded before Flop (didn't bet)
Seat 4: leprekon71 (button) folded before Flop (didn't bet)
Seat 5: Agustín Suárez (small blind) collected ($0.04)
Seat 6: Jake7123 (big blind) folded before Flop


PokerStars Hand #238170688378:  Hold'em No Limit ($0.01/$0.02 USD) - 2022/08/23 13:37:40 ET
Table 'Despina IV' 6-max Seat #5 is the button
Seat 2: AxCent8 ($0.73 in chips)
Seat 3: vezelvu1 ($2.82 in chips)
Seat 4: leprekon71 ($2.04 in chips)
Seat 5: Agustín Suárez ($3.80 in chips)
AxCent8: posts small blind $0.01
vezelvu1: posts big blind $0.02
*** HOLE CARDS ***
leprekon71: folds
Agustín Suárez: folds
AxCent8: calls $0.01
vezelvu1: checks
*** FLOP *** [8c 9h Th]
AxCent8: bets $0.04
vezelvu1: folds
Uncalled bet ($0.04) returned to AxCent8
AxCent8 collected $0.04 from pot
*** SUMMARY ***
Total pot $0.04 | Rake $0
Board [8c 9h Th]
Seat 2: AxCent8 (small blind) collected ($0.04)
Seat 3: vezelvu1 (big blind) folded on the Flop
Seat 4: leprekon71 folded before Flop (didn't bet)
Seat 5: Agustín Suárez (button) folded before Flop (didn't bet)


PokerStars Hand #238170696433:  Hold'em No Limit ($0.01/$0.02 USD) - 2022/08/23 13:38:04 ET
Table 'Despina IV' 6-max Seat #2 is the button
Seat 2: AxCent8 ($0.75 in chips)
Seat 3: vezelvu1 ($2.80 in chips)
Seat 4: leprekon71 ($2.04 in chips)
Seat 5: Agustín Suárez ($3.80 in chips)
vezelvu1: posts small blind $0.01
leprekon71: posts big blind $0.02
rogerel5: sits out
*** HOLE CARDS ***
Agustín Suárez: folds
AxCent8: folds
vezelvu1: folds
Uncalled bet ($0.01) returned to leprekon71
leprekon71 collected $0.02 from pot
leprekon71: doesn't show hand
*** SUMMARY ***
Total pot $0.02 | Rake $0
Seat 2: AxCent8 (button) folded before Flop (didn't bet)
Seat 3: vezelvu1 (small blind) folded before Flop
Seat 4: leprekon71 (big blind) collected ($0.02)
Seat 5: Agustín Suárez folded before Flop (didn't bet)


PokerStars Hand #238170699008:  Hold'em No Limit ($0.01/$0.02 USD) - 2022/08/23 13:38:11 ET
Table 'Despina IV' 6-max Seat #3 is the button
Seat 2: AxCent8 ($0.75 in chips)
Seat 3: vezelvu1 ($2.79 in chips)
Seat 4: leprekon71 ($2.05 in chips)
Seat 5: Agustín Suárez ($3.80 in chips)
leprekon71: posts small blind $0.01
Agustín Suárez: posts big blind $0.02
rogerel5: sits out
*** HOLE CARDS ***
AxCent8: folds
vezelvu1: folds
leprekon71: folds
Uncalled bet ($0.01) returned to Agustín Suárez
Agustín Suárez collected $0.02 from pot
Agustín Suárez: doesn't show hand
*** SUMMARY ***
Total pot $0.02 | Rake $0
Seat 2: AxCent8 folded before Flop (didn't bet)
Seat 3: vezelvu1 (button) folded before Flop (didn't bet)
Seat 4: leprekon71 (small blind) folded before Flop
Seat 5: Agustín Suárez (big blind) collected ($0.02)


PokerStars Hand #238170700913:  Hold'em No Limit ($0.01/$0.02 USD) - 2022/08/23 13:38:17 ET
Table 'Despina IV' 6-max Seat #4 is the button
Seat 1: rogerel5 ($2 in chips)
Seat 2: AxCent8 ($0.75 in chips)
Seat 3: vezelvu1 ($2.79 in chips)
Seat 4: leprekon71 ($2.04 in chips)
Seat 5: Agustín Suárez ($3.81 in chips)
Agustín Suárez: posts small blind $0.01
rogerel5: posts big blind $0.02
*** HOLE CARDS ***
altazorchile joins the table at seat #6
AxCent8: raises $0.02 to $0.04
vezelvu1: folds
leprekon71: folds
Agustín Suárez: folds
rogerel5: calls $0.02
*** FLOP *** [As 2c 4s]
rogerel5: checks
AxCent8: bets $0.09
rogerel5: folds
Uncalled bet ($0.09) returned to AxCent8
AxCent8 collected $0.09 from pot
*** SUMMARY ***
Total pot $0.09 | Rake $0
Board [As 2c 4s]
Seat 1: rogerel5 (big blind) folded on the Flop
Seat 2: AxCent8 collected ($0.09)
Seat 3: vezelvu1 folded before Flop (didn't bet)
Seat 4: leprekon71 (button) folded before Flop (didn't bet)
Seat 5: Agustín Suárez (small blind) folded before Flop


PokerStars Hand #238170709318:  Hold'em No Limit ($0.01/$0.02 USD) - 2022/08/23 13:38:42 ET
Table 'Despina IV' 6-max Seat #5 is the button
Seat 1: rogerel5 ($1.96 in chips)
Seat 2: AxCent8 ($0.80 in chips)
Seat 3: vezelvu1 ($2.79 in chips)
Seat 4: leprekon71 ($2.04 in chips)
Seat 5: Agustín Suárez ($3.80 in chips)
rogerel5: posts small blind $0.01
AxCent8: posts big blind $0.02
*** HOLE CARDS ***
vezelvu1: folds
leprekon71: folds
Agustín Suárez: folds
rogerel5: calls $0.01
AxCent8: raises $0.02 to $0.04
rogerel5: calls $0.02
*** FLOP *** [8s Qd 8c]
rogerel5: checks
AxCent8: bets $0.08
rogerel5: folds
Uncalled bet ($0.08) returned to AxCent8
AxCent8 collected $0.08 from pot
*** SUMMARY ***
Total pot $0.08 | Rake $0
Board [8s Qd 8c]
Seat 1: rogerel5 (small blind) folded on the Flop
Seat 2: AxCent8 (big blind) collected ($0.08)
Seat 3: vezelvu1 folded before Flop (didn't bet)
Seat 4: leprekon71 folded before Flop (didn't bet)
Seat 5: Agustín Suárez (button) folded before Flop (didn't bet)


PokerStars Hand #238170718324:  Hold'em No Limit ($0.01/$0.02 USD) - 2022/08/23 13:39:08 ET
Table 'Despina IV' 6-max Seat #1 is the button
Seat 1: rogerel5 ($1.92 in chips)
Seat 2: AxCent8 ($0.84 in chips)
Seat 3: vezelvu1 ($2.79 in chips)
Seat 4: leprekon71 ($2.04 in chips)
Seat 5: Agustín Suárez ($3.80 in chips)
AxCent8: posts small blind $0.01
vezelvu1: posts big blind $0.02
altazorchile is disconnected
altazorchile has timed out while disconnected
altazorchile: is sitting out
*** HOLE CARDS ***
leprekon71: folds
Agustín Suárez: raises $0.04 to $0.06
rogerel5: calls $0.06
AxCent8: folds
vezelvu1: calls $0.04
*** FLOP *** [5s 2s 8d]
vezelvu1: bets $0.09
Agustín Suárez: folds
rogerel5: calls $0.09
*** TURN *** [5s 2s 8d] [3c]
vezelvu1: bets $0.36
rogerel5: calls $0.36
*** RIVER *** [5s 2s 8d 3c] [Qs]
vezelvu1: checks
rogerel5: bets $1.41 and is all-in
vezelvu1: calls $1.41
*** SHOW DOWN ***
rogerel5: shows [3h 4h] (a pair of Threes)
vezelvu1: shows [Jd Jc] (a pair of Jacks)
vezelvu1 collected $3.77 from pot
*** SUMMARY ***
Total pot $3.91 | Rake $0.14
Board [5s 2s 8d 3c Qs]
Seat 1: rogerel5 (button) showed [3h 4h] and lost with a pair of Threes
Seat 2: AxCent8 (small blind) folded before Flop
Seat 3: vezelvu1 (big blind) showed [Jd Jc] and won ($3.77) with a pair of Jacks
Seat 4: leprekon71 folded before Flop (didn't bet)
Seat 5: Agustín Suárez folded on the Flop


PokerStars Hand #238170738200:  Hold'em No Limit ($0.01/$0.02 USD) - 2022/08/23 13:40:08 ET
Table 'Despina IV' 6-max Seat #2 is the button
Seat 2: AxCent8 ($0.83 in chips)
Seat 3: vezelvu1 ($4.64 in chips)
Seat 4: leprekon71 ($2.04 in chips)
Seat 5: Agustín Suárez ($3.74 in chips)
vezelvu1: posts small blind $0.01
leprekon71: posts big blind $0.02
*** HOLE CARDS ***
Agustín Suárez: folds
AxCent8: folds
vezelvu1: calls $0.01
leprekon71: raises $0.04 to $0.06
vezelvu1: calls $0.04
*** FLOP *** [As Qh Jd]
vezelvu1: bets $0.06
leprekon71: folds
Uncalled bet ($0.06) returned to vezelvu1
vezelvu1 collected $0.12 from pot
*** SUMMARY ***
Total pot $0.12 | Rake $0
Board [As Qh Jd]
Seat 2: AxCent8 (button) folded before Flop (didn't bet)
Seat 3: vezelvu1 (small blind) collected ($0.12)
Seat 4: leprekon71 (big blind) folded on the Flop
Seat 5: Agustín Suárez folded before Flop (didn't bet)


PokerStars Hand #238170750194:  Hold'em No Limit ($0.01/$0.02 USD) - 2022/08/23 13:40:44 ET
Table 'Despina IV' 6-max Seat #4 is the button
Seat 1: rogerel5 ($2 in chips)
Seat 2: AxCent8 ($0.83 in chips)
Seat 3: vezelvu1 ($4.70 in chips)
Seat 4: leprekon71 ($1.97 in chips)
Seat 5: Agustín Suárez ($3.75 in chips)
Agustín Suárez: posts small blind $0.01
rogerel5: posts big blind $0.02
*** HOLE CARDS ***
AxCent8: folds
vezelvu1: folds
leprekon71: folds
Agustín Suárez: folds
Uncalled bet ($0.01) returned to rogerel5
rogerel5 collected $0.02 from pot
rogerel5: doesn't show hand
*** SUMMARY ***
Total pot $0.02 | Rake $0
Seat 1: rogerel5 (big blind) collected ($0.02)
Seat 2: AxCent8 folded before Flop (didn't bet)
Seat 3: vezelvu1 folded before Flop (didn't bet)
Seat 4: leprekon71 (button) folded before Flop (didn't bet)
Seat 5: Agustín Suárez (small blind) folded before Flop


PokerStars Hand #238170746787:  Hold'em No Limit ($0.01/$0.02 USD) - 2022/08/23 13:40:34 ET
Table 'Despina IV' 6-max Seat #3 is the button
Seat 1: rogerel5 ($2 in chips)
Seat 2: AxCent8 ($0.83 in chips)
Seat 3: vezelvu1 ($4.70 in chips)
Seat 4: leprekon71 ($1.98 in chips)
Seat 5: Agustín Suárez ($3.74 in chips)
leprekon71: posts small blind $0.01
Agustín Suárez: posts big blind $0.02
*** HOLE CARDS ***
rogerel5: folds
AxCent8: folds
vezelvu1: folds
leprekon71: folds
Uncalled bet ($0.01) returned to Agustín Suárez
Agustín Suárez collected $0.02 from pot
Agustín Suárez: doesn't show hand
*** SUMMARY ***
Total pot $0.02 | Rake $0
Seat 1: rogerel5 folded before Flop (didn't bet)
Seat 2: AxCent8 folded before Flop (didn't bet)
Seat 3: vezelvu1 (button) folded before Flop (didn't bet)
Seat 4: leprekon71 (small blind) folded before Flop
Seat 5: Agustín Suárez (big blind) collected ($0.02)


PokerStars Hand #238170752649:  Hold'em No Limit ($0.01/$0.02 USD) - 2022/08/23 13:40:51 ET
Table 'Despina IV' 6-max Seat #5 is the button
Seat 1: rogerel5 ($2.01 in chips)
Seat 2: AxCent8 ($0.83 in chips)
Seat 3: vezelvu1 ($4.70 in chips)
Seat 4: leprekon71 ($1.97 in chips)
Seat 5: Agustín Suárez ($3.74 in chips)
rogerel5: posts small blind $0.01
AxCent8: posts big blind $0.02
*** HOLE CARDS ***
vezelvu1: calls $0.02
leprekon71: folds
Agustín Suárez: folds
rogerel5: calls $0.01
AxCent8: checks
*** FLOP *** [Kc 8s Qh]
rogerel5: checks
AxCent8: checks
vezelvu1: checks
*** TURN *** [Kc 8s Qh] [2h]
rogerel5: checks
AxCent8: checks
vezelvu1: bets $0.06
rogerel5: folds
AxCent8: folds
Uncalled bet ($0.06) returned to vezelvu1
vezelvu1 collected $0.06 from pot
*** SUMMARY ***
Total pot $0.06 | Rake $0
Board [Kc 8s Qh 2h]
Seat 1: rogerel5 (small blind) folded on the Turn
Seat 2: AxCent8 (big blind) folded on the Turn
Seat 3: vezelvu1 collected ($0.06)
Seat 4: leprekon71 folded before Flop (didn't bet)
Seat 5: Agustín Suárez (button) folded before Flop (didn't bet)


PokerStars Hand #238170765812:  Hold'em No Limit ($0.01/$0.02 USD) - 2022/08/23 13:41:30 ET
Table 'Despina IV' 6-max Seat #1 is the button
Seat 1: rogerel5 ($1.99 in chips)
Seat 2: AxCent8 ($0.81 in chips)
Seat 3: vezelvu1 ($4.74 in chips)
Seat 4: leprekon71 ($1.97 in chips)
Seat 5: Agustín Suárez ($3.74 in chips)
AxCent8: posts small blind $0.01
vezelvu1: posts big blind $0.02
*** HOLE CARDS ***
leprekon71: folds
Agustín Suárez: folds
rogerel5: raises $0.04 to $0.06
AxCent8: calls $0.05
vezelvu1: folds
*** FLOP *** [9c 2h 7d]
AxCent8: bets $0.07
rogerel5: folds
Uncalled bet ($0.07) returned to AxCent8
AxCent8 collected $0.14 from pot
*** SUMMARY ***
Total pot $0.14 | Rake $0
Board [9c 2h 7d]
Seat 1: rogerel5 (button) folded on the Flop
Seat 2: AxCent8 (small blind) collected ($0.14)
Seat 3: vezelvu1 (big blind) folded before Flop
Seat 4: leprekon71 folded before Flop (didn't bet)
Seat 5: Agustín Suárez folded before Flop (didn't bet)


PokerStars Hand #238170777893:  Hold'em No Limit ($0.01/$0.02 USD) - 2022/08/23 13:42:06 ET
Table 'Despina IV' 6-max Seat #2 is the button
Seat 1: rogerel5 ($1.93 in chips)
Seat 2: AxCent8 ($0.89 in chips)
Seat 3: vezelvu1 ($4.72 in chips)
Seat 4: leprekon71 ($1.97 in chips)
Seat 5: Agustín Suárez ($3.74 in chips)
vezelvu1: posts small blind $0.01
leprekon71: posts big blind $0.02
*** HOLE CARDS ***
Agustín Suárez: folds
rogerel5: raises $0.04 to $0.06
AxCent8: folds
vezelvu1: folds
leprekon71: folds
Uncalled bet ($0.04) returned to rogerel5
rogerel5 collected $0.05 from pot
rogerel5: doesn't show hand
*** SUMMARY ***
Total pot $0.05 | Rake $0
Seat 1: rogerel5 collected ($0.05)
Seat 2: AxCent8 (button) folded before Flop (didn't bet)
Seat 3: vezelvu1 (small blind) folded before Flop
Seat 4: leprekon71 (big blind) folded before Flop
Seat 5: Agustín Suárez folded before Flop (didn't bet)


PokerStars Hand #238170783165:  Hold'em No Limit ($0.01/$0.02 USD) - 2022/08/23 13:42:22 ET
Table 'Despina IV' 6-max Seat #3 is the button
Seat 1: rogerel5 ($1.96 in chips)
Seat 2: AxCent8 ($0.89 in chips)
Seat 3: vezelvu1 ($4.71 in chips)
Seat 4: leprekon71 ($1.95 in chips)
Seat 5: Agustín Suárez ($3.74 in chips)
leprekon71: posts small blind $0.01
Agustín Suárez: posts big blind $0.02
*** HOLE CARDS ***
rogerel5: folds
AxCent8: folds
vezelvu1: folds
leprekon71: raises $0.02 to $0.04
Agustín Suárez: calls $0.02
*** FLOP *** [7c Qs 9s]
leprekon71: checks
Agustín Suárez: bets $0.03
leprekon71: folds
Uncalled bet ($0.03) returned to Agustín Suárez
Agustín Suárez collected $0.08 from pot
Agustín Suárez: doesn't show hand
*** SUMMARY ***
Total pot $0.08 | Rake $0
Board [7c Qs 9s]
Seat 1: rogerel5 folded before Flop (didn't bet)
Seat 2: AxCent8 folded before Flop (didn't bet)
Seat 3: vezelvu1 (button) folded before Flop (didn't bet)
Seat 4: leprekon71 (small blind) folded on the Flop
Seat 5: Agustín Suárez (big blind) collected ($0.08)


PokerStars Hand #238170789062:  Hold'em No Limit ($0.01/$0.02 USD) - 2022/08/23 13:42:39 ET
Table 'Despina IV' 6-max Seat #4 is the button
Seat 1: rogerel5 ($1.96 in chips)
Seat 2: AxCent8 ($0.89 in chips)
Seat 3: vezelvu1 ($4.71 in chips)
Seat 4: leprekon71 ($1.91 in chips)
Seat 5: Agustín Suárez ($3.78 in chips)
Agustín Suárez: posts small blind $0.01
rogerel5: posts big blind $0.02
*** HOLE CARDS ***
AxCent8: folds
vezelvu1: folds
leprekon71: raises $0.02 to $0.04
Agustín Suárez: folds
rogerel5: calls $0.02
*** FLOP *** [4h 2c Tc]
rogerel5: checks
leprekon71: bets $0.07
rogerel5: calls $0.07
*** TURN *** [4h 2c Tc] [8s]
rogerel5: checks
leprekon71: bets $0.17
rogerel5: calls $0.17
*** RIVER *** [4h 2c Tc 8s] [7d]
rogerel5: checks
leprekon71: bets $0.54
rogerel5: calls $0.54
*** SHOW DOWN ***
leprekon71: shows [4c 4d] (three of a kind, Fours)
rogerel5: mucks hand
leprekon71 collected $1.59 from pot
AxCent8 leaves the table
*** SUMMARY ***
Total pot $1.65 | Rake $0.06
Board [4h 2c Tc 8s 7d]
Seat 1: rogerel5 (big blind) mucked
Seat 2: AxCent8 folded before Flop (didn't bet)
Seat 3: vezelvu1 folded before Flop (didn't bet)
Seat 4: leprekon71 (button) showed [4c 4d] and won ($1.59) with three of a kind, Fours
Seat 5: Agustín Suárez (small blind) folded before Flop


PokerStars Hand #238170803498:  Hold'em No Limit ($0.01/$0.02 USD) - 2022/08/23 13:43:22 ET
Table 'Despina IV' 6-max Seat #5 is the button
Seat 1: rogerel5 ($1.14 in chips)
Seat 3: vezelvu1 ($4.71 in chips)
Seat 4: leprekon71 ($2.68 in chips)
Seat 5: Agustín Suárez ($3.77 in chips)
rogerel5: posts small blind $0.01
vezelvu1: posts big blind $0.02
*** HOLE CARDS ***
leprekon71: folds
Agustín Suárez: folds
rogerel5: folds
Uncalled bet ($0.01) returned to vezelvu1
vezelvu1 collected $0.02 from pot
*** SUMMARY ***
Total pot $0.02 | Rake $0
Seat 1: rogerel5 (small blind) folded before Flop
Seat 3: vezelvu1 (big blind) collected ($0.02)
Seat 4: leprekon71 folded before Flop (didn't bet)
Seat 5: Agustín Suárez (button) folded before Flop (didn't bet)


PokerStars Hand #238170806094:  Hold'em No Limit ($0.01/$0.02 USD) - 2022/08/23 13:43:30 ET
Table 'Despina IV' 6-max Seat #1 is the button
Seat 1: rogerel5 ($1.13 in chips)
Seat 3: vezelvu1 ($4.72 in chips)
Seat 4: leprekon71 ($2.68 in chips)
Seat 5: Agustín Suárez ($3.77 in chips)
vezelvu1: posts small blind $0.01
leprekon71: posts big blind $0.02
*** HOLE CARDS ***
Agustín Suárez: folds
rogerel5: raises $0.04 to $0.06
vezelvu1: folds
leprekon71: calls $0.04
*** FLOP *** [6s 2h 4h]
leprekon71: checks
rogerel5: bets $0.06
leprekon71: calls $0.06
*** TURN *** [6s 2h 4h] [Td]
leprekon71: checks
imbAchikko joins the table at seat #2
rogerel5: bets $0.12
leprekon71: calls $0.12
*** RIVER *** [6s 2h 4h Td] [3h]
leprekon71: checks
rogerel5: bets $0.47
leprekon71: calls $0.47
*** SHOW DOWN ***
rogerel5: shows [7c Qc] (high card Queen)
leprekon71: shows [5s 5h] (a straight, Deuce to Six)
leprekon71 collected $1.38 from pot
*** SUMMARY ***
Total pot $1.43 | Rake $0.05
Board [6s 2h 4h Td 3h]
Seat 1: rogerel5 (button) showed [7c Qc] and lost with high card Queen
Seat 3: vezelvu1 (small blind) folded before Flop
Seat 4: leprekon71 (big blind) showed [5s 5h] and won ($1.38) with a straight, Deuce to Six
Seat 5: Agustín Suárez folded before Flop (didn't bet)


PokerStars Hand #238170818929:  Hold'em No Limit ($0.01/$0.02 USD) - 2022/08/23 13:44:08 ET
Table 'Despina IV' 6-max Seat #3 is the button
Seat 1: rogerel5 ($0.42 in chips)
Seat 3: vezelvu1 ($4.71 in chips)
Seat 4: leprekon71 ($3.35 in chips)
Seat 5: Agustín Suárez ($3.77 in chips)
leprekon71: posts small blind $0.01
Agustín Suárez: posts big blind $0.02
imbAchikko: sits out
*** HOLE CARDS ***
rogerel5 has timed out
rogerel5: folds
vezelvu1: folds
leprekon71: folds
Uncalled bet ($0.01) returned to Agustín Suárez
Agustín Suárez collected $0.02 from pot
Agustín Suárez: doesn't show hand
*** SUMMARY ***
Total pot $0.02 | Rake $0
Seat 1: rogerel5 folded before Flop (didn't bet)
Seat 3: vezelvu1 (button) folded before Flop (didn't bet)
Seat 4: leprekon71 (small blind) folded before Flop
Seat 5: Agustín Suárez (big blind) collected ($0.02)


PokerStars Hand #238170823896:  Hold'em No Limit ($0.01/$0.02 USD) - 2022/08/23 13:44:23 ET
Table 'Despina IV' 6-max Seat #4 is the button
Seat 1: rogerel5 ($1.92 in chips)
Seat 3: vezelvu1 ($4.71 in chips)
Seat 4: leprekon71 ($3.34 in chips)
Seat 5: Agustín Suárez ($3.78 in chips)
Agustín Suárez: posts small blind $0.01
rogerel5: posts big blind $0.02
imbAchikko: sits out
*** HOLE CARDS ***
vezelvu1: raises $0.02 to $0.04
leprekon71: folds
Agustín Suárez: folds
rogerel5: calls $0.02
*** FLOP *** [Tc 8d 7s]
rogerel5: checks
vezelvu1: checks
*** TURN *** [Tc 8d 7s] [Jh]
rogerel5: checks
vezelvu1: checks
*** RIVER *** [Tc 8d 7s Jh] [Js]
rogerel5: checks
vezelvu1: checks
*** SHOW DOWN ***
rogerel5: shows [3s Qs] (a pair of Jacks)
vezelvu1: shows [Qh Kc] (a pair of Jacks - King kicker)
vezelvu1 collected $0.09 from pot
altazorchile was removed from the table for failing to post
altazorchile leaves the table
*** SUMMARY ***
Total pot $0.09 | Rake $0
Board [Tc 8d 7s Jh Js]
Seat 1: rogerel5 (big blind) showed [3s Qs] and lost with a pair of Jacks
Seat 3: vezelvu1 showed [Qh Kc] and won ($0.09) with a pair of Jacks
Seat 4: leprekon71 (button) folded before Flop (didn't bet)
Seat 5: Agustín Suárez (small blind) folded before Flop


PokerStars Hand #238170836942:  Hold'em No Limit ($0.01/$0.02 USD) - 2022/08/23 13:45:02 ET
Table 'Despina IV' 6-max Seat #5 is the button
Seat 1: rogerel5 ($1.88 in chips)
Seat 2: imbAchikko ($2 in chips)
Seat 3: vezelvu1 ($4.76 in chips)
Seat 4: leprekon71 ($3.34 in chips)
Seat 5: Agustín Suárez ($3.77 in chips)
rogerel5: posts small blind $0.01
imbAchikko: posts big blind $0.02
*** HOLE CARDS ***
vezelvu1: folds
leprekon71: folds
Agustín Suárez: raises $0.04 to $0.06
rogerel5: folds
Vishny203 joins the table at seat #6
imbAchikko: folds
Uncalled bet ($0.04) returned to Agustín Suárez
Agustín Suárez collected $0.05 from pot
Agustín Suárez: doesn't show hand
*** SUMMARY ***
Total pot $0.05 | Rake $0
Seat 1: rogerel5 (small blind) folded before Flop
Seat 2: imbAchikko (big blind) folded before Flop
Seat 3: vezelvu1 folded before Flop (didn't bet)
Seat 4: leprekon71 folded before Flop (didn't bet)
Seat 5: Agustín Suárez (button) collected ($0.05)


PokerStars Hand #238170843428:  Hold'em No Limit ($0.01/$0.02 USD) - 2022/08/23 13:45:21 ET
Table 'Despina IV' 6-max Seat #1 is the button
Seat 1: rogerel5 ($1.87 in chips)
Seat 2: imbAchikko ($2 in chips)
Seat 3: vezelvu1 ($4.76 in chips)
Seat 4: leprekon71 ($3.34 in chips)
Seat 5: Agustín Suárez ($3.80 in chips)
imbAchikko: posts small blind $0.01
vezelvu1: posts big blind $0.02
Vishny203: sits out
*** HOLE CARDS ***
leprekon71: folds
Agustín Suárez: folds
rogerel5: folds
imbAchikko: raises $0.03 to $0.05
vezelvu1: folds
Uncalled bet ($0.03) returned to imbAchikko
imbAchikko collected $0.04 from pot
imbAchikko: doesn't show hand
*** SUMMARY ***
Total pot $0.04 | Rake $0
Seat 1: rogerel5 (button) folded before Flop (didn't bet)
Seat 2: imbAchikko (small blind) collected ($0.04)
Seat 3: vezelvu1 (big blind) folded before Flop
Seat 4: leprekon71 folded before Flop (didn't bet)
Seat 5: Agustín Suárez folded before Flop (didn't bet)


PokerStars Hand #238170848540:  Hold'em No Limit ($0.01/$0.02 USD) - 2022/08/23 13:45:36 ET
Table 'Despina IV' 6-max Seat #2 is the button
Seat 1: rogerel5 ($1.87 in chips)
Seat 2: imbAchikko ($2.02 in chips)
Seat 3: vezelvu1 ($4.74 in chips)
Seat 4: leprekon71 ($3.34 in chips)
Seat 5: Agustín Suárez ($3.80 in chips)
vezelvu1: posts small blind $0.01
leprekon71: posts big blind $0.02
Vishny203: sits out
*** HOLE CARDS ***
Agustín Suárez: folds
rogerel5: folds
imbAchikko: folds
vezelvu1: folds
Uncalled bet ($0.01) returned to leprekon71
leprekon71 collected $0.02 from pot
leprekon71: doesn't show hand
*** SUMMARY ***
Total pot $0.02 | Rake $0
Seat 1: rogerel5 folded before Flop (didn't bet)
Seat 2: imbAchikko (button) folded before Flop (didn't bet)
Seat 3: vezelvu1 (small blind) folded before Flop
Seat 4: leprekon71 (big blind) collected ($0.02)
Seat 5: Agustín Suárez folded before Flop (didn't bet)


PokerStars Hand #238170851972:  Hold'em No Limit ($0.01/$0.02 USD) - 2022/08/23 13:45:47 ET
Table 'Despina IV' 6-max Seat #3 is the button
Seat 1: rogerel5 ($1.87 in chips)
Seat 2: imbAchikko ($2.02 in chips)
Seat 3: vezelvu1 ($4.73 in chips)
Seat 4: leprekon71 ($3.35 in chips)
Seat 5: Agustín Suárez ($3.80 in chips)
leprekon71: posts small blind $0.01
Agustín Suárez: posts big blind $0.02
Vishny203: sits out
*** HOLE CARDS ***
rogerel5: folds
imbAchikko: folds
vezelvu1: folds
leprekon71: folds
Uncalled bet ($0.01) returned to Agustín Suárez
Agustín Suárez collected $0.02 from pot
Agustín Suárez: doesn't show hand
*** SUMMARY ***
Total pot $0.02 | Rake $0
Seat 1: rogerel5 folded before Flop (didn't bet)
Seat 2: imbAchikko folded before Flop (didn't bet)
Seat 3: vezelvu1 (button) folded before Flop (didn't bet)
Seat 4: leprekon71 (small blind) folded before Flop
Seat 5: Agustín Suárez (big blind) collected ($0.02)


PokerStars Hand #238170856707:  Hold'em No Limit ($0.01/$0.02 USD) - 2022/08/23 13:46:01 ET
Table 'Despina IV' 6-max Seat #4 is the button
Seat 1: rogerel5 ($1.87 in chips)
Seat 2: imbAchikko ($2.02 in chips)
Seat 3: vezelvu1 ($4.73 in chips)
Seat 4: leprekon71 ($3.34 in chips)
Seat 5: Agustín Suárez ($3.81 in chips)
Seat 6: Vishny203 ($2 in chips)
Agustín Suárez: posts small blind $0.01
Vishny203: posts big blind $0.02
*** HOLE CARDS ***
rogerel5: folds
imbAchikko: folds
vezelvu1: folds
leprekon71: folds
Agustín Suárez: raises $0.02 to $0.04
Vishny203: calls $0.02
*** FLOP *** [Jd Ah Ts]
Agustín Suárez: checks
Vishny203: bets $0.05
Agustín Suárez: folds
Uncalled bet ($0.05) returned to Vishny203
Vishny203 collected $0.08 from pot
Vishny203: doesn't show hand
*** SUMMARY ***
Total pot $0.08 | Rake $0
Board [Jd Ah Ts]
Seat 1: rogerel5 folded before Flop (didn't bet)
Seat 2: imbAchikko folded before Flop (didn't bet)
Seat 3: vezelvu1 folded before Flop (didn't bet)
Seat 4: leprekon71 (button) folded before Flop (didn't bet)
Seat 5: Agustín Suárez (small blind) folded on the Flop
Seat 6: Vishny203 (big blind) collected ($0.08)


PokerStars Hand #238170868604:  Hold'em No Limit ($0.01/$0.02 USD) - 2022/08/23 13:46:36 ET
Table 'Despina IV' 6-max Seat #5 is the button
Seat 1: rogerel5 ($1.87 in chips)
Seat 2: imbAchikko ($2.02 in chips)
Seat 3: vezelvu1 ($4.73 in chips)
Seat 4: leprekon71 ($3.34 in chips)
Seat 5: Agustín Suárez ($3.77 in chips)
Seat 6: Vishny203 ($2.04 in chips)
Vishny203: posts small blind $0.01
rogerel5: posts big blind $0.02
*** HOLE CARDS ***
imbAchikko: folds
vezelvu1: folds
leprekon71: folds
Agustín Suárez: raises $0.04 to $0.06
Vishny203: folds
rogerel5: folds
Uncalled bet ($0.04) returned to Agustín Suárez
Agustín Suárez collected $0.05 from pot
Agustín Suárez: doesn't show hand
*** SUMMARY ***
Total pot $0.05 | Rake $0
Seat 1: rogerel5 (big blind) folded before Flop
Seat 2: imbAchikko folded before Flop (didn't bet)
Seat 3: vezelvu1 folded before Flop (didn't bet)
Seat 4: leprekon71 folded before Flop (didn't bet)
Seat 5: Agustín Suárez (button) collected ($0.05)
Seat 6: Vishny203 (small blind) folded before Flop


PokerStars Hand #238170873458:  Hold'em No Limit ($0.01/$0.02 USD) - 2022/08/23 13:46:51 ET
Table 'Despina IV' 6-max Seat #6 is the button
Seat 1: rogerel5 ($1.85 in chips)
Seat 2: imbAchikko ($2.02 in chips)
Seat 3: vezelvu1 ($4.73 in chips)
Seat 4: leprekon71 ($3.34 in chips)
Seat 5: Agustín Suárez ($3.80 in chips)
Seat 6: Vishny203 ($2.03 in chips)
rogerel5: posts small blind $0.01
imbAchikko: posts big blind $0.02
*** HOLE CARDS ***
vezelvu1: folds
leprekon71: folds
Agustín Suárez: folds
Vishny203: folds
rogerel5: folds
Uncalled bet ($0.01) returned to imbAchikko
imbAchikko collected $0.02 from pot
imbAchikko: doesn't show hand
*** SUMMARY ***
Total pot $0.02 | Rake $0
Seat 1: rogerel5 (small blind) folded before Flop
Seat 2: imbAchikko (big blind) collected ($0.02)
Seat 3: vezelvu1 folded before Flop (didn't bet)
Seat 4: leprekon71 folded before Flop (didn't bet)
Seat 5: Agustín Suárez folded before Flop (didn't bet)
Seat 6: Vishny203 (button) folded before Flop (didn't bet)


PokerStars Hand #238170877211:  Hold'em No Limit ($0.01/$0.02 USD) - 2022/08/23 13:47:02 ET
Table 'Despina IV' 6-max Seat #1 is the button
Seat 1: rogerel5 ($1.84 in chips)
Seat 2: imbAchikko ($2.03 in chips)
Seat 3: vezelvu1 ($4.73 in chips)
Seat 4: leprekon71 ($3.34 in chips)
Seat 5: Agustín Suárez ($3.80 in chips)
Seat 6: Vishny203 ($2.03 in chips)
imbAchikko: posts small blind $0.01
vezelvu1: posts big blind $0.02
*** HOLE CARDS ***
leprekon71: raises $0.02 to $0.04
Agustín Suárez: folds
Vishny203: folds
rogerel5: calls $0.04
imbAchikko: folds
vezelvu1: folds
*** FLOP *** [Ah 7h Ks]
leprekon71: bets $0.06
rogerel5: calls $0.06
*** TURN *** [Ah 7h Ks] [7s]
leprekon71: bets $0.10
rogerel5: calls $0.10
*** RIVER *** [Ah 7h Ks 7s] [5h]
leprekon71: bets $0.10
rogerel5: folds
Uncalled bet ($0.10) returned to leprekon71
leprekon71 collected $0.41 from pot
leprekon71: doesn't show hand
*** SUMMARY ***
Total pot $0.43 | Rake $0.02
Board [Ah 7h Ks 7s 5h]
Seat 1: rogerel5 (button) folded on the River
Seat 2: imbAchikko (small blind) folded before Flop
Seat 3: vezelvu1 (big blind) folded before Flop
Seat 4: leprekon71 collected ($0.41)
Seat 5: Agustín Suárez folded before Flop (didn't bet)
Seat 6: Vishny203 folded before Flop (didn't bet)


PokerStars Hand #238170887425:  Hold'em No Limit ($0.01/$0.02 USD) - 2022/08/23 13:47:33 ET
Table 'Despina IV' 6-max Seat #2 is the button
Seat 1: rogerel5 ($1.64 in chips)
Seat 2: imbAchikko ($2.02 in chips)
Seat 3: vezelvu1 ($4.71 in chips)
Seat 4: leprekon71 ($3.55 in chips)
Seat 5: Agustín Suárez ($3.80 in chips)
Seat 6: Vishny203 ($2.03 in chips)
vezelvu1: posts small blind $0.01
leprekon71: posts big blind $0.02
*** HOLE CARDS ***
Agustín Suárez: folds
Vishny203: folds
rogerel5: folds
imbAchikko: raises $0.03 to $0.05
vezelvu1: folds
leprekon71: folds
Uncalled bet ($0.03) returned to imbAchikko
imbAchikko collected $0.05 from pot
imbAchikko: doesn't show hand
*** SUMMARY ***
Total pot $0.05 | Rake $0
Seat 1: rogerel5 folded before Flop (didn't bet)
Seat 2: imbAchikko (button) collected ($0.05)
Seat 3: vezelvu1 (small blind) folded before Flop
Seat 4: leprekon71 (big blind) folded before Flop
Seat 5: Agustín Suárez folded before Flop (didn't bet)
Seat 6: Vishny203 folded before Flop (didn't bet)


PokerStars Hand #238170895168:  Hold'em No Limit ($0.01/$0.02 USD) - 2022/08/23 13:47:56 ET
Table 'Despina IV' 6-max Seat #3 is the button
Seat 1: rogerel5 ($1.64 in chips)
Seat 2: imbAchikko ($2.05 in chips)
Seat 3: vezelvu1 ($4.70 in chips)
Seat 4: leprekon71 ($3.53 in chips)
Seat 6: Vishny203 ($2.03 in chips)
leprekon71: posts small blind $0.01
Vishny203: posts big blind $0.02
*** HOLE CARDS ***
rogerel5: folds
imbAchikko: folds
vezelvu1: folds
leprekon71: folds
Uncalled bet ($0.01) returned to Vishny203
Vishny203 collected $0.02 from pot
Vishny203: doesn't show hand
*** SUMMARY ***
Total pot $0.02 | Rake $0
Seat 1: rogerel5 folded before Flop (didn't bet)
Seat 2: imbAchikko folded before Flop (didn't bet)
Seat 3: vezelvu1 (button) folded before Flop (didn't bet)
Seat 4: leprekon71 (small blind) folded before Flop
Seat 6: Vishny203 (big blind) collected ($0.02)


PokerStars Hand #238170899489:  Hold'em No Limit ($0.01/$0.02 USD) - 2022/08/23 13:48:09 ET
Table 'Despina IV' 6-max Seat #4 is the button
Seat 1: rogerel5 ($1.64 in chips)
Seat 2: imbAchikko ($2.05 in chips)
Seat 3: vezelvu1 ($4.70 in chips)
Seat 4: leprekon71 ($3.52 in chips)
Seat 6: Vishny203 ($2.04 in chips)
Vishny203: posts small blind $0.01
rogerel5: posts big blind $0.02
*** HOLE CARDS ***
imbAchikko: folds
vezelvu1: folds
leprekon71: folds
Vishny203: raises $0.04 to $0.06
rogerel5: calls $0.04
*** FLOP *** [Tc Ad Qh]
Vishny203: checks
rogerel5: bets $0.05
Vishny203: folds
Uncalled bet ($0.05) returned to rogerel5
rogerel5 collected $0.12 from pot
rogerel5: doesn't show hand
*** SUMMARY ***
Total pot $0.12 | Rake $0
Board [Tc Ad Qh]
Seat 1: rogerel5 (big blind) collected ($0.12)
Seat 2: imbAchikko folded before Flop (didn't bet)
Seat 3: vezelvu1 folded before Flop (didn't bet)
Seat 4: leprekon71 (button) folded before Flop (didn't bet)
Seat 6: Vishny203 (small blind) folded on the Flop


PokerStars Hand #238170911486:  Hold'em No Limit ($0.01/$0.02 USD) - 2022/08/23 13:48:45 ET
Table 'Despina IV' 6-max Seat #6 is the button
Seat 1: rogerel5 ($1.70 in chips)
Seat 2: imbAchikko ($2.05 in chips)
Seat 3: vezelvu1 ($4.70 in chips)
Seat 4: leprekon71 ($3.52 in chips)
Seat 6: Vishny203 ($2 in chips)
rogerel5: posts small blind $0.01
imbAchikko: posts big blind $0.02
*** HOLE CARDS ***
vezelvu1: folds
leprekon71: folds
Vishny203: raises $0.04 to $0.06
rogerel5: folds
imbAchikko: folds
Uncalled bet ($0.04) returned to Vishny203
Vishny203 collected $0.05 from pot
Vishny203: doesn't show hand
*** SUMMARY ***
Total pot $0.05 | Rake $0
Seat 1: rogerel5 (small blind) folded before Flop
Seat 2: imbAchikko (big blind) folded before Flop
Seat 3: vezelvu1 folded before Flop (didn't bet)
Seat 4: leprekon71 folded before Flop (didn't bet)
Seat 6: Vishny203 (button) collected ($0.05)


PokerStars Hand #238170917863:  Hold'em No Limit ($0.01/$0.02 USD) - 2022/08/23 13:49:04 ET
Table 'Despina IV' 6-max Seat #1 is the button
Seat 1: rogerel5 ($1.69 in chips)
Seat 2: imbAchikko ($2.03 in chips)
Seat 3: vezelvu1 ($4.70 in chips)
Seat 4: leprekon71 ($3.52 in chips)
Seat 6: Vishny203 ($2.03 in chips)
imbAchikko: posts small blind $0.01
vezelvu1: posts big blind $0.02
*** HOLE CARDS ***
leprekon71: folds
Vishny203: folds
rogerel5: raises $0.04 to $0.06
imbAchikko: folds
vezelvu1: folds
Uncalled bet ($0.04) returned to rogerel5
rogerel5 collected $0.05 from pot
rogerel5: doesn't show hand
*** SUMMARY ***
Total pot $0.05 | Rake $0
Seat 1: rogerel5 (button) collected ($0.05)
Seat 2: imbAchikko (small blind) folded before Flop
Seat 3: vezelvu1 (big blind) folded before Flop
Seat 4: leprekon71 folded before Flop (didn't bet)
Seat 6: Vishny203 folded before Flop (didn't bet)


PokerStars Hand #238170923728:  Hold'em No Limit ($0.01/$0.02 USD) - 2022/08/23 13:49:22 ET
Table 'Despina IV' 6-max Seat #2 is the button
Seat 1: rogerel5 ($1.72 in chips)
Seat 2: imbAchikko ($2.02 in chips)
Seat 3: vezelvu1 ($4.68 in chips)
Seat 4: leprekon71 ($3.52 in chips)
Seat 6: Vishny203 ($2.03 in chips)
vezelvu1: posts small blind $0.01
leprekon71: posts big blind $0.02
*** HOLE CARDS ***
Vishny203: raises $0.04 to $0.06
rogerel5: folds
imbAchikko: folds
vezelvu1: folds
leprekon71: folds
Uncalled bet ($0.04) returned to Vishny203
Vishny203 collected $0.05 from pot
Vishny203: doesn't show hand
*** SUMMARY ***
Total pot $0.05 | Rake $0
Seat 1: rogerel5 folded before Flop (didn't bet)
Seat 2: imbAchikko (button) folded before Flop (didn't bet)
Seat 3: vezelvu1 (small blind) folded before Flop
Seat 4: leprekon71 (big blind) folded before Flop
Seat 6: Vishny203 collected ($0.05)


PokerStars Hand #238170926179:  Hold'em No Limit ($0.01/$0.02 USD) - 2022/08/23 13:49:29 ET
Table 'Despina IV' 6-max Seat #3 is the button
Seat 1: rogerel5 ($1.72 in chips)
Seat 2: imbAchikko ($2.02 in chips)
Seat 3: vezelvu1 ($4.67 in chips)
Seat 4: leprekon71 ($3.50 in chips)
Seat 6: Vishny203 ($2.06 in chips)
leprekon71: posts small blind $0.01
Vishny203: posts big blind $0.02
*** HOLE CARDS ***
rogerel5: folds
imbAchikko: folds
vezelvu1: folds
leprekon71: raises $0.02 to $0.04
Vishny203: calls $0.02
*** FLOP *** [Ks 5h 8s]
leprekon71: checks
Vishny203: checks
*** TURN *** [Ks 5h 8s] [Js]
leprekon71: checks
Vishny203: bets $0.05
leprekon71: calls $0.05
*** RIVER *** [Ks 5h 8s Js] [8d]
leprekon71: checks
Vishny203: bets $0.13
leprekon71: folds
Uncalled bet ($0.13) returned to Vishny203
Vishny203 collected $0.17 from pot
Vishny203: doesn't show hand
*** SUMMARY ***
Total pot $0.18 | Rake $0.01
Board [Ks 5h 8s Js 8d]
Seat 1: rogerel5 folded before Flop (didn't bet)
Seat 2: imbAchikko folded before Flop (didn't bet)
Seat 3: vezelvu1 (button) folded before Flop (didn't bet)
Seat 4: leprekon71 (small blind) folded on the River
Seat 6: Vishny203 (big blind) collected ($0.17)


PokerStars Hand #238170941691:  Hold'em No Limit ($0.01/$0.02 USD) - 2022/08/23 13:50:16 ET
Table 'Despina IV' 6-max Seat #4 is the button
Seat 1: rogerel5 ($1.72 in chips)
Seat 2: imbAchikko ($2.02 in chips)
Seat 3: vezelvu1 ($4.67 in chips)
Seat 4: leprekon71 ($3.41 in chips)
Seat 6: Vishny203 ($2.14 in chips)
Vishny203: posts small blind $0.01
rogerel5: posts big blind $0.02
*** HOLE CARDS ***
imbAchikko: raises $0.03 to $0.05
vezelvu1: folds
leprekon71: folds
Vishny203: folds
rogerel5: folds
Uncalled bet ($0.03) returned to imbAchikko
imbAchikko collected $0.05 from pot
imbAchikko: doesn't show hand
*** SUMMARY ***
Total pot $0.05 | Rake $0
Seat 1: rogerel5 (big blind) folded before Flop
Seat 2: imbAchikko collected ($0.05)
Seat 3: vezelvu1 folded before Flop (didn't bet)
Seat 4: leprekon71 (button) folded before Flop (didn't bet)
Seat 6: Vishny203 (small blind) folded before Flop


PokerStars Hand #238170944664:  Hold'em No Limit ($0.01/$0.02 USD) - 2022/08/23 13:50:25 ET
Table 'Despina IV' 6-max Seat #6 is the button
Seat 1: rogerel5 ($1.70 in chips)
Seat 2: imbAchikko ($2.05 in chips)
Seat 3: vezelvu1 ($4.67 in chips)
Seat 4: leprekon71 ($3.41 in chips)
Seat 6: Vishny203 ($2.13 in chips)
rogerel5: posts small blind $0.01
imbAchikko: posts big blind $0.02
*** HOLE CARDS ***
vezelvu1: folds
leprekon71: folds
Vishny203: folds
rogerel5: raises $0.04 to $0.06
imbAchikko: folds
Uncalled bet ($0.04) returned to rogerel5
rogerel5 collected $0.04 from pot
rogerel5: doesn't show hand
*** SUMMARY ***
Total pot $0.04 | Rake $0
Seat 1: rogerel5 (small blind) collected ($0.04)
Seat 2: imbAchikko (big blind) folded before Flop
Seat 3: vezelvu1 folded before Flop (didn't bet)
Seat 4: leprekon71 folded before Flop (didn't bet)
Seat 6: Vishny203 (button) folded before Flop (didn't bet)


PokerStars Hand #238170951005:  Hold'em No Limit ($0.01/$0.02 USD) - 2022/08/23 13:50:45 ET
Table 'Despina IV' 6-max Seat #1 is the button
Seat 1: rogerel5 ($1.72 in chips)
Seat 2: imbAchikko ($2.03 in chips)
Seat 3: vezelvu1 ($4.67 in chips)
Seat 4: leprekon71 ($3.41 in chips)
Seat 6: Vishny203 ($2.13 in chips)
imbAchikko: posts small blind $0.01
vezelvu1: posts big blind $0.02
*** HOLE CARDS ***
leprekon71: folds
Vishny203: folds
rogerel5: folds
imbAchikko: raises $0.03 to $0.05
vezelvu1: folds
Uncalled bet ($0.03) returned to imbAchikko
imbAchikko collected $0.04 from pot
imbAchikko: doesn't show hand
*** SUMMARY ***
Total pot $0.04 | Rake $0
Seat 1: rogerel5 (button) folded before Flop (didn't bet)
Seat 2: imbAchikko (small blind) collected ($0.04)
Seat 3: vezelvu1 (big blind) folded before Flop
Seat 4: leprekon71 folded before Flop (didn't bet)
Seat 6: Vishny203 folded before Flop (didn't bet)


PokerStars Hand #238170955259:  Hold'em No Limit ($0.01/$0.02 USD) - 2022/08/23 13:50:58 ET
Table 'Despina IV' 6-max Seat #2 is the button
Seat 1: rogerel5 ($1.72 in chips)
Seat 2: imbAchikko ($2.05 in chips)
Seat 3: vezelvu1 ($4.65 in chips)
Seat 4: leprekon71 ($3.41 in chips)
Seat 6: Vishny203 ($2.13 in chips)
vezelvu1: posts small blind $0.01
leprekon71: posts big blind $0.02
*** HOLE CARDS ***
Vishny203: folds
rogerel5: folds
imbAchikko: raises $0.03 to $0.05
vezelvu1: folds
leprekon71: raises $0.11 to $0.16
imbAchikko: folds
Uncalled bet ($0.11) returned to leprekon71
leprekon71 collected $0.11 from pot
leprekon71: doesn't show hand
*** SUMMARY ***
Total pot $0.11 | Rake $0
Seat 1: rogerel5 folded before Flop (didn't bet)
Seat 2: imbAchikko (button) folded before Flop
Seat 3: vezelvu1 (small blind) folded before Flop
Seat 4: leprekon71 (big blind) collected ($0.11)
Seat 6: Vishny203 folded before Flop (didn't bet)


PokerStars Hand #238170961720:  Hold'em No Limit ($0.01/$0.02 USD) - 2022/08/23 13:51:17 ET
Table 'Despina IV' 6-max Seat #3 is the button
Seat 1: rogerel5 ($1.72 in chips)
Seat 2: imbAchikko ($2 in chips)
Seat 3: vezelvu1 ($4.64 in chips)
Seat 4: leprekon71 ($3.47 in chips)
Seat 5: Agustín Suárez ($3.80 in chips)
Seat 6: Vishny203 ($2.13 in chips)
leprekon71: posts small blind $0.01
Agustín Suárez: posts big blind $0.02
*** HOLE CARDS ***
Vishny203: folds
rogerel5: raises $0.04 to $0.06
imbAchikko: folds
vezelvu1: folds
leprekon71: calls $0.05
Agustín Suárez: folds
*** FLOP *** [Ad 4s 6s]
leprekon71: checks
rogerel5: bets $0.14
leprekon71: calls $0.14
*** TURN *** [Ad 4s 6s] [Kh]
leprekon71: checks
rogerel5: bets $0.41
leprekon71: calls $0.41
*** RIVER *** [Ad 4s 6s Kh] [9c]
leprekon71: checks
rogerel5: bets $1.11 and is all-in
leprekon71: calls $1.11
*** SHOW DOWN ***
rogerel5: shows [9s Ts] (a pair of Nines)
leprekon71: shows [Ac Th] (a pair of Aces)
leprekon71 collected $3.34 from pot
*** SUMMARY ***
Total pot $3.46 | Rake $0.12
Board [Ad 4s 6s Kh 9c]
Seat 1: rogerel5 showed [9s Ts] and lost with a pair of Nines
Seat 2: imbAchikko folded before Flop (didn't bet)
Seat 3: vezelvu1 (button) folded before Flop (didn't bet)
Seat 4: leprekon71 (small blind) showed [Ac Th] and won ($3.34) with a pair of Aces
Seat 5: Agustín Suárez (big blind) folded before Flop
Seat 6: Vishny203 folded before Flop (didn't bet)


PokerStars Hand #238170976235:  Hold'em No Limit ($0.01/$0.02 USD) - 2022/08/23 13:52:02 ET
Table 'Despina IV' 6-max Seat #4 is the button
Seat 2: imbAchikko ($2 in chips)
Seat 3: vezelvu1 ($4.64 in chips)
Seat 4: leprekon71 ($5.09 in chips)
Seat 5: Agustín Suárez ($3.78 in chips)
Seat 6: Vishny203 ($2.13 in chips)
Agustín Suárez: posts small blind $0.01
Vishny203: posts big blind $0.02
*** HOLE CARDS ***
imbAchikko: folds
vezelvu1: folds
leprekon71: folds
Agustín Suárez: raises $0.02 to $0.04
Vishny203: folds
Uncalled bet ($0.02) returned to Agustín Suárez
Agustín Suárez collected $0.04 from pot
Agustín Suárez: doesn't show hand
*** SUMMARY ***
Total pot $0.04 | Rake $0
Seat 2: imbAchikko folded before Flop (didn't bet)
Seat 3: vezelvu1 folded before Flop (didn't bet)
Seat 4: leprekon71 (button) folded before Flop (didn't bet)
Seat 5: Agustín Suárez (small blind) collected ($0.04)
Seat 6: Vishny203 (big blind) folded before Flop


PokerStars Hand #238170982971:  Hold'em No Limit ($0.01/$0.02 USD) - 2022/08/23 13:52:22 ET
Table 'Despina IV' 6-max Seat #5 is the button
Seat 1: rogerel5 ($2 in chips)
Seat 2: imbAchikko ($2 in chips)
Seat 3: vezelvu1 ($4.64 in chips)
Seat 4: leprekon71 ($5.09 in chips)
Seat 5: Agustín Suárez ($3.80 in chips)
Seat 6: Vishny203 ($2.11 in chips)
Vishny203: posts small blind $0.01
rogerel5: posts big blind $0.02
*** HOLE CARDS ***
imbAchikko: folds
vezelvu1: folds
leprekon71: folds
Agustín Suárez: folds
Vishny203: folds
Uncalled bet ($0.01) returned to rogerel5
rogerel5 collected $0.02 from pot
rogerel5: doesn't show hand
*** SUMMARY ***
Total pot $0.02 | Rake $0
Seat 1: rogerel5 (big blind) collected ($0.02)
Seat 2: imbAchikko folded before Flop (didn't bet)
Seat 3: vezelvu1 folded before Flop (didn't bet)
Seat 4: leprekon71 folded before Flop (didn't bet)
Seat 5: Agustín Suárez (button) folded before Flop (didn't bet)
Seat 6: Vishny203 (small blind) folded before Flop


PokerStars Hand #238170988150:  Hold'em No Limit ($0.01/$0.02 USD) - 2022/08/23 13:52:38 ET
Table 'Despina IV' 6-max Seat #6 is the button
Seat 1: rogerel5 ($2.01 in chips)
Seat 2: imbAchikko ($2 in chips)
Seat 3: vezelvu1 ($4.64 in chips)
Seat 4: leprekon71 ($5.09 in chips)
Seat 5: Agustín Suárez ($3.80 in chips)
Seat 6: Vishny203 ($2.10 in chips)
rogerel5: posts small blind $0.01
imbAchikko: posts big blind $0.02
*** HOLE CARDS ***
vezelvu1: folds
leprekon71: folds
Agustín Suárez: folds
Vishny203: raises $0.04 to $0.06
rogerel5: folds
imbAchikko: calls $0.04
*** FLOP *** [7d Th Kc]
imbAchikko: checks
Vishny203: checks
*** TURN *** [7d Th Kc] [8d]
imbAchikko: checks
Vishny203: checks
*** RIVER *** [7d Th Kc 8d] [2h]
imbAchikko: checks
Vishny203: bets $0.02
imbAchikko: calls $0.02
*** SHOW DOWN ***
Vishny203: shows [8h Jd] (a pair of Eights)
imbAchikko: shows [Tc As] (a pair of Tens)
imbAchikko collected $0.16 from pot
*** SUMMARY ***
Total pot $0.17 | Rake $0.01
Board [7d Th Kc 8d 2h]
Seat 1: rogerel5 (small blind) folded before Flop
Seat 2: imbAchikko (big blind) showed [Tc As] and won ($0.16) with a pair of Tens
Seat 3: vezelvu1 folded before Flop (didn't bet)
Seat 4: leprekon71 folded before Flop (didn't bet)
Seat 5: Agustín Suárez folded before Flop (didn't bet)
Seat 6: Vishny203 (button) showed [8h Jd] and lost with a pair of Eights


PokerStars Hand #238171009208:  Hold'em No Limit ($0.01/$0.02 USD) - 2022/08/23 13:53:42 ET
Table 'Despina IV' 6-max Seat #1 is the button
Seat 1: rogerel5 ($2 in chips)
Seat 2: imbAchikko ($2.08 in chips)
Seat 3: vezelvu1 ($4.64 in chips)
Seat 4: leprekon71 ($5.09 in chips)
Seat 5: Agustín Suárez ($3.80 in chips)
Seat 6: Vishny203 ($2.02 in chips)
imbAchikko: posts small blind $0.01
vezelvu1: posts big blind $0.02
*** HOLE CARDS ***
leprekon71: folds
Agustín Suárez: raises $0.04 to $0.06
Vishny203: folds
rogerel5: folds
imbAchikko: folds
vezelvu1: folds
Uncalled bet ($0.04) returned to Agustín Suárez
Agustín Suárez collected $0.05 from pot
Agustín Suárez: doesn't show hand
*** SUMMARY ***
Total pot $0.05 | Rake $0
Seat 1: rogerel5 (button) folded before Flop (didn't bet)
Seat 2: imbAchikko (small blind) folded before Flop
Seat 3: vezelvu1 (big blind) folded before Flop
Seat 4: leprekon71 folded before Flop (didn't bet)
Seat 5: Agustín Suárez collected ($0.05)
Seat 6: Vishny203 folded before Flop (didn't bet)


PokerStars Hand #238171014251:  Hold'em No Limit ($0.01/$0.02 USD) - 2022/08/23 13:53:58 ET
Table 'Despina IV' 6-max Seat #2 is the button
Seat 1: rogerel5 ($2 in chips)
Seat 2: imbAchikko ($2.07 in chips)
Seat 3: vezelvu1 ($4.62 in chips)
Seat 4: leprekon71 ($5.09 in chips)
Seat 5: Agustín Suárez ($3.83 in chips)
Seat 6: Vishny203 ($2.02 in chips)
vezelvu1: posts small blind $0.01
leprekon71: posts big blind $0.02
*** HOLE CARDS ***
Agustín Suárez: folds
Vishny203: folds
rogerel5: folds
imbAchikko: raises $0.03 to $0.05
vezelvu1: folds
leprekon71: folds
Uncalled bet ($0.03) returned to imbAchikko
imbAchikko collected $0.05 from pot
imbAchikko: doesn't show hand
*** SUMMARY ***
Total pot $0.05 | Rake $0
Seat 1: rogerel5 folded before Flop (didn't bet)
Seat 2: imbAchikko (button) collected ($0.05)
Seat 3: vezelvu1 (small blind) folded before Flop
Seat 4: leprekon71 (big blind) folded before Flop
Seat 5: Agustín Suárez folded before Flop (didn't bet)
Seat 6: Vishny203 folded before Flop (didn't bet)


PokerStars Hand #238171019449:  Hold'em No Limit ($0.01/$0.02 USD) - 2022/08/23 13:54:14 ET
Table 'Despina IV' 6-max Seat #3 is the button
Seat 1: rogerel5 ($2 in chips)
Seat 2: imbAchikko ($2.10 in chips)
Seat 3: vezelvu1 ($4.61 in chips)
Seat 4: leprekon71 ($5.07 in chips)
Seat 5: Agustín Suárez ($3.83 in chips)
Seat 6: Vishny203 ($2.02 in chips)
leprekon71: posts small blind $0.01
Agustín Suárez: posts big blind $0.02
*** HOLE CARDS ***
Vishny203: folds
rogerel5: folds
imbAchikko: raises $0.03 to $0.05
vezelvu1: folds
leprekon71: folds
Agustín Suárez: calls $0.03
*** FLOP *** [5s 5c Ad]
Agustín Suárez: checks
imbAchikko: checks
*** TURN *** [5s 5c Ad] [Ac]
Agustín Suárez: checks
imbAchikko: checks
*** RIVER *** [5s 5c Ad Ac] [Ah]
Agustín Suárez: checks
imbAchikko: checks
*** SHOW DOWN ***
Agustín Suárez: shows [7d Jd] (a full house, Aces full of Fives)
imbAchikko: shows [Qs Tc] (a full house, Aces full of Fives)
Agustín Suárez collected $0.06 from pot
imbAchikko collected $0.05 from pot
*** SUMMARY ***
Total pot $0.11 | Rake $0
Board [5s 5c Ad Ac Ah]
Seat 1: rogerel5 folded before Flop (didn't bet)
Seat 2: imbAchikko showed [Qs Tc] and won ($0.05) with a full house, Aces full of Fives
Seat 3: vezelvu1 (button) folded before Flop (didn't bet)
Seat 4: leprekon71 (small blind) folded before Flop
Seat 5: Agustín Suárez (big blind) showed [7d Jd] and won ($0.06) with a full house, Aces full of Fives
Seat 6: Vishny203 folded before Flop (didn't bet)


PokerStars Hand #238171035821:  Hold'em No Limit ($0.01/$0.02 USD) - 2022/08/23 13:55:03 ET
Table 'Despina IV' 6-max Seat #4 is the button
Seat 1: rogerel5 ($2 in chips)
Seat 2: imbAchikko ($2.10 in chips)
Seat 3: vezelvu1 ($4.61 in chips)
Seat 4: leprekon71 ($5.06 in chips)
Seat 5: Agustín Suárez ($3.84 in chips)
Seat 6: Vishny203 ($2.02 in chips)
Agustín Suárez: posts small blind $0.01
Vishny203: posts big blind $0.02
*** HOLE CARDS ***
rogerel5: folds
imbAchikko: raises $0.03 to $0.05
vezelvu1: calls $0.05
leprekon71: raises $0.18 to $0.23
Agustín Suárez: folds
Vishny203: folds
imbAchikko: folds
vezelvu1: folds
Uncalled bet ($0.18) returned to leprekon71
leprekon71 collected $0.18 from pot
leprekon71: doesn't show hand
*** SUMMARY ***
Total pot $0.18 | Rake $0
Seat 1: rogerel5 folded before Flop (didn't bet)
Seat 2: imbAchikko folded before Flop
Seat 3: vezelvu1 folded before Flop
Seat 4: leprekon71 (button) collected ($0.18)
Seat 5: Agustín Suárez (small blind) folded before Flop
Seat 6: Vishny203 (big blind) folded before Flop


PokerStars Hand #238171043170:  Hold'em No Limit ($0.01/$0.02 USD) - 2022/08/23 13:55:29 ET
Table 'Despina IV' 6-max Seat #5 is the button
Seat 1: rogerel5 ($2 in chips)
Seat 2: imbAchikko ($2.05 in chips)
Seat 3: vezelvu1 ($4.56 in chips)
Seat 4: leprekon71 ($5.19 in chips)
Seat 5: Agustín Suárez ($3.83 in chips)
Seat 6: Vishny203 ($2 in chips)
Vishny203: posts small blind $0.01
rogerel5: posts big blind $0.02
*** HOLE CARDS ***
imbAchikko: folds
vezelvu1: folds
leprekon71: folds
Agustín Suárez: raises $0.04 to $0.06
Vishny203: folds
rogerel5: folds
Uncalled bet ($0.04) returned to Agustín Suárez
Agustín Suárez collected $0.05 from pot
Agustín Suárez: doesn't show hand
*** SUMMARY ***
Total pot $0.05 | Rake $0
Seat 1: rogerel5 (big blind) folded before Flop
Seat 2: imbAchikko folded before Flop (didn't bet)
Seat 3: vezelvu1 folded before Flop (didn't bet)
Seat 4: leprekon71 folded before Flop (didn't bet)
Seat 5: Agustín Suárez (button) collected ($0.05)
Seat 6: Vishny203 (small blind) folded before Flop


PokerStars Hand #238171047195:  Hold'em No Limit ($0.01/$0.02 USD) - 2022/08/23 13:55:45 ET
Table 'Despina IV' 6-max Seat #6 is the button
Seat 1: rogerel5 ($1.98 in chips)
Seat 2: imbAchikko ($2.05 in chips)
Seat 3: vezelvu1 ($4.56 in chips)
Seat 4: leprekon71 ($5.19 in chips)
Seat 5: Agustín Suárez ($3.86 in chips)
Seat 6: Vishny203 ($2 in chips)
rogerel5: posts small blind $0.01
imbAchikko: posts big blind $0.02
*** HOLE CARDS ***
vezelvu1: folds
leprekon71: raises $0.02 to $0.04
Agustín Suárez: calls $0.04
Vishny203: calls $0.04
rogerel5: folds
imbAchikko: folds
*** FLOP *** [7s 7c 9s]
leprekon71: checks
Agustín Suárez: checks
Vishny203: bets $0.11
leprekon71: folds
Agustín Suárez: calls $0.11
*** TURN *** [7s 7c 9s] [Ah]
Agustín Suárez: checks
Vishny203: bets $0.27
Agustín Suárez: calls $0.27
*** RIVER *** [7s 7c 9s Ah] [2s]
Agustín Suárez: checks
Vishny203: checks
*** SHOW DOWN ***
Agustín Suárez: shows [Jc Js] (two pair, Jacks and Sevens)
Vishny203: shows [9c Ac] (two pair, Aces and Nines)
Vishny203 collected $0.88 from pot
*** SUMMARY ***
Total pot $0.91 | Rake $0.03
Board [7s 7c 9s Ah 2s]
Seat 1: rogerel5 (small blind) folded before Flop
Seat 2: imbAchikko (big blind) folded before Flop
Seat 3: vezelvu1 folded before Flop (didn't bet)
Seat 4: leprekon71 folded on the Flop
Seat 5: Agustín Suárez showed [Jc Js] and lost with two pair, Jacks and Sevens
Seat 6: Vishny203 (button) showed [9c Ac] and won ($0.88) with two pair, Aces and Nines


PokerStars Hand #238171060701:  Hold'em No Limit ($0.01/$0.02 USD) - 2022/08/23 13:56:40 ET
Table 'Despina IV' 6-max Seat #1 is the button
Seat 1: rogerel5 ($1.97 in chips)
Seat 2: imbAchikko ($2.03 in chips)
Seat 4: leprekon71 ($5.15 in chips)
Seat 5: Agustín Suárez ($3.44 in chips)
Seat 6: Vishny203 ($2.46 in chips)
imbAchikko: posts small blind $0.01
vezelvu1: is sitting out
leprekon71: posts big blind $0.02
*** HOLE CARDS ***
vezelvu1 leaves the table
Agustín Suárez: folds
bungle63 joins the table at seat #3
Vishny203: raises $0.06 to $0.08
rogerel5: folds
imbAchikko: folds
leprekon71: folds
Uncalled bet ($0.06) returned to Vishny203
Vishny203 collected $0.05 from pot
Vishny203: doesn't show hand
*** SUMMARY ***
Total pot $0.05 | Rake $0
Seat 1: rogerel5 (button) folded before Flop (didn't bet)
Seat 2: imbAchikko (small blind) folded before Flop
Seat 4: leprekon71 (big blind) folded before Flop
Seat 5: Agustín Suárez folded before Flop (didn't bet)
Seat 6: Vishny203 collected ($0.05)


PokerStars Hand #238171066880:  Hold'em No Limit ($0.01/$0.02 USD) - 2022/08/23 13:57:04 ET
Table 'Despina IV' 6-max Seat #2 is the button
Seat 1: rogerel5 ($1.97 in chips)
Seat 2: imbAchikko ($2.02 in chips)
Seat 4: leprekon71 ($5.13 in chips)
Seat 5: Agustín Suárez ($3.44 in chips)
Seat 6: Vishny203 ($2.49 in chips)
leprekon71: posts small blind $0.01
Agustín Suárez: posts big blind $0.02
*** HOLE CARDS ***
Vishny203: raises $0.04 to $0.06
rogerel5: folds
imbAchikko: folds
leprekon71: folds
Agustín Suárez: folds
Uncalled bet ($0.04) returned to Vishny203
Vishny203 collected $0.05 from pot
Vishny203: doesn't show hand
*** SUMMARY ***
Total pot $0.05 | Rake $0
Seat 1: rogerel5 folded before Flop (didn't bet)
Seat 2: imbAchikko (button) folded before Flop (didn't bet)
Seat 4: leprekon71 (small blind) folded before Flop
Seat 5: Agustín Suárez (big blind) folded before Flop
Seat 6: Vishny203 collected ($0.05)


PokerStars Hand #238171069459:  Hold'em No Limit ($0.01/$0.02 USD) - 2022/08/23 13:57:15 ET
Table 'Despina IV' 6-max Seat #4 is the button
Seat 1: rogerel5 ($1.97 in chips)
Seat 2: imbAchikko ($2.02 in chips)
Seat 3: bungle63 ($0.80 in chips)
Seat 4: leprekon71 ($5.12 in chips)
Seat 5: Agustín Suárez ($3.42 in chips)
Seat 6: Vishny203 ($2.52 in chips)
Agustín Suárez: posts small blind $0.01
Vishny203: posts big blind $0.02
bungle63: posts big blind $0.02
*** HOLE CARDS ***
rogerel5: folds
imbAchikko: folds
bungle63: checks
leprekon71: folds
Agustín Suárez: raises $0.04 to $0.06
Vishny203: folds
bungle63: calls $0.04
*** FLOP *** [9d 8h Ac]
Agustín Suárez: checks
bungle63: bets $0.14
Agustín Suárez: folds
Uncalled bet ($0.14) returned to bungle63
bungle63 collected $0.14 from pot
bungle63: doesn't show hand
*** SUMMARY ***
Total pot $0.14 | Rake $0
Board [9d 8h Ac]
Seat 1: rogerel5 folded before Flop (didn't bet)
Seat 2: imbAchikko folded before Flop (didn't bet)
Seat 3: bungle63 collected ($0.14)
Seat 4: leprekon71 (button) folded before Flop (didn't bet)
Seat 5: Agustín Suárez (small blind) folded on the Flop
Seat 6: Vishny203 (big blind) folded before Flop


PokerStars Hand #238171088237:  Hold'em No Limit ($0.01/$0.02 USD) - 2022/08/23 13:57:54 ET
Table 'Despina IV' 6-max Seat #5 is the button
Seat 1: rogerel5 ($1.97 in chips)
Seat 2: imbAchikko ($2.02 in chips)
Seat 3: bungle63 ($0.88 in chips)
Seat 4: leprekon71 ($5.12 in chips)
Seat 5: Agustín Suárez ($3.36 in chips)
Seat 6: Vishny203 ($2.50 in chips)
Vishny203: posts small blind $0.01
rogerel5: posts big blind $0.02
*** HOLE CARDS ***
imbAchikko: folds
bungle63: calls $0.02
leprekon71: folds
Agustín Suárez: raises $0.04 to $0.06
Vishny203: folds
rogerel5: folds
bungle63: calls $0.04
*** FLOP *** [2s 7s Js]
bungle63: checks
Agustín Suárez: checks
*** TURN *** [2s 7s Js] [4h]
bungle63: checks
Agustín Suárez: checks
*** RIVER *** [2s 7s Js 4h] [Jc]
bungle63: bets $0.02
Agustín Suárez: folds
Uncalled bet ($0.02) returned to bungle63
bungle63 collected $0.14 from pot
bungle63: doesn't show hand
*** SUMMARY ***
Total pot $0.15 | Rake $0.01
Board [2s 7s Js 4h Jc]
Seat 1: rogerel5 (big blind) folded before Flop
Seat 2: imbAchikko folded before Flop (didn't bet)
Seat 3: bungle63 collected ($0.14)
Seat 4: leprekon71 folded before Flop (didn't bet)
Seat 5: Agustín Suárez (button) folded on the River
Seat 6: Vishny203 (small blind) folded before Flop


PokerStars Hand #238171098542:  Hold'em No Limit ($0.01/$0.02 USD) - 2022/08/23 13:58:35 ET
Table 'Despina IV' 6-max Seat #6 is the button
Seat 1: rogerel5 ($1.95 in chips)
Seat 2: imbAchikko ($2.02 in chips)
Seat 3: bungle63 ($0.96 in chips)
Seat 4: leprekon71 ($5.12 in chips)
Seat 5: Agustín Suárez ($3.30 in chips)
Seat 6: Vishny203 ($2.49 in chips)
rogerel5: posts small blind $0.01
imbAchikko: posts big blind $0.02
*** HOLE CARDS ***
bungle63: calls $0.02
leprekon71: raises $0.02 to $0.04
Agustín Suárez: folds
Vishny203: calls $0.04
rogerel5: folds
imbAchikko: folds
bungle63: calls $0.02
*** FLOP *** [Tc 3h Ah]
bungle63: checks
leprekon71: bets $0.09
Vishny203: calls $0.09
bungle63: folds
*** TURN *** [Tc 3h Ah] [9s]
leprekon71: bets $0.18
Vishny203: folds
Uncalled bet ($0.18) returned to leprekon71
leprekon71 collected $0.32 from pot
leprekon71: doesn't show hand
*** SUMMARY ***
Total pot $0.33 | Rake $0.01
Board [Tc 3h Ah 9s]
Seat 1: rogerel5 (small blind) folded before Flop
Seat 2: imbAchikko (big blind) folded before Flop
Seat 3: bungle63 folded on the Flop
Seat 4: leprekon71 collected ($0.32)
Seat 5: Agustín Suárez folded before Flop (didn't bet)
Seat 6: Vishny203 (button) folded on the Turn


PokerStars Hand #238171106672:  Hold'em No Limit ($0.01/$0.02 USD) - 2022/08/23 13:59:08 ET
Table 'Despina IV' 6-max Seat #1 is the button
Seat 1: rogerel5 ($1.94 in chips)
Seat 2: imbAchikko ($2 in chips)
Seat 3: bungle63 ($0.92 in chips)
Seat 4: leprekon71 ($5.31 in chips)
Seat 5: Agustín Suárez ($3.30 in chips)
Seat 6: Vishny203 ($2.36 in chips)
imbAchikko: posts small blind $0.01
bungle63: posts big blind $0.02
*** HOLE CARDS ***
leprekon71: folds
Agustín Suárez: folds
Vishny203: folds
rogerel5: folds
imbAchikko: folds
Uncalled bet ($0.01) returned to bungle63
bungle63 collected $0.02 from pot
bungle63: doesn't show hand
*** SUMMARY ***
Total pot $0.02 | Rake $0
Seat 1: rogerel5 (button) folded before Flop (didn't bet)
Seat 2: imbAchikko (small blind) folded before Flop
Seat 3: bungle63 (big blind) collected ($0.02)
Seat 4: leprekon71 folded before Flop (didn't bet)
Seat 5: Agustín Suárez folded before Flop (didn't bet)
Seat 6: Vishny203 folded before Flop (didn't bet)


PokerStars Hand #238171109086:  Hold'em No Limit ($0.01/$0.02 USD) - 2022/08/23 13:59:17 ET
Table 'Despina IV' 6-max Seat #2 is the button
Seat 1: rogerel5 ($1.94 in chips)
Seat 2: imbAchikko ($2 in chips)
Seat 3: bungle63 ($0.93 in chips)
Seat 4: leprekon71 ($5.31 in chips)
Seat 5: Agustín Suárez ($3.30 in chips)
Seat 6: Vishny203 ($2.36 in chips)
bungle63: posts small blind $0.01
leprekon71: posts big blind $0.02
*** HOLE CARDS ***
Agustín Suárez: folds
Vishny203: folds
rogerel5 has timed out
rogerel5: folds
imbAchikko: folds
bungle63: folds
Uncalled bet ($0.01) returned to leprekon71
leprekon71 collected $0.02 from pot
leprekon71: doesn't show hand
*** SUMMARY ***
Total pot $0.02 | Rake $0
Seat 1: rogerel5 folded before Flop (didn't bet)
Seat 2: imbAchikko (button) folded before Flop (didn't bet)
Seat 3: bungle63 (small blind) folded before Flop
Seat 4: leprekon71 (big blind) collected ($0.02)
Seat 5: Agustín Suárez folded before Flop (didn't bet)
Seat 6: Vishny203 folded before Flop (didn't bet)


PokerStars Hand #238171113995:  Hold'em No Limit ($0.01/$0.02 USD) - 2022/08/23 13:59:37 ET
Table 'Despina IV' 6-max Seat #3 is the button
Seat 2: imbAchikko ($2 in chips)
Seat 3: bungle63 ($0.92 in chips)
Seat 4: leprekon71 ($5.32 in chips)
Seat 5: Agustín Suárez ($3.30 in chips)
Seat 6: Vishny203 ($2.36 in chips)
leprekon71: posts small blind $0.01
Agustín Suárez: posts big blind $0.02
*** HOLE CARDS ***
Vishny203: folds
imbAchikko: raises $0.03 to $0.05
bungle63: folds
leprekon71: folds
Agustín Suárez: folds
Uncalled bet ($0.03) returned to imbAchikko
imbAchikko collected $0.05 from pot
imbAchikko: doesn't show hand
*** SUMMARY ***
Total pot $0.05 | Rake $0
Seat 2: imbAchikko collected ($0.05)
Seat 3: bungle63 (button) folded before Flop (didn't bet)
Seat 4: leprekon71 (small blind) folded before Flop
Seat 5: Agustín Suárez (big blind) folded before Flop
Seat 6: Vishny203 folded before Flop (didn't bet)


PokerStars Hand #238171116443:  Hold'em No Limit ($0.01/$0.02 USD) - 2022/08/23 13:59:47 ET
Table 'Despina IV' 6-max Seat #4 is the button
Seat 1: rogerel5 ($1.94 in chips)
Seat 2: imbAchikko ($2.03 in chips)
Seat 3: bungle63 ($0.92 in chips)
Seat 4: leprekon71 ($5.31 in chips)
Seat 5: Agustín Suárez ($3.28 in chips)
Seat 6: Vishny203 ($2.36 in chips)
Agustín Suárez: posts small blind $0.01
Vishny203: posts big blind $0.02
*** HOLE CARDS ***
rogerel5: folds
imbAchikko: folds
bungle63: calls $0.02
leprekon71: folds
Agustín Suárez: folds
Vishny203: raises $0.06 to $0.08
bungle63: calls $0.06
*** FLOP *** [Td 9h Jd]
Vishny203: checks
bungle63: bets $0.16
Vishny203: folds
Uncalled bet ($0.16) returned to bungle63
bungle63 collected $0.16 from pot
bungle63: doesn't show hand
*** SUMMARY ***
Total pot $0.17 | Rake $0.01
Board [Td 9h Jd]
Seat 1: rogerel5 folded before Flop (didn't bet)
Seat 2: imbAchikko folded before Flop (didn't bet)
Seat 3: bungle63 collected ($0.16)
Seat 4: leprekon71 (button) folded before Flop (didn't bet)
Seat 5: Agustín Suárez (small blind) folded before Flop
Seat 6: Vishny203 (big blind) folded on the Flop


PokerStars Hand #238171122368:  Hold'em No Limit ($0.01/$0.02 USD) - 2022/08/23 14:00:10 ET
Table 'Despina IV' 6-max Seat #5 is the button
Seat 1: rogerel5 ($1.94 in chips)
Seat 2: imbAchikko ($2.03 in chips)
Seat 3: bungle63 ($1 in chips)
Seat 4: leprekon71 ($5.31 in chips)
Seat 5: Agustín Suárez ($3.27 in chips)
Seat 6: Vishny203 ($2.28 in chips)
Vishny203: posts small blind $0.01
rogerel5: posts big blind $0.02
*** HOLE CARDS ***
imbAchikko: folds
bungle63: calls $0.02
leprekon71: folds
Agustín Suárez: folds
Vishny203: folds
rogerel5: checks
*** FLOP *** [Tc 5c 5h]
rogerel5: checks
bungle63: bets $0.05
rogerel5: raises $0.08 to $0.13
bungle63: calls $0.08
*** TURN *** [Tc 5c 5h] [Jc]
rogerel5: checks
bungle63: checks
*** RIVER *** [Tc 5c 5h Jc] [Qc]
rogerel5: checks
bungle63: checks
*** SHOW DOWN ***
rogerel5: shows [6d 5d] (three of a kind, Fives)
bungle63: shows [2c 2s] (a flush, Queen high)
bungle63 collected $0.30 from pot
*** SUMMARY ***
Total pot $0.31 | Rake $0.01
Board [Tc 5c 5h Jc Qc]
Seat 1: rogerel5 (big blind) showed [6d 5d] and lost with three of a kind, Fives
Seat 2: imbAchikko folded before Flop (didn't bet)
Seat 3: bungle63 showed [2c 2s] and won ($0.30) with a flush, Queen high
Seat 4: leprekon71 folded before Flop (didn't bet)
Seat 5: Agustín Suárez (button) folded before Flop (didn't bet)
Seat 6: Vishny203 (small blind) folded before Flop


PokerStars Hand #238171132556:  Hold'em No Limit ($0.01/$0.02 USD) - 2022/08/23 14:00:48 ET
Table 'Despina IV' 6-max Seat #6 is the button
Seat 1: rogerel5 ($1.79 in chips)
Seat 2: imbAchikko ($2.03 in chips)
Seat 3: bungle63 ($1.15 in chips)
Seat 4: leprekon71 ($5.31 in chips)
Seat 5: Agustín Suárez ($3.27 in chips)
Seat 6: Vishny203 ($2.27 in chips)
rogerel5: posts small blind $0.01
imbAchikko: posts big blind $0.02
*** HOLE CARDS ***
bungle63: folds
leprekon71: folds
Agustín Suárez: folds
Vishny203: folds
rogerel5: calls $0.01
imbAchikko: raises $0.04 to $0.06
rogerel5: calls $0.04
*** FLOP *** [Qs Jc 4s]
rogerel5: checks
imbAchikko: bets $0.04
bungle63 leaves the table
rogerel5: calls $0.04
*** TURN *** [Qs Jc 4s] [9s]
Fedorenko26 joins the table at seat #3
rogerel5: checks
imbAchikko: checks
*** RIVER *** [Qs Jc 4s 9s] [6c]
rogerel5: checks
imbAchikko: bets $0.14
rogerel5: folds
Uncalled bet ($0.14) returned to imbAchikko
imbAchikko collected $0.19 from pot
imbAchikko: doesn't show hand
*** SUMMARY ***
Total pot $0.20 | Rake $0.01
Board [Qs Jc 4s 9s 6c]
Seat 1: rogerel5 (small blind) folded on the River
Seat 2: imbAchikko (big blind) collected ($0.19)
Seat 3: bungle63 folded before Flop (didn't bet)
Seat 4: leprekon71 folded before Flop (didn't bet)
Seat 5: Agustín Suárez folded before Flop (didn't bet)
Seat 6: Vishny203 (button) folded before Flop (didn't bet)


PokerStars Hand #238171152171:  Hold'em No Limit ($0.01/$0.02 USD) - 2022/08/23 14:01:53 ET
Table 'Despina IV' 6-max Seat #1 is the button
Seat 1: rogerel5 ($1.69 in chips)
Seat 2: imbAchikko ($2.12 in chips)
Seat 3: Fedorenko26 ($2 in chips)
Seat 4: leprekon71 ($5.31 in chips)
Seat 5: Agustín Suárez ($3.27 in chips)
Seat 6: Vishny203 ($2.27 in chips)
imbAchikko: posts small blind $0.01
Fedorenko26: posts big blind $0.02
*** HOLE CARDS ***
leprekon71: folds
Agustín Suárez: folds
Vishny203: raises $0.04 to $0.06
rogerel5: folds
imbAchikko: folds
Fedorenko26: calls $0.04
*** FLOP *** [8s Kh 9c]
Fedorenko26: checks
Vishny203: bets $0.10
Fedorenko26: folds
Uncalled bet ($0.10) returned to Vishny203
Vishny203 collected $0.13 from pot
Vishny203: doesn't show hand
*** SUMMARY ***
Total pot $0.13 | Rake $0
Board [8s Kh 9c]
Seat 1: rogerel5 (button) folded before Flop (didn't bet)
Seat 2: imbAchikko (small blind) folded before Flop
Seat 3: Fedorenko26 (big blind) folded on the Flop
Seat 4: leprekon71 folded before Flop (didn't bet)
Seat 5: Agustín Suárez folded before Flop (didn't bet)
Seat 6: Vishny203 collected ($0.13)


PokerStars Hand #238171165415:  Hold'em No Limit ($0.01/$0.02 USD) - 2022/08/23 14:02:34 ET
Table 'Despina IV' 6-max Seat #2 is the button
Seat 1: rogerel5 ($1.69 in chips)
Seat 2: imbAchikko ($2.11 in chips)
Seat 3: Fedorenko26 ($2 in chips)
Seat 4: leprekon71 ($5.31 in chips)
Seat 5: Agustín Suárez ($3.27 in chips)
Seat 6: Vishny203 ($2.34 in chips)
Fedorenko26: posts small blind $0.01
leprekon71: posts big blind $0.02
*** HOLE CARDS ***
Agustín Suárez: folds
Vishny203: folds
rogerel5: raises $0.05 to $0.07
imbAchikko: raises $0.15 to $0.22
Fedorenko26: folds
leprekon71: folds
rogerel5: calls $0.15
*** FLOP *** [5d 5h Kc]
rogerel5: checks
imbAchikko: bets $0.23
rogerel5: calls $0.23
*** TURN *** [5d 5h Kc] [Qs]
rogerel5: checks
imbAchikko: bets $0.45
rogerel5: raises $0.79 to $1.24 and is all-in
imbAchikko: calls $0.79
*** RIVER *** [5d 5h Kc Qs] [2d]
*** SHOW DOWN ***
rogerel5: shows [Ks Qh] (two pair, Kings and Queens)
imbAchikko: shows [Ad Ah] (two pair, Aces and Fives)
imbAchikko collected $3.29 from pot
*** SUMMARY ***
Total pot $3.41 | Rake $0.12
Board [5d 5h Kc Qs 2d]
Seat 1: rogerel5 showed [Ks Qh] and lost with two pair, Kings and Queens
Seat 2: imbAchikko (button) showed [Ad Ah] and won ($3.29) with two pair, Aces and Fives
Seat 3: Fedorenko26 (small blind) folded before Flop
Seat 4: leprekon71 (big blind) folded before Flop
Seat 5: Agustín Suárez folded before Flop (didn't bet)
Seat 6: Vishny203 folded before Flop (didn't bet)


PokerStars Hand #238171192608:  Hold'em No Limit ($0.01/$0.02 USD) - 2022/08/23 14:03:55 ET
Table 'Despina IV' 6-max Seat #3 is the button
Seat 2: imbAchikko ($3.71 in chips)
Seat 3: Fedorenko26 ($2 in chips)
Seat 4: leprekon71 ($5.29 in chips)
Seat 5: Agustín Suárez ($3.27 in chips)
Seat 6: Vishny203 ($2.34 in chips)
leprekon71: posts small blind $0.01
Agustín Suárez: posts big blind $0.02
*** HOLE CARDS ***
Vishny203: folds
imbAchikko: folds
Fedorenko26: folds
leprekon71: folds
Uncalled bet ($0.01) returned to Agustín Suárez
Agustín Suárez collected $0.02 from pot
Agustín Suárez: doesn't show hand
*** SUMMARY ***
Total pot $0.02 | Rake $0
Seat 2: imbAchikko folded before Flop (didn't bet)
Seat 3: Fedorenko26 (button) folded before Flop (didn't bet)
Seat 4: leprekon71 (small blind) folded before Flop
Seat 5: Agustín Suárez (big blind) collected ($0.02)
Seat 6: Vishny203 folded before Flop (didn't bet)


PokerStars Hand #238171195171:  Hold'em No Limit ($0.01/$0.02 USD) - 2022/08/23 14:04:03 ET
Table 'Despina IV' 6-max Seat #4 is the button
Seat 2: imbAchikko ($3.71 in chips)
Seat 3: Fedorenko26 ($2 in chips)
Seat 4: leprekon71 ($5.28 in chips)
Seat 5: Agustín Suárez ($3.28 in chips)
Seat 6: Vishny203 ($2.34 in chips)
Agustín Suárez: posts small blind $0.01
Vishny203: posts big blind $0.02
*** HOLE CARDS ***
rogerel5 leaves the table
imbAchikko: folds
Fedorenko26: folds
leprekon71: folds
Agustín Suárez: folds
Uncalled bet ($0.01) returned to Vishny203
Vishny203 collected $0.02 from pot
Vishny203: doesn't show hand
*** SUMMARY ***
Total pot $0.02 | Rake $0
Seat 2: imbAchikko folded before Flop (didn't bet)
Seat 3: Fedorenko26 folded before Flop (didn't bet)
Seat 4: leprekon71 (button) folded before Flop (didn't bet)
Seat 5: Agustín Suárez (small blind) folded before Flop
Seat 6: Vishny203 (big blind) collected ($0.02)


PokerStars Hand #238171200988:  Hold'em No Limit ($0.01/$0.02 USD) - 2022/08/23 14:04:20 ET
Table 'Despina IV' 6-max Seat #5 is the button
Seat 2: imbAchikko ($3.71 in chips)
Seat 3: Fedorenko26 ($2 in chips)
Seat 4: leprekon71 ($5.28 in chips)
Seat 5: Agustín Suárez ($3.27 in chips)
Seat 6: Vishny203 ($2.35 in chips)
Vishny203: posts small blind $0.01
imbAchikko: posts big blind $0.02
*** HOLE CARDS ***
Fedorenko26: folds
leprekon71: folds
Agustín Suárez: folds
Tina-Elissa joins the table at seat #1
Vishny203: raises $0.04 to $0.06
imbAchikko: folds
Uncalled bet ($0.04) returned to Vishny203
Vishny203 collected $0.04 from pot
Vishny203: doesn't show hand
*** SUMMARY ***
Total pot $0.04 | Rake $0
Seat 2: imbAchikko (big blind) folded before Flop
Seat 3: Fedorenko26 folded before Flop (didn't bet)
Seat 4: leprekon71 folded before Flop (didn't bet)
Seat 5: Agustín Suárez (button) folded before Flop (didn't bet)
Seat 6: Vishny203 (small blind) collected ($0.04)


PokerStars Hand #238171214655:  Hold'em No Limit ($0.01/$0.02 USD) - 2022/08/23 14:04:34 ET
Table 'Despina IV' 6-max Seat #6 is the button
Seat 2: imbAchikko ($3.69 in chips)
Seat 3: Fedorenko26 ($2 in chips)
Seat 4: leprekon71 ($5.28 in chips)
Seat 5: Agustín Suárez ($3.27 in chips)
Seat 6: Vishny203 ($2.37 in chips)
imbAchikko: posts small blind $0.01
Fedorenko26: posts big blind $0.02
*** HOLE CARDS ***
leprekon71: folds
Agustín Suárez: folds
Vishny203: folds
imbAchikko: raises $0.03 to $0.05
Fedorenko26: raises $0.13 to $0.18
imbAchikko: folds
Uncalled bet ($0.13) returned to Fedorenko26
Fedorenko26 collected $0.10 from pot
*** SUMMARY ***
Total pot $0.10 | Rake $0
Seat 2: imbAchikko (small blind) folded before Flop
Seat 3: Fedorenko26 (big blind) collected ($0.10)
Seat 4: leprekon71 folded before Flop (didn't bet)
Seat 5: Agustín Suárez folded before Flop (didn't bet)
Seat 6: Vishny203 (button) folded before Flop (didn't bet)


PokerStars Hand #238171222299:  Hold'em No Limit ($0.01/$0.02 USD) - 2022/08/23 14:04:57 ET
Table 'Despina IV' 6-max Seat #2 is the button
Seat 1: Tina-Elissa ($0.80 in chips)
Seat 2: imbAchikko ($3.64 in chips)
Seat 3: Fedorenko26 ($2.05 in chips)
Seat 4: leprekon71 ($5.28 in chips)
Seat 5: Agustín Suárez ($3.27 in chips)
Seat 6: Vishny203 ($2.37 in chips)
Fedorenko26: posts small blind $0.01
leprekon71: posts big blind $0.02
Tina-Elissa: posts big blind $0.02
*** HOLE CARDS ***
Agustín Suárez: folds
Vishny203: folds
Tina-Elissa: checks
imbAchikko: raises $0.05 to $0.07
Fedorenko26: raises $0.25 to $0.32
leprekon71: folds
Tina-Elissa: folds
imbAchikko: folds
Uncalled bet ($0.25) returned to Fedorenko26
Fedorenko26 collected $0.18 from pot
*** SUMMARY ***
Total pot $0.18 | Rake $0
Seat 1: Tina-Elissa folded before Flop (didn't bet)
Seat 2: imbAchikko (button) folded before Flop
Seat 3: Fedorenko26 (small blind) collected ($0.18)
Seat 4: leprekon71 (big blind) folded before Flop
Seat 5: Agustín Suárez folded before Flop (didn't bet)
Seat 6: Vishny203 folded before Flop (didn't bet)


PokerStars Hand #238171235848:  Hold'em No Limit ($0.01/$0.02 USD) - 2022/08/23 14:05:36 ET
Table 'Despina IV' 6-max Seat #3 is the button
Seat 1: Tina-Elissa ($0.78 in chips)
Seat 2: imbAchikko ($3.57 in chips)
Seat 3: Fedorenko26 ($2.16 in chips)
Seat 4: leprekon71 ($5.26 in chips)
Seat 5: Agustín Suárez ($3.27 in chips)
Seat 6: Vishny203 ($2.37 in chips)
leprekon71: posts small blind $0.01
Agustín Suárez: posts big blind $0.02
*** HOLE CARDS ***
Vishny203: folds
Tina-Elissa: folds
imbAchikko: folds
Fedorenko26: raises $0.04 to $0.06
leprekon71: folds
Agustín Suárez: folds
Uncalled bet ($0.04) returned to Fedorenko26
Fedorenko26 collected $0.05 from pot
*** SUMMARY ***
Total pot $0.05 | Rake $0
Seat 1: Tina-Elissa folded before Flop (didn't bet)
Seat 2: imbAchikko folded before Flop (didn't bet)
Seat 3: Fedorenko26 (button) collected ($0.05)
Seat 4: leprekon71 (small blind) folded before Flop
Seat 5: Agustín Suárez (big blind) folded before Flop
Seat 6: Vishny203 folded before Flop (didn't bet)


PokerStars Hand #238171240298:  Hold'em No Limit ($0.01/$0.02 USD) - 2022/08/23 14:05:49 ET
Table 'Despina IV' 6-max Seat #4 is the button
Seat 1: Tina-Elissa ($0.78 in chips)
Seat 2: imbAchikko ($3.57 in chips)
Seat 3: Fedorenko26 ($2.19 in chips)
Seat 4: leprekon71 ($5.25 in chips)
Seat 5: Agustín Suárez ($3.25 in chips)
Seat 6: Vishny203 ($2.37 in chips)
Agustín Suárez: posts small blind $0.01
Vishny203: posts big blind $0.02
*** HOLE CARDS ***
Tina-Elissa: calls $0.02
imbAchikko: folds
Fedorenko26: folds
leprekon71: folds
Agustín Suárez: folds
Vishny203: checks
*** FLOP *** [7s Th 5s]
Vishny203: checks
Tina-Elissa: bets $0.05
Vishny203: calls $0.05
*** TURN *** [7s Th 5s] [As]
Vishny203: checks
Tina-Elissa: checks
*** RIVER *** [7s Th 5s As] [6c]
Vishny203: checks
Tina-Elissa: checks
*** SHOW DOWN ***
Vishny203: shows [5h 6d] (two pair, Sixes and Fives)
Tina-Elissa: mucks hand
Vishny203 collected $0.14 from pot
*** SUMMARY ***
Total pot $0.15 | Rake $0.01
Board [7s Th 5s As 6c]
Seat 1: Tina-Elissa mucked
Seat 2: imbAchikko folded before Flop (didn't bet)
Seat 3: Fedorenko26 folded before Flop (didn't bet)
Seat 4: leprekon71 (button) folded before Flop (didn't bet)
Seat 5: Agustín Suárez (small blind) folded before Flop
Seat 6: Vishny203 (big blind) showed [5h 6d] and won ($0.14) with two pair, Sixes and Fives


PokerStars Hand #238171253803:  Hold'em No Limit ($0.01/$0.02 USD) - 2022/08/23 14:06:29 ET
Table 'Despina IV' 6-max Seat #5 is the button
Seat 1: Tina-Elissa ($0.71 in chips)
Seat 2: imbAchikko ($3.57 in chips)
Seat 3: Fedorenko26 ($2.19 in chips)
Seat 4: leprekon71 ($5.25 in chips)
Seat 5: Agustín Suárez ($3.24 in chips)
Seat 6: Vishny203 ($2.44 in chips)
Vishny203: posts small blind $0.01
Tina-Elissa: posts big blind $0.02
*** HOLE CARDS ***
imbAchikko: folds
Fedorenko26: folds
leprekon71: folds
Agustín Suárez: folds
Vishny203: folds
Uncalled bet ($0.01) returned to Tina-Elissa
Tina-Elissa collected $0.02 from pot
Tina-Elissa: doesn't show hand
*** SUMMARY ***
Total pot $0.02 | Rake $0
Seat 1: Tina-Elissa (big blind) collected ($0.02)
Seat 2: imbAchikko folded before Flop (didn't bet)
Seat 3: Fedorenko26 folded before Flop (didn't bet)
Seat 4: leprekon71 folded before Flop (didn't bet)
Seat 5: Agustín Suárez (button) folded before Flop (didn't bet)
Seat 6: Vishny203 (small blind) folded before Flop


PokerStars Hand #238171259892:  Hold'em No Limit ($0.01/$0.02 USD) - 2022/08/23 14:06:47 ET
Table 'Despina IV' 6-max Seat #6 is the button
Seat 1: Tina-Elissa ($0.72 in chips)
Seat 2: imbAchikko ($3.57 in chips)
Seat 3: Fedorenko26 ($2.19 in chips)
Seat 4: leprekon71 ($5.25 in chips)
Seat 5: Agustín Suárez ($3.24 in chips)
Seat 6: Vishny203 ($2.43 in chips)
Tina-Elissa: posts small blind $0.01
imbAchikko: posts big blind $0.02
*** HOLE CARDS ***
Fedorenko26: folds
leprekon71: folds
Agustín Suárez: folds
Vishny203: folds
Tina-Elissa: raises $0.04 to $0.06
imbAchikko: calls $0.04
*** FLOP *** [3d Qc Qs]
Tina-Elissa: checks
imbAchikko: checks
*** TURN *** [3d Qc Qs] [Js]
Tina-Elissa: checks
imbAchikko: checks
*** RIVER *** [3d Qc Qs Js] [Ac]
Tina-Elissa: bets $0.08
imbAchikko: folds
Uncalled bet ($0.08) returned to Tina-Elissa
Tina-Elissa collected $0.12 from pot
Tina-Elissa: doesn't show hand
*** SUMMARY ***
Total pot $0.12 | Rake $0
Board [3d Qc Qs Js Ac]
Seat 1: Tina-Elissa (small blind) collected ($0.12)
Seat 2: imbAchikko (big blind) folded on the River
Seat 3: Fedorenko26 folded before Flop (didn't bet)
Seat 4: leprekon71 folded before Flop (didn't bet)
Seat 5: Agustín Suárez folded before Flop (didn't bet)
Seat 6: Vishny203 (button) folded before Flop (didn't bet)


PokerStars Hand #238171270026:  Hold'em No Limit ($0.01/$0.02 USD) - 2022/08/23 14:07:16 ET
Table 'Despina IV' 6-max Seat #1 is the button
Seat 1: Tina-Elissa ($0.78 in chips)
Seat 2: imbAchikko ($3.51 in chips)
Seat 3: Fedorenko26 ($2.19 in chips)
Seat 4: leprekon71 ($5.25 in chips)
Seat 5: Agustín Suárez ($3.24 in chips)
Seat 6: Vishny203 ($2.43 in chips)
imbAchikko: posts small blind $0.01
Fedorenko26: posts big blind $0.02
*** HOLE CARDS ***
leprekon71: folds
Agustín Suárez: folds
Vishny203: folds
Tina-Elissa: folds
imbAchikko: raises $0.03 to $0.05
Fedorenko26: calls $0.03
*** FLOP *** [4h Jh Kh]
imbAchikko: checks
Fedorenko26: bets $0.05
imbAchikko: folds
Uncalled bet ($0.05) returned to Fedorenko26
Fedorenko26 collected $0.10 from pot
*** SUMMARY ***
Total pot $0.10 | Rake $0
Board [4h Jh Kh]
Seat 1: Tina-Elissa (button) folded before Flop (didn't bet)
Seat 2: imbAchikko (small blind) folded on the Flop
Seat 3: Fedorenko26 (big blind) collected ($0.10)
Seat 4: leprekon71 folded before Flop (didn't bet)
Seat 5: Agustín Suárez folded before Flop (didn't bet)
Seat 6: Vishny203 folded before Flop (didn't bet)


PokerStars Hand #238171279808:  Hold'em No Limit ($0.01/$0.02 USD) - 2022/08/23 14:07:45 ET
Table 'Despina IV' 6-max Seat #2 is the button
Seat 1: Tina-Elissa ($0.78 in chips)
Seat 2: imbAchikko ($3.46 in chips)
Seat 3: Fedorenko26 ($2.24 in chips)
Seat 4: leprekon71 ($5.25 in chips)
Seat 5: Agustín Suárez ($3.24 in chips)
Seat 6: Vishny203 ($2.43 in chips)
Fedorenko26: posts small blind $0.01
leprekon71: posts big blind $0.02
*** HOLE CARDS ***
Agustín Suárez: folds
Vishny203: folds
Tina-Elissa: calls $0.02
imbAchikko: folds
Fedorenko26: raises $0.06 to $0.08
leprekon71: folds
Tina-Elissa: calls $0.06
*** FLOP *** [6s 4d 3s]
Fedorenko26: bets $0.17
Tina-Elissa: calls $0.17
*** TURN *** [6s 4d 3s] [5h]
Fedorenko26: checks
Tina-Elissa: bets $0.53 and is all-in
Fedorenko26: folds
Uncalled bet ($0.53) returned to Tina-Elissa
Tina-Elissa collected $0.50 from pot
Tina-Elissa: doesn't show hand
*** SUMMARY ***
Total pot $0.52 | Rake $0.02
Board [6s 4d 3s 5h]
Seat 1: Tina-Elissa collected ($0.50)
Seat 2: imbAchikko (button) folded before Flop (didn't bet)
Seat 3: Fedorenko26 (small blind) folded on the Turn
Seat 4: leprekon71 (big blind) folded before Flop
Seat 5: Agustín Suárez folded before Flop (didn't bet)
Seat 6: Vishny203 folded before Flop (didn't bet)


PokerStars Hand #238171294018:  Hold'em No Limit ($0.01/$0.02 USD) - 2022/08/23 14:08:26 ET
Table 'Despina IV' 6-max Seat #3 is the button
Seat 1: Tina-Elissa ($1.03 in chips)
Seat 2: imbAchikko ($3.46 in chips)
Seat 3: Fedorenko26 ($2 in chips)
Seat 4: leprekon71 ($5.23 in chips)
Seat 5: Agustín Suárez ($3.24 in chips)
Seat 6: Vishny203 ($2.43 in chips)
leprekon71: posts small blind $0.01
Agustín Suárez: posts big blind $0.02
*** HOLE CARDS ***
Vishny203: folds
Tina-Elissa: calls $0.02
imbAchikko: raises $0.03 to $0.05
Fedorenko26: folds
leprekon71: folds
Agustín Suárez: folds
Tina-Elissa: calls $0.03
*** FLOP *** [4s Qd Jc]
Tina-Elissa: checks
imbAchikko: checks
*** TURN *** [4s Qd Jc] [Td]
Tina-Elissa: bets $0.06
imbAchikko: calls $0.06
*** RIVER *** [4s Qd Jc Td] [Js]
Tina-Elissa: bets $0.06
imbAchikko: raises $0.06 to $0.12
Tina-Elissa: calls $0.06
*** SHOW DOWN ***
imbAchikko: shows [Jh Ad] (three of a kind, Jacks)
Tina-Elissa: mucks hand
imbAchikko collected $0.47 from pot
*** SUMMARY ***
Total pot $0.49 | Rake $0.02
Board [4s Qd Jc Td Js]
Seat 1: Tina-Elissa mucked
Seat 2: imbAchikko showed [Jh Ad] and won ($0.47) with three of a kind, Jacks
Seat 3: Fedorenko26 (button) folded before Flop (didn't bet)
Seat 4: leprekon71 (small blind) folded before Flop
Seat 5: Agustín Suárez (big blind) folded before Flop
Seat 6: Vishny203 folded before Flop (didn't bet)


PokerStars Hand #238171308216:  Hold'em No Limit ($0.01/$0.02 USD) - 2022/08/23 14:09:08 ET
Table 'Despina IV' 6-max Seat #4 is the button
Seat 1: Tina-Elissa ($0.80 in chips)
Seat 2: imbAchikko ($3.70 in chips)
Seat 3: Fedorenko26 ($2 in chips)
Seat 4: leprekon71 ($5.22 in chips)
Seat 5: Agustín Suárez ($3.22 in chips)
Seat 6: Vishny203 ($2.43 in chips)
Agustín Suárez: posts small blind $0.01
Vishny203: posts big blind $0.02
*** HOLE CARDS ***
Tina-Elissa: calls $0.02
imbAchikko: raises $0.05 to $0.07
Fedorenko26: folds
leprekon71: folds
Agustín Suárez: folds
Vishny203: folds
Tina-Elissa: calls $0.05
*** FLOP *** [Jc 7h As]
Tina-Elissa: checks
imbAchikko: bets $0.05
Tina-Elissa: folds
Uncalled bet ($0.05) returned to imbAchikko
imbAchikko collected $0.16 from pot
imbAchikko: doesn't show hand
*** SUMMARY ***
Total pot $0.17 | Rake $0.01
Board [Jc 7h As]
Seat 1: Tina-Elissa folded on the Flop
Seat 2: imbAchikko collected ($0.16)
Seat 3: Fedorenko26 folded before Flop (didn't bet)
Seat 4: leprekon71 (button) folded before Flop (didn't bet)
Seat 5: Agustín Suárez (small blind) folded before Flop
Seat 6: Vishny203 (big blind) folded before Flop


PokerStars Hand #238171316695:  Hold'em No Limit ($0.01/$0.02 USD) - 2022/08/23 14:09:33 ET
Table 'Despina IV' 6-max Seat #5 is the button
Seat 1: Tina-Elissa ($0.73 in chips)
Seat 2: imbAchikko ($3.79 in chips)
Seat 3: Fedorenko26 ($2 in chips)
Seat 4: leprekon71 ($5.22 in chips)
Seat 5: Agustín Suárez ($3.21 in chips)
Seat 6: Vishny203 ($2.41 in chips)
Vishny203: posts small blind $0.01
Tina-Elissa: posts big blind $0.02
*** HOLE CARDS ***
imbAchikko: raises $0.03 to $0.05
Fedorenko26: folds
leprekon71: folds
Agustín Suárez: calls $0.05
Vishny203: folds
Tina-Elissa: calls $0.03
*** FLOP *** [2s Jc 5c]
Tina-Elissa: checks
imbAchikko: checks
Agustín Suárez: checks
*** TURN *** [2s Jc 5c] [7d]
Tina-Elissa: checks
imbAchikko: checks
Agustín Suárez: bets $0.05
Tina-Elissa: calls $0.05
imbAchikko: folds
*** RIVER *** [2s Jc 5c 7d] [7h]
Tina-Elissa: checks
Agustín Suárez: checks
*** SHOW DOWN ***
Tina-Elissa: shows [3d 6c] (a pair of Sevens)
Agustín Suárez: shows [Kc Js] (two pair, Jacks and Sevens)
Agustín Suárez collected $0.25 from pot
*** SUMMARY ***
Total pot $0.26 | Rake $0.01
Board [2s Jc 5c 7d 7h]
Seat 1: Tina-Elissa (big blind) showed [3d 6c] and lost with a pair of Sevens
Seat 2: imbAchikko folded on the Turn
Seat 3: Fedorenko26 folded before Flop (didn't bet)
Seat 4: leprekon71 folded before Flop (didn't bet)
Seat 5: Agustín Suárez (button) showed [Kc Js] and won ($0.25) with two pair, Jacks and Sevens
Seat 6: Vishny203 (small blind) folded before Flop


PokerStars Hand #238171340383:  Hold'em No Limit ($0.01/$0.02 USD) - 2022/08/23 14:10:42 ET
Table 'Despina IV' 6-max Seat #6 is the button
Seat 1: Tina-Elissa ($0.63 in chips)
Seat 3: Fedorenko26 ($2 in chips)
Seat 4: leprekon71 ($5.22 in chips)
Seat 5: Agustín Suárez ($3.36 in chips)
Seat 6: Vishny203 ($2.40 in chips)
Tina-Elissa: posts small blind $0.01
imbAchikko: is sitting out
Fedorenko26: posts big blind $0.02
*** HOLE CARDS ***
leprekon71: folds
Agustín Suárez: folds
Vishny203: folds
Tina-Elissa: calls $0.01
Fedorenko26: raises $0.04 to $0.06
Tina-Elissa: calls $0.04
*** FLOP *** [5d Qd 4c]
Tina-Elissa: checks
Fedorenko26: bets $0.06
Tina-Elissa: calls $0.06
*** TURN *** [5d Qd 4c] [Ks]
Tina-Elissa: checks
Fedorenko26: checks
*** RIVER *** [5d Qd 4c Ks] [Kh]
Tina-Elissa: bets $0.15
Fedorenko26: folds
Uncalled bet ($0.15) returned to Tina-Elissa
Tina-Elissa collected $0.23 from pot
Tina-Elissa: doesn't show hand
*** SUMMARY ***
Total pot $0.24 | Rake $0.01
Board [5d Qd 4c Ks Kh]
Seat 1: Tina-Elissa (small blind) collected ($0.23)
Seat 3: Fedorenko26 (big blind) folded on the River
Seat 4: leprekon71 folded before Flop (didn't bet)
Seat 5: Agustín Suárez folded before Flop (didn't bet)
Seat 6: Vishny203 (button) folded before Flop (didn't bet)


PokerStars Hand #238171355482:  Hold'em No Limit ($0.01/$0.02 USD) - 2022/08/23 14:11:25 ET
Table 'Despina IV' 6-max Seat #1 is the button
Seat 1: Tina-Elissa ($0.74 in chips)
Seat 3: Fedorenko26 ($2 in chips)
Seat 4: leprekon71 ($5.22 in chips)
Seat 5: Agustín Suárez ($3.36 in chips)
Seat 6: Vishny203 ($2.40 in chips)
Fedorenko26: posts small blind $0.01
leprekon71: posts big blind $0.02
*** HOLE CARDS ***
Agustín Suárez: folds
Vishny203: folds
Tina-Elissa: folds
Fedorenko26: folds
Uncalled bet ($0.01) returned to leprekon71
leprekon71 collected $0.02 from pot
leprekon71: doesn't show hand
*** SUMMARY ***
Total pot $0.02 | Rake $0
Seat 1: Tina-Elissa (button) folded before Flop (didn't bet)
Seat 3: Fedorenko26 (small blind) folded before Flop
Seat 4: leprekon71 (big blind) collected ($0.02)
Seat 5: Agustín Suárez folded before Flop (didn't bet)
Seat 6: Vishny203 folded before Flop (didn't bet)


PokerStars Hand #238171364525:  Hold'em No Limit ($0.01/$0.02 USD) - 2022/08/23 14:11:52 ET
Table 'Despina IV' 6-max Seat #3 is the button
Seat 1: Tina-Elissa ($0.74 in chips)
Seat 3: Fedorenko26 ($2 in chips)
Seat 4: leprekon71 ($5.23 in chips)
Seat 5: Agustín Suárez ($3.36 in chips)
Seat 6: Vishny203 ($2.40 in chips)
leprekon71: posts small blind $0.01
Agustín Suárez: posts big blind $0.02
*** HOLE CARDS ***
Vishny203: raises $0.04 to $0.06
Tina-Elissa: folds
Fedorenko26: folds
leprekon71: folds
Agustín Suárez: folds
Uncalled bet ($0.04) returned to Vishny203
Vishny203 collected $0.05 from pot
Vishny203: doesn't show hand
*** SUMMARY ***
Total pot $0.05 | Rake $0
Seat 1: Tina-Elissa folded before Flop (didn't bet)
Seat 3: Fedorenko26 (button) folded before Flop (didn't bet)
Seat 4: leprekon71 (small blind) folded before Flop
Seat 5: Agustín Suárez (big blind) folded before Flop
Seat 6: Vishny203 collected ($0.05)


PokerStars Hand #238171373432:  Hold'em No Limit ($0.01/$0.02 USD) - 2022/08/23 14:12:18 ET
Table 'Despina IV' 6-max Seat #4 is the button
Seat 1: Tina-Elissa ($0.74 in chips)
Seat 3: Fedorenko26 ($2 in chips)
Seat 4: leprekon71 ($5.22 in chips)
Seat 5: Agustín Suárez ($3.34 in chips)
Seat 6: Vishny203 ($2.43 in chips)
Agustín Suárez: posts small blind $0.01
Vishny203: posts big blind $0.02
*** HOLE CARDS ***
Tina-Elissa: calls $0.02
Fedorenko26: folds
leprekon71: folds
Agustín Suárez: raises $0.04 to $0.06
Vishny203: folds
Tina-Elissa: calls $0.04
*** FLOP *** [4d As Kh]
Agustín Suárez: checks
Tina-Elissa: checks
*** TURN *** [4d As Kh] [6s]
Agustín Suárez: checks
Tina-Elissa: checks
*** RIVER *** [4d As Kh 6s] [Tc]
Agustín Suárez: bets $0.11
Tina-Elissa: folds
Uncalled bet ($0.11) returned to Agustín Suárez
Agustín Suárez collected $0.14 from pot
Agustín Suárez: doesn't show hand
*** SUMMARY ***
Total pot $0.14 | Rake $0
Board [4d As Kh 6s Tc]
Seat 1: Tina-Elissa folded on the River
Seat 3: Fedorenko26 folded before Flop (didn't bet)
Seat 4: leprekon71 (button) folded before Flop (didn't bet)
Seat 5: Agustín Suárez (small blind) collected ($0.14)
Seat 6: Vishny203 (big blind) folded before Flop


PokerStars Hand #238171382848:  Hold'em No Limit ($0.01/$0.02 USD) - 2022/08/23 14:12:45 ET
Table 'Despina IV' 6-max Seat #5 is the button
Seat 1: Tina-Elissa ($0.68 in chips)
Seat 3: Fedorenko26 ($2 in chips)
Seat 4: leprekon71 ($5.22 in chips)
Seat 5: Agustín Suárez ($3.42 in chips)
Seat 6: Vishny203 ($2.41 in chips)
Vishny203: posts small blind $0.01
Tina-Elissa: posts big blind $0.02
*** HOLE CARDS ***
Fedorenko26: folds
leprekon71: folds
Agustín Suárez: folds
Vishny203: folds
Uncalled bet ($0.01) returned to Tina-Elissa
Tina-Elissa collected $0.02 from pot
Tina-Elissa: doesn't show hand
*** SUMMARY ***
Total pot $0.02 | Rake $0
Seat 1: Tina-Elissa (big blind) collected ($0.02)
Seat 3: Fedorenko26 folded before Flop (didn't bet)
Seat 4: leprekon71 folded before Flop (didn't bet)
Seat 5: Agustín Suárez (button) folded before Flop (didn't bet)
Seat 6: Vishny203 (small blind) folded before Flop


PokerStars Hand #238171385908:  Hold'em No Limit ($0.01/$0.02 USD) - 2022/08/23 14:12:54 ET
Table 'Despina IV' 6-max Seat #6 is the button
Seat 1: Tina-Elissa ($0.69 in chips)
Seat 3: Fedorenko26 ($2 in chips)
Seat 4: leprekon71 ($5.22 in chips)
Seat 5: Agustín Suárez ($3.42 in chips)
Seat 6: Vishny203 ($2.40 in chips)
Tina-Elissa: posts small blind $0.01
Fedorenko26: posts big blind $0.02
*** HOLE CARDS ***
leprekon71: raises $0.02 to $0.04
Agustín Suárez: folds
Vishny203: folds
Tina-Elissa: raises $0.02 to $0.06
Fedorenko26: calls $0.04
leprekon71: calls $0.02
*** FLOP *** [Jh 2c 5h]
Tina-Elissa: bets $0.08
Fedorenko26: folds
leprekon71: calls $0.08
*** TURN *** [Jh 2c 5h] [6c]
Tina-Elissa: bets $0.16
leprekon71: folds
Uncalled bet ($0.16) returned to Tina-Elissa
Tina-Elissa collected $0.33 from pot
Tina-Elissa: doesn't show hand
*** SUMMARY ***
Total pot $0.34 | Rake $0.01
Board [Jh 2c 5h 6c]
Seat 1: Tina-Elissa (small blind) collected ($0.33)
Seat 3: Fedorenko26 (big blind) folded on the Flop
Seat 4: leprekon71 folded on the Turn
Seat 5: Agustín Suárez folded before Flop (didn't bet)
Seat 6: Vishny203 (button) folded before Flop (didn't bet)


PokerStars Hand #238171395586:  Hold'em No Limit ($0.01/$0.02 USD) - 2022/08/23 14:13:22 ET
Table 'Despina IV' 6-max Seat #1 is the button
Seat 1: Tina-Elissa ($0.88 in chips)
Seat 3: Fedorenko26 ($2 in chips)
Seat 4: leprekon71 ($5.08 in chips)
Seat 5: Agustín Suárez ($3.42 in chips)
Seat 6: Vishny203 ($2.40 in chips)
Fedorenko26: posts small blind $0.01
leprekon71: posts big blind $0.02
*** HOLE CARDS ***
Agustín Suárez: folds
Vishny203: raises $0.04 to $0.06
Tina-Elissa: folds
Fedorenko26: raises $0.14 to $0.20
leprekon71: folds
Vishny203: folds
Uncalled bet ($0.14) returned to Fedorenko26
Fedorenko26 collected $0.14 from pot
*** SUMMARY ***
Total pot $0.14 | Rake $0
Seat 1: Tina-Elissa (button) folded before Flop (didn't bet)
Seat 3: Fedorenko26 (small blind) collected ($0.14)
Seat 4: leprekon71 (big blind) folded before Flop
Seat 5: Agustín Suárez folded before Flop (didn't bet)
Seat 6: Vishny203 folded before Flop


PokerStars Hand #238171406227:  Hold'em No Limit ($0.01/$0.02 USD) - 2022/08/23 14:13:53 ET
Table 'Despina IV' 6-max Seat #3 is the button
Seat 1: Tina-Elissa ($0.88 in chips)
Seat 3: Fedorenko26 ($2.08 in chips)
Seat 4: leprekon71 ($5.06 in chips)
Seat 5: Agustín Suárez ($3.42 in chips)
Seat 6: Vishny203 ($2.34 in chips)
leprekon71: posts small blind $0.01
Agustín Suárez: posts big blind $0.02
*** HOLE CARDS ***
Vishny203: folds
Tina-Elissa: calls $0.02
Fedorenko26: raises $0.06 to $0.08
leprekon71: folds
Agustín Suárez: folds
Tina-Elissa: calls $0.06
*** FLOP *** [Ah 5h Ts]
Tina-Elissa: checks
Fedorenko26: bets $0.18
Tina-Elissa: folds
Uncalled bet ($0.18) returned to Fedorenko26
Fedorenko26 collected $0.18 from pot
*** SUMMARY ***
Total pot $0.19 | Rake $0.01
Board [Ah 5h Ts]
Seat 1: Tina-Elissa folded on the Flop
Seat 3: Fedorenko26 (button) collected ($0.18)
Seat 4: leprekon71 (small blind) folded before Flop
Seat 5: Agustín Suárez (big blind) folded before Flop
Seat 6: Vishny203 folded before Flop (didn't bet)


PokerStars Hand #238171413310:  Hold'em No Limit ($0.01/$0.02 USD) - 2022/08/23 14:14:13 ET
Table 'Despina IV' 6-max Seat #4 is the button
Seat 1: Tina-Elissa ($0.80 in chips)
Seat 3: Fedorenko26 ($2.18 in chips)
Seat 4: leprekon71 ($5.05 in chips)
Seat 5: Agustín Suárez ($3.40 in chips)
Seat 6: Vishny203 ($2.34 in chips)
Agustín Suárez: posts small blind $0.01
Vishny203: posts big blind $0.02
*** HOLE CARDS ***
Tina-Elissa: raises $0.02 to $0.04
Fedorenko26: folds
leprekon71: folds
Agustín Suárez: folds
Vishny203: calls $0.02
*** FLOP *** [Td 5s 6s]
Vishny203: checks
Tina-Elissa: bets $0.09
Vishny203: calls $0.09
*** TURN *** [Td 5s 6s] [2s]
Vishny203: checks
Tina-Elissa: checks
*** RIVER *** [Td 5s 6s 2s] [6d]
Vishny203: checks
Tina-Elissa: bets $0.26
Vishny203: calls $0.26
*** SHOW DOWN ***
Tina-Elissa: shows [Kh Ad] (a pair of Sixes)
Vishny203: shows [Js 8s] (a flush, Jack high)
Vishny203 collected $0.76 from pot
*** SUMMARY ***
Total pot $0.79 | Rake $0.03
Board [Td 5s 6s 2s 6d]
Seat 1: Tina-Elissa showed [Kh Ad] and lost with a pair of Sixes
Seat 3: Fedorenko26 folded before Flop (didn't bet)
Seat 4: leprekon71 (button) folded before Flop (didn't bet)
Seat 5: Agustín Suárez (small blind) folded before Flop
Seat 6: Vishny203 (big blind) showed [Js 8s] and won ($0.76) with a flush, Jack high


PokerStars Hand #238171427342:  Hold'em No Limit ($0.01/$0.02 USD) - 2022/08/23 14:14:54 ET
Table 'Despina IV' 6-max Seat #5 is the button
Seat 1: Tina-Elissa ($0.41 in chips)
Seat 3: Fedorenko26 ($2.18 in chips)
Seat 4: leprekon71 ($5.05 in chips)
Seat 5: Agustín Suárez ($3.39 in chips)
Seat 6: Vishny203 ($2.71 in chips)
Vishny203: posts small blind $0.01
Tina-Elissa: posts big blind $0.02
imbAchikko: sits out
*** HOLE CARDS ***
Fedorenko26: folds
leprekon71: folds
Agustín Suárez: folds
Vishny203: folds
Uncalled bet ($0.01) returned to Tina-Elissa
Tina-Elissa collected $0.02 from pot
Tina-Elissa: doesn't show hand
*** SUMMARY ***
Total pot $0.02 | Rake $0
Seat 1: Tina-Elissa (big blind) collected ($0.02)
Seat 3: Fedorenko26 folded before Flop (didn't bet)
Seat 4: leprekon71 folded before Flop (didn't bet)
Seat 5: Agustín Suárez (button) folded before Flop (didn't bet)
Seat 6: Vishny203 (small blind) folded before Flop


PokerStars Hand #238171430192:  Hold'em No Limit ($0.01/$0.02 USD) - 2022/08/23 14:15:02 ET
Table 'Despina IV' 6-max Seat #6 is the button
Seat 1: Tina-Elissa ($0.42 in chips)
Seat 2: imbAchikko ($3.74 in chips)
Seat 3: Fedorenko26 ($2.18 in chips)
Seat 4: leprekon71 ($5.05 in chips)
Seat 5: Agustín Suárez ($3.39 in chips)
Seat 6: Vishny203 ($2.70 in chips)
Tina-Elissa: posts small blind $0.01
imbAchikko: posts big blind $0.02
*** HOLE CARDS ***
Fedorenko26: raises $0.04 to $0.06
leprekon71: folds
Agustín Suárez: folds
Vishny203: folds
Tina-Elissa: folds
imbAchikko: folds
Uncalled bet ($0.04) returned to Fedorenko26
Fedorenko26 collected $0.05 from pot
*** SUMMARY ***
Total pot $0.05 | Rake $0
Seat 1: Tina-Elissa (small blind) folded before Flop
Seat 2: imbAchikko (big blind) folded before Flop
Seat 3: Fedorenko26 collected ($0.05)
Seat 4: leprekon71 folded before Flop (didn't bet)
Seat 5: Agustín Suárez folded before Flop (didn't bet)
Seat 6: Vishny203 (button) folded before Flop (didn't bet)


PokerStars Hand #238171437823:  Hold'em No Limit ($0.01/$0.02 USD) - 2022/08/23 14:15:23 ET
Table 'Despina IV' 6-max Seat #1 is the button
Seat 1: Tina-Elissa ($0.41 in chips)
Seat 2: imbAchikko ($3.72 in chips)
Seat 3: Fedorenko26 ($2.21 in chips)
Seat 4: leprekon71 ($5.05 in chips)
Seat 5: Agustín Suárez ($3.39 in chips)
Seat 6: Vishny203 ($2.70 in chips)
imbAchikko: posts small blind $0.01
Fedorenko26: posts big blind $0.02
*** HOLE CARDS ***
leprekon71: folds
Agustín Suárez: folds
Vishny203: folds
Tina-Elissa: folds
imbAchikko: folds
Uncalled bet ($0.01) returned to Fedorenko26
Fedorenko26 collected $0.02 from pot
*** SUMMARY ***
Total pot $0.02 | Rake $0
Seat 1: Tina-Elissa (button) folded before Flop (didn't bet)
Seat 2: imbAchikko (small blind) folded before Flop
Seat 3: Fedorenko26 (big blind) collected ($0.02)
Seat 4: leprekon71 folded before Flop (didn't bet)
Seat 5: Agustín Suárez folded before Flop (didn't bet)
Seat 6: Vishny203 folded before Flop (didn't bet)


PokerStars Hand #238171442541:  Hold'em No Limit ($0.01/$0.02 USD) - 2022/08/23 14:15:37 ET
Table 'Despina IV' 6-max Seat #2 is the button
Seat 1: Tina-Elissa ($0.41 in chips)
Seat 2: imbAchikko ($3.71 in chips)
Seat 3: Fedorenko26 ($2.22 in chips)
Seat 4: leprekon71 ($5.05 in chips)
Seat 5: Agustín Suárez ($3.39 in chips)
Seat 6: Vishny203 ($2.70 in chips)
Fedorenko26: posts small blind $0.01
leprekon71: posts big blind $0.02
*** HOLE CARDS ***
Agustín Suárez: raises $0.04 to $0.06
Vishny203: folds
Tina-Elissa: calls $0.06
imbAchikko: folds
Fedorenko26: folds
leprekon71: folds
*** FLOP *** [5s Qs Kh]
Agustín Suárez: bets $0.05
Tina-Elissa: folds
Uncalled bet ($0.05) returned to Agustín Suárez
Agustín Suárez collected $0.14 from pot
Agustín Suárez: doesn't show hand
*** SUMMARY ***
Total pot $0.15 | Rake $0.01
Board [5s Qs Kh]
Seat 1: Tina-Elissa folded on the Flop
Seat 2: imbAchikko (button) folded before Flop (didn't bet)
Seat 3: Fedorenko26 (small blind) folded before Flop
Seat 4: leprekon71 (big blind) folded before Flop
Seat 5: Agustín Suárez collected ($0.14)
Seat 6: Vishny203 folded before Flop (didn't bet)


PokerStars Hand #238171450586:  Hold'em No Limit ($0.01/$0.02 USD) - 2022/08/23 14:16:00 ET
Table 'Despina IV' 6-max Seat #3 is the button
Seat 1: Tina-Elissa ($0.35 in chips)
Seat 2: imbAchikko ($3.71 in chips)
Seat 3: Fedorenko26 ($2.21 in chips)
Seat 4: leprekon71 ($5.03 in chips)
Seat 5: Agustín Suárez ($3.47 in chips)
Seat 6: Vishny203 ($2.70 in chips)
leprekon71: posts small blind $0.01
Agustín Suárez: posts big blind $0.02
*** HOLE CARDS ***
Vishny203: folds
Tina-Elissa: raises $0.07 to $0.09
imbAchikko: folds
Fedorenko26: folds
leprekon71: folds
Agustín Suárez: folds
Uncalled bet ($0.07) returned to Tina-Elissa
Tina-Elissa collected $0.05 from pot
Tina-Elissa: doesn't show hand
*** SUMMARY ***
Total pot $0.05 | Rake $0
Seat 1: Tina-Elissa collected ($0.05)
Seat 2: imbAchikko folded before Flop (didn't bet)
Seat 3: Fedorenko26 (button) folded before Flop (didn't bet)
Seat 4: leprekon71 (small blind) folded before Flop
Seat 5: Agustín Suárez (big blind) folded before Flop
Seat 6: Vishny203 folded before Flop (didn't bet)


PokerStars Hand #238171462421:  Hold'em No Limit ($0.01/$0.02 USD) - 2022/08/23 14:16:34 ET
Table 'Despina IV' 6-max Seat #4 is the button
Seat 1: Tina-Elissa ($0.38 in chips)
Seat 2: imbAchikko ($3.71 in chips)
Seat 3: Fedorenko26 ($2.21 in chips)
Seat 4: leprekon71 ($5.02 in chips)
Seat 5: Agustín Suárez ($3.45 in chips)
Seat 6: Vishny203 ($2.70 in chips)
Agustín Suárez: posts small blind $0.01
Vishny203: posts big blind $0.02
*** HOLE CARDS ***
Tina-Elissa: raises $0.05 to $0.07
imbAchikko: raises $0.32 to $0.39
Fedorenko26: folds
leprekon71: folds
Agustín Suárez: folds
Vishny203: folds
Tina-Elissa: folds
Uncalled bet ($0.32) returned to imbAchikko
imbAchikko collected $0.17 from pot
imbAchikko: doesn't show hand
*** SUMMARY ***
Total pot $0.17 | Rake $0
Seat 1: Tina-Elissa folded before Flop
Seat 2: imbAchikko collected ($0.17)
Seat 3: Fedorenko26 folded before Flop (didn't bet)
Seat 4: leprekon71 (button) folded before Flop (didn't bet)
Seat 5: Agustín Suárez (small blind) folded before Flop
Seat 6: Vishny203 (big blind) folded before Flop


PokerStars Hand #238171473259:  Hold'em No Limit ($0.01/$0.02 USD) - 2022/08/23 14:17:05 ET
Table 'Despina IV' 6-max Seat #5 is the button
Seat 1: Tina-Elissa ($0.31 in chips)
Seat 2: imbAchikko ($3.81 in chips)
Seat 3: Fedorenko26 ($2.21 in chips)
Seat 4: leprekon71 ($5.02 in chips)
Seat 5: Agustín Suárez ($3.44 in chips)
Seat 6: Vishny203 ($2.68 in chips)
Vishny203: posts small blind $0.01
Tina-Elissa: posts big blind $0.02
*** HOLE CARDS ***
imbAchikko: raises $0.03 to $0.05
Fedorenko26: folds
leprekon71: folds
Agustín Suárez: raises $0.13 to $0.18
Vishny203: folds
Tina-Elissa: folds
imbAchikko: folds
Uncalled bet ($0.13) returned to Agustín Suárez
Agustín Suárez collected $0.13 from pot
Agustín Suárez: doesn't show hand
*** SUMMARY ***
Total pot $0.13 | Rake $0
Seat 1: Tina-Elissa (big blind) folded before Flop
Seat 2: imbAchikko folded before Flop
Seat 3: Fedorenko26 folded before Flop (didn't bet)
Seat 4: leprekon71 folded before Flop (didn't bet)
Seat 5: Agustín Suárez (button) collected ($0.13)
Seat 6: Vishny203 (small blind) folded before Flop


PokerStars Hand #238171482602:  Hold'em No Limit ($0.01/$0.02 USD) - 2022/08/23 14:17:32 ET
Table 'Despina IV' 6-max Seat #6 is the button
Seat 1: Tina-Elissa ($0.29 in chips)
Seat 2: imbAchikko ($3.76 in chips)
Seat 3: Fedorenko26 ($2.21 in chips)
Seat 4: leprekon71 ($5.02 in chips)
Seat 5: Agustín Suárez ($3.52 in chips)
Seat 6: Vishny203 ($2.67 in chips)
Tina-Elissa: posts small blind $0.01
imbAchikko: posts big blind $0.02
*** HOLE CARDS ***
Fedorenko26: folds
leprekon71: raises $0.02 to $0.04
Agustín Suárez: folds
Vishny203: folds
Tina-Elissa: folds
imbAchikko: calls $0.02
*** FLOP *** [3c Jc Ks]
Agustín Suárez leaves the table
imbAchikko: checks
leprekon71: checks
*** TURN *** [3c Jc Ks] [2h]
imbAchikko: checks
leprekon71: bets $0.02
imbAchikko: folds
Uncalled bet ($0.02) returned to leprekon71
leprekon71 collected $0.09 from pot
leprekon71: doesn't show hand
*** SUMMARY ***
Total pot $0.09 | Rake $0
Board [3c Jc Ks 2h]
Seat 1: Tina-Elissa (small blind) folded before Flop
Seat 2: imbAchikko (big blind) folded on the Turn
Seat 3: Fedorenko26 folded before Flop (didn't bet)
Seat 4: leprekon71 collected ($0.09)
Seat 5: Agustín Suárez folded before Flop (didn't bet)
Seat 6: Vishny203 (button) folded before Flop (didn't bet)


PokerStars Hand #238171491903:  Hold'em No Limit ($0.01/$0.02 USD) - 2022/08/23 14:17:59 ET
Table 'Despina IV' 6-max Seat #1 is the button
Seat 1: Tina-Elissa ($0.28 in chips)
Seat 2: imbAchikko ($3.72 in chips)
Seat 3: Fedorenko26 ($2.21 in chips)
Seat 4: leprekon71 ($5.07 in chips)
Seat 6: Vishny203 ($2.67 in chips)
imbAchikko: posts small blind $0.01
Fedorenko26: posts big blind $0.02
*** HOLE CARDS ***
leprekon71: folds
Vishny203: folds
Tina-Elissa: calls $0.02
imbAchikko: calls $0.01
Fedorenko26: checks
*** FLOP *** [Ad Kd Qs]
SEN196 joins the table at seat #5
SEN196 is disconnected
imbAchikko: checks
Fedorenko26: checks
Tina-Elissa: checks
*** TURN *** [Ad Kd Qs] [Kh]
imbAchikko: checks
Fedorenko26: checks
Tina-Elissa: checks
*** RIVER *** [Ad Kd Qs Kh] [4d]
imbAchikko: checks
Fedorenko26: checks
Tina-Elissa: checks
*** SHOW DOWN ***
imbAchikko: shows [2h 7h] (a pair of Kings)
Fedorenko26: mucks hand
Tina-Elissa: shows [7c Jh] (a pair of Kings - Ace+Queen+Jack kicker)
Tina-Elissa collected $0.06 from pot
*** SUMMARY ***
Total pot $0.06 | Rake $0
Board [Ad Kd Qs Kh 4d]
Seat 1: Tina-Elissa (button) showed [7c Jh] and won ($0.06) with a pair of Kings
Seat 2: imbAchikko (small blind) showed [2h 7h] and lost with a pair of Kings
Seat 3: Fedorenko26 (big blind) mucked
Seat 4: leprekon71 folded before Flop (didn't bet)
Seat 6: Vishny203 folded before Flop (didn't bet)


PokerStars Hand #238171511037:  Hold'em No Limit ($0.01/$0.02 USD) - 2022/08/23 14:18:54 ET
Table 'Despina IV' 6-max Seat #2 is the button
Seat 1: Tina-Elissa ($0.32 in chips)
Seat 2: imbAchikko ($3.70 in chips)
Seat 3: Fedorenko26 ($2.19 in chips)
Seat 4: leprekon71 ($5.07 in chips)
Seat 6: Vishny203 ($2.67 in chips)
Fedorenko26: posts small blind $0.01
leprekon71: posts big blind $0.02
SEN196: sits out
*** HOLE CARDS ***
Vishny203: folds
Tina-Elissa: calls $0.02
imbAchikko: raises $0.05 to $0.07
Fedorenko26: folds
leprekon71: folds
Tina-Elissa: calls $0.05
*** FLOP *** [6c Tc 7d]
Tina-Elissa: bets $0.25 and is all-in
imbAchikko: calls $0.25
*** TURN *** [6c Tc 7d] [Ts]
*** RIVER *** [6c Tc 7d Ts] [2c]
*** SHOW DOWN ***
Tina-Elissa: shows [Jc Td] (three of a kind, Tens)
imbAchikko: shows [6h 7h] (two pair, Tens and Sevens)
Tina-Elissa collected $0.65 from pot
*** SUMMARY ***
Total pot $0.67 | Rake $0.02
Board [6c Tc 7d Ts 2c]
Seat 1: Tina-Elissa showed [Jc Td] and won ($0.65) with three of a kind, Tens
Seat 2: imbAchikko (button) showed [6h 7h] and lost with two pair, Tens and Sevens
Seat 3: Fedorenko26 (small blind) folded before Flop
Seat 4: leprekon71 (big blind) folded before Flop
Seat 6: Vishny203 folded before Flop (didn't bet)


PokerStars Hand #238171522784:  Hold'em No Limit ($0.01/$0.02 USD) - 2022/08/23 14:19:28 ET
Table 'Despina IV' 6-max Seat #3 is the button
Seat 1: Tina-Elissa ($0.65 in chips)
Seat 2: imbAchikko ($3.38 in chips)
Seat 3: Fedorenko26 ($2.18 in chips)
Seat 4: leprekon71 ($5.05 in chips)
Seat 5: SEN196 ($1 in chips)
Seat 6: Vishny203 ($2.67 in chips)
leprekon71: posts small blind $0.01
SEN196: posts big blind $0.02
*** HOLE CARDS ***
Vishny203: raises $0.04 to $0.06
Tina-Elissa: folds
imbAchikko: folds
Fedorenko26: folds
leprekon71: folds
SEN196: folds
Uncalled bet ($0.04) returned to Vishny203
Vishny203 collected $0.05 from pot
Vishny203: doesn't show hand
*** SUMMARY ***
Total pot $0.05 | Rake $0
Seat 1: Tina-Elissa folded before Flop (didn't bet)
Seat 2: imbAchikko folded before Flop (didn't bet)
Seat 3: Fedorenko26 (button) folded before Flop (didn't bet)
Seat 4: leprekon71 (small blind) folded before Flop
Seat 5: SEN196 (big blind) folded before Flop
Seat 6: Vishny203 collected ($0.05)


PokerStars Hand #238171528488:  Hold'em No Limit ($0.01/$0.02 USD) - 2022/08/23 14:19:44 ET
Table 'Despina IV' 6-max Seat #4 is the button
Seat 1: Tina-Elissa ($0.65 in chips)
Seat 2: imbAchikko ($3.38 in chips)
Seat 3: Fedorenko26 ($2.18 in chips)
Seat 4: leprekon71 ($5.04 in chips)
Seat 5: SEN196 ($0.98 in chips)
Seat 6: Vishny203 ($2.70 in chips)
SEN196: posts small blind $0.01
Vishny203: posts big blind $0.02
*** HOLE CARDS ***
Tina-Elissa: calls $0.02
imbAchikko: folds
Fedorenko26: folds
leprekon71: raises $0.07 to $0.09
SEN196: folds
Vishny203: folds
Tina-Elissa: calls $0.07
*** FLOP *** [Qd 8d Ah]
Tina-Elissa: checks
leprekon71: bets $0.15
Tina-Elissa: folds
Uncalled bet ($0.15) returned to leprekon71
leprekon71 collected $0.20 from pot
leprekon71: doesn't show hand
*** SUMMARY ***
Total pot $0.21 | Rake $0.01
Board [Qd 8d Ah]
Seat 1: Tina-Elissa folded on the Flop
Seat 2: imbAchikko folded before Flop (didn't bet)
Seat 3: Fedorenko26 folded before Flop (didn't bet)
Seat 4: leprekon71 (button) collected ($0.20)
Seat 5: SEN196 (small blind) folded before Flop
Seat 6: Vishny203 (big blind) folded before Flop


PokerStars Hand #238171536711:  Hold'em No Limit ($0.01/$0.02 USD) - 2022/08/23 14:20:07 ET
Table 'Despina IV' 6-max Seat #5 is the button
Seat 1: Tina-Elissa ($0.56 in chips)
Seat 2: imbAchikko ($3.38 in chips)
Seat 3: Fedorenko26 ($2.18 in chips)
Seat 4: leprekon71 ($5.15 in chips)
Seat 5: SEN196 ($0.97 in chips)
Seat 6: Vishny203 ($2.68 in chips)
Vishny203: posts small blind $0.01
Tina-Elissa: posts big blind $0.02
*** HOLE CARDS ***
imbAchikko: raises $0.03 to $0.05
Fedorenko26: folds
leprekon71: calls $0.05
SEN196: folds
Vishny203: folds
Tina-Elissa: calls $0.03
*** FLOP *** [Tc Kc 8h]
Tina-Elissa: checks
imbAchikko: bets $0.08
leprekon71: folds
Tina-Elissa: folds
Uncalled bet ($0.08) returned to imbAchikko
imbAchikko collected $0.15 from pot
imbAchikko: doesn't show hand
*** SUMMARY ***
Total pot $0.16 | Rake $0.01
Board [Tc Kc 8h]
Seat 1: Tina-Elissa (big blind) folded on the Flop
Seat 2: imbAchikko collected ($0.15)
Seat 3: Fedorenko26 folded before Flop (didn't bet)
Seat 4: leprekon71 folded on the Flop
Seat 5: SEN196 (button) folded before Flop (didn't bet)
Seat 6: Vishny203 (small blind) folded before Flop


PokerStars Hand #238171544834:  Hold'em No Limit ($0.01/$0.02 USD) - 2022/08/23 14:20:30 ET
Table 'Despina IV' 6-max Seat #6 is the button
Seat 1: Tina-Elissa ($0.51 in chips)
Seat 2: imbAchikko ($3.48 in chips)
Seat 3: Fedorenko26 ($2.18 in chips)
Seat 4: leprekon71 ($5.10 in chips)
Seat 5: SEN196 ($0.97 in chips)
Seat 6: Vishny203 ($2.67 in chips)
Tina-Elissa: posts small blind $0.01
imbAchikko: posts big blind $0.02
*** HOLE CARDS ***
Fedorenko26: folds
leprekon71: folds
SEN196: folds
Vishny203: folds
Tina-Elissa: calls $0.01
imbAchikko: checks
*** FLOP *** [9s Ah 5c]
Tina-Elissa: bets $0.02
imbAchikko: folds
Uncalled bet ($0.02) returned to Tina-Elissa
Tina-Elissa collected $0.04 from pot
Tina-Elissa: doesn't show hand
*** SUMMARY ***
Total pot $0.04 | Rake $0
Board [9s Ah 5c]
Seat 1: Tina-Elissa (small blind) collected ($0.04)
Seat 2: imbAchikko (big blind) folded on the Flop
Seat 3: Fedorenko26 folded before Flop (didn't bet)
Seat 4: leprekon71 folded before Flop (didn't bet)
Seat 5: SEN196 folded before Flop (didn't bet)
Seat 6: Vishny203 (button) folded before Flop (didn't bet)


PokerStars Hand #238171552971:  Hold'em No Limit ($0.01/$0.02 USD) - 2022/08/23 14:20:54 ET
Table 'Despina IV' 6-max Seat #1 is the button
Seat 1: Tina-Elissa ($0.53 in chips)
Seat 2: imbAchikko ($3.46 in chips)
Seat 3: Fedorenko26 ($2.18 in chips)
Seat 4: leprekon71 ($5.10 in chips)
Seat 5: SEN196 ($0.97 in chips)
Seat 6: Vishny203 ($2.67 in chips)
imbAchikko: posts small blind $0.01
Fedorenko26: posts big blind $0.02
*** HOLE CARDS ***
leprekon71: folds
SEN196: folds
Vishny203: folds
Tina-Elissa: calls $0.02
imbAchikko: calls $0.01
Fedorenko26: checks
*** FLOP *** [2c 6s 8d]
imbAchikko: checks
Fedorenko26: bets $0.03
Tina-Elissa: folds
imbAchikko: calls $0.03
*** TURN *** [2c 6s 8d] [Ah]
imbAchikko: checks
Fedorenko26: checks
*** RIVER *** [2c 6s 8d Ah] [3h]
imbAchikko: checks
Fedorenko26: checks
*** SHOW DOWN ***
imbAchikko: shows [4c 4d] (a pair of Fours)
Fedorenko26: mucks hand
imbAchikko collected $0.12 from pot
*** SUMMARY ***
Total pot $0.12 | Rake $0
Board [2c 6s 8d Ah 3h]
Seat 1: Tina-Elissa (button) folded on the Flop
Seat 2: imbAchikko (small blind) showed [4c 4d] and won ($0.12) with a pair of Fours
Seat 3: Fedorenko26 (big blind) mucked
Seat 4: leprekon71 folded before Flop (didn't bet)
Seat 5: SEN196 folded before Flop (didn't bet)
Seat 6: Vishny203 folded before Flop (didn't bet)


PokerStars Hand #238171576988:  Hold'em No Limit ($0.01/$0.02 USD) - 2022/08/23 14:22:02 ET
Table 'Despina IV' 6-max Seat #2 is the button
Seat 1: Tina-Elissa ($0.51 in chips)
Seat 2: imbAchikko ($3.53 in chips)
Seat 3: Fedorenko26 ($2.13 in chips)
Seat 4: leprekon71 ($5.10 in chips)
Seat 5: SEN196 ($0.97 in chips)
Seat 6: Vishny203 ($2.67 in chips)
Fedorenko26: posts small blind $0.01
leprekon71: posts big blind $0.02
*** HOLE CARDS ***
SEN196: calls $0.02
Vishny203: folds
Tina-Elissa: calls $0.02
imbAchikko: folds
Fedorenko26: raises $0.08 to $0.10
leprekon71: folds
SEN196: folds
Tina-Elissa: calls $0.08
*** FLOP *** [5d Jd 7h]
Fedorenko26: checks
Tina-Elissa: checks
*** TURN *** [5d Jd 7h] [4h]
Fedorenko26: bets $0.11
Tina-Elissa: calls $0.11
*** RIVER *** [5d Jd 7h 4h] [8c]
Fedorenko26: checks
Tina-Elissa: bets $0.30 and is all-in
Fedorenko26: folds
Uncalled bet ($0.30) returned to Tina-Elissa
Tina-Elissa collected $0.44 from pot
Tina-Elissa: doesn't show hand
*** SUMMARY ***
Total pot $0.46 | Rake $0.02
Board [5d Jd 7h 4h 8c]
Seat 1: Tina-Elissa collected ($0.44)
Seat 2: imbAchikko (button) folded before Flop (didn't bet)
Seat 3: Fedorenko26 (small blind) folded on the River
Seat 4: leprekon71 (big blind) folded before Flop
Seat 5: SEN196 folded before Flop
Seat 6: Vishny203 folded before Flop (didn't bet)


PokerStars Hand #238171592153:  Hold'em No Limit ($0.01/$0.02 USD) - 2022/08/23 14:22:45 ET
Table 'Despina IV' 6-max Seat #3 is the button
Seat 1: Tina-Elissa ($0.74 in chips)
Seat 2: imbAchikko ($3.53 in chips)
Seat 3: Fedorenko26 ($2 in chips)
Seat 4: leprekon71 ($5.08 in chips)
Seat 5: SEN196 ($0.95 in chips)
Seat 6: Vishny203 ($2.67 in chips)
leprekon71: posts small blind $0.01
SEN196: posts big blind $0.02
*** HOLE CARDS ***
Vishny203: folds
Tina-Elissa: calls $0.02
imbAchikko: raises $0.05 to $0.07
Fedorenko26: folds
leprekon71: folds
SEN196: calls $0.05
Tina-Elissa: calls $0.05
*** FLOP *** [3s 2s 8s]
SEN196: bets $0.88 and is all-in
Tina-Elissa: calls $0.67 and is all-in
imbAchikko: folds
Uncalled bet ($0.21) returned to SEN196
*** TURN *** [3s 2s 8s] [5d]
*** RIVER *** [3s 2s 8s 5d] [8h]
*** SHOW DOWN ***
SEN196: shows [Td Ks] (a pair of Eights)
Tina-Elissa: shows [4h As] (a straight, Ace to Five)
Tina-Elissa collected $1.51 from pot
*** SUMMARY ***
Total pot $1.56 | Rake $0.05
Board [3s 2s 8s 5d 8h]
Seat 1: Tina-Elissa showed [4h As] and won ($1.51) with a straight, Ace to Five
Seat 2: imbAchikko folded on the Flop
Seat 3: Fedorenko26 (button) folded before Flop (didn't bet)
Seat 4: leprekon71 (small blind) folded before Flop
Seat 5: SEN196 (big blind) showed [Td Ks] and lost with a pair of Eights
Seat 6: Vishny203 folded before Flop (didn't bet)


PokerStars Hand #238171604090:  Hold'em No Limit ($0.01/$0.02 USD) - 2022/08/23 14:23:19 ET
Table 'Despina IV' 6-max Seat #4 is the button
Seat 1: Tina-Elissa ($1.51 in chips)
Seat 2: imbAchikko ($3.46 in chips)
Seat 3: Fedorenko26 ($2 in chips)
Seat 4: leprekon71 ($5.07 in chips)
Seat 5: SEN196 ($0.21 in chips)
Seat 6: Vishny203 ($2.67 in chips)
SEN196: posts small blind $0.01
Vishny203: posts big blind $0.02
*** HOLE CARDS ***
Tina-Elissa: folds
imbAchikko: folds
Fedorenko26: folds
leprekon71: folds
SEN196: calls $0.01
Vishny203: checks
*** FLOP *** [7d 6h 7c]
SEN196: checks
Vishny203: checks
*** TURN *** [7d 6h 7c] [Jc]
SEN196: checks
Vishny203: checks
*** RIVER *** [7d 6h 7c Jc] [Qc]
SEN196: bets $0.19 and is all-in
Vishny203: folds
Uncalled bet ($0.19) returned to SEN196
SEN196 collected $0.04 from pot
*** SUMMARY ***
Total pot $0.04 | Rake $0
Board [7d 6h 7c Jc Qc]
Seat 1: Tina-Elissa folded before Flop (didn't bet)
Seat 2: imbAchikko folded before Flop (didn't bet)
Seat 3: Fedorenko26 folded before Flop (didn't bet)
Seat 4: leprekon71 (button) folded before Flop (didn't bet)
Seat 5: SEN196 (small blind) collected ($0.04)
Seat 6: Vishny203 (big blind) folded on the River


PokerStars Hand #238171614990:  Hold'em No Limit ($0.01/$0.02 USD) - 2022/08/23 14:23:50 ET
Table 'Despina IV' 6-max Seat #5 is the button
Seat 1: Tina-Elissa ($1.51 in chips)
Seat 2: imbAchikko ($3.46 in chips)
Seat 3: Fedorenko26 ($2 in chips)
Seat 4: leprekon71 ($5.07 in chips)
Seat 5: SEN196 ($0.23 in chips)
Seat 6: Vishny203 ($2.65 in chips)
Vishny203: posts small blind $0.01
Tina-Elissa: posts big blind $0.02
*** HOLE CARDS ***
imbAchikko: folds
Fedorenko26: folds
leprekon71: folds
SEN196: raises $0.21 to $0.23 and is all-in
Vishny203: folds
Tina-Elissa: folds
Uncalled bet ($0.21) returned to SEN196
SEN196 collected $0.05 from pot
*** SUMMARY ***
Total pot $0.05 | Rake $0
Seat 1: Tina-Elissa (big blind) folded before Flop
Seat 2: imbAchikko folded before Flop (didn't bet)
Seat 3: Fedorenko26 folded before Flop (didn't bet)
Seat 4: leprekon71 folded before Flop (didn't bet)
Seat 5: SEN196 (button) collected ($0.05)
Seat 6: Vishny203 (small blind) folded before Flop


PokerStars Hand #238171619602:  Hold'em No Limit ($0.01/$0.02 USD) - 2022/08/23 14:24:03 ET
Table 'Despina IV' 6-max Seat #6 is the button
Seat 1: Tina-Elissa ($1.49 in chips)
Seat 2: imbAchikko ($3.46 in chips)
Seat 3: Fedorenko26 ($2 in chips)
Seat 4: leprekon71 ($5.07 in chips)
Seat 5: SEN196 ($0.26 in chips)
Seat 6: Vishny203 ($2.64 in chips)
Tina-Elissa: posts small blind $0.01
imbAchikko: posts big blind $0.02
*** HOLE CARDS ***
Fedorenko26: folds
leprekon71: folds
SEN196: folds
Vishny203: raises $0.04 to $0.06
Tina-Elissa: calls $0.05
imbAchikko: folds
*** FLOP *** [3d 4c Qd]
Tina-Elissa: checks
Vishny203: bets $0.09
Tina-Elissa: folds
Uncalled bet ($0.09) returned to Vishny203
Vishny203 collected $0.14 from pot
Vishny203: doesn't show hand
*** SUMMARY ***
Total pot $0.14 | Rake $0
Board [3d 4c Qd]
Seat 1: Tina-Elissa (small blind) folded on the Flop
Seat 2: imbAchikko (big blind) folded before Flop
Seat 3: Fedorenko26 folded before Flop (didn't bet)
Seat 4: leprekon71 folded before Flop (didn't bet)
Seat 5: SEN196 folded before Flop (didn't bet)
Seat 6: Vishny203 (button) collected ($0.14)


PokerStars Hand #238171631532:  Hold'em No Limit ($0.01/$0.02 USD) - 2022/08/23 14:24:37 ET
Table 'Despina IV' 6-max Seat #1 is the button
Seat 1: Tina-Elissa ($1.43 in chips)
Seat 2: imbAchikko ($3.44 in chips)
Seat 3: Fedorenko26 ($2 in chips)
Seat 4: leprekon71 ($5.07 in chips)
Seat 5: SEN196 ($0.26 in chips)
Seat 6: Vishny203 ($2.72 in chips)
imbAchikko: posts small blind $0.01
Fedorenko26: posts big blind $0.02
*** HOLE CARDS ***
leprekon71: folds
SEN196: folds
Vishny203: raises $0.04 to $0.06
Tina-Elissa: folds
imbAchikko: folds
Fedorenko26: folds
Uncalled bet ($0.04) returned to Vishny203
Vishny203 collected $0.05 from pot
Vishny203: doesn't show hand
*** SUMMARY ***
Total pot $0.05 | Rake $0
Seat 1: Tina-Elissa (button) folded before Flop (didn't bet)
Seat 2: imbAchikko (small blind) folded before Flop
Seat 3: Fedorenko26 (big blind) folded before Flop
Seat 4: leprekon71 folded before Flop (didn't bet)
Seat 5: SEN196 folded before Flop (didn't bet)
Seat 6: Vishny203 collected ($0.05)


PokerStars Hand #238171642849:  Hold'em No Limit ($0.01/$0.02 USD) - 2022/08/23 14:25:09 ET
Table 'Despina IV' 6-max Seat #2 is the button
Seat 1: Tina-Elissa ($1.43 in chips)
Seat 2: imbAchikko ($3.43 in chips)
Seat 3: Fedorenko26 ($2 in chips)
Seat 4: leprekon71 ($5.07 in chips)
Seat 5: SEN196 ($0.26 in chips)
Seat 6: Vishny203 ($2.75 in chips)
Fedorenko26: posts small blind $0.01
leprekon71: posts big blind $0.02
*** HOLE CARDS ***
SEN196: folds
Vishny203 has timed out
Vishny203: folds
Tina-Elissa: calls $0.02
imbAchikko: folds
Fedorenko26: folds
leprekon71: checks
*** FLOP *** [Jd 7d 9d]
leprekon71: checks
Tina-Elissa: bets $0.02
leprekon71: calls $0.02
*** TURN *** [Jd 7d 9d] [7h]
leprekon71: checks
Tina-Elissa: bets $0.04
leprekon71: calls $0.04
*** RIVER *** [Jd 7d 9d 7h] [2d]
leprekon71: checks
Tina-Elissa: bets $0.04
leprekon71: folds
Uncalled bet ($0.04) returned to Tina-Elissa
Tina-Elissa collected $0.16 from pot
Tina-Elissa: doesn't show hand
*** SUMMARY ***
Total pot $0.17 | Rake $0.01
Board [Jd 7d 9d 7h 2d]
Seat 1: Tina-Elissa collected ($0.16)
Seat 2: imbAchikko (button) folded before Flop (didn't bet)
Seat 3: Fedorenko26 (small blind) folded before Flop
Seat 4: leprekon71 (big blind) folded on the River
Seat 5: SEN196 folded before Flop (didn't bet)
Seat 6: Vishny203 folded before Flop (didn't bet)


PokerStars Hand #238171655976:  Hold'em No Limit ($0.01/$0.02 USD) - 2022/08/23 14:25:46 ET
Table 'Despina IV' 6-max Seat #3 is the button
Seat 1: Tina-Elissa ($1.51 in chips)
Seat 2: imbAchikko ($3.43 in chips)
Seat 3: Fedorenko26 ($2 in chips)
Seat 4: leprekon71 ($4.99 in chips)
Seat 5: SEN196 ($0.26 in chips)
Seat 6: Vishny203 ($2.75 in chips)
leprekon71: posts small blind $0.01
SEN196: posts big blind $0.02
*** HOLE CARDS ***
Vishny203: folds
Tina-Elissa: folds
imbAchikko: raises $0.03 to $0.05
Fedorenko26: raises $0.13 to $0.18
leprekon71: folds
SEN196: folds
imbAchikko: calls $0.13
*** FLOP *** [4h 3s 5s]
imbAchikko: checks
Fedorenko26: bets $0.19
imbAchikko: raises $3.06 to $3.25 and is all-in
Fedorenko26: folds
Uncalled bet ($3.06) returned to imbAchikko
imbAchikko collected $0.74 from pot
imbAchikko: doesn't show hand
*** SUMMARY ***
Total pot $0.77 | Rake $0.03
Board [4h 3s 5s]
Seat 1: Tina-Elissa folded before Flop (didn't bet)
Seat 2: imbAchikko collected ($0.74)
Seat 3: Fedorenko26 (button) folded on the Flop
Seat 4: leprekon71 (small blind) folded before Flop
Seat 5: SEN196 (big blind) folded before Flop
Seat 6: Vishny203 folded before Flop (didn't bet)


PokerStars Hand #238171677749:  Hold'em No Limit ($0.01/$0.02 USD) - 2022/08/23 14:26:48 ET
Table 'Despina IV' 6-max Seat #4 is the button
Seat 1: Tina-Elissa ($1.51 in chips)
Seat 2: imbAchikko ($3.80 in chips)
Seat 3: Fedorenko26 ($2 in chips)
Seat 4: leprekon71 ($4.98 in chips)
Seat 5: SEN196 ($0.24 in chips)
Seat 6: Vishny203 ($2.75 in chips)
SEN196: posts small blind $0.01
Vishny203: posts big blind $0.02
*** HOLE CARDS ***
Tina-Elissa: calls $0.02
imbAchikko: folds
Fedorenko26: folds
leprekon71: folds
SEN196: calls $0.01
Vishny203: checks
*** FLOP *** [5d 6d Js]
SEN196: checks
Vishny203: checks
Tina-Elissa: bets $0.03
SEN196: folds
Vishny203: folds
Uncalled bet ($0.03) returned to Tina-Elissa
Tina-Elissa collected $0.06 from pot
Tina-Elissa: doesn't show hand
*** SUMMARY ***
Total pot $0.06 | Rake $0
Board [5d 6d Js]
Seat 1: Tina-Elissa collected ($0.06)
Seat 2: imbAchikko folded before Flop (didn't bet)
Seat 3: Fedorenko26 folded before Flop (didn't bet)
Seat 4: leprekon71 (button) folded before Flop (didn't bet)
Seat 5: SEN196 (small blind) folded on the Flop
Seat 6: Vishny203 (big blind) folded on the Flop


PokerStars Hand #238171685387:  Hold'em No Limit ($0.01/$0.02 USD) - 2022/08/23 14:27:10 ET
Table 'Despina IV' 6-max Seat #5 is the button
Seat 1: Tina-Elissa ($1.55 in chips)
Seat 2: imbAchikko ($3.80 in chips)
Seat 3: Fedorenko26 ($2 in chips)
Seat 4: leprekon71 ($4.98 in chips)
Seat 5: SEN196 ($0.22 in chips)
Seat 6: Vishny203 ($2.73 in chips)
Vishny203: posts small blind $0.01
Tina-Elissa: posts big blind $0.02
*** HOLE CARDS ***
imbAchikko: folds
Fedorenko26: raises $0.04 to $0.06
leprekon71: folds
SEN196: folds
Vishny203: folds
Tina-Elissa: calls $0.04
*** FLOP *** [6s 3s Ts]
Tina-Elissa: checks
Fedorenko26: bets $0.06
Tina-Elissa: folds
Uncalled bet ($0.06) returned to Fedorenko26
Fedorenko26 collected $0.13 from pot
*** SUMMARY ***
Total pot $0.13 | Rake $0
Board [6s 3s Ts]
Seat 1: Tina-Elissa (big blind) folded on the Flop
Seat 2: imbAchikko folded before Flop (didn't bet)
Seat 3: Fedorenko26 collected ($0.13)
Seat 4: leprekon71 folded before Flop (didn't bet)
Seat 5: SEN196 (button) folded before Flop (didn't bet)
Seat 6: Vishny203 (small blind) folded before Flop


PokerStars Hand #238171692891:  Hold'em No Limit ($0.01/$0.02 USD) - 2022/08/23 14:27:31 ET
Table 'Despina IV' 6-max Seat #6 is the button
Seat 1: Tina-Elissa ($1.49 in chips)
Seat 2: imbAchikko ($3.80 in chips)
Seat 3: Fedorenko26 ($2.07 in chips)
Seat 4: leprekon71 ($4.98 in chips)
Seat 5: SEN196 ($0.22 in chips)
Seat 6: Vishny203 ($2.72 in chips)
Tina-Elissa: posts small blind $0.01
imbAchikko: posts big blind $0.02
*** HOLE CARDS ***
Fedorenko26: raises $0.04 to $0.06
leprekon71: folds
SEN196: folds
Vishny203: folds
Tina-Elissa: calls $0.05
imbAchikko: calls $0.04
*** FLOP *** [6d Ad 5h]
Tina-Elissa: checks
imbAchikko: checks
Fedorenko26: bets $0.16
Tina-Elissa: folds
imbAchikko: folds
Uncalled bet ($0.16) returned to Fedorenko26
Fedorenko26 collected $0.17 from pot
*** SUMMARY ***
Total pot $0.18 | Rake $0.01
Board [6d Ad 5h]
Seat 1: Tina-Elissa (small blind) folded on the Flop
Seat 2: imbAchikko (big blind) folded on the Flop
Seat 3: Fedorenko26 collected ($0.17)
Seat 4: leprekon71 folded before Flop (didn't bet)
Seat 5: SEN196 folded before Flop (didn't bet)
Seat 6: Vishny203 (button) folded before Flop (didn't bet)


PokerStars Hand #238171701875:  Hold'em No Limit ($0.01/$0.02 USD) - 2022/08/23 14:27:57 ET
Table 'Despina IV' 6-max Seat #1 is the button
Seat 1: Tina-Elissa ($1.43 in chips)
Seat 2: imbAchikko ($3.74 in chips)
Seat 3: Fedorenko26 ($2.18 in chips)
Seat 4: leprekon71 ($4.98 in chips)
Seat 5: SEN196 ($0.22 in chips)
Seat 6: Vishny203 ($2.72 in chips)
imbAchikko: posts small blind $0.01
Fedorenko26: posts big blind $0.02
*** HOLE CARDS ***
leprekon71: raises $0.02 to $0.04
SEN196: folds
Vishny203: folds
Tina-Elissa: calls $0.04
imbAchikko: raises $0.14 to $0.18
Fedorenko26: folds
leprekon71: folds
Tina-Elissa: calls $0.14
*** FLOP *** [6h 4s 3d]
imbAchikko: checks
Tina-Elissa: checks
*** TURN *** [6h 4s 3d] [5h]
imbAchikko: bets $0.12
Tina-Elissa: calls $0.12
*** RIVER *** [6h 4s 3d 5h] [Ks]
imbAchikko: checks
Tina-Elissa: checks
*** SHOW DOWN ***
imbAchikko: shows [9s 9h] (a pair of Nines)
Tina-Elissa: mucks hand
imbAchikko collected $0.64 from pot
*** SUMMARY ***
Total pot $0.66 | Rake $0.02
Board [6h 4s 3d 5h Ks]
Seat 1: Tina-Elissa (button) mucked
Seat 2: imbAchikko (small blind) showed [9s 9h] and won ($0.64) with a pair of Nines
Seat 3: Fedorenko26 (big blind) folded before Flop
Seat 4: leprekon71 folded before Flop
Seat 5: SEN196 folded before Flop (didn't bet)
Seat 6: Vishny203 folded before Flop (didn't bet)


PokerStars Hand #238171716547:  Hold'em No Limit ($0.01/$0.02 USD) - 2022/08/23 14:28:39 ET
Table 'Despina IV' 6-max Seat #2 is the button
Seat 1: Tina-Elissa ($1.13 in chips)
Seat 2: imbAchikko ($4.08 in chips)
Seat 3: Fedorenko26 ($2.16 in chips)
Seat 4: leprekon71 ($4.94 in chips)
Seat 5: SEN196 ($0.22 in chips)
Seat 6: Vishny203 ($2.72 in chips)
Fedorenko26: posts small blind $0.01
leprekon71: posts big blind $0.02
*** HOLE CARDS ***
SEN196: folds
Vishny203: folds
Tina-Elissa: raises $0.04 to $0.06
imbAchikko: folds
Fedorenko26: folds
leprekon71: folds
Uncalled bet ($0.04) returned to Tina-Elissa
Tina-Elissa collected $0.05 from pot
Tina-Elissa: doesn't show hand
*** SUMMARY ***
Total pot $0.05 | Rake $0
Seat 1: Tina-Elissa collected ($0.05)
Seat 2: imbAchikko (button) folded before Flop (didn't bet)
Seat 3: Fedorenko26 (small blind) folded before Flop
Seat 4: leprekon71 (big blind) folded before Flop
Seat 5: SEN196 folded before Flop (didn't bet)
Seat 6: Vishny203 folded before Flop (didn't bet)


PokerStars Hand #238171730535:  Hold'em No Limit ($0.01/$0.02 USD) - 2022/08/23 14:29:20 ET
Table 'Despina IV' 6-max Seat #3 is the button
Seat 1: Tina-Elissa ($1.16 in chips)
Seat 2: imbAchikko ($4.08 in chips)
Seat 3: Fedorenko26 ($2.15 in chips)
Seat 4: leprekon71 ($4.92 in chips)
Seat 5: SEN196 ($0.22 in chips)
Seat 6: Vishny203 ($2.72 in chips)
leprekon71: posts small blind $0.01
SEN196: posts big blind $0.02
*** HOLE CARDS ***
Vishny203: folds
Tina-Elissa: folds
imbAchikko: raises $0.03 to $0.05
Fedorenko26: folds
leprekon71: folds
SEN196: calls $0.03
*** FLOP *** [5c 5d As]
SEN196: checks
imbAchikko: checks
*** TURN *** [5c 5d As] [Js]
SEN196: checks
imbAchikko: bets $0.06
SEN196: folds
Uncalled bet ($0.06) returned to imbAchikko
imbAchikko collected $0.11 from pot
imbAchikko: doesn't show hand
*** SUMMARY ***
Total pot $0.11 | Rake $0
Board [5c 5d As Js]
Seat 1: Tina-Elissa folded before Flop (didn't bet)
Seat 2: imbAchikko collected ($0.11)
Seat 3: Fedorenko26 (button) folded before Flop (didn't bet)
Seat 4: leprekon71 (small blind) folded before Flop
Seat 5: SEN196 (big blind) folded on the Turn
Seat 6: Vishny203 folded before Flop (didn't bet)


PokerStars Hand #238171739754:  Hold'em No Limit ($0.01/$0.02 USD) - 2022/08/23 14:29:47 ET
Table 'Despina IV' 6-max Seat #4 is the button
Seat 1: Tina-Elissa ($1.16 in chips)
Seat 2: imbAchikko ($4.14 in chips)
Seat 3: Fedorenko26 ($2.15 in chips)
Seat 4: leprekon71 ($4.91 in chips)
Seat 5: SEN196 ($0.17 in chips)
Seat 6: Vishny203 ($2.72 in chips)
SEN196: posts small blind $0.01
Vishny203: posts big blind $0.02
*** HOLE CARDS ***
Tina-Elissa: raises $0.04 to $0.06
imbAchikko: folds
Fedorenko26: folds
leprekon71: folds
SEN196: folds
Vishny203: folds
Uncalled bet ($0.04) returned to Tina-Elissa
Tina-Elissa collected $0.05 from pot
Tina-Elissa: doesn't show hand
*** SUMMARY ***
Total pot $0.05 | Rake $0
Seat 1: Tina-Elissa collected ($0.05)
Seat 2: imbAchikko folded before Flop (didn't bet)
Seat 3: Fedorenko26 folded before Flop (didn't bet)
Seat 4: leprekon71 (button) folded before Flop (didn't bet)
Seat 5: SEN196 (small blind) folded before Flop
Seat 6: Vishny203 (big blind) folded before Flop


PokerStars Hand #238171744816:  Hold'em No Limit ($0.01/$0.02 USD) - 2022/08/23 14:30:01 ET
Table 'Despina IV' 6-max Seat #5 is the button
Seat 1: Tina-Elissa ($1.19 in chips)
Seat 2: imbAchikko ($4.14 in chips)
Seat 3: Fedorenko26 ($2.15 in chips)
Seat 4: leprekon71 ($4.91 in chips)
Seat 5: SEN196 ($0.16 in chips)
Seat 6: Vishny203 ($2.70 in chips)
Vishny203: posts small blind $0.01
Tina-Elissa: posts big blind $0.02
*** HOLE CARDS ***
imbAchikko: folds
Fedorenko26: folds
leprekon71: raises $0.02 to $0.04
SEN196: raises $0.12 to $0.16 and is all-in
Vishny203: folds
Tina-Elissa: folds
leprekon71: folds
Uncalled bet ($0.12) returned to SEN196
SEN196 collected $0.11 from pot
*** SUMMARY ***
Total pot $0.11 | Rake $0
Seat 1: Tina-Elissa (big blind) folded before Flop
Seat 2: imbAchikko folded before Flop (didn't bet)
Seat 3: Fedorenko26 folded before Flop (didn't bet)
Seat 4: leprekon71 folded before Flop
Seat 5: SEN196 (button) collected ($0.11)
Seat 6: Vishny203 (small blind) folded before Flop


PokerStars Hand #238171750685:  Hold'em No Limit ($0.01/$0.02 USD) - 2022/08/23 14:30:17 ET
Table 'Despina IV' 6-max Seat #6 is the button
Seat 1: Tina-Elissa ($1.17 in chips)
Seat 2: imbAchikko ($4.14 in chips)
Seat 3: Fedorenko26 ($2.15 in chips)
Seat 4: leprekon71 ($4.87 in chips)
Seat 5: SEN196 ($0.23 in chips)
Seat 6: Vishny203 ($2.69 in chips)
Tina-Elissa: posts small blind $0.01
imbAchikko: posts big blind $0.02
*** HOLE CARDS ***
Fedorenko26: folds
leprekon71: folds
SEN196: folds
Vishny203: raises $0.04 to $0.06
Tina-Elissa: calls $0.05
imbAchikko: folds
*** FLOP *** [3c Js 5s]
Tina-Elissa: checks
Vishny203: bets $0.09
Tina-Elissa: folds
Uncalled bet ($0.09) returned to Vishny203
Vishny203 collected $0.14 from pot
Vishny203: doesn't show hand
*** SUMMARY ***
Total pot $0.14 | Rake $0
Board [3c Js 5s]
Seat 1: Tina-Elissa (small blind) folded on the Flop
Seat 2: imbAchikko (big blind) folded before Flop
Seat 3: Fedorenko26 folded before Flop (didn't bet)
Seat 4: leprekon71 folded before Flop (didn't bet)
Seat 5: SEN196 folded before Flop (didn't bet)
Seat 6: Vishny203 (button) collected ($0.14)


PokerStars Hand #238171760549:  Hold'em No Limit ($0.01/$0.02 USD) - 2022/08/23 14:30:46 ET
Table 'Despina IV' 6-max Seat #1 is the button
Seat 1: Tina-Elissa ($1.11 in chips)
Seat 2: imbAchikko ($4.12 in chips)
Seat 3: Fedorenko26 ($2.15 in chips)
Seat 4: leprekon71 ($4.87 in chips)
Seat 5: SEN196 ($0.23 in chips)
Seat 6: Vishny203 ($2.77 in chips)
imbAchikko: posts small blind $0.01
Fedorenko26: posts big blind $0.02
*** HOLE CARDS ***
leprekon71: folds
SEN196: folds
Vishny203: folds
Tina-Elissa: raises $0.04 to $0.06
imbAchikko: folds
Fedorenko26: folds
Uncalled bet ($0.04) returned to Tina-Elissa
Tina-Elissa collected $0.05 from pot
Tina-Elissa: doesn't show hand
*** SUMMARY ***
Total pot $0.05 | Rake $0
Seat 1: Tina-Elissa (button) collected ($0.05)
Seat 2: imbAchikko (small blind) folded before Flop
Seat 3: Fedorenko26 (big blind) folded before Flop
Seat 4: leprekon71 folded before Flop (didn't bet)
Seat 5: SEN196 folded before Flop (didn't bet)
Seat 6: Vishny203 folded before Flop (didn't bet)


PokerStars Hand #238171765517:  Hold'em No Limit ($0.01/$0.02 USD) - 2022/08/23 14:31:00 ET
Table 'Despina IV' 6-max Seat #2 is the button
Seat 1: Tina-Elissa ($1.14 in chips)
Seat 2: imbAchikko ($4.11 in chips)
Seat 3: Fedorenko26 ($2.13 in chips)
Seat 4: leprekon71 ($4.87 in chips)
Seat 5: SEN196 ($0.23 in chips)
Seat 6: Vishny203 ($2.77 in chips)
Fedorenko26: posts small blind $0.01
leprekon71: posts big blind $0.02
*** HOLE CARDS ***
SEN196: folds
Vishny203: folds
Tina-Elissa: raises $0.02 to $0.04
imbAchikko: folds
Fedorenko26: folds
leprekon71: folds
Uncalled bet ($0.02) returned to Tina-Elissa
Tina-Elissa collected $0.05 from pot
Tina-Elissa: doesn't show hand
*** SUMMARY ***
Total pot $0.05 | Rake $0
Seat 1: Tina-Elissa collected ($0.05)
Seat 2: imbAchikko (button) folded before Flop (didn't bet)
Seat 3: Fedorenko26 (small blind) folded before Flop
Seat 4: leprekon71 (big blind) folded before Flop
Seat 5: SEN196 folded before Flop (didn't bet)
Seat 6: Vishny203 folded before Flop (didn't bet)


PokerStars Hand #238171774183:  Hold'em No Limit ($0.01/$0.02 USD) - 2022/08/23 14:31:25 ET
Table 'Despina IV' 6-max Seat #3 is the button
Seat 1: Tina-Elissa ($1.17 in chips)
Seat 2: imbAchikko ($4.11 in chips)
Seat 3: Fedorenko26 ($2.12 in chips)
Seat 4: leprekon71 ($4.85 in chips)
Seat 5: SEN196 ($0.23 in chips)
Seat 6: Vishny203 ($2.77 in chips)
leprekon71: posts small blind $0.01
SEN196: posts big blind $0.02
*** HOLE CARDS ***
Vishny203: folds
Tina-Elissa: folds
imbAchikko: folds
Fedorenko26: folds
leprekon71: folds
Uncalled bet ($0.01) returned to SEN196
SEN196 collected $0.02 from pot
*** SUMMARY ***
Total pot $0.02 | Rake $0
Seat 1: Tina-Elissa folded before Flop (didn't bet)
Seat 2: imbAchikko folded before Flop (didn't bet)
Seat 3: Fedorenko26 (button) folded before Flop (didn't bet)
Seat 4: leprekon71 (small blind) folded before Flop
Seat 5: SEN196 (big blind) collected ($0.02)
Seat 6: Vishny203 folded before Flop (didn't bet)


PokerStars Hand #238171779305:  Hold'em No Limit ($0.01/$0.02 USD) - 2022/08/23 14:31:39 ET
Table 'Despina IV' 6-max Seat #4 is the button
Seat 1: Tina-Elissa ($1.17 in chips)
Seat 2: imbAchikko ($4.11 in chips)
Seat 3: Fedorenko26 ($2.12 in chips)
Seat 4: leprekon71 ($4.84 in chips)
Seat 5: SEN196 ($0.24 in chips)
Seat 6: Vishny203 ($2.77 in chips)
SEN196: posts small blind $0.01
Vishny203: posts big blind $0.02
*** HOLE CARDS ***
Tina-Elissa: folds
imbAchikko: folds
Fedorenko26: folds
leprekon71: folds
SEN196: raises $0.22 to $0.24 and is all-in
Vishny203: folds
Uncalled bet ($0.22) returned to SEN196
SEN196 collected $0.04 from pot
*** SUMMARY ***
Total pot $0.04 | Rake $0
Seat 1: Tina-Elissa folded before Flop (didn't bet)
Seat 2: imbAchikko folded before Flop (didn't bet)
Seat 3: Fedorenko26 folded before Flop (didn't bet)
Seat 4: leprekon71 (button) folded before Flop (didn't bet)
Seat 5: SEN196 (small blind) collected ($0.04)
Seat 6: Vishny203 (big blind) folded before Flop


PokerStars Hand #238171783801:  Hold'em No Limit ($0.01/$0.02 USD) - 2022/08/23 14:31:52 ET
Table 'Despina IV' 6-max Seat #5 is the button
Seat 1: Tina-Elissa ($1.17 in chips)
Seat 2: imbAchikko ($4.11 in chips)
Seat 3: Fedorenko26 ($2.12 in chips)
Seat 4: leprekon71 ($4.84 in chips)
Seat 5: SEN196 ($0.26 in chips)
Seat 6: Vishny203 ($2.75 in chips)
Vishny203: posts small blind $0.01
Tina-Elissa: posts big blind $0.02
*** HOLE CARDS ***
imbAchikko: folds
Fedorenko26: folds
leprekon71: folds
SEN196: raises $0.24 to $0.26 and is all-in
Vishny203: folds
Tina-Elissa: folds
Uncalled bet ($0.24) returned to SEN196
SEN196 collected $0.05 from pot
*** SUMMARY ***
Total pot $0.05 | Rake $0
Seat 1: Tina-Elissa (big blind) folded before Flop
Seat 2: imbAchikko folded before Flop (didn't bet)
Seat 3: Fedorenko26 folded before Flop (didn't bet)
Seat 4: leprekon71 folded before Flop (didn't bet)
Seat 5: SEN196 (button) collected ($0.05)
Seat 6: Vishny203 (small blind) folded before Flop


PokerStars Hand #238171790663:  Hold'em No Limit ($0.01/$0.02 USD) - 2022/08/23 14:32:11 ET
Table 'Despina IV' 6-max Seat #6 is the button
Seat 1: Tina-Elissa ($1.15 in chips)
Seat 2: imbAchikko ($4.11 in chips)
Seat 3: Fedorenko26 ($2.12 in chips)
Seat 4: leprekon71 ($4.84 in chips)
Seat 5: SEN196 ($0.29 in chips)
Seat 6: Vishny203 ($2.74 in chips)
Tina-Elissa: posts small blind $0.01
imbAchikko: posts big blind $0.02
*** HOLE CARDS ***
Fedorenko26: folds
leprekon71: folds
SEN196: raises $0.27 to $0.29 and is all-in
Vishny203: calls $0.29
Tina-Elissa: folds
imbAchikko: folds
*** FLOP *** [3s Th 8h]
*** TURN *** [3s Th 8h] [Kd]
*** RIVER *** [3s Th 8h Kd] [Jc]
*** SHOW DOWN ***
SEN196: shows [Ac 5d] (high card Ace)
Vishny203: shows [Qh Ah] (a straight, Ten to Ace)
Vishny203 collected $0.59 from pot
*** SUMMARY ***
Total pot $0.61 | Rake $0.02
Board [3s Th 8h Kd Jc]
Seat 1: Tina-Elissa (small blind) folded before Flop
Seat 2: imbAchikko (big blind) folded before Flop
Seat 3: Fedorenko26 folded before Flop (didn't bet)
Seat 4: leprekon71 folded before Flop (didn't bet)
Seat 5: SEN196 showed [Ac 5d] and lost with high card Ace
Seat 6: Vishny203 (button) showed [Qh Ah] and won ($0.59) with a straight, Ten to Ace


PokerStars Hand #238171810378:  Hold'em No Limit ($0.01/$0.02 USD) - 2022/08/23 14:32:44 ET
Table 'Despina IV' 6-max Seat #1 is the button
Seat 1: Tina-Elissa ($1.14 in chips)
Seat 2: imbAchikko ($4.09 in chips)
Seat 3: Fedorenko26 ($2.12 in chips)
Seat 4: leprekon71 ($4.84 in chips)
Seat 6: Vishny203 ($3.04 in chips)
imbAchikko: posts small blind $0.01
Fedorenko26: posts big blind $0.02
*** HOLE CARDS ***
leprekon71: folds
Vishny203: raises $0.04 to $0.06
SEN196 leaves the table
Tina-Elissa: calls $0.06
imbAchikko: folds
Fedorenko26: calls $0.04
*** FLOP *** [5c Qh Ac]
Fedorenko26: checks
Vishny203: bets $0.09
Tina-Elissa: calls $0.09
SeijuroAk joins the table at seat #5
Fedorenko26: raises $0.21 to $0.30
Vishny203: folds
Tina-Elissa: folds
Uncalled bet ($0.21) returned to Fedorenko26
Fedorenko26 collected $0.44 from pot
*** SUMMARY ***
Total pot $0.46 | Rake $0.02
Board [5c Qh Ac]
Seat 1: Tina-Elissa (button) folded on the Flop
Seat 2: imbAchikko (small blind) folded before Flop
Seat 3: Fedorenko26 (big blind) collected ($0.44)
Seat 4: leprekon71 folded before Flop (didn't bet)
Seat 6: Vishny203 folded on the Flop


PokerStars Hand #238171831127:  Hold'em No Limit ($0.01/$0.02 USD) - 2022/08/23 14:33:16 ET
Table 'Despina IV' 6-max Seat #3 is the button
Seat 1: Tina-Elissa ($0.99 in chips)
Seat 3: Fedorenko26 ($2.41 in chips)
Seat 4: leprekon71 ($4.84 in chips)
Seat 5: SeijuroAk ($2 in chips)
Seat 6: Vishny203 ($2.89 in chips)
leprekon71: posts small blind $0.01
SeijuroAk: posts big blind $0.02
*** HOLE CARDS ***
Vishny203: folds
Tina-Elissa: raises $0.05 to $0.07
imbAchikko leaves the table
Fedorenko26: raises $0.17 to $0.24
leprekon71: folds
SeijuroAk: folds
Tina-Elissa: calls $0.17
*** FLOP *** [Js Qs 5h]
Tina-Elissa: checks
Fedorenko26: bets $0.24
Tina-Elissa: folds
Uncalled bet ($0.24) returned to Fedorenko26
Fedorenko26 collected $0.49 from pot
*** SUMMARY ***
Total pot $0.51 | Rake $0.02
Board [Js Qs 5h]
Seat 1: Tina-Elissa folded on the Flop
Seat 3: Fedorenko26 (button) collected ($0.49)
Seat 4: leprekon71 (small blind) folded before Flop
Seat 5: SeijuroAk (big blind) folded before Flop
Seat 6: Vishny203 folded before Flop (didn't bet)


PokerStars Hand #238171842963:  Hold'em No Limit ($0.01/$0.02 USD) - 2022/08/23 14:33:50 ET
Table 'Despina IV' 6-max Seat #4 is the button
Seat 1: Tina-Elissa ($0.75 in chips)
Seat 3: Fedorenko26 ($2.66 in chips)
Seat 4: leprekon71 ($4.83 in chips)
Seat 5: SeijuroAk ($2 in chips)
Seat 6: Vishny203 ($2.89 in chips)
SeijuroAk: posts small blind $0.01
Vishny203: posts big blind $0.02
*** HOLE CARDS ***
Tina-Elissa: raises $0.07 to $0.09
Fedorenko26: raises $0.21 to $0.30
leprekon71: folds
SeijuroAk: folds
Vishny203: folds
Tina-Elissa: calls $0.21
*** FLOP *** [5s 2c Kh]
Tina-Elissa: checks
Fedorenko26: checks
*** TURN *** [5s 2c Kh] [Ac]
Tina-Elissa: checks
Fedorenko26: bets $0.46
Tina-Elissa: folds
Uncalled bet ($0.46) returned to Fedorenko26
Fedorenko26 collected $0.61 from pot
*** SUMMARY ***
Total pot $0.63 | Rake $0.02
Board [5s 2c Kh Ac]
Seat 1: Tina-Elissa folded on the Turn
Seat 3: Fedorenko26 collected ($0.61)
Seat 4: leprekon71 (button) folded before Flop (didn't bet)
Seat 5: SeijuroAk (small blind) folded before Flop
Seat 6: Vishny203 (big blind) folded before Flop


PokerStars Hand #238171859913:  Hold'em No Limit ($0.01/$0.02 USD) - 2022/08/23 14:34:39 ET
Table 'Despina IV' 6-max Seat #5 is the button
Seat 1: Tina-Elissa ($0.45 in chips)
Seat 3: Fedorenko26 ($2.97 in chips)
Seat 4: leprekon71 ($4.83 in chips)
Seat 5: SeijuroAk ($2 in chips)
Seat 6: Vishny203 ($2.87 in chips)
Vishny203: posts small blind $0.01
Tina-Elissa: posts big blind $0.02
*** HOLE CARDS ***
Fedorenko26: folds
leprekon71: raises $0.02 to $0.04
SeijuroAk: folds
Vishny203: folds
Tina-Elissa: calls $0.02
*** FLOP *** [8h Jc Kd]
Tina-Elissa: checks
leprekon71: bets $0.02
Tina-Elissa: calls $0.02
*** TURN *** [8h Jc Kd] [2h]
Tina-Elissa: checks
leprekon71: bets $0.02
Tina-Elissa: calls $0.02
*** RIVER *** [8h Jc Kd 2h] [8s]
Tina-Elissa: checks
leprekon71: checks
*** SHOW DOWN ***
Tina-Elissa: shows [7s Tc] (a pair of Eights)
leprekon71: shows [7c 7d] (two pair, Eights and Sevens)
leprekon71 collected $0.16 from pot
*** SUMMARY ***
Total pot $0.17 | Rake $0.01
Board [8h Jc Kd 2h 8s]
Seat 1: Tina-Elissa (big blind) showed [7s Tc] and lost with a pair of Eights
Seat 3: Fedorenko26 folded before Flop (didn't bet)
Seat 4: leprekon71 showed [7c 7d] and won ($0.16) with two pair, Eights and Sevens
Seat 5: SeijuroAk (button) folded before Flop (didn't bet)
Seat 6: Vishny203 (small blind) folded before Flop


PokerStars Hand #238171868782:  Hold'em No Limit ($0.01/$0.02 USD) - 2022/08/23 14:35:04 ET
Table 'Despina IV' 6-max Seat #6 is the button
Seat 1: Tina-Elissa ($0.37 in chips)
Seat 3: Fedorenko26 ($2.97 in chips)
Seat 4: leprekon71 ($4.91 in chips)
Seat 5: SeijuroAk ($2 in chips)
Seat 6: Vishny203 ($2.86 in chips)
Tina-Elissa: posts small blind $0.01
Fedorenko26: posts big blind $0.02
*** HOLE CARDS ***
leprekon71: folds
SeijuroAk: folds
Vishny203: raises $0.04 to $0.06
spiritofdrose joins the table at seat #2
Tina-Elissa: raises $0.31 to $0.37 and is all-in
Fedorenko26: folds
Vishny203: folds
Uncalled bet ($0.31) returned to Tina-Elissa
Tina-Elissa collected $0.14 from pot
Tina-Elissa: doesn't show hand
*** SUMMARY ***
Total pot $0.14 | Rake $0
Seat 1: Tina-Elissa (small blind) collected ($0.14)
Seat 3: Fedorenko26 (big blind) folded before Flop
Seat 4: leprekon71 folded before Flop (didn't bet)
Seat 5: SeijuroAk folded before Flop (didn't bet)
Seat 6: Vishny203 (button) folded before Flop


PokerStars Hand #238171884862:  Hold'em No Limit ($0.01/$0.02 USD) - 2022/08/23 14:35:50 ET
Table 'Despina IV' 6-max Seat #3 is the button
Seat 1: Tina-Elissa ($0.43 in chips)
Seat 3: Fedorenko26 ($2.99 in chips)
Seat 4: leprekon71 ($4.89 in chips)
Seat 5: SeijuroAk ($2 in chips)
Seat 6: Vishny203 ($2.80 in chips)
leprekon71: posts small blind $0.01
SeijuroAk: posts big blind $0.02
spiritofdrose: sits out
*** HOLE CARDS ***
Vishny203: raises $0.04 to $0.06
Tina-Elissa: calls $0.06
Fedorenko26: folds
leprekon71: folds
SeijuroAk: folds
*** FLOP *** [Td 5s 8s]
Vishny203: checks
Tina-Elissa: checks
*** TURN *** [Td 5s 8s] [7d]
Vishny203: checks
Tina-Elissa: checks
*** RIVER *** [Td 5s 8s 7d] [4d]
Vishny203: bets $0.02
Tina-Elissa: raises $0.09 to $0.11
Vishny203: raises $0.27 to $0.38
Tina-Elissa: folds
Uncalled bet ($0.27) returned to Vishny203
Vishny203 collected $0.36 from pot
Vishny203: doesn't show hand
*** SUMMARY ***
Total pot $0.37 | Rake $0.01
Board [Td 5s 8s 7d 4d]
Seat 1: Tina-Elissa folded on the River
Seat 3: Fedorenko26 (button) folded before Flop (didn't bet)
Seat 4: leprekon71 (small blind) folded before Flop
Seat 5: SeijuroAk (big blind) folded before Flop
Seat 6: Vishny203 collected ($0.36)


PokerStars Hand #238171900250:  Hold'em No Limit ($0.01/$0.02 USD) - 2022/08/23 14:36:34 ET
Table 'Despina IV' 6-max Seat #4 is the button
Seat 1: Tina-Elissa ($0.26 in chips)
Seat 3: Fedorenko26 ($2.99 in chips)
Seat 4: leprekon71 ($4.88 in chips)
Seat 5: SeijuroAk ($2 in chips)
SeijuroAk: posts small blind $0.01
Vishny203: is sitting out
Tina-Elissa: posts big blind $0.02
spiritofdrose: sits out
*** HOLE CARDS ***
Fedorenko26: folds
leprekon71: folds
SeijuroAk: folds
Uncalled bet ($0.01) returned to Tina-Elissa
Tina-Elissa collected $0.02 from pot
Tina-Elissa: doesn't show hand
*** SUMMARY ***
Total pot $0.02 | Rake $0
Seat 1: Tina-Elissa (big blind) collected ($0.02)
Seat 3: Fedorenko26 folded before Flop (didn't bet)
Seat 4: leprekon71 (button) folded before Flop (didn't bet)
Seat 5: SeijuroAk (small blind) folded before Flop


PokerStars Hand #238171902782:  Hold'em No Limit ($0.01/$0.02 USD) - 2022/08/23 14:36:41 ET
Table 'Despina IV' 6-max Seat #5 is the button
Seat 1: Tina-Elissa ($0.27 in chips)
Seat 2: spiritofdrose ($1.50 in chips)
Seat 3: Fedorenko26 ($2.99 in chips)
Seat 4: leprekon71 ($4.88 in chips)
Seat 5: SeijuroAk ($2 in chips)
Tina-Elissa: posts small blind $0.01
spiritofdrose: posts big blind $0.02
*** HOLE CARDS ***
Fedorenko26: folds
leprekon71: raises $0.02 to $0.04
SeijuroAk: calls $0.04
Tina-Elissa: calls $0.03
spiritofdrose: calls $0.02
*** FLOP *** [8d 9s 4h]
Tina-Elissa: checks
spiritofdrose: checks
leprekon71: checks
SeijuroAk: bets $0.08
Tina-Elissa: folds
spiritofdrose: folds
leprekon71: calls $0.08
*** TURN *** [8d 9s 4h] [5c]
leprekon71: checks
SeijuroAk: bets $0.16
leprekon71: folds
Uncalled bet ($0.16) returned to SeijuroAk
SeijuroAk collected $0.31 from pot
SeijuroAk: doesn't show hand
*** SUMMARY ***
Total pot $0.32 | Rake $0.01
Board [8d 9s 4h 5c]
Seat 1: Tina-Elissa (small blind) folded on the Flop
Seat 2: spiritofdrose (big blind) folded on the Flop
Seat 3: Fedorenko26 folded before Flop (didn't bet)
Seat 4: leprekon71 folded on the Turn
Seat 5: SeijuroAk (button) collected ($0.31)


PokerStars Hand #238171915348:  Hold'em No Limit ($0.01/$0.02 USD) - 2022/08/23 14:37:17 ET
Table 'Despina IV' 6-max Seat #1 is the button
Seat 1: Tina-Elissa ($0.23 in chips)
Seat 2: spiritofdrose ($1.46 in chips)
Seat 3: Fedorenko26 ($2.99 in chips)
Seat 4: leprekon71 ($4.76 in chips)
Seat 5: SeijuroAk ($2.19 in chips)
spiritofdrose: posts small blind $0.01
Fedorenko26: posts big blind $0.02
*** HOLE CARDS ***
leprekon71: folds
SeijuroAk: folds
Tina-Elissa: raises $0.21 to $0.23 and is all-in
spiritofdrose: folds
Fedorenko26: folds
Uncalled bet ($0.21) returned to Tina-Elissa
Tina-Elissa collected $0.05 from pot
Tina-Elissa: doesn't show hand
*** SUMMARY ***
Total pot $0.05 | Rake $0
Seat 1: Tina-Elissa (button) collected ($0.05)
Seat 2: spiritofdrose (small blind) folded before Flop
Seat 3: Fedorenko26 (big blind) folded before Flop
Seat 4: leprekon71 folded before Flop (didn't bet)
Seat 5: SeijuroAk folded before Flop (didn't bet)


PokerStars Hand #238171919964:  Hold'em No Limit ($0.01/$0.02 USD) - 2022/08/23 14:37:30 ET
Table 'Despina IV' 6-max Seat #2 is the button
Seat 1: Tina-Elissa ($0.26 in chips)
Seat 2: spiritofdrose ($1.45 in chips)
Seat 3: Fedorenko26 ($2.97 in chips)
Seat 4: leprekon71 ($4.76 in chips)
Seat 5: SeijuroAk ($2.19 in chips)
Fedorenko26: posts small blind $0.01
leprekon71: posts big blind $0.02
*** HOLE CARDS ***
SeijuroAk: folds
Tina-Elissa: folds
spiritofdrose: raises $0.04 to $0.06
Fedorenko26: folds
leprekon71: folds
Uncalled bet ($0.04) returned to spiritofdrose
spiritofdrose collected $0.05 from pot
spiritofdrose: doesn't show hand
*** SUMMARY ***
Total pot $0.05 | Rake $0
Seat 1: Tina-Elissa folded before Flop (didn't bet)
Seat 2: spiritofdrose (button) collected ($0.05)
Seat 3: Fedorenko26 (small blind) folded before Flop
Seat 4: leprekon71 (big blind) folded before Flop
Seat 5: SeijuroAk folded before Flop (didn't bet)


PokerStars Hand #238171923470:  Hold'em No Limit ($0.01/$0.02 USD) - 2022/08/23 14:37:40 ET
Table 'Despina IV' 6-max Seat #3 is the button
Seat 1: Tina-Elissa ($0.26 in chips)
Seat 2: spiritofdrose ($1.48 in chips)
Seat 3: Fedorenko26 ($2.96 in chips)
Seat 4: leprekon71 ($4.74 in chips)
Seat 5: SeijuroAk ($2.19 in chips)
leprekon71: posts small blind $0.01
SeijuroAk: posts big blind $0.02
*** HOLE CARDS ***
Tina-Elissa: raises $0.24 to $0.26 and is all-in
spiritofdrose: calls $0.26
Fedorenko26: folds
leprekon71: folds
SeijuroAk: folds
*** FLOP *** [5c 3h 5d]
*** TURN *** [5c 3h 5d] [7s]
*** RIVER *** [5c 3h 5d 7s] [8c]
*** SHOW DOWN ***
Tina-Elissa: shows [Qh Jd] (a pair of Fives)
spiritofdrose: shows [8s Qd] (two pair, Eights and Fives)
spiritofdrose collected $0.53 from pot
*** SUMMARY ***
Total pot $0.55 | Rake $0.02
Board [5c 3h 5d 7s 8c]
Seat 1: Tina-Elissa showed [Qh Jd] and lost with a pair of Fives
Seat 2: spiritofdrose showed [8s Qd] and won ($0.53) with two pair, Eights and Fives
Seat 3: Fedorenko26 (button) folded before Flop (didn't bet)
Seat 4: leprekon71 (small blind) folded before Flop
Seat 5: SeijuroAk (big blind) folded before Flop


PokerStars Hand #238171935745:  Hold'em No Limit ($0.01/$0.02 USD) - 2022/08/23 14:38:15 ET
Table 'Despina IV' 6-max Seat #4 is the button
Seat 2: spiritofdrose ($1.75 in chips)
Seat 3: Fedorenko26 ($2.96 in chips)
Seat 4: leprekon71 ($4.73 in chips)
Seat 5: SeijuroAk ($2.17 in chips)
SeijuroAk: posts small blind $0.01
spiritofdrose: posts big blind $0.02
*** HOLE CARDS ***
Fedorenko26: folds
leprekon71: folds
Tina-Elissa leaves the table
Special One4444 joins the table at seat #1
SeijuroAk: folds
Uncalled bet ($0.01) returned to spiritofdrose
spiritofdrose collected $0.02 from pot
spiritofdrose: doesn't show hand
*** SUMMARY ***
Total pot $0.02 | Rake $0
Seat 2: spiritofdrose (big blind) collected ($0.02)
Seat 3: Fedorenko26 folded before Flop (didn't bet)
Seat 4: leprekon71 (button) folded before Flop (didn't bet)
Seat 5: SeijuroAk (small blind) folded before Flop


PokerStars Hand #238171941446:  Hold'em No Limit ($0.01/$0.02 USD) - 2022/08/23 14:38:31 ET
Table 'Despina IV' 6-max Seat #5 is the button
Seat 2: spiritofdrose ($1.76 in chips)
Seat 3: Fedorenko26 ($2.96 in chips)
Seat 4: leprekon71 ($4.73 in chips)
Seat 5: SeijuroAk ($2.16 in chips)
spiritofdrose: posts small blind $0.01
Fedorenko26: posts big blind $0.02
*** HOLE CARDS ***
leprekon71: folds
SeijuroAk: folds
spiritofdrose: folds
Uncalled bet ($0.01) returned to Fedorenko26
Fedorenko26 collected $0.02 from pot
*** SUMMARY ***
Total pot $0.02 | Rake $0
Seat 2: spiritofdrose (small blind) folded before Flop
Seat 3: Fedorenko26 (big blind) collected ($0.02)
Seat 4: leprekon71 folded before Flop (didn't bet)
Seat 5: SeijuroAk (button) folded before Flop (didn't bet)


PokerStars Hand #238171946911:  Hold'em No Limit ($0.01/$0.02 USD) - 2022/08/23 14:38:46 ET
Table 'Despina IV' 6-max Seat #2 is the button
Seat 2: spiritofdrose ($1.75 in chips)
Seat 3: Fedorenko26 ($2.97 in chips)
Seat 4: leprekon71 ($4.73 in chips)
Seat 5: SeijuroAk ($2.16 in chips)
Fedorenko26: posts small blind $0.01
leprekon71: posts big blind $0.02
Special One4444: sits out
*** HOLE CARDS ***
Special One4444 leaves the table
SeijuroAk: folds
spiritofdrose: calls $0.02
Fedorenko26: calls $0.01
leprekon71: checks
*** FLOP *** [2h Kc 9c]
Fedorenko26: checks
luzbel6662019 joins the table at seat #1
leprekon71: checks
spiritofdrose: checks
*** TURN *** [2h Kc 9c] [Qc]
Fedorenko26: checks
leprekon71: checks
spiritofdrose: checks
*** RIVER *** [2h Kc 9c Qc] [4s]
Fedorenko26: checks
leprekon71: checks
spiritofdrose: checks
*** SHOW DOWN ***
Fedorenko26: shows [9h 6d] (a pair of Nines)
leprekon71: mucks hand
spiritofdrose: shows [Ah 9s] (a pair of Nines - Ace kicker)
spiritofdrose collected $0.06 from pot
*** SUMMARY ***
Total pot $0.06 | Rake $0
Board [2h Kc 9c Qc 4s]
Seat 2: spiritofdrose (button) showed [Ah 9s] and won ($0.06) with a pair of Nines
Seat 3: Fedorenko26 (small blind) showed [9h 6d] and lost with a pair of Nines
Seat 4: leprekon71 (big blind) mucked
Seat 5: SeijuroAk folded before Flop (didn't bet)


PokerStars Hand #238171958398:  Hold'em No Limit ($0.01/$0.02 USD) - 2022/08/23 14:39:19 ET
Table 'Despina IV' 6-max Seat #3 is the button
Seat 2: spiritofdrose ($1.79 in chips)
Seat 3: Fedorenko26 ($2.95 in chips)
Seat 4: leprekon71 ($4.71 in chips)
Seat 5: SeijuroAk ($2.16 in chips)
leprekon71: posts small blind $0.01
SeijuroAk: posts big blind $0.02
luzbel6662019: sits out
*** HOLE CARDS ***
spiritofdrose: calls $0.02
Fedorenko26: raises $0.06 to $0.08
leprekon71: folds
SeijuroAk: folds
spiritofdrose: calls $0.06
*** FLOP *** [9s 2c 5c]
spiritofdrose: bets $0.06
Fedorenko26: calls $0.06
*** TURN *** [9s 2c 5c] [9h]
spiritofdrose: bets $0.08
Fedorenko26: calls $0.08
*** RIVER *** [9s 2c 5c 9h] [9d]
spiritofdrose: checks
Fedorenko26: checks
*** SHOW DOWN ***
spiritofdrose: shows [Td Qd] (three of a kind, Nines)
Fedorenko26: shows [Ac 7c] (three of a kind, Nines - Ace kicker)
Fedorenko26 collected $0.45 from pot
*** SUMMARY ***
Total pot $0.47 | Rake $0.02
Board [9s 2c 5c 9h 9d]
Seat 2: spiritofdrose showed [Td Qd] and lost with three of a kind, Nines
Seat 3: Fedorenko26 (button) showed [Ac 7c] and won ($0.45) with three of a kind, Nines
Seat 4: leprekon71 (small blind) folded before Flop
Seat 5: SeijuroAk (big blind) folded before Flop


PokerStars Hand #238171976780:  Hold'em No Limit ($0.01/$0.02 USD) - 2022/08/23 14:40:11 ET
Table 'Despina IV' 6-max Seat #4 is the button
Seat 1: luzbel6662019 ($2 in chips)
Seat 2: spiritofdrose ($1.57 in chips)
Seat 3: Fedorenko26 ($3.18 in chips)
Seat 4: leprekon71 ($4.70 in chips)
Seat 5: SeijuroAk ($2.14 in chips)
SeijuroAk: posts small blind $0.01
luzbel6662019: posts big blind $0.02
*** HOLE CARDS ***
spiritofdrose: raises $0.02 to $0.04
Fedorenko26: raises $0.12 to $0.16
leprekon71: folds
SeijuroAk: folds
luzbel6662019: folds
spiritofdrose: calls $0.12
*** FLOP *** [3d Jh Kc]
spiritofdrose: checks
Fedorenko26: bets $0.28
spiritofdrose: folds
Uncalled bet ($0.28) returned to Fedorenko26
Fedorenko26 collected $0.34 from pot
*** SUMMARY ***
Total pot $0.35 | Rake $0.01
Board [3d Jh Kc]
Seat 1: luzbel6662019 (big blind) folded before Flop
Seat 2: spiritofdrose folded on the Flop
Seat 3: Fedorenko26 collected ($0.34)
Seat 4: leprekon71 (button) folded before Flop (didn't bet)
Seat 5: SeijuroAk (small blind) folded before Flop


PokerStars Hand #238171988011:  Hold'em No Limit ($0.01/$0.02 USD) - 2022/08/23 14:40:42 ET
Table 'Despina IV' 6-max Seat #5 is the button
Seat 1: luzbel6662019 ($2 in chips)
Seat 2: spiritofdrose ($1.41 in chips)
Seat 3: Fedorenko26 ($3.36 in chips)
Seat 4: leprekon71 ($4.70 in chips)
Seat 5: SeijuroAk ($2.13 in chips)
luzbel6662019: posts small blind $0.01
spiritofdrose: posts big blind $0.02
*** HOLE CARDS ***
Fedorenko26: folds
leprekon71: folds
SeijuroAk: raises $0.04 to $0.06
luzbel6662019 has timed out
luzbel6662019: folds
spiritofdrose: folds
Uncalled bet ($0.04) returned to SeijuroAk
SeijuroAk collected $0.05 from pot
SeijuroAk: doesn't show hand
*** SUMMARY ***
Total pot $0.05 | Rake $0
Seat 1: luzbel6662019 (small blind) folded before Flop
Seat 2: spiritofdrose (big blind) folded before Flop
Seat 3: Fedorenko26 folded before Flop (didn't bet)
Seat 4: leprekon71 folded before Flop (didn't bet)
Seat 5: SeijuroAk (button) collected ($0.05)


PokerStars Hand #238172002395:  Hold'em No Limit ($0.01/$0.02 USD) - 2022/08/23 14:41:23 ET
Table 'Despina IV' 6-max Seat #2 is the button
Seat 2: spiritofdrose ($1.39 in chips)
Seat 3: Fedorenko26 ($3.36 in chips)
Seat 4: leprekon71 ($4.70 in chips)
Seat 5: SeijuroAk ($2.16 in chips)
Fedorenko26: posts small blind $0.01
leprekon71: posts big blind $0.02
*** HOLE CARDS ***
SeijuroAk: folds
spiritofdrose: calls $0.02
Fedorenko26: calls $0.01
leprekon71: checks
*** FLOP *** [Ac 3c 3h]
Fedorenko26: checks
leprekon71: checks
spiritofdrose: checks
*** TURN *** [Ac 3c 3h] [Js]
Fedorenko26: checks
leprekon71: checks
spiritofdrose: checks
*** RIVER *** [Ac 3c 3h Js] [4d]
Fedorenko26: checks
leprekon71: checks
luzbel6662019 is disconnected
spiritofdrose: checks
*** SHOW DOWN ***
Fedorenko26: shows [9s Qh] (a pair of Threes)
leprekon71: shows [Qd 7s] (a pair of Threes)
spiritofdrose: shows [9c Ks] (a pair of Threes - Ace+King kicker)
spiritofdrose collected $0.06 from pot
*** SUMMARY ***
Total pot $0.06 | Rake $0
Board [Ac 3c 3h Js 4d]
Seat 2: spiritofdrose (button) showed [9c Ks] and won ($0.06) with a pair of Threes
Seat 3: Fedorenko26 (small blind) showed [9s Qh] and lost with a pair of Threes
Seat 4: leprekon71 (big blind) showed [Qd 7s] and lost with a pair of Threes
Seat 5: SeijuroAk folded before Flop (didn't bet)


PokerStars Hand #238172020298:  Hold'em No Limit ($0.01/$0.02 USD) - 2022/08/23 14:42:13 ET
Table 'Despina IV' 6-max Seat #4 is the button
Seat 2: spiritofdrose ($1.43 in chips)
Seat 3: Fedorenko26 ($3.34 in chips)
Seat 4: leprekon71 ($4.67 in chips)
Seat 5: SeijuroAk ($2.17 in chips)
SeijuroAk: posts small blind $0.01
spiritofdrose: posts big blind $0.02
*** HOLE CARDS ***
Fedorenko26: folds
leprekon71: folds
SeijuroAk: folds
Uncalled bet ($0.01) returned to spiritofdrose
spiritofdrose collected $0.02 from pot
Vishny203 was removed from the table for failing to post
Vishny203 leaves the table
spiritofdrose: doesn't show hand
*** SUMMARY ***
Total pot $0.02 | Rake $0
Seat 2: spiritofdrose (big blind) collected ($0.02)
Seat 3: Fedorenko26 folded before Flop (didn't bet)
Seat 4: leprekon71 (button) folded before Flop (didn't bet)
Seat 5: SeijuroAk (small blind) folded before Flop


PokerStars Hand #238172017521:  Hold'em No Limit ($0.01/$0.02 USD) - 2022/08/23 14:42:06 ET
Table 'Despina IV' 6-max Seat #3 is the button
Seat 2: spiritofdrose ($1.43 in chips)
Seat 3: Fedorenko26 ($3.34 in chips)
Seat 4: leprekon71 ($4.68 in chips)
Seat 5: SeijuroAk ($2.16 in chips)
leprekon71: posts small blind $0.01
SeijuroAk: posts big blind $0.02
*** HOLE CARDS ***
spiritofdrose: folds
Fedorenko26: folds
leprekon71: folds
Uncalled bet ($0.01) returned to SeijuroAk
SeijuroAk collected $0.02 from pot
SeijuroAk: doesn't show hand
*** SUMMARY ***
Total pot $0.02 | Rake $0
Seat 2: spiritofdrose folded before Flop (didn't bet)
Seat 3: Fedorenko26 (button) folded before Flop (didn't bet)
Seat 4: leprekon71 (small blind) folded before Flop
Seat 5: SeijuroAk (big blind) collected ($0.02)


PokerStars Hand #238172027547:  Hold'em No Limit ($0.01/$0.02 USD) - 2022/08/23 14:42:34 ET
Table 'Despina IV' 6-max Seat #2 is the button
Seat 2: spiritofdrose ($1.40 in chips)
Seat 3: Fedorenko26 ($3.38 in chips)
Seat 5: SeijuroAk ($2.16 in chips)
Fedorenko26: posts small blind $0.01
SeijuroAk: posts big blind $0.02
*** HOLE CARDS ***
spiritofdrose: folds
Fedorenko26: folds
Uncalled bet ($0.01) returned to SeijuroAk
SeijuroAk collected $0.02 from pot
SeijuroAk: doesn't show hand
*** SUMMARY ***
Total pot $0.02 | Rake $0
Seat 2: spiritofdrose (button) folded before Flop (didn't bet)
Seat 3: Fedorenko26 (small blind) folded before Flop
Seat 5: SeijuroAk (big blind) collected ($0.02)


PokerStars Hand #238172021946:  Hold'em No Limit ($0.01/$0.02 USD) - 2022/08/23 14:42:18 ET
Table 'Despina IV' 6-max Seat #5 is the button
Seat 2: spiritofdrose ($1.44 in chips)
Seat 3: Fedorenko26 ($3.34 in chips)
Seat 4: leprekon71 ($4.67 in chips)
Seat 5: SeijuroAk ($2.16 in chips)
spiritofdrose: posts small blind $0.01
Fedorenko26: posts big blind $0.02
*** HOLE CARDS ***
leprekon71: folds
leprekon71 leaves the table
SeijuroAk: folds
spiritofdrose: raises $0.02 to $0.04
Fedorenko26: raises $0.12 to $0.16
spiritofdrose: folds
Uncalled bet ($0.12) returned to Fedorenko26
Fedorenko26 collected $0.08 from pot
*** SUMMARY ***
Total pot $0.08 | Rake $0
Seat 2: spiritofdrose (small blind) folded before Flop
Seat 3: Fedorenko26 (big blind) collected ($0.08)
Seat 4: leprekon71 folded before Flop (didn't bet)
Seat 5: SeijuroAk (button) folded before Flop (didn't bet)


PokerStars Hand #238172030199:  Hold'em No Limit ($0.01/$0.02 USD) - 2022/08/23 14:42:41 ET
Table 'Despina IV' 6-max Seat #3 is the button
Seat 2: spiritofdrose ($1.40 in chips)
Seat 3: Fedorenko26 ($3.37 in chips)
Seat 5: SeijuroAk ($2.17 in chips)
SeijuroAk: posts small blind $0.01
spiritofdrose: posts big blind $0.02
*** HOLE CARDS ***
Fedorenko26: folds
SeijuroAk: calls $0.01
spiritofdrose: checks
*** FLOP *** [6d As Ts]
SeijuroAk: checks
spiritofdrose: checks
*** TURN *** [6d As Ts] [5c]
SeijuroAk: bets $0.02
spiritofdrose: calls $0.02
*** RIVER *** [6d As Ts 5c] [8c]
SeijuroAk: bets $0.04
spiritofdrose is disconnected
spiritofdrose has timed out while disconnected
spiritofdrose: folds
Uncalled bet ($0.04) returned to SeijuroAk
SeijuroAk collected $0.08 from pot
SeijuroAk: doesn't show hand
*** SUMMARY ***
Total pot $0.08 | Rake $0
Board [6d As Ts 5c 8c]
Seat 2: spiritofdrose (big blind) folded on the River
Seat 3: Fedorenko26 (button) folded before Flop (didn't bet)
Seat 5: SeijuroAk (small blind) collected ($0.08)


