PokerStars Hand #238159637138:  Hold'em No Limit ($0.01/$0.02 USD) - 2022/08/22 21:37:23 ET
Table 'Achilles IV' 6-max Seat #3 is the button
Seat 1: HJ ($2 in chips)
Seat 2: CO ($0.80 in chips)
Seat 3: BTN ($1.62 in chips)
Seat 4: SB ($1.62 in chips)
Seat 6: BB ($0.78 in chips)
BB: posts small blind $0.01
HJ: posts big blind $0.02
SurfinGhost: sits out
*** HOLE CARDS ***
CO: folds
BTN: calls $0.02
BB: calls $0.01
SurfinGhost leaves the table
HJ: checks
*** FLOP *** [5h 2d 8d]
BB: checks
HJ: checks
BTN: bets $0.06
BB: calls $0.06
HJ: folds
*** TURN *** [5h 2d 8d] [4s]
BB: checks
BTN: checks
*** RIVER *** [5h 2d 8d 4s] [5c]
BB: bets $0.10
tantanmen19 joins the table at seat #3
BTN: folds
Uncalled bet ($0.10) returned to BB
BB collected $0.17 from pot
BB: doesn't show hand
*** SUMMARY ***
Total pot $0.18 | Rake $0.01
Board [5h 2d 8d 4s 5c]
Seat 1: HJ (big blind) folded on the Flop
Seat 2: CO folded before Flop (didn't bet)
Seat 4: BTN (button) folded on the River
Seat 6: BB (small blind) collected ($0.17)


PokerStars Hand #238159655139:  Hold'em No Limit ($0.01/$0.02 USD) - 2022/08/22 21:38:49 ET
Table 'Achilles IV' 6-max Seat #6 is the button
Seat 1: SB ($2 in chips)
Seat 2: BB ($0.80 in chips)
Seat 4: CO ($1.54 in chips)
Seat 6: BTN ($0.87 in chips)
SB: posts small blind $0.01
BB: posts big blind $0.02
tantanmen19: sits out
bichito72: sits out
*** HOLE CARDS ***
CO: calls $0.02
BTN: raises $0.02 to $0.04
SB: folds
BB: calls $0.02
CO: calls $0.02
*** FLOP *** [9h Ts 6d]
BB: bets $0.06
CO: calls $0.06
BTN: raises $0.06 to $0.12
BB: calls $0.06
CO: calls $0.06
*** TURN *** [9h Ts 6d] [8c]
BB: checks
CO: checks
BTN: bets $0.20
BB: folds
CO: calls $0.20
*** RIVER *** [9h Ts 6d 8c] [5d]
CO: checks
BTN: bets $0.51 and is all-in
CO: folds
Uncalled bet ($0.51) returned to BTN
BTN collected $0.86 from pot
BTN: doesn't show hand
*** SUMMARY ***
Total pot $0.89 | Rake $0.03
Board [9h Ts 6d 8c 5d]
Seat 1: SB (small blind) folded before Flop
Seat 2: BB (big blind) folded on the Turn
Seat 4: CO folded on the River
Seat 6: BTN (button) collected ($0.86)


PokerStars Hand #238159666177:  Hold'em No Limit ($0.01/$0.02 USD) - 2022/08/22 21:39:43 ET
Table 'Achilles IV' 6-max Seat #1 is the button
Seat 1: BTN ($2 in chips)
Seat 2: SB ($0.64 in chips)
Seat 3: BB ($1.60 in chips)
Seat 4: HJ ($1.18 in chips)
Seat 6: CO ($1.37 in chips)
SB: posts small blind $0.01
BB: posts big blind $0.02
bichito72: sits out
*** HOLE CARDS ***
HJ: raises $0.02 to $0.04
CO: calls $0.04
BTN: raises $0.20 to $0.24
SB: folds
BB: calls $0.22
HJ: folds
CO: calls $0.20
*** FLOP *** [Ah 5h Jd]
BB: checks
CO: checks
BTN: bets $0.24
BB: folds
CO: folds
Uncalled bet ($0.24) returned to BTN
BTN collected $0.74 from pot
*** SUMMARY ***
Total pot $0.77 | Rake $0.03
Board [Ah 5h Jd]
Seat 1: BTN (button) collected ($0.74)
Seat 2: SB (small blind) folded before Flop
Seat 3: BB (big blind) folded on the Flop
Seat 4: HJ folded before Flop
Seat 6: CO folded on the Flop


PokerStars Hand #238159679044:  Hold'em No Limit ($0.01/$0.02 USD) - 2022/08/22 21:40:45 ET
Table 'Achilles IV' 6-max Seat #2 is the button
Seat 1: CO ($2.50 in chips)
Seat 2: BTN ($0.63 in chips)
Seat 3: SB ($1.36 in chips)
Seat 4: BB ($1.14 in chips)
Seat 6: HJ ($1.13 in chips)
SB: posts small blind $0.01
BB: posts big blind $0.02
bichito72: sits out
*** HOLE CARDS ***
HJ: calls $0.02
CO: folds
BTN: folds
SB: folds
BB: checks
*** FLOP *** [8d 2s Jc]
SB leaves the table
BB: checks
HJ: checks
*** TURN *** [8d 2s Jc] [Js]
BB: checks
HJ: bets $0.02
BB: calls $0.02
*** RIVER *** [8d 2s Jc Js] [Jd]
BB: checks
HJ: bets $0.10
BB: raises $0.15 to $0.25
HJ: raises $0.15 to $0.40
BB: raises $0.70 to $1.10 and is all-in
HJ: folds
Uncalled bet ($0.70) returned to BB
BB collected $0.86 from pot
*** SUMMARY ***
Total pot $0.89 | Rake $0.03
Board [8d 2s Jc Js Jd]
Seat 1: CO folded before Flop (didn't bet)
Seat 2: BTN (button) folded before Flop (didn't bet)
Seat 3: SB (small blind) folded before Flop
Seat 4: BB (big blind) collected ($0.86)
Seat 6: HJ folded on the River


PokerStars Hand #238159690908:  Hold'em No Limit ($0.01/$0.02 USD) - 2022/08/22 21:41:42 ET
Table 'Achilles IV' 6-max Seat #4 is the button
Seat 1: BB ($2.50 in chips)
Seat 2: CO ($0.63 in chips)
Seat 4: BTN ($1.56 in chips)
Seat 6: SB ($0.69 in chips)
SB: posts small blind $0.01
BB: posts big blind $0.02
*** HOLE CARDS ***
CO: folds
BTN: calls $0.02
SB: raises $0.02 to $0.04
BB: folds
BTN: calls $0.02
*** FLOP *** [6h 4s 3d]
SB: checks
BTN: checks
*** TURN *** [6h 4s 3d] [9c]
SB: checks
BTN: checks
*** RIVER *** [6h 4s 3d 9c] [5h]
SB: checks
BTN: checks
*** SHOW DOWN ***
SB: shows [Ac 8c] (high card Ace)
BTN: shows [As 8h] (high card Ace)
SB collected $0.05 from pot
BTN collected $0.05 from pot
*** SUMMARY ***
Total pot $0.10 | Rake $0
Board [6h 4s 3d 9c 5h]
Seat 1: BB (big blind) folded before Flop
Seat 2: CO folded before Flop (didn't bet)
Seat 4: BTN (button) showed [As 8h] and won ($0.05) with high card Ace
Seat 6: SB (small blind) showed [Ac 8c] and won ($0.05) with high card Ace


PokerStars Hand #238159698862:  Hold'em No Limit ($0.01/$0.02 USD) - 2022/08/22 21:42:20 ET
Table 'Achilles IV' 6-max Seat #6 is the button
Seat 1: SB ($2.48 in chips)
Seat 2: BB ($0.63 in chips)
Seat 4: CO ($1.57 in chips)
Seat 6: BTN ($0.70 in chips)
SB: posts small blind $0.01
BB: posts big blind $0.02
bichito72: sits out
*** HOLE CARDS ***
CO: folds
BTN: folds
SB: folds
Uncalled bet ($0.01) returned to BB
BB collected $0.02 from pot
BB: doesn't show hand
*** SUMMARY ***
Total pot $0.02 | Rake $0
Seat 1: SB (small blind) folded before Flop
Seat 2: BB (big blind) collected ($0.02)
Seat 4: CO folded before Flop (didn't bet)
Seat 6: BTN (button) folded before Flop (didn't bet)


PokerStars Hand #238159701377:  Hold'em No Limit ($0.01/$0.02 USD) - 2022/08/22 21:42:33 ET
Table 'Achilles IV' 6-max Seat #1 is the button
Seat 1: BTN ($2.47 in chips)
Seat 2: SB ($0.64 in chips)
Seat 4: BB ($1.57 in chips)
Seat 6: CO ($0.70 in chips)
SB: posts small blind $0.01
BB: posts big blind $0.02
bichito72: sits out
*** HOLE CARDS ***
CO: calls $0.02
BTN: folds
SB: calls $0.01
BB: checks
*** FLOP *** [Js Ts Qc]
SB: checks
BB: bets $0.06
CO: folds
SB: folds
Uncalled bet ($0.06) returned to BB
BB collected $0.06 from pot
*** SUMMARY ***
Total pot $0.06 | Rake $0
Board [Js Ts Qc]
Seat 1: BTN (button) folded before Flop (didn't bet)
Seat 2: SB (small blind) folded on the Flop
Seat 4: BB (big blind) collected ($0.06)
Seat 6: CO folded on the Flop


PokerStars Hand #238159706610:  Hold'em No Limit ($0.01/$0.02 USD) - 2022/08/22 21:42:58 ET
Table 'Achilles IV' 6-max Seat #2 is the button
Seat 1: CO ($2.47 in chips)
Seat 2: BTN ($0.62 in chips)
Seat 4: SB ($1.61 in chips)
Seat 5: BB ($2 in chips)
Seat 6: HJ ($0.68 in chips)
SB: posts small blind $0.01
BB: posts big blind $0.02
*** HOLE CARDS ***
HJ: calls $0.02
CO: folds
BTN: raises $0.04 to $0.06
SB: calls $0.05
BB: folds
HJ: calls $0.04
*** FLOP *** [5s 2d 9d]
SB: checks
HJ: checks
BTN: bets $0.09
SB: folds
HJ: folds
Uncalled bet ($0.09) returned to BTN
BTN collected $0.19 from pot
BTN: doesn't show hand
*** SUMMARY ***
Total pot $0.20 | Rake $0.01
Board [5s 2d 9d]
Seat 1: CO folded before Flop (didn't bet)
Seat 2: BTN (button) collected ($0.19)
Seat 4: SB (small blind) folded on the Flop
Seat 5: BB (big blind) folded before Flop
Seat 6: HJ folded on the Flop


PokerStars Hand #238159712379:  Hold'em No Limit ($0.01/$0.02 USD) - 2022/08/22 21:43:26 ET
Table 'Achilles IV' 6-max Seat #4 is the button
Seat 1: HJ ($2.47 in chips)
Seat 2: CO ($0.75 in chips)
Seat 4: BTN ($1.55 in chips)
Seat 5: SB ($1.98 in chips)
Seat 6: BB ($0.62 in chips)
SB: posts small blind $0.01
BB: posts big blind $0.02
*** HOLE CARDS ***
HJ: folds
CO: folds
BTN: calls $0.02
SB: folds
BB: checks
*** FLOP *** [Ad Td 8s]
BB: checks
BTN: bets $0.05
BB: folds
Uncalled bet ($0.05) returned to BTN
BTN collected $0.05 from pot
*** SUMMARY ***
Total pot $0.05 | Rake $0
Board [Ad Td 8s]
Seat 1: HJ folded before Flop (didn't bet)
Seat 2: CO folded before Flop (didn't bet)
Seat 4: BTN (button) collected ($0.05)
Seat 5: SB (small blind) folded before Flop
Seat 6: BB (big blind) folded on the Flop


PokerStars Hand #238159718332:  Hold'em No Limit ($0.01/$0.02 USD) - 2022/08/22 21:43:55 ET
Table 'Achilles IV' 6-max Seat #5 is the button
Seat 1: BB ($2.47 in chips)
Seat 2: HJ ($0.75 in chips)
Seat 4: CO ($1.58 in chips)
Seat 5: BTN ($1.97 in chips)
Seat 6: SB ($0.60 in chips)
SB: posts small blind $0.01
BB: posts big blind $0.02
*** HOLE CARDS ***
HJ: folds
CO: calls $0.02
BTN: raises $0.06 to $0.08
SB: calls $0.07
BB: folds
CO: calls $0.06
*** FLOP *** [6h Ts 5s]
MOE.DINO joins the table at seat #3
SB: checks
CO: checks
BTN: bets $0.17
SB: folds
CO: folds
Uncalled bet ($0.17) returned to BTN
BTN collected $0.25 from pot
BTN: doesn't show hand
*** SUMMARY ***
Total pot $0.26 | Rake $0.01
Board [6h Ts 5s]
Seat 1: BB (big blind) folded before Flop
Seat 2: HJ folded before Flop (didn't bet)
Seat 4: CO folded on the Flop
Seat 5: BTN (button) collected ($0.25)
Seat 6: SB (small blind) folded on the Flop


PokerStars Hand #238159725743:  Hold'em No Limit ($0.01/$0.02 USD) - 2022/08/22 21:44:31 ET
Table 'Achilles IV' 6-max Seat #6 is the button
Seat 1: SB ($2.45 in chips)
Seat 2: BB ($0.75 in chips)
Seat 4: HJ ($1.50 in chips)
Seat 5: CO ($2.14 in chips)
Seat 6: BTN ($0.52 in chips)
SB: posts small blind $0.01
BB: posts big blind $0.02
MOE.DINO: sits out
*** HOLE CARDS ***
HJ: calls $0.02
CO: folds
BTN: calls $0.02
SB: raises $0.04 to $0.06
BB: calls $0.04
HJ: calls $0.04
BTN: calls $0.04
*** FLOP *** [Qh Ts 4d]
SB: checks
BB: checks
HJ: bets $0.11
BTN: folds
SB: folds
BB: folds
Uncalled bet ($0.11) returned to HJ
HJ collected $0.23 from pot
*** SUMMARY ***
Total pot $0.24 | Rake $0.01
Board [Qh Ts 4d]
Seat 1: SB (small blind) folded on the Flop
Seat 2: BB (big blind) folded on the Flop
Seat 4: HJ collected ($0.23)
Seat 5: CO folded before Flop (didn't bet)
Seat 6: BTN (button) folded on the Flop


PokerStars Hand #238159732645:  Hold'em No Limit ($0.01/$0.02 USD) - 2022/08/22 21:45:05 ET
Table 'Achilles IV' 6-max Seat #1 is the button
Seat 1: BTN ($2.39 in chips)
Seat 2: SB ($0.69 in chips)
Seat 3: BB ($1.75 in chips)
Seat 4: UTG ($1.67 in chips)
Seat 5: HJ ($2.14 in chips)
Seat 6: CO ($0.46 in chips)
SB: posts small blind $0.01
BB: posts big blind $0.02
*** HOLE CARDS ***
UTG: calls $0.02
HJ: folds
CO: calls $0.02
BTN: raises $0.07 to $0.09
SB: folds
BB: calls $0.07
UTG: calls $0.07
CO: calls $0.07
*** FLOP *** [Kd 6c 2h]
BB: checks
UTG: checks
CO: checks
BTN: bets $0.26
BB: folds
UTG: folds
CO: folds
Uncalled bet ($0.26) returned to BTN
BTN collected $0.36 from pot
*** SUMMARY ***
Total pot $0.37 | Rake $0.01
Board [Kd 6c 2h]
Seat 1: BTN (button) collected ($0.36)
Seat 2: SB (small blind) folded before Flop
Seat 3: BB (big blind) folded on the Flop
Seat 4: UTG folded on the Flop
Seat 5: HJ folded before Flop (didn't bet)
Seat 6: CO folded on the Flop


PokerStars Hand #238159741555:  Hold'em No Limit ($0.01/$0.02 USD) - 2022/08/22 21:45:49 ET
Table 'Achilles IV' 6-max Seat #2 is the button
Seat 1: CO ($2.66 in chips)
Seat 2: BTN ($0.68 in chips)
Seat 3: SB ($1.66 in chips)
Seat 4: BB ($1.58 in chips)
Seat 5: UTG ($2.14 in chips)
Seat 6: HJ ($0.37 in chips)
SB: posts small blind $0.01
BB: posts big blind $0.02
*** HOLE CARDS ***
UTG: raises $0.04 to $0.06
HJ: folds
CO: folds
BTN: calls $0.06
SB: calls $0.05
BB: calls $0.04
*** FLOP *** [6s 9c 2s]
SB: checks
BB: bets $0.11
UTG: folds
BTN: calls $0.11
SB: calls $0.11
*** TURN *** [6s 9c 2s] [4c]
SB: checks
BB: bets $0.55
BTN: calls $0.51 and is all-in
SB: calls $0.55
*** RIVER *** [6s 9c 2s 4c] [3s]
SB: checks
BB: bets $0.86 and is all-in
SB: folds
Uncalled bet ($0.86) returned to BB
*** SHOW DOWN ***
BB: shows [9h 7h] (a pair of Nines)
BB collected $0.07 from side pot
BTN: shows [4s Ks] (a flush, King high)
BTN collected $2.03 from main pot
*** SUMMARY ***
Total pot $2.18 Main pot $2.03. Side pot $0.07. | Rake $0.08
Board [6s 9c 2s 4c 3s]
Seat 1: CO folded before Flop (didn't bet)
Seat 2: BTN (button) showed [4s Ks] and won ($2.03) with a flush, King high
Seat 3: SB (small blind) folded on the River
Seat 4: BB (big blind) showed [9h 7h] and won ($0.07) with a pair of Nines
Seat 5: UTG folded on the Flop
Seat 6: HJ folded before Flop (didn't bet)


PokerStars Hand #238159759669:  Hold'em No Limit ($0.01/$0.02 USD) - 2022/08/22 21:47:19 ET
Table 'Achilles IV' 6-max Seat #3 is the button
Seat 1: HJ ($2.66 in chips)
Seat 2: CO ($2.03 in chips)
Seat 3: BTN ($0.94 in chips)
Seat 4: SB ($0.93 in chips)
Seat 5: BB ($2.08 in chips)
Seat 6: UTG ($0.37 in chips)
SB: posts small blind $0.01
BB: posts big blind $0.02
*** HOLE CARDS ***
UTG: calls $0.02
HJ: raises $0.03 to $0.05
CO: folds
BTN: calls $0.05
SB: folds
BB: folds
UTG: folds
*** FLOP *** [Ac 8d 4h]
HJ: checks
BTN: checks
*** TURN *** [Ac 8d 4h] [5h]
HJ: checks
BTN: bets $0.14
HJ: folds
Uncalled bet ($0.14) returned to BTN
BTN collected $0.14 from pot
*** SUMMARY ***
Total pot $0.15 | Rake $0.01
Board [Ac 8d 4h 5h]
Seat 1: HJ folded on the Turn
Seat 2: CO folded before Flop (didn't bet)
Seat 3: BTN (button) collected ($0.14)
Seat 4: SB (small blind) folded before Flop
Seat 5: BB (big blind) folded before Flop
Seat 6: UTG folded before Flop


PokerStars Hand #238159772058:  Hold'em No Limit ($0.01/$0.02 USD) - 2022/08/22 21:48:10 ET
Table 'Achilles IV' 6-max Seat #4 is the button
Seat 1: UTG ($2.61 in chips)
Seat 2: HJ ($2.03 in chips)
Seat 3: CO ($1.03 in chips)
Seat 4: BTN ($0.92 in chips)
Seat 5: SB ($2.06 in chips)
Seat 6: BB ($0.35 in chips)
SB: posts small blind $0.01
BB: posts big blind $0.02
*** HOLE CARDS ***
UTG: folds
HJ: folds
CO: calls $0.02
BTN: calls $0.02
SB: calls $0.01
BB: checks
*** FLOP *** [Jc Ah 7h]
SB: checks
BB: checks
CO: bets $0.04
BTN: folds
SB: folds
BB: folds
Uncalled bet ($0.04) returned to CO
CO collected $0.08 from pot
*** SUMMARY ***
Total pot $0.08 | Rake $0
Board [Jc Ah 7h]
Seat 1: UTG folded before Flop (didn't bet)
Seat 2: HJ folded before Flop (didn't bet)
Seat 3: CO collected ($0.08)
Seat 4: BTN (button) folded on the Flop
Seat 5: SB (small blind) folded on the Flop
Seat 6: BB (big blind) folded on the Flop


PokerStars Hand #238159780286:  Hold'em No Limit ($0.01/$0.02 USD) - 2022/08/22 21:48:51 ET
Table 'Achilles IV' 6-max Seat #5 is the button
Seat 1: BB ($2.61 in chips)
Seat 2: UTG ($2.03 in chips)
Seat 3: HJ ($1.09 in chips)
Seat 4: CO ($0.90 in chips)
Seat 5: BTN ($2.04 in chips)
Seat 6: SB ($0.33 in chips)
SB: posts small blind $0.01
BB: posts big blind $0.02
*** HOLE CARDS ***
UTG: folds
HJ: folds
CO: calls $0.02
BTN: raises $0.04 to $0.06
SB: folds
BB: folds
CO: calls $0.04
*** FLOP *** [9c 5s Qs]
CO: checks
BTN: bets $0.07
CO: calls $0.07
*** TURN *** [9c 5s Qs] [6s]
CO: checks
BTN: checks
*** RIVER *** [9c 5s Qs 6s] [Kd]
CO: bets $0.28
BTN: folds
Uncalled bet ($0.28) returned to CO
CO collected $0.28 from pot
*** SUMMARY ***
Total pot $0.29 | Rake $0.01
Board [9c 5s Qs 6s Kd]
Seat 1: BB (big blind) folded before Flop
Seat 2: UTG folded before Flop (didn't bet)
Seat 3: HJ folded before Flop (didn't bet)
Seat 4: CO collected ($0.28)
Seat 5: BTN (button) folded on the River
Seat 6: SB (small blind) folded before Flop


PokerStars Hand #238159798745:  Hold'em No Limit ($0.01/$0.02 USD) - 2022/08/22 21:50:22 ET
Table 'Achilles IV' 6-max Seat #6 is the button
Seat 1: SB ($2.59 in chips)
Seat 2: BB ($2.03 in chips)
Seat 3: UTG ($1.09 in chips)
Seat 4: HJ ($1.05 in chips)
Seat 5: CO ($1.91 in chips)
Seat 6: BTN ($0.32 in chips)
SB: posts small blind $0.01
BB: posts big blind $0.02
*** HOLE CARDS ***
UTG: folds
HJ: calls $0.02
CO: folds
BTN: folds
SB: raises $0.08 to $0.10
BB: calls $0.08
HJ: calls $0.08
*** FLOP *** [6c 6s 9c]
SB: checks
BB: checks
HJ: checks
*** TURN *** [6c 6s 9c] [3d]
SB: checks
BB: checks
HJ: checks
*** RIVER *** [6c 6s 9c 3d] [Ah]
SB: bets $0.24
BB: folds
HJ: folds
Uncalled bet ($0.24) returned to SB
SB collected $0.29 from pot
*** SUMMARY ***
Total pot $0.30 | Rake $0.01
Board [6c 6s 9c 3d Ah]
Seat 1: SB (small blind) collected ($0.29)
Seat 2: BB (big blind) folded on the River
Seat 3: UTG folded before Flop (didn't bet)
Seat 4: HJ folded on the River
Seat 5: CO folded before Flop (didn't bet)
Seat 6: BTN (button) folded before Flop (didn't bet)


PokerStars Hand #238159806147:  Hold'em No Limit ($0.01/$0.02 USD) - 2022/08/22 21:50:59 ET
Table 'Achilles IV' 6-max Seat #1 is the button
Seat 1: BTN ($2.78 in chips)
Seat 2: SB ($1.93 in chips)
Seat 3: BB ($1.09 in chips)
Seat 4: UTG ($0.95 in chips)
Seat 5: HJ ($1.91 in chips)
Seat 6: CO ($0.32 in chips)
SB: posts small blind $0.01
BB: posts big blind $0.02
*** HOLE CARDS ***
UTG: calls $0.02
HJ: folds
CO: calls $0.02
BTN: folds
SB: calls $0.01
BB: raises $0.04 to $0.06
UTG: calls $0.04
CO: folds
SB: calls $0.04
*** FLOP *** [4s Qs 8h]
SB: checks
BB: checks
UTG: bets $0.09
SB: calls $0.09
BB: calls $0.09
*** TURN *** [4s Qs 8h] [9c]
SB: checks
BB: checks
UTG: bets $0.45
SB: folds
BB: calls $0.45
*** RIVER *** [4s Qs 8h 9c] [Ks]
BB: bets $0.49 and is all-in
UTG: calls $0.35 and is all-in
Uncalled bet ($0.14) returned to BB
*** SHOW DOWN ***
BB: shows [6c 6d] (a pair of Sixes)
UTG: shows [Jh Qd] (a pair of Queens)
UTG collected $2 from pot
*** SUMMARY ***
Total pot $2.07 | Rake $0.07
Board [4s Qs 8h 9c Ks]
Seat 1: BTN (button) folded before Flop (didn't bet)
Seat 2: SB (small blind) folded on the Turn
Seat 3: BB (big blind) showed [6c 6d] and lost with a pair of Sixes
Seat 4: UTG showed [Jh Qd] and won ($2) with a pair of Queens
Seat 5: HJ folded before Flop (didn't bet)
Seat 6: CO folded before Flop


PokerStars Hand #238159833545:  Hold'em No Limit ($0.01/$0.02 USD) - 2022/08/22 21:52:07 ET
Table 'Achilles IV' 6-max Seat #2 is the button
Seat 1: CO ($2.78 in chips)
Seat 2: BTN ($1.78 in chips)
Seat 3: SB ($0.14 in chips)
Seat 4: BB ($2 in chips)
Seat 5: UTG ($1.91 in chips)
Seat 6: HJ ($0.30 in chips)
SB: posts small blind $0.01
BB: posts big blind $0.02
*** HOLE CARDS ***
UTG: folds
HJ: calls $0.02
CO: raises $0.04 to $0.06
BTN: calls $0.06
SB: raises $0.08 to $0.14 and is all-in
BB: calls $0.12
HJ: calls $0.12
CO: calls $0.08
BTN: calls $0.08
*** FLOP *** [2h 8s Td]
BB: checks
HJ: bets $0.16 and is all-in
CO: calls $0.16
BTN: folds
BB: folds
*** TURN *** [2h 8s Td] [8d]
*** RIVER *** [2h 8s Td 8d] [Ad]
*** SHOW DOWN ***
HJ: shows [5h 5c] (two pair, Eights and Fives)
CO: shows [7d 6d] (a flush, Ace high)
CO collected $0.30 from side pot
SB: shows [7c Ks] (a pair of Eights)
CO collected $0.68 from main pot
*** SUMMARY ***
Total pot $1.02 Main pot $0.68. Side pot $0.30. | Rake $0.04
Board [2h 8s Td 8d Ad]
Seat 1: CO showed [7d 6d] and won ($0.98) with a flush, Ace high
Seat 2: BTN (button) folded on the Flop
Seat 3: SB (small blind) showed [7c Ks] and lost with a pair of Eights
Seat 4: BB (big blind) folded on the Flop
Seat 5: UTG folded before Flop (didn't bet)
Seat 6: HJ showed [5h 5c] and lost with two pair, Eights and Fives


PokerStars Hand #238159845702:  Hold'em No Limit ($0.01/$0.02 USD) - 2022/08/22 21:53:08 ET
Table 'Achilles IV' 6-max Seat #4 is the button
Seat 1: BB ($3.46 in chips)
Seat 2: CO ($1.64 in chips)
Seat 4: BTN ($1.86 in chips)
Seat 5: SB ($1.91 in chips)
SB: posts small blind $0.01
BB: posts big blind $0.02
*** HOLE CARDS ***
pbanks08 leaves the table
CO: folds
Koresh153 joins the table at seat #6
BTN: folds
SB: raises $0.03 to $0.05
BB: folds
Uncalled bet ($0.03) returned to SB
SB collected $0.04 from pot
SB: doesn't show hand
*** SUMMARY ***
Total pot $0.04 | Rake $0
Seat 1: BB (big blind) folded before Flop
Seat 2: CO folded before Flop (didn't bet)
Seat 4: BTN (button) folded before Flop (didn't bet)
Seat 5: SB (small blind) collected ($0.04)


PokerStars Hand #238159849339:  Hold'em No Limit ($0.01/$0.02 USD) - 2022/08/22 21:53:26 ET
Table 'Achilles IV' 6-max Seat #5 is the button
Seat 1: SB ($3.44 in chips)
Seat 2: BB ($1.64 in chips)
Seat 3: HJ ($2 in chips)
Seat 4: CO ($1.86 in chips)
Seat 5: BTN ($1.93 in chips)
SB: posts small blind $0.01
BB: posts big blind $0.02
*** HOLE CARDS ***
HJ: calls $0.02
CO: calls $0.02
BTN: calls $0.02
SB: folds
BB: checks
*** FLOP *** [Qh 4s 5d]
BB: checks
HJ: bets $0.06
CO: raises $0.06 to $0.12
BTN: folds
BB: folds
HJ: calls $0.06
*** TURN *** [Qh 4s 5d] [4c]
HJ: bets $0.08
CO: calls $0.08
*** RIVER *** [Qh 4s 5d 4c] [6c]
HJ: bets $0.08
CO: raises $0.63 to $0.71
HJ: calls $0.63
*** SHOW DOWN ***
CO: shows [Qc 6s] (two pair, Queens and Sixes)
HJ: mucks hand
CO collected $1.84 from pot
*** SUMMARY ***
Total pot $1.91 | Rake $0.07
Board [Qh 4s 5d 4c 6c]
Seat 1: SB (small blind) folded before Flop
Seat 2: BB (big blind) folded on the Flop
Seat 3: HJ mucked
Seat 4: CO showed [Qc 6s] and won ($1.84) with two pair, Queens and Sixes
Seat 5: BTN (button) folded on the Flop


PokerStars Hand #238159863859:  Hold'em No Limit ($0.01/$0.02 USD) - 2022/08/22 21:54:39 ET
Table 'Achilles IV' 6-max Seat #1 is the button
Seat 1: BTN ($3.43 in chips)
Seat 2: SB ($1.62 in chips)
Seat 3: BB ($1.07 in chips)
Seat 4: HJ ($2.77 in chips)
Seat 5: CO ($1.91 in chips)
SB: posts small blind $0.01
BB: posts big blind $0.02
Koresh153: sits out
*** HOLE CARDS ***
HJ: calls $0.02
CO: folds
BTN: raises $0.04 to $0.06
SB: calls $0.05
BB: calls $0.04
HJ: calls $0.04
*** FLOP *** [4d 4h 7d]
SB: bets $0.11
BB: calls $0.11
HJ: folds
BTN: folds
*** TURN *** [4d 4h 7d] [Js]
SB: bets $0.22
BB: calls $0.22
*** RIVER *** [4d 4h 7d Js] [Td]
SB: bets $0.43
BB: folds
Uncalled bet ($0.43) returned to SB
SB collected $0.87 from pot
SB: doesn't show hand
*** SUMMARY ***
Total pot $0.90 | Rake $0.03
Board [4d 4h 7d Js Td]
Seat 1: BTN (button) folded on the Flop
Seat 2: SB (small blind) collected ($0.87)
Seat 3: BB (big blind) folded on the River
Seat 4: HJ folded on the Flop
Seat 5: CO folded before Flop (didn't bet)


PokerStars Hand #238159872840:  Hold'em No Limit ($0.01/$0.02 USD) - 2022/08/22 21:55:27 ET
Table 'Achilles IV' 6-max Seat #2 is the button
Seat 1: CO ($3.37 in chips)
Seat 2: BTN ($2.10 in chips)
Seat 3: SB ($0.68 in chips)
Seat 4: BB ($2.71 in chips)
Seat 5: HJ ($1.91 in chips)
SB: posts small blind $0.01
BB: posts big blind $0.02
Koresh153: sits out
*** HOLE CARDS ***
HJ: folds
CO: folds
BTN: folds
SB: calls $0.01
BB: checks
*** FLOP *** [5h 7h 4h]
SB: checks
BB: checks
*** TURN *** [5h 7h 4h] [6c]
SB: bets $0.04
BB: folds
Uncalled bet ($0.04) returned to SB
SB collected $0.04 from pot
*** SUMMARY ***
Total pot $0.04 | Rake $0
Board [5h 7h 4h 6c]
Seat 1: CO folded before Flop (didn't bet)
Seat 2: BTN (button) folded before Flop (didn't bet)
Seat 3: SB (small blind) collected ($0.04)
Seat 4: BB (big blind) folded on the Turn
Seat 5: HJ folded before Flop (didn't bet)


PokerStars Hand #238159875794:  Hold'em No Limit ($0.01/$0.02 USD) - 2022/08/22 21:55:46 ET
Table 'Achilles IV' 6-max Seat #3 is the button
Seat 1: HJ ($3.37 in chips)
Seat 2: CO ($2.10 in chips)
Seat 3: BTN ($0.70 in chips)
Seat 4: SB ($2.69 in chips)
Seat 5: BB ($1.91 in chips)
SB: posts small blind $0.01
BB: posts big blind $0.02
Koresh153: sits out
*** HOLE CARDS ***
HJ: folds
CO: folds
BTN: calls $0.02
SB: calls $0.01
BB: checks
*** FLOP *** [2h 3s Kd]
SB: checks
BB: bets $0.04
BTN: calls $0.04
SB: calls $0.04
*** TURN *** [2h 3s Kd] [Td]
SB: bets $0.10
BB: calls $0.10
BTN: calls $0.10
*** RIVER *** [2h 3s Kd Td] [3d]
SB: checks
BB: checks
BTN: checks
*** SHOW DOWN ***
SB: shows [Jd Kh] (two pair, Kings and Threes)
BB: mucks hand
BTN: mucks hand
SB collected $0.46 from pot
*** SUMMARY ***
Total pot $0.48 | Rake $0.02
Board [2h 3s Kd Td 3d]
Seat 1: HJ folded before Flop (didn't bet)
Seat 2: CO folded before Flop (didn't bet)
Seat 3: BTN (button) mucked
Seat 4: SB (small blind) showed [Jd Kh] and won ($0.46) with two pair, Kings and Threes
Seat 5: BB (big blind) mucked


PokerStars Hand #238159883954:  Hold'em No Limit ($0.01/$0.02 USD) - 2022/08/22 21:56:36 ET
Table 'Achilles IV' 6-max Seat #4 is the button
Seat 1: HJ ($3.37 in chips)
Seat 3: CO ($0.54 in chips)
Seat 4: BTN ($2.99 in chips)
Seat 5: SB ($1.75 in chips)
Seat 6: BB ($0.80 in chips)
SB: posts small blind $0.01
BB: posts big blind $0.02
*** HOLE CARDS ***
HJ: folds
CO: raises $0.04 to $0.06
BTN: calls $0.06
SB: folds
BB: folds
*** FLOP *** [Kh 2c 2d]
CO: checks
BTN: checks
*** TURN *** [Kh 2c 2d] [7c]
CO: checks
BTN: checks
*** RIVER *** [Kh 2c 2d 7c] [3d]
CO: checks
BTN: checks
*** SHOW DOWN ***
CO: shows [Qs Tc] (a pair of Deuces)
BTN: mucks hand
CO collected $0.14 from pot
*** SUMMARY ***
Total pot $0.15 | Rake $0.01
Board [Kh 2c 2d 7c 3d]
Seat 1: HJ folded before Flop (didn't bet)
Seat 3: CO showed [Qs Tc] and won ($0.14) with a pair of Deuces
Seat 4: BTN (button) mucked
Seat 5: SB (small blind) folded before Flop
Seat 6: BB (big blind) folded before Flop


PokerStars Hand #238159889527:  Hold'em No Limit ($0.01/$0.02 USD) - 2022/08/22 21:57:12 ET
Table 'Achilles IV' 6-max Seat #5 is the button
Seat 1: BB ($3.37 in chips)
Seat 3: HJ ($0.62 in chips)
Seat 4: CO ($2.93 in chips)
Seat 5: BTN ($1.74 in chips)
Seat 6: SB ($0.80 in chips)
SB: posts small blind $0.01
BB: posts big blind $0.02
*** HOLE CARDS ***
HJ: calls $0.02
CO: calls $0.02
BTN: folds
SB: folds
BB: checks
*** FLOP *** [Ac Ad 5d]
BB: checks
HJ: checks
CO: bets $0.07
BB: folds
HJ: folds
Uncalled bet ($0.07) returned to CO
CO collected $0.07 from pot
*** SUMMARY ***
Total pot $0.07 | Rake $0
Board [Ac Ad 5d]
Seat 1: BB (big blind) folded on the Flop
Seat 3: HJ folded on the Flop
Seat 4: CO collected ($0.07)
Seat 5: BTN (button) folded before Flop (didn't bet)
Seat 6: SB (small blind) folded before Flop


PokerStars Hand #238159894820:  Hold'em No Limit ($0.01/$0.02 USD) - 2022/08/22 21:57:45 ET
Table 'Achilles IV' 6-max Seat #6 is the button
Seat 1: SB ($3.35 in chips)
Seat 2: BB ($2.10 in chips)
Seat 3: UTG ($0.60 in chips)
Seat 4: HJ ($2.98 in chips)
Seat 5: CO ($1.74 in chips)
Seat 6: BTN ($0.80 in chips)
SB: posts small blind $0.01
BB: posts big blind $0.02
*** HOLE CARDS ***
UTG: calls $0.02
HJ: calls $0.02
CO: raises $0.08 to $0.10
BTN: folds
SB: folds
BB: folds
UTG: calls $0.08
HJ: calls $0.08
*** FLOP *** [5h 2h 7s]
UTG: checks
HJ: bets $0.12
CO: folds
UTG: folds
Uncalled bet ($0.12) returned to HJ
HJ collected $0.32 from pot
*** SUMMARY ***
Total pot $0.33 | Rake $0.01
Board [5h 2h 7s]
Seat 1: SB (small blind) folded before Flop
Seat 2: BB (big blind) folded before Flop
Seat 3: UTG folded on the Flop
Seat 4: HJ collected ($0.32)
Seat 5: CO folded on the Flop
Seat 6: BTN (button) folded before Flop (didn't bet)


PokerStars Hand #238159902666:  Hold'em No Limit ($0.01/$0.02 USD) - 2022/08/22 21:58:35 ET
Table 'Achilles IV' 6-max Seat #1 is the button
Seat 1: BTN ($3.34 in chips)
Seat 3: SB ($0.50 in chips)
Seat 4: BB ($3.20 in chips)
Seat 5: HJ ($1.64 in chips)
Seat 6: CO ($0.80 in chips)
SB: posts small blind $0.01
BB: posts big blind $0.02
*** HOLE CARDS ***
HJ: folds
CO: folds
BTN: folds
SB: raises $0.04 to $0.06
BB: calls $0.04
*** FLOP *** [3h Qh 7s]
SB: checks
BB: checks
*** TURN *** [3h Qh 7s] [Th]
SB: bets $0.12
BB: calls $0.12
*** RIVER *** [3h Qh 7s Th] [9h]
SB: checks
BB: bets $0.28
SB: calls $0.28
*** SHOW DOWN ***
BB: shows [Ah 2s] (a flush, Ace high)
SB: mucks hand
BB collected $0.89 from pot
*** SUMMARY ***
Total pot $0.92 | Rake $0.03
Board [3h Qh 7s Th 9h]
Seat 1: BTN (button) folded before Flop (didn't bet)
Seat 3: SB (small blind) mucked
Seat 4: BB (big blind) showed [Ah 2s] and won ($0.89) with a flush, Ace high
Seat 5: HJ folded before Flop (didn't bet)
Seat 6: CO folded before Flop (didn't bet)


PokerStars Hand #238159910735:  Hold'em No Limit ($0.01/$0.02 USD) - 2022/08/22 21:59:26 ET
Table 'Achilles IV' 6-max Seat #3 is the button
Seat 1: CO ($3.34 in chips)
Seat 3: BTN ($0.04 in chips)
Seat 4: SB ($3.63 in chips)
Seat 5: BB ($1.64 in chips)
Seat 6: HJ ($0.80 in chips)
SB: posts small blind $0.01
BB: posts big blind $0.02
MojaMamka: sits out
*** HOLE CARDS ***
HJ: folds
CO: folds
BTN: raises $0.02 to $0.04 and is all-in
SB: folds
BB: calls $0.02
SB leaves the table
*** FLOP *** [8d 5h 2c]
terryfox1 joins the table at seat #4
*** TURN *** [8d 5h 2c] [4c]
*** RIVER *** [8d 5h 2c 4c] [Tc]
*** SHOW DOWN ***
BB: shows [Jd Qs] (high card Queen)
BTN: shows [Ad 4d] (a pair of Fours)
BTN collected $0.09 from pot
BB cashed out the hand for $0.04
*** SUMMARY ***
Total pot $0.09 | Rake $0
Board [8d 5h 2c 4c Tc]
Seat 1: CO folded before Flop (didn't bet)
Seat 3: BTN (button) showed [Ad 4d] and won ($0.09) with a pair of Fours
Seat 4: SB (small blind) folded before Flop
Seat 5: BB (big blind) showed [Jd Qs] and lost with high card Queen (cashed out).
Seat 6: HJ folded before Flop (didn't bet)


PokerStars Hand #238159914622:  Hold'em No Limit ($0.01/$0.02 USD) - 2022/08/22 21:59:50 ET
Table 'Achilles IV' 6-max Seat #5 is the button
Seat 1: BB ($3.34 in chips)
Seat 2: HJ ($2.08 in chips)
Seat 3: CO ($0.09 in chips)
Seat 5: BTN ($1.64 in chips)
Seat 6: SB ($0.80 in chips)
SB: posts small blind $0.01
BB: posts big blind $0.02
HJ: posts small blind $0.01
terryfox1: sits out
*** HOLE CARDS ***
HJ: raises $0.04 to $0.06
CO: folds
BTN: folds
SB: folds
BB: calls $0.04
*** FLOP *** [5c Ac 5s]
BB: checks
HJ: bets $0.07
BB: folds
Uncalled bet ($0.07) returned to HJ
HJ collected $0.14 from pot
HJ: doesn't show hand
*** SUMMARY ***
Total pot $0.14 | Rake $0
Board [5c Ac 5s]
Seat 1: BB (big blind) folded on the Flop
Seat 2: HJ collected ($0.14)
Seat 3: CO folded before Flop (didn't bet)
Seat 5: BTN (button) folded before Flop (didn't bet)
Seat 6: SB (small blind) folded before Flop


PokerStars Hand #238159922156:  Hold'em No Limit ($0.01/$0.02 USD) - 2022/08/22 22:00:37 ET
Table 'Achilles IV' 6-max Seat #6 is the button
Seat 1: SB ($3.28 in chips)
Seat 2: BB ($2.15 in chips)
Seat 3: HJ ($0.09 in chips)
Seat 5: CO ($1.64 in chips)
Seat 6: BTN ($0.80 in chips)
SB: posts small blind $0.01
BB: posts big blind $0.02
terryfox1: sits out
*** HOLE CARDS ***
HJ: calls $0.02
CO: folds
BTN has timed out
BTN: folds
SB: raises $0.08 to $0.10
BB: calls $0.08
HJ: calls $0.07 and is all-in
*** FLOP *** [As Th Td]
SB: bets $0.08
BB: folds
Uncalled bet ($0.08) returned to SB
*** TURN *** [As Th Td] [5d]
*** RIVER *** [As Th Td 5d] [5s]
*** SHOW DOWN ***
SB: shows [Ac Ad] (a full house, Aces full of Tens)
SB collected $0.02 from side pot
HJ: shows [6c 7c] (two pair, Tens and Fives)
SB collected $0.26 from main pot
*** SUMMARY ***
Total pot $0.29 Main pot $0.26. Side pot $0.02. | Rake $0.01
Board [As Th Td 5d 5s]
Seat 1: SB (small blind) showed [Ac Ad] and won ($0.28) with a full house, Aces full of Tens
Seat 2: BB (big blind) folded on the Flop
Seat 3: HJ showed [6c 7c] and lost with two pair, Tens and Fives
Seat 5: CO folded before Flop (didn't bet)
Seat 6: BTN (button) folded before Flop (didn't bet)


PokerStars Hand #238159930161:  Hold'em No Limit ($0.01/$0.02 USD) - 2022/08/22 22:01:21 ET
Table 'Achilles IV' 6-max Seat #1 is the button
Seat 1: BTN ($3.46 in chips)
Seat 2: SB ($2.05 in chips)
Seat 4: BB ($1.60 in chips)
Seat 5: HJ ($1.64 in chips)
Seat 6: CO ($2 in chips)
SB: posts small blind $0.01
BB: posts big blind $0.02
*** HOLE CARDS ***
MOE.DINO leaves the table
HJ: raises $0.04 to $0.06
CO: folds
BTN: folds
SB: calls $0.05
BB: folds
*** FLOP *** [Jh Kd Js]
SB: checks
HJ: bets $0.08
SB: calls $0.08
*** TURN *** [Jh Kd Js] [Qc]
SB: checks
HJ: checks
*** RIVER *** [Jh Kd Js Qc] [9c]
SB: bets $0.14
HJ: folds
Uncalled bet ($0.14) returned to SB
SB collected $0.29 from pot
SB: doesn't show hand
*** SUMMARY ***
Total pot $0.30 | Rake $0.01
Board [Jh Kd Js Qc 9c]
Seat 1: BTN (button) folded before Flop (didn't bet)
Seat 2: SB (small blind) collected ($0.29)
Seat 4: BB (big blind) folded before Flop
Seat 5: HJ folded on the River
Seat 6: CO folded before Flop (didn't bet)


PokerStars Hand #238159941973:  Hold'em No Limit ($0.01/$0.02 USD) - 2022/08/22 22:02:23 ET
Table 'Achilles IV' 6-max Seat #2 is the button
Seat 1: CO ($3.46 in chips)
Seat 2: BTN ($2.20 in chips)
Seat 4: SB ($1.58 in chips)
Seat 5: BB ($1.50 in chips)
Seat 6: HJ ($2 in chips)
SB: posts small blind $0.01
raduarte10 joins the table at seat #3
BB: posts big blind $0.02
*** HOLE CARDS ***
HJ: folds
CO: folds
BTN: folds
SB: calls $0.01
BB: checks
*** FLOP *** [3d Ts Qs]
SB: checks
BB: checks
*** TURN *** [3d Ts Qs] [9d]
SB: bets $0.04
BB: calls $0.04
*** RIVER *** [3d Ts Qs 9d] [6c]
SB: checks
BB: checks
*** SHOW DOWN ***
SB: shows [Kh 4d] (high card King)
BB: shows [Qd 8s] (a pair of Queens)
BB collected $0.12 from pot
*** SUMMARY ***
Total pot $0.12 | Rake $0
Board [3d Ts Qs 9d 6c]
Seat 1: CO folded before Flop (didn't bet)
Seat 2: BTN (button) folded before Flop (didn't bet)
Seat 4: SB (small blind) showed [Kh 4d] and lost with high card King
Seat 5: BB (big blind) showed [Qd 8s] and won ($0.12) with a pair of Queens
Seat 6: HJ folded before Flop (didn't bet)


PokerStars Hand #238159950501:  Hold'em No Limit ($0.01/$0.02 USD) - 2022/08/22 22:03:07 ET
Table 'Achilles IV' 6-max Seat #4 is the button
Seat 1: UTG ($3.46 in chips)
Seat 2: HJ ($2.20 in chips)
Seat 3: CO ($1.17 in chips)
Seat 4: BTN ($1.52 in chips)
Seat 5: SB ($1.56 in chips)
Seat 6: BB ($2 in chips)
SB: posts small blind $0.01
BB: posts big blind $0.02
CO: posts big blind $0.02
*** HOLE CARDS ***
UTG: folds
HJ: raises $0.07 to $0.09
CO: calls $0.07
BTN: folds
SB: folds
BB: folds
*** FLOP *** [3h Qd 4s]
HJ: bets $0.10
CO: calls $0.10
*** TURN *** [3h Qd 4s] [Ks]
HJ: checks
CO: bets $0.10
HJ: folds
Uncalled bet ($0.10) returned to CO
CO collected $0.40 from pot
*** SUMMARY ***
Total pot $0.41 | Rake $0.01
Board [3h Qd 4s Ks]
Seat 1: UTG folded before Flop (didn't bet)
Seat 2: HJ folded on the Turn
Seat 3: CO collected ($0.40)
Seat 4: BTN (button) folded before Flop (didn't bet)
Seat 5: SB (small blind) folded before Flop
Seat 6: BB (big blind) folded before Flop


PokerStars Hand #238159961030:  Hold'em No Limit ($0.01/$0.02 USD) - 2022/08/22 22:04:01 ET
Table 'Achilles IV' 6-max Seat #5 is the button
Seat 1: BB ($3.46 in chips)
Seat 2: UTG ($2.01 in chips)
Seat 3: HJ ($1.38 in chips)
Seat 4: CO ($1.52 in chips)
Seat 5: BTN ($1.55 in chips)
Seat 6: SB ($1.98 in chips)
SB: posts small blind $0.01
BB: posts big blind $0.02
*** HOLE CARDS ***
UTG: calls $0.02
HJ: folds
CO: raises $0.02 to $0.04
BTN: folds
SB: folds
BB: folds
UTG: calls $0.02
*** FLOP *** [Ts Kd 2c]
UTG: bets $0.05
CO: folds
Uncalled bet ($0.05) returned to UTG
UTG collected $0.11 from pot
UTG: doesn't show hand
*** SUMMARY ***
Total pot $0.11 | Rake $0
Board [Ts Kd 2c]
Seat 1: BB (big blind) folded before Flop
Seat 2: UTG collected ($0.11)
Seat 3: HJ folded before Flop (didn't bet)
Seat 4: CO folded on the Flop
Seat 5: BTN (button) folded before Flop (didn't bet)
Seat 6: SB (small blind) folded before Flop


PokerStars Hand #238159973319:  Hold'em No Limit ($0.01/$0.02 USD) - 2022/08/22 22:04:52 ET
Table 'Achilles IV' 6-max Seat #6 is the button
Seat 1: SB ($3.44 in chips)
Seat 2: BB ($2.08 in chips)
Seat 3: UTG ($1.38 in chips)
Seat 4: HJ ($1.48 in chips)
Seat 5: CO ($1.55 in chips)
Seat 6: BTN ($1.97 in chips)
SB: posts small blind $0.01
BB: posts big blind $0.02
*** HOLE CARDS ***
UTG: folds
HJ: calls $0.02
CO: folds
BTN: folds
SB: folds
BB: checks
*** FLOP *** [5s 9d Kc]
BB: checks
HJ: bets $0.02
BB: calls $0.02
*** TURN *** [5s 9d Kc] [7h]
BB: checks
HJ: bets $0.06
BB: folds
Uncalled bet ($0.06) returned to HJ
HJ collected $0.09 from pot
*** SUMMARY ***
Total pot $0.09 | Rake $0
Board [5s 9d Kc 7h]
Seat 1: SB (small blind) folded before Flop
Seat 2: BB (big blind) folded on the Turn
Seat 3: UTG folded before Flop (didn't bet)
Seat 4: HJ collected ($0.09)
Seat 5: CO folded before Flop (didn't bet)
Seat 6: BTN (button) folded before Flop (didn't bet)


PokerStars Hand #238159982198:  Hold'em No Limit ($0.01/$0.02 USD) - 2022/08/22 22:05:38 ET
Table 'Achilles IV' 6-max Seat #1 is the button
Seat 1: BTN ($3.43 in chips)
Seat 2: SB ($2.04 in chips)
Seat 3: BB ($1.38 in chips)
Seat 4: UTG ($1.53 in chips)
Seat 5: HJ ($1.55 in chips)
Seat 6: CO ($1.97 in chips)
SB: posts small blind $0.01
BB: posts big blind $0.02
*** HOLE CARDS ***
UTG: folds
HJ: folds
CO: folds
BTN: folds
SB: calls $0.01
BB: raises $0.04 to $0.06
SB: calls $0.04
*** FLOP *** [6h Jc 7d]
SB: checks
BB: checks
*** TURN *** [6h Jc 7d] [5s]
SB: checks
BB: checks
*** RIVER *** [6h Jc 7d 5s] [3s]
SB: checks
BB: checks
*** SHOW DOWN ***
SB: shows [6s 9h] (a pair of Sixes)
BB: mucks hand
SB collected $0.12 from pot
*** SUMMARY ***
Total pot $0.12 | Rake $0
Board [6h Jc 7d 5s 3s]
Seat 1: BTN (button) folded before Flop (didn't bet)
Seat 2: SB (small blind) showed [6s 9h] and won ($0.12) with a pair of Sixes
Seat 3: BB (big blind) mucked
Seat 4: UTG folded before Flop (didn't bet)
Seat 5: HJ folded before Flop (didn't bet)
Seat 6: CO folded before Flop (didn't bet)


PokerStars Hand #238159992940:  Hold'em No Limit ($0.01/$0.02 USD) - 2022/08/22 22:06:33 ET
Table 'Achilles IV' 6-max Seat #2 is the button
Seat 1: CO ($3.43 in chips)
Seat 2: BTN ($2.10 in chips)
Seat 3: SB ($1.32 in chips)
Seat 4: BB ($1.53 in chips)
Seat 5: UTG ($1.55 in chips)
Seat 6: HJ ($1.97 in chips)
SB: posts small blind $0.01
BB: posts big blind $0.02
*** HOLE CARDS ***
UTG: raises $0.04 to $0.06
HJ: folds
CO: folds
BTN: folds
SB: raises $0.06 to $0.12
BB: folds
HJ was removed from the table for failing to post
HJ leaves the table
UTG: calls $0.06
*** FLOP *** [As 8c Jc]
SB: checks
UTG: checks
*** TURN *** [As 8c Jc] [5s]
SB: checks
UTG: bets $0.10
SB: calls $0.10
*** RIVER *** [As 8c Jc 5s] [Ts]
SB: checks
UTG: checks
*** SHOW DOWN ***
SB: shows [Qs Qc] (a pair of Queens)
UTG: mucks hand
SB collected $0.44 from pot
*** SUMMARY ***
Total pot $0.46 | Rake $0.02
Board [As 8c Jc 5s Ts]
Seat 1: CO folded before Flop (didn't bet)
Seat 2: BTN (button) folded before Flop (didn't bet)
Seat 3: SB (small blind) showed [Qs Qc] and won ($0.44) with a pair of Queens
Seat 4: BB (big blind) folded before Flop
Seat 5: UTG mucked
Seat 6: HJ folded before Flop (didn't bet)


PokerStars Hand #238160006927:  Hold'em No Limit ($0.01/$0.02 USD) - 2022/08/22 22:07:45 ET
Table 'Achilles IV' 6-max Seat #3 is the button
Seat 1: HJ ($3.43 in chips)
Seat 2: CO ($2.10 in chips)
Seat 3: BTN ($1.54 in chips)
Seat 4: SB ($1.51 in chips)
Seat 5: BB ($1.33 in chips)
SB: posts small blind $0.01
BB: posts big blind $0.02
*** HOLE CARDS ***
HJ: folds
CO: folds
BTN: calls $0.02
SB: folds
BB: checks
*** FLOP *** [7c 4d 2c]
BB: checks
BTN: bets $0.06
BB: folds
Uncalled bet ($0.06) returned to BTN
BTN collected $0.05 from pot
*** SUMMARY ***
Total pot $0.05 | Rake $0
Board [7c 4d 2c]
Seat 1: HJ folded before Flop (didn't bet)
Seat 2: CO folded before Flop (didn't bet)
Seat 3: BTN (button) collected ($0.05)
Seat 4: SB (small blind) folded before Flop
Seat 5: BB (big blind) folded on the Flop


PokerStars Hand #238160014792:  Hold'em No Limit ($0.01/$0.02 USD) - 2022/08/22 22:08:26 ET
Table 'Achilles IV' 6-max Seat #4 is the button
Seat 1: BB ($3.43 in chips)
Seat 2: HJ ($2.10 in chips)
Seat 3: CO ($1.57 in chips)
Seat 4: BTN ($1.50 in chips)
Seat 5: SB ($1.31 in chips)
SB: posts small blind $0.01
BB: posts big blind $0.02
*** HOLE CARDS ***
HJ: folds
CO: folds
BTN: raises $0.04 to $0.06
SB: folds
BB: calls $0.04
*** FLOP *** [9d 4d 6c]
BB: checks
BTN: bets $0.06
BB: raises $0.12 to $0.18
chrisluh81 joins the table at seat #6
BTN: folds
Uncalled bet ($0.12) returned to BB
BB collected $0.24 from pot
*** SUMMARY ***
Total pot $0.25 | Rake $0.01
Board [9d 4d 6c]
Seat 1: BB (big blind) collected ($0.24)
Seat 2: HJ folded before Flop (didn't bet)
Seat 3: CO folded before Flop (didn't bet)
Seat 4: BTN (button) folded on the Flop
Seat 5: SB (small blind) folded before Flop


PokerStars Hand #238160025960:  Hold'em No Limit ($0.01/$0.02 USD) - 2022/08/22 22:09:08 ET
Table 'Achilles IV' 6-max Seat #5 is the button
Seat 1: SB ($3.55 in chips)
Seat 2: BB ($2.10 in chips)
Seat 3: HJ ($1.57 in chips)
Seat 4: CO ($1.38 in chips)
Seat 5: BTN ($1.30 in chips)
SB: posts small blind $0.01
BB: posts big blind $0.02
*** HOLE CARDS ***
HJ: calls $0.02
CO: raises $0.06 to $0.08
BTN: folds
SB: folds
BB: folds
HJ: calls $0.06
*** FLOP *** [9h 3c Jc]
HJ: checks
CO: bets $0.09
HJ: folds
Uncalled bet ($0.09) returned to CO
CO collected $0.18 from pot
*** SUMMARY ***
Total pot $0.19 | Rake $0.01
Board [9h 3c Jc]
Seat 1: SB (small blind) folded before Flop
Seat 2: BB (big blind) folded before Flop
Seat 3: HJ folded on the Flop
Seat 4: CO collected ($0.18)
Seat 5: BTN (button) folded before Flop (didn't bet)


PokerStars Hand #238160031309:  Hold'em No Limit ($0.01/$0.02 USD) - 2022/08/22 22:09:36 ET
Table 'Achilles IV' 6-max Seat #1 is the button
Seat 1: BTN ($3.54 in chips)
Seat 2: SB ($2.08 in chips)
Seat 3: BB ($1.49 in chips)
Seat 4: HJ ($1.48 in chips)
Seat 5: CO ($1.30 in chips)
SB: posts small blind $0.01
BB: posts big blind $0.02
chrisluh81: sits out
*** HOLE CARDS ***
HJ: folds
CO: folds
BTN: folds
SB: calls $0.01
BB: raises $0.04 to $0.06
SB: folds
Uncalled bet ($0.04) returned to BB
BB collected $0.04 from pot
*** SUMMARY ***
Total pot $0.04 | Rake $0
Seat 1: BTN (button) folded before Flop (didn't bet)
Seat 2: SB (small blind) folded before Flop
Seat 3: BB (big blind) collected ($0.04)
Seat 4: HJ folded before Flop (didn't bet)
Seat 5: CO folded before Flop (didn't bet)


PokerStars Hand #238160038483:  Hold'em No Limit ($0.01/$0.02 USD) - 2022/08/22 22:10:13 ET
Table 'Achilles IV' 6-max Seat #2 is the button
Seat 1: CO ($3.54 in chips)
Seat 2: BTN ($2.06 in chips)
Seat 3: SB ($1.51 in chips)
Seat 4: BB ($1.48 in chips)
Seat 5: UTG ($1.30 in chips)
Seat 6: HJ ($1.60 in chips)
SB: posts small blind $0.01
BB: posts big blind $0.02
HJ: posts big blind $0.02
*** HOLE CARDS ***
UTG: folds
HJ: checks
CO: folds
BTN: folds
SB: folds
BB: checks
*** FLOP *** [Js 9s Jc]
BB: checks
HJ: bets $0.02
BB: calls $0.02
*** TURN *** [Js 9s Jc] [Kh]
BB: checks
HJ: bets $0.02
BB: calls $0.02
*** RIVER *** [Js 9s Jc Kh] [2s]
BB: checks
HJ: bets $0.30
BB: raises $0.30 to $0.60
HJ: calls $0.30
*** SHOW DOWN ***
BB: shows [Jd 9c] (a full house, Jacks full of Nines)
HJ: mucks hand
BB collected $1.28 from pot
*** SUMMARY ***
Total pot $1.33 | Rake $0.05
Board [Js 9s Jc Kh 2s]
Seat 1: CO folded before Flop (didn't bet)
Seat 2: BTN (button) folded before Flop (didn't bet)
Seat 3: SB (small blind) folded before Flop
Seat 4: BB (big blind) showed [Jd 9c] and won ($1.28) with a full house, Jacks full of Nines
Seat 5: UTG folded before Flop (didn't bet)
Seat 6: HJ mucked


PokerStars Hand #238160051492:  Hold'em No Limit ($0.01/$0.02 USD) - 2022/08/22 22:11:21 ET
Table 'Achilles IV' 6-max Seat #3 is the button
Seat 1: HJ ($3.54 in chips)
Seat 2: CO ($2.06 in chips)
Seat 3: BTN ($1.50 in chips)
Seat 4: SB ($2.10 in chips)
Seat 5: BB ($1.30 in chips)
Seat 6: UTG ($0.94 in chips)
SB: posts small blind $0.01
BB: posts big blind $0.02
*** HOLE CARDS ***
UTG: raises $0.02 to $0.04
HJ: folds
CO: folds
BTN: folds
SB: folds
BB: folds
Uncalled bet ($0.02) returned to UTG
UTG collected $0.05 from pot
*** SUMMARY ***
Total pot $0.05 | Rake $0
Seat 1: HJ folded before Flop (didn't bet)
Seat 2: CO folded before Flop (didn't bet)
Seat 3: BTN (button) folded before Flop (didn't bet)
Seat 4: SB (small blind) folded before Flop
Seat 5: BB (big blind) folded before Flop
Seat 6: UTG collected ($0.05)


PokerStars Hand #238160054352:  Hold'em No Limit ($0.01/$0.02 USD) - 2022/08/22 22:11:36 ET
Table 'Achilles IV' 6-max Seat #4 is the button
Seat 1: UTG ($3.54 in chips)
Seat 2: HJ ($2.06 in chips)
Seat 3: CO ($1.50 in chips)
Seat 4: BTN ($2.09 in chips)
Seat 5: SB ($1.28 in chips)
Seat 6: BB ($0.97 in chips)
SB: posts small blind $0.01
BB: posts big blind $0.02
*** HOLE CARDS ***
UTG: folds
HJ: folds
CO: folds
BTN: raises $0.02 to $0.04
SB: folds
BB: raises $0.02 to $0.06
BTN: calls $0.02
*** FLOP *** [Jd Qc 5d]
BB: bets $0.08
BTN: calls $0.08
*** TURN *** [Jd Qc 5d] [2d]
BB: bets $0.08
BTN: calls $0.08
*** RIVER *** [Jd Qc 5d 2d] [2s]
BB: bets $0.02
BTN: raises $0.24 to $0.26
BB: calls $0.24
*** SHOW DOWN ***
BTN: shows [6d Ad] (a flush, Ace high)
BB: mucks hand
BTN collected $0.94 from pot
*** SUMMARY ***
Total pot $0.97 | Rake $0.03
Board [Jd Qc 5d 2d 2s]
Seat 1: UTG folded before Flop (didn't bet)
Seat 2: HJ folded before Flop (didn't bet)
Seat 3: CO folded before Flop (didn't bet)
Seat 4: BTN (button) showed [6d Ad] and won ($0.94) with a flush, Ace high
Seat 5: SB (small blind) folded before Flop
Seat 6: BB (big blind) mucked


PokerStars Hand #238160062321:  Hold'em No Limit ($0.01/$0.02 USD) - 2022/08/22 22:12:18 ET
Table 'Achilles IV' 6-max Seat #5 is the button
Seat 1: BB ($3.54 in chips)
Seat 2: UTG ($2.06 in chips)
Seat 3: HJ ($1.50 in chips)
Seat 4: CO ($2.55 in chips)
Seat 5: BTN ($1.27 in chips)
Seat 6: SB ($0.49 in chips)
SB: posts small blind $0.01
BB: posts big blind $0.02
*** HOLE CARDS ***
UTG: raises $0.04 to $0.06
HJ: folds
CO: folds
BTN: folds
SB: calls $0.05
BB: folds
*** FLOP *** [Qc 8c 5c]
SB: bets $0.02
UTG: folds
Uncalled bet ($0.02) returned to SB
SB collected $0.14 from pot
*** SUMMARY ***
Total pot $0.14 | Rake $0
Board [Qc 8c 5c]
Seat 1: BB (big blind) folded before Flop
Seat 2: UTG folded on the Flop
Seat 3: HJ folded before Flop (didn't bet)
Seat 4: CO folded before Flop (didn't bet)
Seat 5: BTN (button) folded before Flop (didn't bet)
Seat 6: SB (small blind) collected ($0.14)


PokerStars Hand #238160066729:  Hold'em No Limit ($0.01/$0.02 USD) - 2022/08/22 22:12:41 ET
Table 'Achilles IV' 6-max Seat #6 is the button
Seat 1: SB ($3.52 in chips)
Seat 2: BB ($2 in chips)
Seat 3: UTG ($1.50 in chips)
Seat 4: HJ ($2.55 in chips)
Seat 5: CO ($1.27 in chips)
Seat 6: BTN ($0.57 in chips)
SB: posts small blind $0.01
BB: posts big blind $0.02
*** HOLE CARDS ***
UTG: folds
HJ: folds
CO: calls $0.02
BTN: raises $0.02 to $0.04
SB: folds
BB: calls $0.02
CO: raises $0.55 to $0.59
BTN: calls $0.53 and is all-in
BB: folds
Uncalled bet ($0.02) returned to CO
*** FLOP *** [Tc 3h Th]
*** TURN *** [Tc 3h Th] [8h]
*** RIVER *** [Tc 3h Th 8h] [3c]
*** SHOW DOWN ***
CO: shows [8c 8s] (a full house, Eights full of Tens)
BTN: shows [Js 9d] (two pair, Tens and Threes)
CO cashed out the hand for $0.62 | Cash Out Fee $0.01
*** SUMMARY ***
Total pot $1.19 | Rake $0.04
Board [Tc 3h Th 8h 3c]
Seat 1: SB (small blind) folded before Flop
Seat 2: BB (big blind) folded before Flop
Seat 3: UTG folded before Flop (didn't bet)
Seat 4: HJ folded before Flop (didn't bet)
Seat 5: CO showed [8c 8s] and won ($1.15) with a full house, Eights full of Tens (pot not awarded as player cashed out)
Seat 6: BTN (button) showed [Js 9d] and lost with two pair, Tens and Threes


PokerStars Hand #238160074232:  Hold'em No Limit ($0.01/$0.02 USD) - 2022/08/22 22:13:21 ET
Table 'Achilles IV' 6-max Seat #1 is the button
Seat 1: BTN ($3.51 in chips)
Seat 2: SB ($1.96 in chips)
Seat 3: BB ($1.50 in chips)
Seat 4: HJ ($2.55 in chips)
Seat 5: CO ($1.32 in chips)
SB: posts small blind $0.01
BB: posts big blind $0.02
*** HOLE CARDS ***
HJ: raises $0.02 to $0.04
chrisluh81 leaves the table
CO: folds
BTN: raises $0.09 to $0.13
SB: folds
BB: folds
TammyFs joins the table at seat #6
HJ: folds
Uncalled bet ($0.09) returned to BTN
BTN collected $0.11 from pot
*** SUMMARY ***
Total pot $0.11 | Rake $0
Seat 1: BTN (button) collected ($0.11)
Seat 2: SB (small blind) folded before Flop
Seat 3: BB (big blind) folded before Flop
Seat 4: HJ folded before Flop
Seat 5: CO folded before Flop (didn't bet)


PokerStars Hand #238160080794:  Hold'em No Limit ($0.01/$0.02 USD) - 2022/08/22 22:13:56 ET
Table 'Achilles IV' 6-max Seat #2 is the button
Seat 1: CO ($3.58 in chips)
Seat 2: BTN ($1.95 in chips)
Seat 3: SB ($1.48 in chips)
Seat 4: BB ($2.51 in chips)
Seat 5: HJ ($1.32 in chips)
SB: posts small blind $0.01
BB: posts big blind $0.02
TammyFs: sits out
*** HOLE CARDS ***
HJ: folds
CO: folds
BTN: raises $0.04 to $0.06
SB: folds
BB: folds
Uncalled bet ($0.04) returned to BTN
BTN collected $0.05 from pot
BTN: doesn't show hand
*** SUMMARY ***
Total pot $0.05 | Rake $0
Seat 1: CO folded before Flop (didn't bet)
Seat 2: BTN (button) collected ($0.05)
Seat 3: SB (small blind) folded before Flop
Seat 4: BB (big blind) folded before Flop
Seat 5: HJ folded before Flop (didn't bet)


PokerStars Hand #238160090241:  Hold'em No Limit ($0.01/$0.02 USD) - 2022/08/22 22:14:14 ET
Table 'Achilles IV' 6-max Seat #3 is the button
Seat 1: HJ ($3.58 in chips)
Seat 2: CO ($1.98 in chips)
Seat 3: BTN ($1.47 in chips)
Seat 4: SB ($2.49 in chips)
Seat 5: BB ($1.32 in chips)
SB: posts small blind $0.01
BB: posts big blind $0.02
TammyFs: sits out
*** HOLE CARDS ***
HJ: folds
CO: folds
BTN: raises $0.04 to $0.06
SB: folds
BB: folds
Uncalled bet ($0.04) returned to BTN
BTN collected $0.05 from pot
*** SUMMARY ***
Total pot $0.05 | Rake $0
Seat 1: HJ folded before Flop (didn't bet)
Seat 2: CO folded before Flop (didn't bet)
Seat 3: BTN (button) collected ($0.05)
Seat 4: SB (small blind) folded before Flop
Seat 5: BB (big blind) folded before Flop


PokerStars Hand #238160093995:  Hold'em No Limit ($0.01/$0.02 USD) - 2022/08/22 22:14:34 ET
Table 'Achilles IV' 6-max Seat #4 is the button
Seat 1: UTG ($3.58 in chips)
Seat 2: HJ ($1.98 in chips)
Seat 3: CO ($1.50 in chips)
Seat 4: BTN ($2.48 in chips)
Seat 5: SB ($1.30 in chips)
Seat 6: BB ($0.80 in chips)
SB: posts small blind $0.01
BB: posts big blind $0.02
*** HOLE CARDS ***
UTG: folds
HJ: folds
CO: folds
BTN: raises $0.04 to $0.06
SB: folds
BB: calls $0.04
*** FLOP *** [2c 4h Qd]
BB: bets $0.06
BTN: calls $0.06
*** TURN *** [2c 4h Qd] [Qs]
BB: bets $0.10
BTN: folds
Uncalled bet ($0.10) returned to BB
BB collected $0.24 from pot
*** SUMMARY ***
Total pot $0.25 | Rake $0.01
Board [2c 4h Qd Qs]
Seat 1: UTG folded before Flop (didn't bet)
Seat 2: HJ folded before Flop (didn't bet)
Seat 3: CO folded before Flop (didn't bet)
Seat 4: BTN (button) folded on the Turn
Seat 5: SB (small blind) folded before Flop
Seat 6: BB (big blind) collected ($0.24)


PokerStars Hand #238160103082:  Hold'em No Limit ($0.01/$0.02 USD) - 2022/08/22 22:15:23 ET
Table 'Achilles IV' 6-max Seat #5 is the button
Seat 1: BB ($3.58 in chips)
Seat 2: UTG ($1.98 in chips)
Seat 3: HJ ($1.50 in chips)
Seat 4: CO ($2.36 in chips)
Seat 5: BTN ($1.29 in chips)
Seat 6: SB ($0.92 in chips)
SB: posts small blind $0.01
BB: posts big blind $0.02
*** HOLE CARDS ***
UTG: folds
HJ: folds
CO: folds
BTN: raises $0.04 to $0.06
SB: folds
BB: folds
Uncalled bet ($0.04) returned to BTN
BTN collected $0.05 from pot
BTN: doesn't show hand
*** SUMMARY ***
Total pot $0.05 | Rake $0
Seat 1: BB (big blind) folded before Flop
Seat 2: UTG folded before Flop (didn't bet)
Seat 3: HJ folded before Flop (didn't bet)
Seat 4: CO folded before Flop (didn't bet)
Seat 5: BTN (button) collected ($0.05)
Seat 6: SB (small blind) folded before Flop


PokerStars Hand #238160109293:  Hold'em No Limit ($0.01/$0.02 USD) - 2022/08/22 22:15:56 ET
Table 'Achilles IV' 6-max Seat #6 is the button
Seat 1: SB ($3.56 in chips)
Seat 2: BB ($1.98 in chips)
Seat 3: UTG ($1.50 in chips)
Seat 4: HJ ($2.36 in chips)
Seat 5: CO ($1.32 in chips)
Seat 6: BTN ($0.91 in chips)
SB: posts small blind $0.01
BB: posts big blind $0.02
*** HOLE CARDS ***
UTG: folds
HJ: folds
CO: folds
BTN: raises $0.02 to $0.04
SB: folds
BB: calls $0.02
*** FLOP *** [8c Jh 6c]
BB: bets $0.04
BTN: calls $0.04
*** TURN *** [8c Jh 6c] [Qs]
BB: bets $0.08
BTN: calls $0.08
*** RIVER *** [8c Jh 6c Qs] [Ks]
BB: checks
BTN: bets $0.16
BB: calls $0.16
*** SHOW DOWN ***
BTN: shows [8h Kh] (two pair, Kings and Eights)
BB: mucks hand
BTN collected $0.63 from pot
*** SUMMARY ***
Total pot $0.65 | Rake $0.02
Board [8c Jh 6c Qs Ks]
Seat 1: SB (small blind) folded before Flop
Seat 2: BB (big blind) mucked
Seat 3: UTG folded before Flop (didn't bet)
Seat 4: HJ folded before Flop (didn't bet)
Seat 5: CO folded before Flop (didn't bet)
Seat 6: BTN (button) showed [8h Kh] and won ($0.63) with two pair, Kings and Eights


PokerStars Hand #238160118897:  Hold'em No Limit ($0.01/$0.02 USD) - 2022/08/22 22:16:48 ET
Table 'Achilles IV' 6-max Seat #1 is the button
Seat 1: BTN ($3.55 in chips)
Seat 2: SB ($1.66 in chips)
Seat 3: BB ($1.50 in chips)
Seat 4: UTG ($2.36 in chips)
Seat 5: HJ ($1.32 in chips)
Seat 6: CO ($1.22 in chips)
SB: posts small blind $0.01
BB: posts big blind $0.02
*** HOLE CARDS ***
UTG: folds
HJ: folds
CO: raises $0.02 to $0.04
BTN: folds
UTG leaves the table
SB: calls $0.03
BB: folds
*** FLOP *** [Kc 2c 6d]
rjmnhs joins the table at seat #4
SB: bets $0.05
CO: calls $0.05
*** TURN *** [Kc 2c 6d] [5d]
SB: bets $0.09
CO: calls $0.09
*** RIVER *** [Kc 2c 6d 5d] [Jd]
SB: checks
CO: checks
*** SHOW DOWN ***
SB: shows [Ks 8d] (a pair of Kings)
CO: mucks hand
SB collected $0.37 from pot
*** SUMMARY ***
Total pot $0.38 | Rake $0.01
Board [Kc 2c 6d 5d Jd]
Seat 1: BTN (button) folded before Flop (didn't bet)
Seat 2: SB (small blind) showed [Ks 8d] and won ($0.37) with a pair of Kings
Seat 3: BB (big blind) folded before Flop
Seat 4: UTG folded before Flop (didn't bet)
Seat 5: HJ folded before Flop (didn't bet)
Seat 6: CO mucked


PokerStars Hand #238160136547:  Hold'em No Limit ($0.01/$0.02 USD) - 2022/08/22 22:17:32 ET
Table 'Achilles IV' 6-max Seat #2 is the button
Seat 1: CO ($3.55 in chips)
Seat 2: BTN ($1.85 in chips)
Seat 3: SB ($1.48 in chips)
Seat 4: BB ($0.80 in chips)
Seat 5: UTG ($1.32 in chips)
Seat 6: HJ ($1.04 in chips)
SB: posts small blind $0.01
BB: posts big blind $0.02
*** HOLE CARDS ***
UTG: raises $0.04 to $0.06
HJ: calls $0.06
CO: calls $0.06
BTN: folds
SB: folds
BB: calls $0.04
*** FLOP *** [2d 2s 9h]
BB: checks
UTG: bets $0.14
HJ: folds
CO: folds
BB: folds
Uncalled bet ($0.14) returned to UTG
UTG collected $0.24 from pot
UTG: doesn't show hand
*** SUMMARY ***
Total pot $0.25 | Rake $0.01
Board [2d 2s 9h]
Seat 1: CO folded on the Flop
Seat 2: BTN (button) folded before Flop (didn't bet)
Seat 3: SB (small blind) folded before Flop
Seat 4: BB (big blind) folded on the Flop
Seat 5: UTG collected ($0.24)
Seat 6: HJ folded on the Flop


PokerStars Hand #238160146845:  Hold'em No Limit ($0.01/$0.02 USD) - 2022/08/22 22:18:27 ET
Table 'Achilles IV' 6-max Seat #3 is the button
Seat 1: HJ ($3.49 in chips)
Seat 2: CO ($1.85 in chips)
Seat 3: BTN ($1.47 in chips)
Seat 4: SB ($0.74 in chips)
Seat 5: BB ($1.50 in chips)
Seat 6: UTG ($0.98 in chips)
SB: posts small blind $0.01
BB: posts big blind $0.02
*** HOLE CARDS ***
UTG: folds
HJ: folds
CO: folds
BTN: folds
SB: folds
Uncalled bet ($0.01) returned to BB
BB collected $0.02 from pot
BB: doesn't show hand
*** SUMMARY ***
Total pot $0.02 | Rake $0
Seat 1: HJ folded before Flop (didn't bet)
Seat 2: CO folded before Flop (didn't bet)
Seat 3: BTN (button) folded before Flop (didn't bet)
Seat 4: SB (small blind) folded before Flop
Seat 5: BB (big blind) collected ($0.02)
Seat 6: UTG folded before Flop (didn't bet)


PokerStars Hand #238160148931:  Hold'em No Limit ($0.01/$0.02 USD) - 2022/08/22 22:18:38 ET
Table 'Achilles IV' 6-max Seat #4 is the button
Seat 1: UTG ($3.49 in chips)
Seat 2: HJ ($1.85 in chips)
Seat 3: CO ($1.47 in chips)
Seat 4: BTN ($0.73 in chips)
Seat 5: SB ($1.51 in chips)
Seat 6: BB ($0.98 in chips)
SB: posts small blind $0.01
BB: posts big blind $0.02
*** HOLE CARDS ***
UTG: folds
HJ: folds
CO: calls $0.02
BTN: raises $0.04 to $0.06
SB: folds
BB: folds
CO: calls $0.04
*** FLOP *** [3s 7s 6s]
CO: checks
BTN: checks
*** TURN *** [3s 7s 6s] [9h]
CO: checks
BTN: checks
*** RIVER *** [3s 7s 6s 9h] [Js]
CO: bets $0.06
BTN: folds
Uncalled bet ($0.06) returned to CO
CO collected $0.14 from pot
*** SUMMARY ***
Total pot $0.15 | Rake $0.01
Board [3s 7s 6s 9h Js]
Seat 1: UTG folded before Flop (didn't bet)
Seat 2: HJ folded before Flop (didn't bet)
Seat 3: CO collected ($0.14)
Seat 4: BTN (button) folded on the River
Seat 5: SB (small blind) folded before Flop
Seat 6: BB (big blind) folded before Flop


PokerStars Hand #238160154658:  Hold'em No Limit ($0.01/$0.02 USD) - 2022/08/22 22:19:09 ET
Table 'Achilles IV' 6-max Seat #5 is the button
Seat 1: BB ($3.49 in chips)
Seat 2: UTG ($1.85 in chips)
Seat 3: HJ ($1.55 in chips)
Seat 4: CO ($0.67 in chips)
Seat 5: BTN ($1.50 in chips)
Seat 6: SB ($0.96 in chips)
SB: posts small blind $0.01
BB: posts big blind $0.02
*** HOLE CARDS ***
UTG: calls $0.02
HJ: raises $0.06 to $0.08
CO: folds
BTN: calls $0.08
SB: folds
BB: folds
UTG: calls $0.06
*** FLOP *** [Ks 9c 5c]
UTG: checks
HJ: bets $0.10
BTN: calls $0.10
UTG: folds
*** TURN *** [Ks 9c 5c] [7d]
HJ: bets $0.10
BTN: calls $0.10
*** RIVER *** [Ks 9c 5c 7d] [7c]
HJ: bets $0.10
BTN: calls $0.10
*** SHOW DOWN ***
HJ: shows [9h 9s] (a full house, Nines full of Sevens)
BTN: mucks hand
HJ collected $0.84 from pot
*** SUMMARY ***
Total pot $0.87 | Rake $0.03
Board [Ks 9c 5c 7d 7c]
Seat 1: BB (big blind) folded before Flop
Seat 2: UTG folded on the Flop
Seat 3: HJ showed [9h 9s] and won ($0.84) with a full house, Nines full of Sevens
Seat 4: CO folded before Flop (didn't bet)
Seat 5: BTN (button) mucked
Seat 6: SB (small blind) folded before Flop


PokerStars Hand #238160169172:  Hold'em No Limit ($0.01/$0.02 USD) - 2022/08/22 22:20:26 ET
Table 'Achilles IV' 6-max Seat #6 is the button
Seat 2: SB ($1.77 in chips)
Seat 3: BB ($2.01 in chips)
Seat 4: HJ ($0.67 in chips)
Seat 5: CO ($1.12 in chips)
Seat 6: BTN ($0.95 in chips)
SB: posts small blind $0.01
BB: posts big blind $0.02
*** HOLE CARDS ***
HJ: folds
CO: folds
BTN: calls $0.02
SB: calls $0.01
BB: checks
*** FLOP *** [2c 9c 6s]
SB: checks
BB: checks
BTN: bets $0.03
SB: folds
BB: folds
Uncalled bet ($0.03) returned to BTN
BTN collected $0.06 from pot
*** SUMMARY ***
Total pot $0.06 | Rake $0
Board [2c 9c 6s]
Seat 2: SB (small blind) folded on the Flop
Seat 3: BB (big blind) folded on the Flop
Seat 4: HJ folded before Flop (didn't bet)
Seat 5: CO folded before Flop (didn't bet)
Seat 6: BTN (button) collected ($0.06)


PokerStars Hand #238160174831:  Hold'em No Limit ($0.01/$0.02 USD) - 2022/08/22 22:20:57 ET
Table 'Achilles IV' 6-max Seat #2 is the button
Seat 2: BTN ($1.75 in chips)
Seat 3: SB ($1.99 in chips)
Seat 4: BB ($0.67 in chips)
Seat 5: HJ ($1.12 in chips)
Seat 6: CO ($0.99 in chips)
SB: posts small blind $0.01
BB: posts big blind $0.02
Ramirres: sits out
*** HOLE CARDS ***
HJ: folds
CO: folds
BTN: calls $0.02
SB: folds
BB: raises $0.05 to $0.07
BTN: calls $0.05
*** FLOP *** [4c 4h 2h]
BB: bets $0.07
BTN: folds
Uncalled bet ($0.07) returned to BB
BB collected $0.14 from pot
*** SUMMARY ***
Total pot $0.15 | Rake $0.01
Board [4c 4h 2h]
Seat 2: BTN (button) folded on the Flop
Seat 3: SB (small blind) folded before Flop
Seat 4: BB (big blind) collected ($0.14)
Seat 5: HJ folded before Flop (didn't bet)
Seat 6: CO folded before Flop (didn't bet)


PokerStars Hand #238160178496:  Hold'em No Limit ($0.01/$0.02 USD) - 2022/08/22 22:21:16 ET
Table 'Achilles IV' 6-max Seat #3 is the button
Seat 2: CO ($1.68 in chips)
Seat 3: BTN ($1.98 in chips)
Seat 4: SB ($0.74 in chips)
Seat 5: BB ($2 in chips)
Seat 6: HJ ($0.99 in chips)
SB: posts small blind $0.01
BB: posts big blind $0.02
Ramirres: sits out
*** HOLE CARDS ***
HJ: raises $0.02 to $0.04
CO: calls $0.04
BTN: folds
SB: calls $0.03
BB: folds
*** FLOP *** [Jd Th 4c]
SB: checks
HJ: checks
CO: checks
*** TURN *** [Jd Th 4c] [5s]
SB: checks
HJ: bets $0.02
CO: folds
SB: calls $0.02
*** RIVER *** [Jd Th 4c 5s] [9s]
SB: checks
HJ: bets $0.08
SB: folds
Uncalled bet ($0.08) returned to HJ
HJ collected $0.17 from pot
*** SUMMARY ***
Total pot $0.18 | Rake $0.01
Board [Jd Th 4c 5s 9s]
Seat 2: CO folded on the Turn
Seat 3: BTN (button) folded before Flop (didn't bet)
Seat 4: SB (small blind) folded on the River
Seat 5: BB (big blind) folded before Flop
Seat 6: HJ collected ($0.17)


PokerStars Hand #238160184676:  Hold'em No Limit ($0.01/$0.02 USD) - 2022/08/22 22:21:49 ET
Table 'Achilles IV' 6-max Seat #4 is the button
Seat 2: HJ ($1.64 in chips)
Seat 3: CO ($1.98 in chips)
Seat 4: BTN ($0.68 in chips)
Seat 5: SB ($1.98 in chips)
Seat 6: BB ($1.10 in chips)
SB: posts small blind $0.01
BB: posts big blind $0.02
Ramirres: sits out
*** HOLE CARDS ***
HJ: folds
CO: calls $0.02
BTN: raises $0.04 to $0.06
SB: folds
BB: calls $0.04
CO: calls $0.04
*** FLOP *** [Qs Td Ah]
BB: bets $0.09
CO: folds
BTN: calls $0.09
*** TURN *** [Qs Td Ah] [2d]
BB: checks
BTN: bets $0.18
BB: folds
Uncalled bet ($0.18) returned to BTN
BTN collected $0.36 from pot
*** SUMMARY ***
Total pot $0.37 | Rake $0.01
Board [Qs Td Ah 2d]
Seat 2: HJ folded before Flop (didn't bet)
Seat 3: CO folded on the Flop
Seat 4: BTN (button) collected ($0.36)
Seat 5: SB (small blind) folded before Flop
Seat 6: BB (big blind) folded on the Turn


PokerStars Hand #238160193265:  Hold'em No Limit ($0.01/$0.02 USD) - 2022/08/22 22:22:36 ET
Table 'Achilles IV' 6-max Seat #5 is the button
Seat 1: BB ($3.47 in chips)
Seat 2: UTG ($1.64 in chips)
Seat 3: HJ ($1.92 in chips)
Seat 4: CO ($0.89 in chips)
Seat 5: BTN ($1.97 in chips)
Seat 6: SB ($0.95 in chips)
SB: posts small blind $0.01
BB: posts big blind $0.02
*** HOLE CARDS ***
UTG: folds
HJ: raises $0.02 to $0.04
CO: folds
BTN: folds
SB: calls $0.03
BB: folds
*** FLOP *** [7c 6s Kc]
SB: bets $0.05
HJ: folds
Uncalled bet ($0.05) returned to SB
SB collected $0.10 from pot
*** SUMMARY ***
Total pot $0.10 | Rake $0
Board [7c 6s Kc]
Seat 1: BB (big blind) folded before Flop
Seat 2: UTG folded before Flop (didn't bet)
Seat 3: HJ folded on the Flop
Seat 4: CO folded before Flop (didn't bet)
Seat 5: BTN (button) folded before Flop (didn't bet)
Seat 6: SB (small blind) collected ($0.10)


PokerStars Hand #238160201200:  Hold'em No Limit ($0.01/$0.02 USD) - 2022/08/22 22:23:19 ET
Table 'Achilles IV' 6-max Seat #6 is the button
Seat 1: SB ($3.45 in chips)
Seat 2: BB ($1.64 in chips)
Seat 3: UTG ($1.88 in chips)
Seat 4: HJ ($0.89 in chips)
Seat 5: CO ($1.97 in chips)
Seat 6: BTN ($1.01 in chips)
SB: posts small blind $0.01
BB: posts big blind $0.02
*** HOLE CARDS ***
UTG: folds
HJ: folds
CO: folds
BTN: calls $0.02
SB: raises $0.08 to $0.10
BB: folds
BTN: calls $0.08
*** FLOP *** [3d 2d 4c]
SB: checks
BTN: checks
*** TURN *** [3d 2d 4c] [5c]
SB: bets $0.14
BTN: folds
Uncalled bet ($0.14) returned to SB
SB collected $0.21 from pot
*** SUMMARY ***
Total pot $0.22 | Rake $0.01
Board [3d 2d 4c 5c]
Seat 1: SB (small blind) collected ($0.21)
Seat 2: BB (big blind) folded before Flop
Seat 3: UTG folded before Flop (didn't bet)
Seat 4: HJ folded before Flop (didn't bet)
Seat 5: CO folded before Flop (didn't bet)
Seat 6: BTN (button) folded on the Turn


PokerStars Hand #238160208153:  Hold'em No Limit ($0.01/$0.02 USD) - 2022/08/22 22:23:56 ET
Table 'Achilles IV' 6-max Seat #1 is the button
Seat 1: BTN ($3.56 in chips)
Seat 2: SB ($1.62 in chips)
Seat 3: BB ($1.88 in chips)
Seat 4: UTG ($0.89 in chips)
Seat 5: HJ ($1.97 in chips)
Seat 6: CO ($0.91 in chips)
SB: posts small blind $0.01
BB: posts big blind $0.02
*** HOLE CARDS ***
UTG: folds
HJ: raises $0.04 to $0.06
CO: folds
BTN: folds
SB: folds
BB: folds
Uncalled bet ($0.04) returned to HJ
HJ collected $0.05 from pot
HJ: doesn't show hand
*** SUMMARY ***
Total pot $0.05 | Rake $0
Seat 1: BTN (button) folded before Flop (didn't bet)
Seat 2: SB (small blind) folded before Flop
Seat 3: BB (big blind) folded before Flop
Seat 4: UTG folded before Flop (didn't bet)
Seat 5: HJ collected ($0.05)
Seat 6: CO folded before Flop (didn't bet)


PokerStars Hand #238160221292:  Hold'em No Limit ($0.01/$0.02 USD) - 2022/08/22 22:24:19 ET
Table 'Achilles IV' 6-max Seat #2 is the button
Seat 1: CO ($3.56 in chips)
Seat 2: BTN ($1.61 in chips)
Seat 3: SB ($1.86 in chips)
Seat 4: BB ($0.89 in chips)
Seat 5: UTG ($2 in chips)
Seat 6: HJ ($0.91 in chips)
SB: posts small blind $0.01
BB: posts big blind $0.02
*** HOLE CARDS ***
UTG: folds
HJ: calls $0.02
CO: folds
BTN: folds
SB: folds
BB: checks
*** FLOP *** [Ks Jc Qh]
BB: checks
HJ: checks
*** TURN *** [Ks Jc Qh] [6h]
BB: checks
HJ: checks
*** RIVER *** [Ks Jc Qh 6h] [Kh]
BB: checks
HJ: checks
*** SHOW DOWN ***
BB: shows [5d Qc] (two pair, Kings and Queens)
HJ: mucks hand
BB collected $0.05 from pot
*** SUMMARY ***
Total pot $0.05 | Rake $0
Board [Ks Jc Qh 6h Kh]
Seat 1: CO folded before Flop (didn't bet)
Seat 2: BTN (button) folded before Flop (didn't bet)
Seat 3: SB (small blind) folded before Flop
Seat 4: BB (big blind) showed [5d Qc] and won ($0.05) with two pair, Kings and Queens
Seat 5: UTG folded before Flop (didn't bet)
Seat 6: HJ mucked


PokerStars Hand #238160225716:  Hold'em No Limit ($0.01/$0.02 USD) - 2022/08/22 22:24:43 ET
Table 'Achilles IV' 6-max Seat #3 is the button
Seat 1: HJ ($3.56 in chips)
Seat 2: CO ($1.61 in chips)
Seat 3: BTN ($1.85 in chips)
Seat 4: SB ($0.92 in chips)
Seat 5: BB ($2 in chips)
Seat 6: UTG ($0.89 in chips)
SB: posts small blind $0.01
BB: posts big blind $0.02
*** HOLE CARDS ***
UTG: calls $0.02
HJ: folds
CO: calls $0.02
BTN: folds
SB: folds
BB: checks
*** FLOP *** [6c 3h Jd]
BB: checks
UTG: bets $0.02
CO: calls $0.02
BB: folds
*** TURN *** [6c 3h Jd] [Kd]
UTG: bets $0.05
CO: calls $0.05
*** RIVER *** [6c 3h Jd Kd] [As]
UTG: checks
CO: bets $0.10
UTG: calls $0.10
*** SHOW DOWN ***
CO: shows [Th Qh] (a straight, Ten to Ace)
UTG: mucks hand
CO collected $0.40 from pot
*** SUMMARY ***
Total pot $0.41 | Rake $0.01
Board [6c 3h Jd Kd As]
Seat 1: HJ folded before Flop (didn't bet)
Seat 2: CO showed [Th Qh] and won ($0.40) with a straight, Ten to Ace
Seat 3: BTN (button) folded before Flop (didn't bet)
Seat 4: SB (small blind) folded before Flop
Seat 5: BB (big blind) folded on the Flop
Seat 6: UTG mucked


PokerStars Hand #238160238094:  Hold'em No Limit ($0.01/$0.02 USD) - 2022/08/22 22:25:50 ET
Table 'Achilles IV' 6-max Seat #4 is the button
Seat 1: UTG ($3.56 in chips)
Seat 2: HJ ($1.82 in chips)
Seat 3: CO ($1.85 in chips)
Seat 4: BTN ($0.91 in chips)
Seat 5: SB ($1.98 in chips)
Seat 6: BB ($0.70 in chips)
SB: posts small blind $0.01
BB: posts big blind $0.02
*** HOLE CARDS ***
UTG: raises $0.04 to $0.06
HJ: folds
CO: calls $0.06
BTN: folds
SB: calls $0.05
BB: folds
*** FLOP *** [3d Ks 9c]
SB: checks
UTG: checks
CO: bets $0.08
SB: calls $0.08
UTG: folds
*** TURN *** [3d Ks 9c] [Jd]
SB: checks
CO: checks
*** RIVER *** [3d Ks 9c Jd] [7d]
SB: bets $0.17
CO: calls $0.17
*** SHOW DOWN ***
SB: shows [9d 9s] (three of a kind, Nines)
CO: mucks hand
SB collected $0.68 from pot
*** SUMMARY ***
Total pot $0.70 | Rake $0.02
Board [3d Ks 9c Jd 7d]
Seat 1: UTG folded on the Flop
Seat 2: HJ folded before Flop (didn't bet)
Seat 3: CO mucked
Seat 4: BTN (button) folded before Flop (didn't bet)
Seat 5: SB (small blind) showed [9d 9s] and won ($0.68) with three of a kind, Nines
Seat 6: BB (big blind) folded before Flop


PokerStars Hand #238160252240:  Hold'em No Limit ($0.01/$0.02 USD) - 2022/08/22 22:26:46 ET
Table 'Achilles IV' 6-max Seat #5 is the button
Seat 1: BB ($3.50 in chips)
Seat 2: UTG ($1.82 in chips)
Seat 3: HJ ($1.54 in chips)
Seat 4: CO ($0.91 in chips)
Seat 5: BTN ($2.35 in chips)
Seat 6: SB ($0.68 in chips)
SB: posts small blind $0.01
BB: posts big blind $0.02
*** HOLE CARDS ***
UTG: raises $0.05 to $0.07
HJ: calls $0.07
CO: folds
BTN: folds
SB: folds
BB: folds
*** FLOP *** [3c 6d Ac]
UTG: bets $0.08
HJ: folds
Uncalled bet ($0.08) returned to UTG
UTG collected $0.16 from pot
UTG: doesn't show hand
*** SUMMARY ***
Total pot $0.17 | Rake $0.01
Board [3c 6d Ac]
Seat 1: BB (big blind) folded before Flop
Seat 2: UTG collected ($0.16)
Seat 3: HJ folded on the Flop
Seat 4: CO folded before Flop (didn't bet)
Seat 5: BTN (button) folded before Flop (didn't bet)
Seat 6: SB (small blind) folded before Flop


PokerStars Hand #238160255498:  Hold'em No Limit ($0.01/$0.02 USD) - 2022/08/22 22:27:04 ET
Table 'Achilles IV' 6-max Seat #6 is the button
Seat 1: SB ($3.48 in chips)
Seat 2: BB ($1.91 in chips)
Seat 3: UTG ($1.47 in chips)
Seat 4: HJ ($0.91 in chips)
Seat 5: CO ($2.35 in chips)
Seat 6: BTN ($0.67 in chips)
SB: posts small blind $0.01
BB: posts big blind $0.02
*** HOLE CARDS ***
UTG: calls $0.02
HJ: raises $0.07 to $0.09
CO: folds
BTN: calls $0.09
SB: folds
BB: folds
UTG: calls $0.07
*** FLOP *** [8h Qd 8c]
UTG: checks
HJ: bets $0.14
BTN: folds
UTG: folds
Uncalled bet ($0.14) returned to HJ
HJ collected $0.29 from pot
*** SUMMARY ***
Total pot $0.30 | Rake $0.01
Board [8h Qd 8c]
Seat 1: SB (small blind) folded before Flop
Seat 2: BB (big blind) folded before Flop
Seat 3: UTG folded on the Flop
Seat 4: HJ collected ($0.29)
Seat 5: CO folded before Flop (didn't bet)
Seat 6: BTN (button) folded on the Flop


PokerStars Hand #238160263645:  Hold'em No Limit ($0.01/$0.02 USD) - 2022/08/22 22:27:49 ET
Table 'Achilles IV' 6-max Seat #1 is the button
Seat 1: BTN ($3.47 in chips)
Seat 2: SB ($1.89 in chips)
Seat 3: BB ($1.38 in chips)
Seat 4: UTG ($1.11 in chips)
Seat 5: HJ ($2.35 in chips)
Seat 6: CO ($0.58 in chips)
SB: posts small blind $0.01
BB: posts big blind $0.02
*** HOLE CARDS ***
UTG: folds
HJ: folds
CO: calls $0.02
BTN: folds
SB: calls $0.01
BB: checks
*** FLOP *** [7c 3h 5s]
SB: checks
BB: checks
CO: checks
*** TURN *** [7c 3h 5s] [2s]
SB: checks
BB: checks
CO: checks
*** RIVER *** [7c 3h 5s 2s] [Kh]
SB: checks
BB: bets $0.08
CO: calls $0.08
SB: calls $0.08
*** SHOW DOWN ***
BB: shows [2c Ks] (two pair, Kings and Deuces)
CO: mucks hand
SB: mucks hand
BB collected $0.29 from pot
*** SUMMARY ***
Total pot $0.30 | Rake $0.01
Board [7c 3h 5s 2s Kh]
Seat 1: BTN (button) folded before Flop (didn't bet)
Seat 2: SB (small blind) mucked
Seat 3: BB (big blind) showed [2c Ks] and won ($0.29) with two pair, Kings and Deuces
Seat 4: UTG folded before Flop (didn't bet)
Seat 5: HJ folded before Flop (didn't bet)
Seat 6: CO mucked


PokerStars Hand #238160273508:  Hold'em No Limit ($0.01/$0.02 USD) - 2022/08/22 22:28:44 ET
Table 'Achilles IV' 6-max Seat #2 is the button
Seat 1: CO ($3.47 in chips)
Seat 2: BTN ($1.79 in chips)
Seat 3: SB ($1.57 in chips)
Seat 4: BB ($1.11 in chips)
Seat 5: UTG ($2.35 in chips)
Seat 6: HJ ($0.48 in chips)
SB: posts small blind $0.01
BB: posts big blind $0.02
*** HOLE CARDS ***
UTG: folds
HJ: calls $0.02
CO: folds
BTN: folds
SB: folds
BB: checks
*** FLOP *** [7s 5s Kh]
BB: checks
HJ: bets $0.05
BB: folds
Uncalled bet ($0.05) returned to HJ
HJ collected $0.05 from pot
*** SUMMARY ***
Total pot $0.05 | Rake $0
Board [7s 5s Kh]
Seat 1: CO folded before Flop (didn't bet)
Seat 2: BTN (button) folded before Flop (didn't bet)
Seat 3: SB (small blind) folded before Flop
Seat 4: BB (big blind) folded on the Flop
Seat 5: UTG folded before Flop (didn't bet)
Seat 6: HJ collected ($0.05)


PokerStars Hand #238160277910:  Hold'em No Limit ($0.01/$0.02 USD) - 2022/08/22 22:29:07 ET
Table 'Achilles IV' 6-max Seat #3 is the button
Seat 1: HJ ($3.47 in chips)
Seat 2: CO ($1.79 in chips)
Seat 3: BTN ($1.56 in chips)
Seat 4: SB ($1.09 in chips)
Seat 5: BB ($2.35 in chips)
Seat 6: UTG ($0.51 in chips)
SB: posts small blind $0.01
BB: posts big blind $0.02
*** HOLE CARDS ***
UTG: calls $0.02
HJ: folds
CO has timed out
CO: folds
BTN: calls $0.02
SB: raises $0.08 to $0.10
BB: calls $0.08
UTG: folds
BTN: folds
*** FLOP *** [7c 6d Ah]
SB: bets $0.11
BB: calls $0.11
*** TURN *** [7c 6d Ah] [9c]
SB: bets $0.22
BB: folds
Uncalled bet ($0.22) returned to SB
SB collected $0.44 from pot
*** SUMMARY ***
Total pot $0.46 | Rake $0.02
Board [7c 6d Ah 9c]
Seat 1: HJ folded before Flop (didn't bet)
Seat 2: CO folded before Flop (didn't bet)
Seat 3: BTN (button) folded before Flop
Seat 4: SB (small blind) collected ($0.44)
Seat 5: BB (big blind) folded on the Turn
Seat 6: UTG folded before Flop


PokerStars Hand #238160288064:  Hold'em No Limit ($0.01/$0.02 USD) - 2022/08/22 22:30:03 ET
Table 'Achilles IV' 6-max Seat #4 is the button
Seat 2: HJ ($1.79 in chips)
Seat 3: CO ($1.54 in chips)
Seat 4: BTN ($1.32 in chips)
Seat 5: SB ($2.14 in chips)
Seat 6: BB ($0.49 in chips)
SB: posts small blind $0.01
BB: posts big blind $0.02
*** HOLE CARDS ***
HJ: folds
CO: calls $0.02
BTN: folds
SB: raises $0.08 to $0.10
BB: folds
CO: folds
Uncalled bet ($0.08) returned to SB
SB collected $0.06 from pot
SB: doesn't show hand
*** SUMMARY ***
Total pot $0.06 | Rake $0
Seat 2: HJ folded before Flop (didn't bet)
Seat 3: CO folded before Flop
Seat 4: BTN (button) folded before Flop (didn't bet)
Seat 5: SB (small blind) collected ($0.06)
Seat 6: BB (big blind) folded before Flop


PokerStars Hand #238160293289:  Hold'em No Limit ($0.01/$0.02 USD) - 2022/08/22 22:30:33 ET
Table 'Achilles IV' 6-max Seat #5 is the button
Seat 1: BB ($3.47 in chips)
Seat 2: UTG ($1.79 in chips)
Seat 3: HJ ($1.52 in chips)
Seat 4: CO ($1.32 in chips)
Seat 5: BTN ($2.18 in chips)
Seat 6: SB ($0.47 in chips)
SB: posts small blind $0.01
BB: posts big blind $0.02
*** HOLE CARDS ***
UTG: raises $0.05 to $0.07
HJ: folds
CO: folds
BTN: folds
SB: calls $0.06
BB: calls $0.05
*** FLOP *** [Kc 2s 5s]
SB: checks
BB: bets $0.14
UTG: folds
SB: calls $0.14
*** TURN *** [Kc 2s 5s] [Kh]
SB: checks
BB: bets $0.31
SB: folds
Uncalled bet ($0.31) returned to BB
BB collected $0.47 from pot
*** SUMMARY ***
Total pot $0.49 | Rake $0.02
Board [Kc 2s 5s Kh]
Seat 1: BB (big blind) collected ($0.47)
Seat 2: UTG folded on the Flop
Seat 3: HJ folded before Flop (didn't bet)
Seat 4: CO folded before Flop (didn't bet)
Seat 5: BTN (button) folded before Flop (didn't bet)
Seat 6: SB (small blind) folded on the Turn


PokerStars Hand #238160304932:  Hold'em No Limit ($0.01/$0.02 USD) - 2022/08/22 22:31:37 ET
Table 'Achilles IV' 6-max Seat #6 is the button
Seat 1: SB ($3.73 in chips)
Seat 2: BB ($1.72 in chips)
Seat 3: UTG ($1.52 in chips)
Seat 4: HJ ($1.32 in chips)
Seat 5: CO ($2.18 in chips)
Seat 6: BTN ($0.26 in chips)
SB: posts small blind $0.01
BB: posts big blind $0.02
*** HOLE CARDS ***
UTG: folds
HJ: folds
CO: folds
BTN: calls $0.02
SB: raises $0.08 to $0.10
BB: folds
BTN: folds
Uncalled bet ($0.08) returned to SB
SB collected $0.06 from pot
*** SUMMARY ***
Total pot $0.06 | Rake $0
Seat 1: SB (small blind) collected ($0.06)
Seat 2: BB (big blind) folded before Flop
Seat 3: UTG folded before Flop (didn't bet)
Seat 4: HJ folded before Flop (didn't bet)
Seat 5: CO folded before Flop (didn't bet)
Seat 6: BTN (button) folded before Flop


PokerStars Hand #238160308316:  Hold'em No Limit ($0.01/$0.02 USD) - 2022/08/22 22:31:56 ET
Table 'Achilles IV' 6-max Seat #1 is the button
Seat 1: BTN ($3.77 in chips)
Seat 2: SB ($1.70 in chips)
Seat 3: BB ($1.52 in chips)
Seat 4: UTG ($1.32 in chips)
Seat 5: HJ ($2.18 in chips)
Seat 6: CO ($0.24 in chips)
SB: posts small blind $0.01
BB: posts big blind $0.02
*** HOLE CARDS ***
UTG: folds
HJ: folds
CO: calls $0.02
BTN: folds
SB: calls $0.01
BB: checks
*** FLOP *** [6s Kc 5c]
SB: checks
BB: checks
CO: checks
*** TURN *** [6s Kc 5c] [Ah]
SB: checks
BB: checks
CO: bets $0.06
SB: calls $0.06
BB: folds
*** RIVER *** [6s Kc 5c Ah] [4s]
SB: checks
CO: checks
*** SHOW DOWN ***
SB: shows [Ac 3c] (a pair of Aces)
CO: mucks hand
SB collected $0.17 from pot
*** SUMMARY ***
Total pot $0.18 | Rake $0.01
Board [6s Kc 5c Ah 4s]
Seat 1: BTN (button) folded before Flop (didn't bet)
Seat 2: SB (small blind) showed [Ac 3c] and won ($0.17) with a pair of Aces
Seat 3: BB (big blind) folded on the Turn
Seat 4: UTG folded before Flop (didn't bet)
Seat 5: HJ folded before Flop (didn't bet)
Seat 6: CO mucked


PokerStars Hand #238160315416:  Hold'em No Limit ($0.01/$0.02 USD) - 2022/08/22 22:32:35 ET
Table 'Achilles IV' 6-max Seat #2 is the button
Seat 1: CO ($3.77 in chips)
Seat 2: BTN ($1.79 in chips)
Seat 3: SB ($1.50 in chips)
Seat 4: BB ($1.32 in chips)
Seat 5: UTG ($2.18 in chips)
Seat 6: HJ ($0.16 in chips)
SB: posts small blind $0.01
BB: posts big blind $0.02
*** HOLE CARDS ***
UTG: folds
HJ: raises $0.02 to $0.04
CO: folds
BTN: folds
SB: calls $0.03
BB: calls $0.02
*** FLOP *** [Jc 5d Kh]
SB: checks
BB: checks
HJ: checks
*** TURN *** [Jc 5d Kh] [4d]
SB: checks
BB: checks
HJ: checks
*** RIVER *** [Jc 5d Kh 4d] [5h]
SB: checks
BB: bets $0.06
HJ: folds
SB: folds
Uncalled bet ($0.06) returned to BB
BB collected $0.12 from pot
*** SUMMARY ***
Total pot $0.12 | Rake $0
Board [Jc 5d Kh 4d 5h]
Seat 1: CO folded before Flop (didn't bet)
Seat 2: BTN (button) folded before Flop (didn't bet)
Seat 3: SB (small blind) folded on the River
Seat 4: BB (big blind) collected ($0.12)
Seat 5: UTG folded before Flop (didn't bet)
Seat 6: HJ folded on the River


PokerStars Hand #238160322918:  Hold'em No Limit ($0.01/$0.02 USD) - 2022/08/22 22:33:17 ET
Table 'Achilles IV' 6-max Seat #3 is the button
Seat 1: HJ ($3.77 in chips)
Seat 2: CO ($1.79 in chips)
Seat 3: BTN ($1.46 in chips)
Seat 4: SB ($1.40 in chips)
Seat 5: BB ($2.18 in chips)
Seat 6: UTG ($0.12 in chips)
SB: posts small blind $0.01
BB: posts big blind $0.02
*** HOLE CARDS ***
UTG: folds
HJ: folds
CO: folds
BTN: folds
SB: folds
Uncalled bet ($0.01) returned to BB
BB collected $0.02 from pot
BB: doesn't show hand
*** SUMMARY ***
Total pot $0.02 | Rake $0
Seat 1: HJ folded before Flop (didn't bet)
Seat 2: CO folded before Flop (didn't bet)
Seat 3: BTN (button) folded before Flop (didn't bet)
Seat 4: SB (small blind) folded before Flop
Seat 5: BB (big blind) collected ($0.02)
Seat 6: UTG folded before Flop (didn't bet)


PokerStars Hand #238160324896:  Hold'em No Limit ($0.01/$0.02 USD) - 2022/08/22 22:33:28 ET
Table 'Achilles IV' 6-max Seat #4 is the button
Seat 1: UTG ($3.77 in chips)
Seat 2: HJ ($1.79 in chips)
Seat 3: CO ($1.46 in chips)
Seat 4: BTN ($1.39 in chips)
Seat 5: SB ($2.19 in chips)
Seat 6: BB ($0.12 in chips)
SB: posts small blind $0.01
BB: posts big blind $0.02
*** HOLE CARDS ***
UTG: folds
HJ: calls $0.02
CO has timed out
CO: folds
BTN: folds
CO is disconnected
SB: raises $0.10 to $0.12
BB: folds
HJ: calls $0.10
*** FLOP *** [7h Js 6h]
SB: bets $0.18
HJ: folds
Uncalled bet ($0.18) returned to SB
SB collected $0.25 from pot
SB: doesn't show hand
*** SUMMARY ***
Total pot $0.26 | Rake $0.01
Board [7h Js 6h]
Seat 1: UTG folded before Flop (didn't bet)
Seat 2: HJ folded on the Flop
Seat 3: CO folded before Flop (didn't bet)
Seat 4: BTN (button) folded before Flop (didn't bet)
Seat 5: SB (small blind) collected ($0.25)
Seat 6: BB (big blind) folded before Flop


PokerStars Hand #238160342911:  Hold'em No Limit ($0.01/$0.02 USD) - 2022/08/22 22:34:38 ET
Table 'Achilles IV' 6-max Seat #5 is the button
Seat 2: BB ($1.67 in chips)
Seat 4: CO ($1.39 in chips)
Seat 5: BTN ($2.32 in chips)
Seat 6: SB ($0.10 in chips)
SB: posts small blind $0.01
BB: posts big blind $0.02
*** HOLE CARDS ***
CO: folds
BTN: folds
SB: calls $0.01
BB: checks
*** FLOP *** [3c 5h 9s]
SB: checks
BB: checks
*** TURN *** [3c 5h 9s] [Ts]
SB: bets $0.04
BB: calls $0.04
*** RIVER *** [3c 5h 9s Ts] [8s]
SB: bets $0.04 and is all-in
BB: folds
Uncalled bet ($0.04) returned to SB
SB collected $0.12 from pot
*** SUMMARY ***
Total pot $0.12 | Rake $0
Board [3c 5h 9s Ts 8s]
Seat 2: BB (big blind) folded on the River
Seat 4: CO folded before Flop (didn't bet)
Seat 5: BTN (button) folded before Flop (didn't bet)
Seat 6: SB (small blind) collected ($0.12)


PokerStars Hand #238160350559:  Hold'em No Limit ($0.01/$0.02 USD) - 2022/08/22 22:35:21 ET
Table 'Achilles IV' 6-max Seat #6 is the button
Seat 2: SB ($1.61 in chips)
Seat 4: BB ($1.39 in chips)
Seat 5: CO ($2.32 in chips)
Seat 6: BTN ($0.16 in chips)
SB: posts small blind $0.01
BB: posts big blind $0.02
*** HOLE CARDS ***
CO: folds
BTN: calls $0.02
SB: calls $0.01
BB: checks
*** FLOP *** [6h 6c 2h]
SB: checks
BB: checks
BTN: checks
*** TURN *** [6h 6c 2h] [4s]
SB: checks
BB: checks
BTN: checks
*** RIVER *** [6h 6c 2h 4s] [7c]
SB: checks
BB: checks
BTN: checks
*** SHOW DOWN ***
SB: shows [Js Ks] (a pair of Sixes)
BB: shows [5s 4h] (two pair, Sixes and Fours)
BTN: mucks hand
BB collected $0.06 from pot
*** SUMMARY ***
Total pot $0.06 | Rake $0
Board [6h 6c 2h 4s 7c]
Seat 2: SB (small blind) showed [Js Ks] and lost with a pair of Sixes
Seat 4: BB (big blind) showed [5s 4h] and won ($0.06) with two pair, Sixes and Fours
Seat 5: CO folded before Flop (didn't bet)
Seat 6: BTN (button) mucked


PokerStars Hand #238160357131:  Hold'em No Limit ($0.01/$0.02 USD) - 2022/08/22 22:35:57 ET
Table 'Achilles IV' 6-max Seat #2 is the button
Seat 2: BTN ($1.59 in chips)
Seat 4: SB ($1.43 in chips)
Seat 5: BB ($2.32 in chips)
Seat 6: CO ($0.14 in chips)
SB: posts small blind $0.01
BB: posts big blind $0.02
*** HOLE CARDS ***
CO: folds
BTN: folds
SB: folds
Uncalled bet ($0.01) returned to BB
BB collected $0.02 from pot
BB: doesn't show hand
*** SUMMARY ***
Total pot $0.02 | Rake $0
Seat 2: BTN (button) folded before Flop (didn't bet)
Seat 4: SB (small blind) folded before Flop
Seat 5: BB (big blind) collected ($0.02)
Seat 6: CO folded before Flop (didn't bet)


PokerStars Hand #238160359004:  Hold'em No Limit ($0.01/$0.02 USD) - 2022/08/22 22:36:08 ET
Table 'Achilles IV' 6-max Seat #4 is the button
Seat 2: HJ ($1.59 in chips)
Seat 3: CO ($1.46 in chips)
Seat 4: BTN ($1.42 in chips)
Seat 5: SB ($2.33 in chips)
Seat 6: BB ($0.14 in chips)
SB: posts small blind $0.01
BB: posts big blind $0.02
CO: posts small & big blinds $0.03
*** HOLE CARDS ***
HJ: calls $0.02
CO: checks
BTN: folds
SB: folds
BB: checks
*** FLOP *** [Ks Th As]
BB: checks
HJ: bets $0.04
CO: raises $0.04 to $0.08
BB: folds
HJ: calls $0.04
*** TURN *** [Ks Th As] [2s]
HJ: checks
CO: bets $0.06
HJ: calls $0.06
*** RIVER *** [Ks Th As 2s] [Td]
HJ: checks
CO: bets $0.08
HJ: calls $0.08
*** SHOW DOWN ***
CO: shows [Qc Jd] (a straight, Ten to Ace)
HJ: mucks hand
CO collected $0.50 from pot
*** SUMMARY ***
Total pot $0.52 | Rake $0.02
Board [Ks Th As 2s Td]
Seat 2: HJ mucked
Seat 3: CO showed [Qc Jd] and won ($0.50) with a straight, Ten to Ace
Seat 4: BTN (button) folded before Flop (didn't bet)
Seat 5: SB (small blind) folded before Flop
Seat 6: BB (big blind) folded on the Flop


PokerStars Hand #238160366031:  Hold'em No Limit ($0.01/$0.02 USD) - 2022/08/22 22:36:48 ET
Table 'Achilles IV' 6-max Seat #5 is the button
Seat 1: BB ($3.77 in chips)
Seat 2: UTG ($1.35 in chips)
Seat 3: HJ ($1.71 in chips)
Seat 4: CO ($1.42 in chips)
Seat 5: BTN ($2.32 in chips)
Seat 6: SB ($0.12 in chips)
SB: posts small blind $0.01
BB: posts big blind $0.02
*** HOLE CARDS ***
UTG: folds
UTG leaves the table
HJ: raises $0.04 to $0.06
CO: folds
BTN: folds
SB: calls $0.05
BB: folds
*** FLOP *** [Kc 8c Ad]
SB: checks
HJ: bets $0.06
SB: folds
Uncalled bet ($0.06) returned to HJ
HJ collected $0.14 from pot
*** SUMMARY ***
Total pot $0.14 | Rake $0
Board [Kc 8c Ad]
Seat 1: BB (big blind) folded before Flop
Seat 2: UTG folded before Flop (didn't bet)
Seat 3: HJ collected ($0.14)
Seat 4: CO folded before Flop (didn't bet)
Seat 5: BTN (button) folded before Flop (didn't bet)
Seat 6: SB (small blind) folded on the Flop


PokerStars Hand #238160371387:  Hold'em No Limit ($0.01/$0.02 USD) - 2022/08/22 22:37:18 ET
Table 'Achilles IV' 6-max Seat #6 is the button
Seat 1: SB ($3.75 in chips)
Seat 3: BB ($1.79 in chips)
Seat 4: HJ ($1.42 in chips)
Seat 5: CO ($2.32 in chips)
Seat 6: BTN ($0.06 in chips)
SB: posts small blind $0.01
BB: posts big blind $0.02
*** HOLE CARDS ***
HJ: folds
CO: raises $0.04 to $0.06
HJ leaves the table
BTN: calls $0.06 and is all-in
SB: folds
BB: folds
*** FLOP *** [8h 9d 4d]
*** TURN *** [8h 9d 4d] [8s]
*** RIVER *** [8h 9d 4d 8s] [6c]
*** SHOW DOWN ***
CO: shows [Kc Ks] (two pair, Kings and Eights)
BTN: shows [9s Qs] (two pair, Nines and Eights)
CO cashed out the hand for $0.12
*** SUMMARY ***
Total pot $0.15 | Rake $0.01
Board [8h 9d 4d 8s 6c]
Seat 1: SB (small blind) folded before Flop
Seat 3: BB (big blind) folded before Flop
Seat 4: HJ folded before Flop (didn't bet)
Seat 5: CO showed [Kc Ks] and won ($0.14) with two pair, Kings and Eights (pot not awarded as player cashed out)
Seat 6: BTN (button) showed [9s Qs] and lost with two pair, Nines and Eights


PokerStars Hand #238160375666:  Hold'em No Limit ($0.01/$0.02 USD) - 2022/08/22 22:37:43 ET
Table 'Achilles IV' 6-max Seat #1 is the button
Seat 1: BTN ($3.74 in chips)
Seat 3: SB ($1.77 in chips)
Seat 5: BB ($2.38 in chips)
SB: posts small blind $0.01
BB: posts big blind $0.02
*** HOLE CARDS ***
BTN: folds
SB: calls $0.01
BB: checks
*** FLOP *** [4d 3s 7s]
SB: checks
TammyFs leaves the table
BB: bets $0.02
SB: folds
Uncalled bet ($0.02) returned to BB
BB collected $0.04 from pot
BB: doesn't show hand
*** SUMMARY ***
Total pot $0.04 | Rake $0
Board [4d 3s 7s]
Seat 1: BTN (button) folded before Flop (didn't bet)
Seat 3: SB (small blind) folded on the Flop
Seat 5: BB (big blind) collected ($0.04)


PokerStars Hand #238160379061:  Hold'em No Limit ($0.01/$0.02 USD) - 2022/08/22 22:38:02 ET
Table 'Achilles IV' 6-max Seat #3 is the button
Seat 1: BB ($3.74 in chips)
Seat 3: BTN ($1.75 in chips)
Seat 5: SB ($2.40 in chips)
SB: posts small blind $0.01
BB: posts big blind $0.02
*** HOLE CARDS ***
BTN: folds
SB: folds
Uncalled bet ($0.01) returned to BB
BB collected $0.02 from pot
*** SUMMARY ***
Total pot $0.02 | Rake $0
Seat 1: BB (big blind) collected ($0.02)
Seat 3: BTN (button) folded before Flop (didn't bet)
Seat 5: SB (small blind) folded before Flop


PokerStars Hand #238160448010:  Hold'em No Limit ($0.01/$0.02 USD) - 2022/08/22 22:44:45 ET
Table 'Achilles IV' 6-max Seat #1 is the button
Seat 1: BTN ($3.75 in chips)
Seat 2: SB ($1.63 in chips)
Seat 3: BB ($1.60 in chips)
SB: posts small blind $0.01
BB: posts big blind $0.02
kcarrion30: sits out
*** HOLE CARDS ***
Roogrid joins the table at seat #5
BTN: folds
SB: raises $0.02 to $0.04
NikoRamos14 joins the table at seat #6
BB: calls $0.02
*** FLOP *** [Ad 3d 2h]
SB: checks
BB: bets $0.02
SB: calls $0.02
*** TURN *** [Ad 3d 2h] [Ks]
SB: bets $0.04
BB: folds
Uncalled bet ($0.04) returned to SB
SB collected $0.12 from pot
*** SUMMARY ***
Total pot $0.12 | Rake $0
Board [Ad 3d 2h Ks]
Seat 1: BTN (button) folded before Flop (didn't bet)
Seat 2: SB (small blind) collected ($0.12)
Seat 3: BB (big blind) folded on the Turn


PokerStars Hand #238160452910:  Hold'em No Limit ($0.01/$0.02 USD) - 2022/08/22 22:45:14 ET
Table 'Achilles IV' 6-max Seat #2 is the button
Seat 1: CO ($3.75 in chips)
Seat 2: BTN ($1.69 in chips)
Seat 3: SB ($1.54 in chips)
Seat 4: BB ($2 in chips)
SB: posts small blind $0.01
BB: posts big blind $0.02
Roogrid: sits out
NikoRamos14: sits out
*** HOLE CARDS ***
CO: raises $0.03 to $0.05
BTN: raises $0.03 to $0.08
SB: folds
BB: folds
CO: calls $0.03
*** FLOP *** [Ac 6c 4c]
CO: checks
BTN: checks
*** TURN *** [Ac 6c 4c] [2d]
CO: checks
BTN: checks
*** RIVER *** [Ac 6c 4c 2d] [Jc]
CO: checks
BTN: checks
*** SHOW DOWN ***
CO: shows [As 5s] (a pair of Aces)
BTN: mucks hand
CO collected $0.18 from pot
*** SUMMARY ***
Total pot $0.19 | Rake $0.01
Board [Ac 6c 4c 2d Jc]
Seat 1: CO showed [As 5s] and won ($0.18) with a pair of Aces
Seat 2: BTN (button) mucked
Seat 3: SB (small blind) folded before Flop
Seat 4: BB (big blind) folded before Flop


PokerStars Hand #238160458217:  Hold'em No Limit ($0.01/$0.02 USD) - 2022/08/22 22:45:45 ET
Table 'Achilles IV' 6-max Seat #3 is the button
Seat 1: HJ ($3.85 in chips)
Seat 2: CO ($1.61 in chips)
Seat 3: BTN ($1.53 in chips)
Seat 4: SB ($1.98 in chips)
Seat 5: BB ($0.80 in chips)
SB: posts small blind $0.01
BB: posts big blind $0.02
NikoRamos14: sits out
*** HOLE CARDS ***
HJ: raises $0.04 to $0.06
CO: raises $0.04 to $0.10
BTN: folds
SB: folds
BB: folds
HJ: calls $0.04
*** FLOP *** [9s 7c 3s]
HJ: checks
CO: checks
*** TURN *** [9s 7c 3s] [2d]
HJ: checks
CO: checks
*** RIVER *** [9s 7c 3s 2d] [9c]
HJ: checks
CO: bets $0.06
HJ: folds
Uncalled bet ($0.06) returned to CO
CO collected $0.22 from pot
*** SUMMARY ***
Total pot $0.23 | Rake $0.01
Board [9s 7c 3s 2d 9c]
Seat 1: HJ folded on the River
Seat 2: CO collected ($0.22)
Seat 3: BTN (button) folded before Flop (didn't bet)
Seat 4: SB (small blind) folded before Flop
Seat 5: BB (big blind) folded before Flop


PokerStars Hand #238160465867:  Hold'em No Limit ($0.01/$0.02 USD) - 2022/08/22 22:46:31 ET
Table 'Achilles IV' 6-max Seat #4 is the button
Seat 1: UTG ($3.75 in chips)
Seat 2: HJ ($1.73 in chips)
Seat 3: CO ($1.53 in chips)
Seat 4: BTN ($1.97 in chips)
Seat 5: SB ($0.78 in chips)
Seat 6: BB ($2 in chips)
SB: posts small blind $0.01
BB: posts big blind $0.02
*** HOLE CARDS ***
UTG: raises $0.04 to $0.06
HJ: folds
CO: calls $0.06
BTN: folds
SB: folds
BB: folds
*** FLOP *** [7c 8h 5s]
UTG: bets $0.09
CO: calls $0.09
*** TURN *** [7c 8h 5s] [6h]
UTG: bets $0.26
CO: folds
Uncalled bet ($0.26) returned to UTG
UTG collected $0.32 from pot
*** SUMMARY ***
Total pot $0.33 | Rake $0.01
Board [7c 8h 5s 6h]
Seat 1: UTG collected ($0.32)
Seat 2: HJ folded before Flop (didn't bet)
Seat 3: CO folded on the Turn
Seat 4: BTN (button) folded before Flop (didn't bet)
Seat 5: SB (small blind) folded before Flop
Seat 6: BB (big blind) folded before Flop


PokerStars Hand #238160478279:  Hold'em No Limit ($0.01/$0.02 USD) - 2022/08/22 22:47:32 ET
Table 'Achilles IV' 6-max Seat #5 is the button
Seat 1: BB ($3.92 in chips)
Seat 2: UTG ($1.73 in chips)
Seat 3: HJ ($1.38 in chips)
Seat 4: CO ($1.97 in chips)
Seat 5: BTN ($0.77 in chips)
Seat 6: SB ($1.98 in chips)
SB: posts small blind $0.01
BB: posts big blind $0.02
*** HOLE CARDS ***
UTG: folds
HJ: folds
CO: folds
BTN: raises $0.02 to $0.04
SB: calls $0.03
BB: folds
*** FLOP *** [7s 2c 4d]
SB: checks
BTN: checks
*** TURN *** [7s 2c 4d] [Jd]
SB: checks
BTN: checks
*** RIVER *** [7s 2c 4d Jd] [4c]
SB: bets $0.10
BTN: folds
Uncalled bet ($0.10) returned to SB
SB collected $0.10 from pot
*** SUMMARY ***
Total pot $0.10 | Rake $0
Board [7s 2c 4d Jd 4c]
Seat 1: BB (big blind) folded before Flop
Seat 2: UTG folded before Flop (didn't bet)
Seat 3: HJ folded before Flop (didn't bet)
Seat 4: CO folded before Flop (didn't bet)
Seat 5: BTN (button) folded on the River
Seat 6: SB (small blind) collected ($0.10)


PokerStars Hand #238160485268:  Hold'em No Limit ($0.01/$0.02 USD) - 2022/08/22 22:48:14 ET
Table 'Achilles IV' 6-max Seat #6 is the button
Seat 1: SB ($3.90 in chips)
Seat 2: BB ($1.73 in chips)
Seat 3: UTG ($1.38 in chips)
Seat 4: HJ ($1.97 in chips)
Seat 5: CO ($0.73 in chips)
Seat 6: BTN ($2.04 in chips)
SB: posts small blind $0.01
BB: posts big blind $0.02
*** HOLE CARDS ***
UTG: folds
HJ: folds
CO: folds
BTN: calls $0.02
SB: folds
BB: raises $0.04 to $0.06
BTN: calls $0.04
*** FLOP *** [Tc 7d 6s]
BB: checks
BTN: bets $0.06
BB: calls $0.06
*** TURN *** [Tc 7d 6s] [Jd]
BB: checks
BTN: bets $0.12
BB: folds
Uncalled bet ($0.12) returned to BTN
BTN collected $0.24 from pot
*** SUMMARY ***
Total pot $0.25 | Rake $0.01
Board [Tc 7d 6s Jd]
Seat 1: SB (small blind) folded before Flop
Seat 2: BB (big blind) folded on the Turn
Seat 3: UTG folded before Flop (didn't bet)
Seat 4: HJ folded before Flop (didn't bet)
Seat 5: CO folded before Flop (didn't bet)
Seat 6: BTN (button) collected ($0.24)


PokerStars Hand #238160494232:  Hold'em No Limit ($0.01/$0.02 USD) - 2022/08/22 22:49:07 ET
Table 'Achilles IV' 6-max Seat #1 is the button
Seat 1: BTN ($3.89 in chips)
Seat 2: SB ($1.61 in chips)
Seat 3: BB ($1.38 in chips)
Seat 4: UTG ($1.97 in chips)
Seat 5: HJ ($0.73 in chips)
Seat 6: CO ($2.16 in chips)
SB: posts small blind $0.01
BB: posts big blind $0.02
*** HOLE CARDS ***
UTG: folds
HJ: raises $0.02 to $0.04
CO: calls $0.04
BTN: calls $0.04
SB: folds
BB: calls $0.02
*** FLOP *** [9d As Kh]
BB: checks
HJ: checks
CO: checks
BTN: checks
*** TURN *** [9d As Kh] [6c]
BB: checks
HJ: checks
CO: checks
BTN: checks
*** RIVER *** [9d As Kh 6c] [7h]
BB: bets $0.06
HJ: raises $0.06 to $0.12
CO: folds
BTN: folds
BB: folds
Uncalled bet ($0.06) returned to HJ
HJ collected $0.28 from pot
HJ: doesn't show hand
*** SUMMARY ***
Total pot $0.29 | Rake $0.01
Board [9d As Kh 6c 7h]
Seat 1: BTN (button) folded on the River
Seat 2: SB (small blind) folded before Flop
Seat 3: BB (big blind) folded on the River
Seat 4: UTG folded before Flop (didn't bet)
Seat 5: HJ collected ($0.28)
Seat 6: CO folded on the River


PokerStars Hand #238160504207:  Hold'em No Limit ($0.01/$0.02 USD) - 2022/08/22 22:50:06 ET
Table 'Achilles IV' 6-max Seat #2 is the button
Seat 1: CO ($3.85 in chips)
Seat 2: BTN ($1.60 in chips)
Seat 3: SB ($1.28 in chips)
Seat 4: BB ($1.97 in chips)
Seat 5: UTG ($0.91 in chips)
Seat 6: HJ ($2.12 in chips)
SB: posts small blind $0.01
BB: posts big blind $0.02
*** HOLE CARDS ***
UTG: folds
HJ: calls $0.02
CO: folds
BTN: raises $0.02 to $0.04
SB: folds
BB: calls $0.02
HJ: calls $0.02
*** FLOP *** [2s Jh 7d]
BB: checks
HJ: checks
BTN: bets $0.06
BB: folds
HJ: folds
Uncalled bet ($0.06) returned to BTN
BTN collected $0.13 from pot
*** SUMMARY ***
Total pot $0.13 | Rake $0
Board [2s Jh 7d]
Seat 1: CO folded before Flop (didn't bet)
Seat 2: BTN (button) collected ($0.13)
Seat 3: SB (small blind) folded before Flop
Seat 4: BB (big blind) folded on the Flop
Seat 5: UTG folded before Flop (didn't bet)
Seat 6: HJ folded on the Flop


PokerStars Hand #238160513760:  Hold'em No Limit ($0.01/$0.02 USD) - 2022/08/22 22:50:56 ET
Table 'Achilles IV' 6-max Seat #3 is the button
Seat 1: HJ ($3.85 in chips)
Seat 2: CO ($1.69 in chips)
Seat 3: BTN ($1.27 in chips)
Seat 4: SB ($1.93 in chips)
Seat 5: BB ($0.91 in chips)
Seat 6: UTG ($2.08 in chips)
SB: posts small blind $0.01
BB: posts big blind $0.02
*** HOLE CARDS ***
UTG: calls $0.02
HJ: folds
CO: raises $0.04 to $0.06
BTN: folds
BTN leaves the table
SB: calls $0.05
BB: calls $0.04
UTG: calls $0.04
*** FLOP *** [5c 9h 5s]
Christianzt1 joins the table at seat #3
SB: checks
BB: checks
UTG: checks
CO: checks
*** TURN *** [5c 9h 5s] [3h]
SB: checks
BB: checks
UTG: bets $0.09
CO: calls $0.09
SB: folds
BB: calls $0.09
*** RIVER *** [5c 9h 5s 3h] [3d]
BB: bets $0.02
UTG: folds
CO: calls $0.02
*** SHOW DOWN ***
BB: shows [7d 7c] (two pair, Sevens and Fives)
CO: mucks hand
BB collected $0.53 from pot
*** SUMMARY ***
Total pot $0.55 | Rake $0.02
Board [5c 9h 5s 3h 3d]
Seat 1: HJ folded before Flop (didn't bet)
Seat 2: CO mucked
Seat 3: BTN (button) folded before Flop (didn't bet)
Seat 4: SB (small blind) folded on the Turn
Seat 5: BB (big blind) showed [7d 7c] and won ($0.53) with two pair, Sevens and Fives
Seat 6: UTG folded on the River


PokerStars Hand #238160530589:  Hold'em No Limit ($0.01/$0.02 USD) - 2022/08/22 22:52:25 ET
Table 'Achilles IV' 6-max Seat #4 is the button
Seat 1: HJ ($3.85 in chips)
Seat 2: CO ($1.52 in chips)
Seat 4: BTN ($1.87 in chips)
Seat 5: SB ($1.27 in chips)
Seat 6: BB ($1.93 in chips)
SB: posts small blind $0.01
BB: posts big blind $0.02
Christianzt1: sits out
*** HOLE CARDS ***
HJ: folds
CO: raises $0.04 to $0.06
BTN: folds
SB: folds
BB: calls $0.04
*** FLOP *** [2h Ks Jc]
BB: checks
CO: bets $0.04
BB: calls $0.04
*** TURN *** [2h Ks Jc] [Ac]
BB: checks
CO: bets $0.10
BB: calls $0.10
*** RIVER *** [2h Ks Jc Ac] [Kh]
BB: checks
CO: bets $0.10
BB: raises $0.30 to $0.40
CO: calls $0.30
*** SHOW DOWN ***
BB: shows [Qs 4d] (a pair of Kings)
CO: shows [9s As] (two pair, Aces and Kings)
CO collected $1.17 from pot
*** SUMMARY ***
Total pot $1.21 | Rake $0.04
Board [2h Ks Jc Ac Kh]
Seat 1: HJ folded before Flop (didn't bet)
Seat 2: CO showed [9s As] and won ($1.17) with two pair, Aces and Kings
Seat 4: BTN (button) folded before Flop (didn't bet)
Seat 5: SB (small blind) folded before Flop
Seat 6: BB (big blind) showed [Qs 4d] and lost with a pair of Kings


PokerStars Hand #238160543425:  Hold'em No Limit ($0.01/$0.02 USD) - 2022/08/22 22:53:43 ET
Table 'Achilles IV' 6-max Seat #5 is the button
Seat 1: BB ($3.85 in chips)
Seat 2: HJ ($2.09 in chips)
Seat 4: CO ($1.87 in chips)
Seat 5: BTN ($1.26 in chips)
Seat 6: SB ($1.33 in chips)
SB: posts small blind $0.01
BB: posts big blind $0.02
Christianzt1: sits out
*** HOLE CARDS ***
HJ: folds
CO: folds
BTN: folds
SB: calls $0.01
BB: raises $0.04 to $0.06
SB: calls $0.04
*** FLOP *** [9s 6s 9d]
SB: checks
BB: bets $0.08
SB: folds
Uncalled bet ($0.08) returned to BB
BB collected $0.12 from pot
*** SUMMARY ***
Total pot $0.12 | Rake $0
Board [9s 6s 9d]
Seat 1: BB (big blind) collected ($0.12)
Seat 2: HJ folded before Flop (didn't bet)
Seat 4: CO folded before Flop (didn't bet)
Seat 5: BTN (button) folded before Flop (didn't bet)
Seat 6: SB (small blind) folded on the Flop


PokerStars Hand #238160548950:  Hold'em No Limit ($0.01/$0.02 USD) - 2022/08/22 22:54:16 ET
Table 'Achilles IV' 6-max Seat #6 is the button
Seat 1: SB ($3.91 in chips)
Seat 2: BB ($2.09 in chips)
Seat 4: HJ ($1.87 in chips)
Seat 5: CO ($1.26 in chips)
Seat 6: BTN ($1.27 in chips)
SB: posts small blind $0.01
BB: posts big blind $0.02
Christianzt1: sits out
*** HOLE CARDS ***
HJ: folds
CO: raises $0.02 to $0.04
BTN: folds
SB: folds
BB: raises $0.12 to $0.16
CO: folds
Uncalled bet ($0.12) returned to BB
BB collected $0.09 from pot
*** SUMMARY ***
Total pot $0.09 | Rake $0
Seat 1: SB (small blind) folded before Flop
Seat 2: BB (big blind) collected ($0.09)
Seat 4: HJ folded before Flop (didn't bet)
Seat 5: CO folded before Flop
Seat 6: BTN (button) folded before Flop (didn't bet)


PokerStars Hand #238160552271:  Hold'em No Limit ($0.01/$0.02 USD) - 2022/08/22 22:54:36 ET
Table 'Achilles IV' 6-max Seat #1 is the button
Seat 1: BTN ($3.90 in chips)
Seat 2: SB ($2.14 in chips)
Seat 3: BB ($2 in chips)
Seat 4: UTG ($1.87 in chips)
Seat 5: HJ ($1.22 in chips)
Seat 6: CO ($1.27 in chips)
SB: posts small blind $0.01
BB: posts big blind $0.02
*** HOLE CARDS ***
UTG: raises $0.04 to $0.06
HJ: folds
CO: calls $0.06
BTN: folds
SB: folds
BB: calls $0.04
*** FLOP *** [Kd Kc Qs]
BB: checks
UTG: bets $0.08
CO: calls $0.08
BB: folds
*** TURN *** [Kd Kc Qs] [4c]
UTG: checks
CO: checks
*** RIVER *** [Kd Kc Qs 4c] [9s]
UTG: checks
CO: bets $0.34
UTG: folds
Uncalled bet ($0.34) returned to CO
CO collected $0.34 from pot
CO: doesn't show hand
*** SUMMARY ***
Total pot $0.35 | Rake $0.01
Board [Kd Kc Qs 4c 9s]
Seat 1: BTN (button) folded before Flop (didn't bet)
Seat 2: SB (small blind) folded before Flop
Seat 3: BB (big blind) folded on the Flop
Seat 4: UTG folded on the River
Seat 5: HJ folded before Flop (didn't bet)
Seat 6: CO collected ($0.34)


PokerStars Hand #238160570856:  Hold'em No Limit ($0.01/$0.02 USD) - 2022/08/22 22:55:50 ET
Table 'Achilles IV' 6-max Seat #2 is the button
Seat 1: CO ($3.90 in chips)
Seat 2: BTN ($2.13 in chips)
Seat 3: SB ($2 in chips)
Seat 4: BB ($1.73 in chips)
Seat 5: UTG ($1.22 in chips)
Seat 6: HJ ($1.47 in chips)
SB: posts small blind $0.01
BB: posts big blind $0.02
*** HOLE CARDS ***
UTG: folds
HJ: calls $0.02
CO: folds
BTN: folds
SB: folds
BB: raises $0.04 to $0.06
HJ: calls $0.04
*** FLOP *** [4s 2h 6h]
BB: checks
HJ: bets $0.08
BB: folds
Uncalled bet ($0.08) returned to HJ
HJ collected $0.13 from pot
HJ: doesn't show hand
*** SUMMARY ***
Total pot $0.13 | Rake $0
Board [4s 2h 6h]
Seat 1: CO folded before Flop (didn't bet)
Seat 2: BTN (button) folded before Flop (didn't bet)
Seat 3: SB (small blind) folded before Flop
Seat 4: BB (big blind) folded on the Flop
Seat 5: UTG folded before Flop (didn't bet)
Seat 6: HJ collected ($0.13)


PokerStars Hand #238160583146:  Hold'em No Limit ($0.01/$0.02 USD) - 2022/08/22 22:56:29 ET
Table 'Achilles IV' 6-max Seat #3 is the button
Seat 1: HJ ($3.90 in chips)
Seat 2: CO ($2.13 in chips)
Seat 3: BTN ($2 in chips)
Seat 4: SB ($1.67 in chips)
Seat 5: BB ($1.22 in chips)
Seat 6: UTG ($1.54 in chips)
SB: posts small blind $0.01
BB: posts big blind $0.02
*** HOLE CARDS ***
UTG: calls $0.02
HJ: folds
CO: raises $0.02 to $0.04
BTN: raises $0.14 to $0.18
SB: folds
BB: folds
UTG: folds
CO: folds
Uncalled bet ($0.14) returned to BTN
BTN collected $0.13 from pot
BTN: doesn't show hand
*** SUMMARY ***
Total pot $0.13 | Rake $0
Seat 1: HJ folded before Flop (didn't bet)
Seat 2: CO folded before Flop
Seat 3: BTN (button) collected ($0.13)
Seat 4: SB (small blind) folded before Flop
Seat 5: BB (big blind) folded before Flop
Seat 6: UTG folded before Flop


PokerStars Hand #238160586056:  Hold'em No Limit ($0.01/$0.02 USD) - 2022/08/22 22:56:49 ET
Table 'Achilles IV' 6-max Seat #4 is the button
Seat 1: UTG ($3.90 in chips)
Seat 2: HJ ($2.09 in chips)
Seat 3: CO ($2.09 in chips)
Seat 4: BTN ($1.66 in chips)
Seat 5: SB ($1.20 in chips)
Seat 6: BB ($1.52 in chips)
SB: posts small blind $0.01
BB: posts big blind $0.02
*** HOLE CARDS ***
UTG: folds
HJ: folds
CO: folds
BTN: folds
SB: folds
Uncalled bet ($0.01) returned to BB
BB collected $0.02 from pot
*** SUMMARY ***
Total pot $0.02 | Rake $0
Seat 1: UTG folded before Flop (didn't bet)
Seat 2: HJ folded before Flop (didn't bet)
Seat 3: CO folded before Flop (didn't bet)
Seat 4: BTN (button) folded before Flop (didn't bet)
Seat 5: SB (small blind) folded before Flop
Seat 6: BB (big blind) collected ($0.02)


PokerStars Hand #238160587230:  Hold'em No Limit ($0.01/$0.02 USD) - 2022/08/22 22:56:57 ET
Table 'Achilles IV' 6-max Seat #5 is the button
Seat 1: BB ($3.90 in chips)
Seat 2: UTG ($2.09 in chips)
Seat 3: HJ ($2.09 in chips)
Seat 4: CO ($1.66 in chips)
Seat 5: BTN ($1.19 in chips)
Seat 6: SB ($1.53 in chips)
SB: posts small blind $0.01
BB: posts big blind $0.02
*** HOLE CARDS ***
UTG: folds
HJ: folds
CO: folds
BTN: folds
SB: folds
Uncalled bet ($0.01) returned to BB
BB collected $0.02 from pot
*** SUMMARY ***
Total pot $0.02 | Rake $0
Seat 1: BB (big blind) collected ($0.02)
Seat 2: UTG folded before Flop (didn't bet)
Seat 3: HJ folded before Flop (didn't bet)
Seat 4: CO folded before Flop (didn't bet)
Seat 5: BTN (button) folded before Flop (didn't bet)
Seat 6: SB (small blind) folded before Flop


PokerStars Hand #238160588648:  Hold'em No Limit ($0.01/$0.02 USD) - 2022/08/22 22:57:07 ET
Table 'Achilles IV' 6-max Seat #6 is the button
Seat 1: SB ($3.91 in chips)
Seat 2: BB ($2.09 in chips)
Seat 3: UTG ($2.09 in chips)
Seat 4: HJ ($1.66 in chips)
Seat 5: CO ($1.19 in chips)
Seat 6: BTN ($1.52 in chips)
SB: posts small blind $0.01
BB: posts big blind $0.02
*** HOLE CARDS ***
UTG: folds
HJ: raises $0.04 to $0.06
CO: calls $0.06
BTN: folds
SB: folds
BB: folds
*** FLOP *** [5c 2d 4d]
HJ: bets $0.07
CO: calls $0.07
*** TURN *** [5c 2d 4d] [Tc]
HJ: bets $0.24
CO: folds
Uncalled bet ($0.24) returned to HJ
HJ collected $0.28 from pot
*** SUMMARY ***
Total pot $0.29 | Rake $0.01
Board [5c 2d 4d Tc]
Seat 1: SB (small blind) folded before Flop
Seat 2: BB (big blind) folded before Flop
Seat 3: UTG folded before Flop (didn't bet)
Seat 4: HJ collected ($0.28)
Seat 5: CO folded on the Turn
Seat 6: BTN (button) folded before Flop (didn't bet)


PokerStars Hand #238160593993:  Hold'em No Limit ($0.01/$0.02 USD) - 2022/08/22 22:57:45 ET
Table 'Achilles IV' 6-max Seat #1 is the button
Seat 1: BTN ($3.90 in chips)
Seat 2: SB ($2.07 in chips)
Seat 3: BB ($2.09 in chips)
Seat 4: UTG ($1.81 in chips)
Seat 5: HJ ($1.06 in chips)
Seat 6: CO ($1.52 in chips)
SB: posts small blind $0.01
BB: posts big blind $0.02
*** HOLE CARDS ***
UTG: folds
HJ: folds
CO: calls $0.02
BTN: raises $0.04 to $0.06
SB: folds
BB: folds
CO: calls $0.04
*** FLOP *** [Th 8c 8d]
CO: checks
BTN: bets $0.09
CO: folds
Uncalled bet ($0.09) returned to BTN
BTN collected $0.14 from pot
*** SUMMARY ***
Total pot $0.15 | Rake $0.01
Board [Th 8c 8d]
Seat 1: BTN (button) collected ($0.14)
Seat 2: SB (small blind) folded before Flop
Seat 3: BB (big blind) folded before Flop
Seat 4: UTG folded before Flop (didn't bet)
Seat 5: HJ folded before Flop (didn't bet)
Seat 6: CO folded on the Flop


PokerStars Hand #238160599133:  Hold'em No Limit ($0.01/$0.02 USD) - 2022/08/22 22:58:22 ET
Table 'Achilles IV' 6-max Seat #2 is the button
Seat 1: CO ($3.98 in chips)
Seat 2: BTN ($2.06 in chips)
Seat 3: SB ($2.07 in chips)
Seat 4: BB ($1.81 in chips)
Seat 5: UTG ($1.06 in chips)
Seat 6: HJ ($1.46 in chips)
SB: posts small blind $0.01
BB: posts big blind $0.02
*** HOLE CARDS ***
UTG: folds
HJ: calls $0.02
CO: folds
BTN: folds
SB: folds
BB: raises $0.04 to $0.06
HJ: calls $0.04
*** FLOP *** [7s 3s Th]
BB: bets $0.08
HJ: calls $0.08
*** TURN *** [7s 3s Th] [Ah]
BB: bets $0.16
HJ: raises $0.16 to $0.32
BB: folds
Uncalled bet ($0.16) returned to HJ
HJ collected $0.59 from pot
*** SUMMARY ***
Total pot $0.61 | Rake $0.02
Board [7s 3s Th Ah]
Seat 1: CO folded before Flop (didn't bet)
Seat 2: BTN (button) folded before Flop (didn't bet)
Seat 3: SB (small blind) folded before Flop
Seat 4: BB (big blind) folded on the Turn
Seat 5: UTG folded before Flop (didn't bet)
Seat 6: HJ collected ($0.59)


PokerStars Hand #238160608011:  Hold'em No Limit ($0.01/$0.02 USD) - 2022/08/22 22:59:27 ET
Table 'Achilles IV' 6-max Seat #3 is the button
Seat 1: HJ ($3.98 in chips)
Seat 2: CO ($2.06 in chips)
Seat 3: BTN ($2.06 in chips)
Seat 4: SB ($1.51 in chips)
Seat 5: BB ($1.06 in chips)
Seat 6: UTG ($1.75 in chips)
SB: posts small blind $0.01
BB: posts big blind $0.02
*** HOLE CARDS ***
UTG: calls $0.02
HJ: folds
CO: folds
BTN: folds
SB: folds
BB: raises $0.02 to $0.04
UTG: calls $0.02
*** FLOP *** [6s 3d Jc]
BB: checks
UTG: checks
*** TURN *** [6s 3d Jc] [8c]
BB: checks
UTG: checks
*** RIVER *** [6s 3d Jc 8c] [2c]
BB: bets $0.02
UTG: folds
Uncalled bet ($0.02) returned to BB
BB collected $0.09 from pot
BB: doesn't show hand
*** SUMMARY ***
Total pot $0.09 | Rake $0
Board [6s 3d Jc 8c 2c]
Seat 1: HJ folded before Flop (didn't bet)
Seat 2: CO folded before Flop (didn't bet)
Seat 3: BTN (button) folded before Flop (didn't bet)
Seat 4: SB (small blind) folded before Flop
Seat 5: BB (big blind) collected ($0.09)
Seat 6: UTG folded on the River


PokerStars Hand #238160615268:  Hold'em No Limit ($0.01/$0.02 USD) - 2022/08/22 23:00:20 ET
Table 'Achilles IV' 6-max Seat #4 is the button
Seat 1: UTG ($3.98 in chips)
Seat 2: HJ ($2.06 in chips)
Seat 3: CO ($2.06 in chips)
Seat 4: BTN ($1.50 in chips)
Seat 5: SB ($1.11 in chips)
Seat 6: BB ($1.71 in chips)
SB: posts small blind $0.01
BB: posts big blind $0.02
*** HOLE CARDS ***
UTG: folds
HJ: raises $0.02 to $0.04
CO: folds
BTN: folds
SB: folds
BB: calls $0.02
*** FLOP *** [Jh 5d Ts]
BB: checks
HJ: checks
*** TURN *** [Jh 5d Ts] [Qd]
BB: bets $0.09
HJ: calls $0.09
*** RIVER *** [Jh 5d Ts Qd] [4h]
BB: bets $0.11
HJ: folds
Uncalled bet ($0.11) returned to BB
BB collected $0.26 from pot
*** SUMMARY ***
Total pot $0.27 | Rake $0.01
Board [Jh 5d Ts Qd 4h]
Seat 1: UTG folded before Flop (didn't bet)
Seat 2: HJ folded on the River
Seat 3: CO folded before Flop (didn't bet)
Seat 4: BTN (button) folded before Flop (didn't bet)
Seat 5: SB (small blind) folded before Flop
Seat 6: BB (big blind) collected ($0.26)


PokerStars Hand #238160624036:  Hold'em No Limit ($0.01/$0.02 USD) - 2022/08/22 23:01:18 ET
Table 'Achilles IV' 6-max Seat #5 is the button
Seat 1: BB ($3.98 in chips)
Seat 2: UTG ($1.93 in chips)
Seat 3: HJ ($2.06 in chips)
Seat 4: CO ($1.50 in chips)
Seat 5: BTN ($1.10 in chips)
Seat 6: SB ($1.84 in chips)
SB: posts small blind $0.01
BB: posts big blind $0.02
*** HOLE CARDS ***
UTG: folds
HJ: folds
CO: folds
BTN: folds
SB: calls $0.01
BB: checks
*** FLOP *** [Qc 2h Tc]
SB: bets $0.04
BB: folds
Uncalled bet ($0.04) returned to SB
SB collected $0.04 from pot
*** SUMMARY ***
Total pot $0.04 | Rake $0
Board [Qc 2h Tc]
Seat 1: BB (big blind) folded on the Flop
Seat 2: UTG folded before Flop (didn't bet)
Seat 3: HJ folded before Flop (didn't bet)
Seat 4: CO folded before Flop (didn't bet)
Seat 5: BTN (button) folded before Flop (didn't bet)
Seat 6: SB (small blind) collected ($0.04)


PokerStars Hand #238160629196:  Hold'em No Limit ($0.01/$0.02 USD) - 2022/08/22 23:01:50 ET
Table 'Achilles IV' 6-max Seat #6 is the button
Seat 1: SB ($3.96 in chips)
Seat 2: BB ($1.93 in chips)
Seat 3: UTG ($2.06 in chips)
Seat 4: HJ ($1.50 in chips)
Seat 5: CO ($1.10 in chips)
Seat 6: BTN ($1.86 in chips)
SB: posts small blind $0.01
BB: posts big blind $0.02
*** HOLE CARDS ***
UTG: folds
HJ: folds
CO: folds
BTN: calls $0.02
SB: folds
BB: checks
*** FLOP *** [8h 8s Qd]
BB: checks
BTN: checks
*** TURN *** [8h 8s Qd] [3s]
BB: checks
BTN: checks
*** RIVER *** [8h 8s Qd 3s] [Ks]
BB: checks
BTN: bets $0.05
BB: folds
Uncalled bet ($0.05) returned to BTN
BTN collected $0.05 from pot
BTN: doesn't show hand
*** SUMMARY ***
Total pot $0.05 | Rake $0
Board [8h 8s Qd 3s Ks]
Seat 1: SB (small blind) folded before Flop
Seat 2: BB (big blind) folded on the River
Seat 3: UTG folded before Flop (didn't bet)
Seat 4: HJ folded before Flop (didn't bet)
Seat 5: CO folded before Flop (didn't bet)
Seat 6: BTN (button) collected ($0.05)


PokerStars Hand #238160636094:  Hold'em No Limit ($0.01/$0.02 USD) - 2022/08/22 23:02:33 ET
Table 'Achilles IV' 6-max Seat #1 is the button
Seat 1: BTN ($3.95 in chips)
Seat 2: SB ($1.91 in chips)
Seat 3: BB ($2.06 in chips)
Seat 4: UTG ($1.50 in chips)
Seat 5: HJ ($1.10 in chips)
Seat 6: CO ($1.89 in chips)
SB: posts small blind $0.01
BB: posts big blind $0.02
*** HOLE CARDS ***
UTG: folds
HJ: raises $0.02 to $0.04
CO: folds
BTN: folds
SB: folds
BB: calls $0.02
*** FLOP *** [5s Kd Jc]
BB: checks
HJ: checks
*** TURN *** [5s Kd Jc] [9s]
BB: checks
HJ: checks
*** RIVER *** [5s Kd Jc 9s] [Tc]
BB: checks
HJ: bets $0.02
BB: calls $0.02
*** SHOW DOWN ***
HJ: shows [Jh Kc] (two pair, Kings and Jacks)
BB: mucks hand
HJ collected $0.13 from pot
*** SUMMARY ***
Total pot $0.13 | Rake $0
Board [5s Kd Jc 9s Tc]
Seat 1: BTN (button) folded before Flop (didn't bet)
Seat 2: SB (small blind) folded before Flop
Seat 3: BB (big blind) mucked
Seat 4: UTG folded before Flop (didn't bet)
Seat 5: HJ showed [Jh Kc] and won ($0.13) with two pair, Kings and Jacks
Seat 6: CO folded before Flop (didn't bet)


PokerStars Hand #238160643401:  Hold'em No Limit ($0.01/$0.02 USD) - 2022/08/22 23:03:20 ET
Table 'Achilles IV' 6-max Seat #2 is the button
Seat 1: CO ($3.95 in chips)
Seat 2: BTN ($1.90 in chips)
Seat 3: SB ($2 in chips)
Seat 4: BB ($1.50 in chips)
Seat 5: UTG ($1.17 in chips)
Seat 6: HJ ($1.89 in chips)
SB: posts small blind $0.01
BB: posts big blind $0.02
*** HOLE CARDS ***
UTG: folds
HJ: calls $0.02
CO: raises $0.05 to $0.07
BTN: folds
SB: calls $0.06
BB: calls $0.05
HJ: raises $0.07 to $0.14
CO: calls $0.07
SB: calls $0.07
BB: calls $0.07
*** FLOP *** [Kd Tc 9s]
SB: checks
BB: bets $0.28
HJ: calls $0.28
CO: calls $0.28
SB: folds
*** TURN *** [Kd Tc 9s] [Jd]
BB: checks
HJ: checks
CO: checks
*** RIVER *** [Kd Tc 9s Jd] [3s]
BB: bets $0.28
HJ: raises $0.54 to $0.82
CO: folds
BB: calls $0.54
*** SHOW DOWN ***
HJ: shows [Ac Qs] (a straight, Ten to Ace)
BB: mucks hand
HJ collected $2.93 from pot
*** SUMMARY ***
Total pot $3.04 | Rake $0.11
Board [Kd Tc 9s Jd 3s]
Seat 1: CO folded on the River
Seat 2: BTN (button) folded before Flop (didn't bet)
Seat 3: SB (small blind) folded on the Flop
Seat 4: BB (big blind) mucked
Seat 5: UTG folded before Flop (didn't bet)
Seat 6: HJ showed [Ac Qs] and won ($2.93) with a straight, Ten to Ace


PokerStars Hand #238160670382:  Hold'em No Limit ($0.01/$0.02 USD) - 2022/08/22 23:06:08 ET
Table 'Achilles IV' 6-max Seat #3 is the button
Seat 1: HJ ($3.53 in chips)
Seat 2: CO ($1.90 in chips)
Seat 3: BTN ($2 in chips)
Seat 4: SB ($0.26 in chips)
Seat 5: BB ($1.17 in chips)
Seat 6: UTG ($3.58 in chips)
SB: posts small blind $0.01
BB: posts big blind $0.02
*** HOLE CARDS ***
UTG: calls $0.02
HJ: folds
CO has timed out
CO: folds
BTN: raises $0.06 to $0.08
SB: calls $0.07
BB: folds
UTG: calls $0.06
*** FLOP *** [2c Th 3h]
SB: checks
UTG: checks
BTN: checks
*** TURN *** [2c Th 3h] [6s]
SB: checks
UTG: bets $0.10
BTN: folds
SB: folds
Uncalled bet ($0.10) returned to UTG
UTG collected $0.25 from pot
*** SUMMARY ***
Total pot $0.26 | Rake $0.01
Board [2c Th 3h 6s]
Seat 1: HJ folded before Flop (didn't bet)
Seat 2: CO folded before Flop (didn't bet)
Seat 3: BTN (button) folded on the Turn
Seat 4: SB (small blind) folded on the Turn
Seat 5: BB (big blind) folded before Flop
Seat 6: UTG collected ($0.25)


PokerStars Hand #238160683237:  Hold'em No Limit ($0.01/$0.02 USD) - 2022/08/22 23:07:27 ET
Table 'Achilles IV' 6-max Seat #4 is the button
Seat 1: UTG ($3.53 in chips)
Seat 2: HJ ($1.90 in chips)
Seat 3: CO ($2 in chips)
Seat 4: BTN ($0.18 in chips)
Seat 5: SB ($1.15 in chips)
Seat 6: BB ($3.75 in chips)
SB: posts small blind $0.01
BB: posts big blind $0.02
*** HOLE CARDS ***
UTG: folds
HJ has timed out
HJ: folds
CO: folds
BTN: raises $0.16 to $0.18 and is all-in
SB: folds
BB: calls $0.16
*** FLOP *** [Ks 4d Kd]
*** TURN *** [Ks 4d Kd] [6c]
*** RIVER *** [Ks 4d Kd 6c] [5h]
*** SHOW DOWN ***
BB: shows [As Th] (a pair of Kings)
BTN: shows [7c Qs] (a pair of Kings - lower kicker)
BB collected $0.36 from pot
*** SUMMARY ***
Total pot $0.37 | Rake $0.01
Board [Ks 4d Kd 6c 5h]
Seat 1: UTG folded before Flop (didn't bet)
Seat 2: HJ folded before Flop (didn't bet)
Seat 3: CO folded before Flop (didn't bet)
Seat 4: BTN (button) showed [7c Qs] and lost with a pair of Kings
Seat 5: SB (small blind) folded before Flop
Seat 6: BB (big blind) showed [As Th] and won ($0.36) with a pair of Kings


PokerStars Hand #238160689570:  Hold'em No Limit ($0.01/$0.02 USD) - 2022/08/22 23:08:07 ET
Table 'Achilles IV' 6-max Seat #5 is the button
Seat 1: BB ($3.53 in chips)
Seat 3: CO ($2 in chips)
Seat 5: BTN ($1.14 in chips)
Seat 6: SB ($3.93 in chips)
SB: posts small blind $0.01
BB: posts big blind $0.02
*** HOLE CARDS ***
CO: folds
BTN: folds
SB: calls $0.01
BB: raises $0.04 to $0.06
SB: calls $0.04
*** FLOP *** [8d 9d Ks]
SB: checks
BB: bets $0.08
SB: calls $0.08
*** TURN *** [8d 9d Ks] [3c]
SB: checks
BB: checks
*** RIVER *** [8d 9d Ks 3c] [Jc]
SB: bets $0.27
BB: calls $0.27
*** SHOW DOWN ***
SB: shows [8c Jd] (two pair, Jacks and Eights)
BB: mucks hand
SB collected $0.79 from pot
*** SUMMARY ***
Total pot $0.82 | Rake $0.03
Board [8d 9d Ks 3c Jc]
Seat 1: BB (big blind) mucked
Seat 3: CO folded before Flop (didn't bet)
Seat 5: BTN (button) folded before Flop (didn't bet)
Seat 6: SB (small blind) showed [8c Jd] and won ($0.79) with two pair, Jacks and Eights


PokerStars Hand #238160698980:  Hold'em No Limit ($0.01/$0.02 USD) - 2022/08/22 23:09:07 ET
Table 'Achilles IV' 6-max Seat #6 is the button
Seat 1: SB ($3.12 in chips)
Seat 3: BB ($2 in chips)
Seat 4: HJ ($2 in chips)
Seat 5: CO ($1.14 in chips)
Seat 6: BTN ($4.31 in chips)
SB: posts small blind $0.01
BB: posts big blind $0.02
*** HOLE CARDS ***
HJ: folds
CO: folds
BTN: calls $0.02
SB: folds
BB: checks
*** FLOP *** [5c 5h 5d]
BB: checks
BTN: checks
*** TURN *** [5c 5h 5d] [2h]
BB: checks
BTN: bets $0.05
BB: folds
Uncalled bet ($0.05) returned to BTN
BTN collected $0.05 from pot
*** SUMMARY ***
Total pot $0.05 | Rake $0
Board [5c 5h 5d 2h]
Seat 1: SB (small blind) folded before Flop
Seat 3: BB (big blind) folded on the Turn
Seat 4: HJ folded before Flop (didn't bet)
Seat 5: CO folded before Flop (didn't bet)
Seat 6: BTN (button) collected ($0.05)


PokerStars Hand #238160704486:  Hold'em No Limit ($0.01/$0.02 USD) - 2022/08/22 23:09:42 ET
Table 'Achilles IV' 6-max Seat #1 is the button
Seat 1: BTN ($3.11 in chips)
Seat 3: SB ($2 in chips)
Seat 4: BB ($2 in chips)
Seat 5: HJ ($1.14 in chips)
Seat 6: CO ($4.34 in chips)
SB: posts small blind $0.01
BB: posts big blind $0.02
*** HOLE CARDS ***
HJ: folds
CO: calls $0.02
BTN: folds
SB: folds
BB: checks
*** FLOP *** [Qh 2d Kd]
BB: checks
CO: checks
*** TURN *** [Qh 2d Kd] [8s]
BB: checks
CO: checks
*** RIVER *** [Qh 2d Kd 8s] [Tc]
BB: checks
CO: bets $0.05
BB: folds
Uncalled bet ($0.05) returned to CO
CO collected $0.05 from pot
CO: doesn't show hand
*** SUMMARY ***
Total pot $0.05 | Rake $0
Board [Qh 2d Kd 8s Tc]
Seat 1: BTN (button) folded before Flop (didn't bet)
Seat 3: SB (small blind) folded before Flop
Seat 4: BB (big blind) folded on the River
Seat 5: HJ folded before Flop (didn't bet)
Seat 6: CO collected ($0.05)


PokerStars Hand #238160709754:  Hold'em No Limit ($0.01/$0.02 USD) - 2022/08/22 23:10:15 ET
Table 'Achilles IV' 6-max Seat #3 is the button
Seat 1: CO ($3.11 in chips)
Seat 3: BTN ($2 in chips)
Seat 4: SB ($1.98 in chips)
Seat 5: BB ($1.14 in chips)
Seat 6: HJ ($4.37 in chips)
SB: posts small blind $0.01
BB: posts big blind $0.02
*** HOLE CARDS ***
HJ: folds
CO: raises $0.03 to $0.05
BTN: folds
SB: folds
BB: calls $0.03
*** FLOP *** [8d Qh 6s]
BB: checks
CO: checks
*** TURN *** [8d Qh 6s] [Qs]
BB: checks
CO: checks
*** RIVER *** [8d Qh 6s Qs] [5d]
BB: bets $0.02
CO: calls $0.02
*** SHOW DOWN ***
BB: shows [3c Ad] (a pair of Queens)
CO: shows [Td Ac] (a pair of Queens - Ace+Ten kicker)
CO collected $0.14 from pot
*** SUMMARY ***
Total pot $0.15 | Rake $0.01
Board [8d Qh 6s Qs 5d]
Seat 1: CO showed [Td Ac] and won ($0.14) with a pair of Queens
Seat 3: BTN (button) folded before Flop (didn't bet)
Seat 4: SB (small blind) folded before Flop
Seat 5: BB (big blind) showed [3c Ad] and lost with a pair of Queens
Seat 6: HJ folded before Flop (didn't bet)


PokerStars Hand #238160713881:  Hold'em No Limit ($0.01/$0.02 USD) - 2022/08/22 23:10:42 ET
Table 'Achilles IV' 6-max Seat #4 is the button
Seat 1: HJ ($3.18 in chips)
Seat 3: CO ($2 in chips)
Seat 4: BTN ($1.97 in chips)
Seat 5: SB ($1.07 in chips)
Seat 6: BB ($4.37 in chips)
SB: posts small blind $0.01
BB: posts big blind $0.02
*** HOLE CARDS ***
HJ: folds
CO: folds
BTN: raises $0.04 to $0.06
SB: folds
BB: raises $0.06 to $0.12
BTN: calls $0.06
*** FLOP *** [4s Th 5h]
BB: checks
BTN: checks
*** TURN *** [4s Th 5h] [Ad]
BB: checks
BTN: checks
*** RIVER *** [4s Th 5h Ad] [Jd]
BB: bets $0.24
BTN: folds
Uncalled bet ($0.24) returned to BB
BB collected $0.24 from pot
*** SUMMARY ***
Total pot $0.25 | Rake $0.01
Board [4s Th 5h Ad Jd]
Seat 1: HJ folded before Flop (didn't bet)
Seat 3: CO folded before Flop (didn't bet)
Seat 4: BTN (button) folded on the River
Seat 5: SB (small blind) folded before Flop
Seat 6: BB (big blind) collected ($0.24)


PokerStars Hand #238160721764:  Hold'em No Limit ($0.01/$0.02 USD) - 2022/08/22 23:11:33 ET
Table 'Achilles IV' 6-max Seat #5 is the button
Seat 1: BB ($3.18 in chips)
Seat 3: HJ ($2 in chips)
Seat 4: CO ($1.85 in chips)
Seat 5: BTN ($1.06 in chips)
Seat 6: SB ($4.49 in chips)
SB: posts small blind $0.01
BB: posts big blind $0.02
*** HOLE CARDS ***
HJ: folds
CO: folds
BTN: folds
SB: calls $0.01
BB: checks
*** FLOP *** [5d 7d 4s]
SB: checks
BB: bets $0.04
SB: calls $0.04
*** TURN *** [5d 7d 4s] [Qc]
SB: checks
BB: bets $0.15
SB: folds
Uncalled bet ($0.15) returned to BB
BB collected $0.12 from pot
*** SUMMARY ***
Total pot $0.12 | Rake $0
Board [5d 7d 4s Qc]
Seat 1: BB (big blind) collected ($0.12)
Seat 3: HJ folded before Flop (didn't bet)
Seat 4: CO folded before Flop (didn't bet)
Seat 5: BTN (button) folded before Flop (didn't bet)
Seat 6: SB (small blind) folded on the Turn


PokerStars Hand #238160728583:  Hold'em No Limit ($0.01/$0.02 USD) - 2022/08/22 23:12:16 ET
Table 'Achilles IV' 6-max Seat #6 is the button
Seat 1: SB ($3.24 in chips)
Seat 3: BB ($2 in chips)
Seat 4: HJ ($1.85 in chips)
Seat 5: CO ($1.06 in chips)
Seat 6: BTN ($4.43 in chips)
SB: posts small blind $0.01
BB: posts big blind $0.02
*** HOLE CARDS ***
HJ: folds
CO: raises $0.02 to $0.04
BTN: calls $0.04
SB: folds
BB: folds
*** FLOP *** [2d 9h Js]
CO: checks
BTN: checks
*** TURN *** [2d 9h Js] [3s]
CO: checks
BTN: bets $0.05
CO: folds
Uncalled bet ($0.05) returned to BTN
BTN collected $0.11 from pot
BTN: doesn't show hand
*** SUMMARY ***
Total pot $0.11 | Rake $0
Board [2d 9h Js 3s]
Seat 1: SB (small blind) folded before Flop
Seat 3: BB (big blind) folded before Flop
Seat 4: HJ folded before Flop (didn't bet)
Seat 5: CO folded on the Turn
Seat 6: BTN (button) collected ($0.11)


PokerStars Hand #238160734102:  Hold'em No Limit ($0.01/$0.02 USD) - 2022/08/22 23:12:52 ET
Table 'Achilles IV' 6-max Seat #1 is the button
Seat 1: BTN ($3.23 in chips)
Seat 3: SB ($2 in chips)
Seat 4: BB ($1.85 in chips)
Seat 5: HJ ($1.02 in chips)
Seat 6: CO ($4.50 in chips)
SB: posts small blind $0.01
BB: posts big blind $0.02
*** HOLE CARDS ***
HJ: folds
CO: calls $0.02
BTN: folds
SB: folds
BB: raises $0.04 to $0.06
CO: calls $0.04
*** FLOP *** [Ac 2h 5d]
BB: checks
CO: checks
*** TURN *** [Ac 2h 5d] [3h]
BB: checks
CO: bets $0.06
BB: folds
Uncalled bet ($0.06) returned to CO
CO collected $0.13 from pot
CO: doesn't show hand
*** SUMMARY ***
Total pot $0.13 | Rake $0
Board [Ac 2h 5d 3h]
Seat 1: BTN (button) folded before Flop (didn't bet)
Seat 3: SB (small blind) folded before Flop
Seat 4: BB (big blind) folded on the Turn
Seat 5: HJ folded before Flop (didn't bet)
Seat 6: CO collected ($0.13)


PokerStars Hand #238160744089:  Hold'em No Limit ($0.01/$0.02 USD) - 2022/08/22 23:13:34 ET
Table 'Achilles IV' 6-max Seat #3 is the button
Seat 1: CO ($3.23 in chips)
Seat 3: BTN ($2 in chips)
Seat 4: SB ($1.79 in chips)
Seat 5: BB ($1.02 in chips)
Seat 6: HJ ($4.57 in chips)
SB: posts small blind $0.01
BB: posts big blind $0.02
*** HOLE CARDS ***
HJ: calls $0.02
CO: folds
BTN: folds
SB: folds
BB: raises $0.02 to $0.04
HJ: calls $0.02
*** FLOP *** [Jd 9c 2s]
BB: checks
HJ: checks
*** TURN *** [Jd 9c 2s] [7c]
BB: checks
HJ: checks
*** RIVER *** [Jd 9c 2s 7c] [4h]
BB: bets $0.02
HJ: folds
Uncalled bet ($0.02) returned to BB
BB collected $0.09 from pot
BB: doesn't show hand
*** SUMMARY ***
Total pot $0.09 | Rake $0
Board [Jd 9c 2s 7c 4h]
Seat 1: CO folded before Flop (didn't bet)
Seat 3: BTN (button) folded before Flop (didn't bet)
Seat 4: SB (small blind) folded before Flop
Seat 5: BB (big blind) collected ($0.09)
Seat 6: HJ folded on the River


PokerStars Hand #238160750172:  Hold'em No Limit ($0.01/$0.02 USD) - 2022/08/22 23:14:13 ET
Table 'Achilles IV' 6-max Seat #4 is the button
Seat 1: HJ ($3.23 in chips)
Seat 3: CO ($2 in chips)
Seat 4: BTN ($1.78 in chips)
Seat 5: SB ($1.07 in chips)
Seat 6: BB ($4.53 in chips)
SB: posts small blind $0.01
BB: posts big blind $0.02
*** HOLE CARDS ***
HJ: folds
CO: folds
BTN: folds
SB: raises $0.02 to $0.04
BB: calls $0.02
*** FLOP *** [Qs Qc Ah]
SB: checks
BB: checks
*** TURN *** [Qs Qc Ah] [2c]
SB: checks
BB: bets $0.04
SB: folds
Uncalled bet ($0.04) returned to BB
BB collected $0.08 from pot
*** SUMMARY ***
Total pot $0.08 | Rake $0
Board [Qs Qc Ah 2c]
Seat 1: HJ folded before Flop (didn't bet)
Seat 3: CO folded before Flop (didn't bet)
Seat 4: BTN (button) folded before Flop (didn't bet)
Seat 5: SB (small blind) folded on the Turn
Seat 6: BB (big blind) collected ($0.08)


PokerStars Hand #238160757105:  Hold'em No Limit ($0.01/$0.02 USD) - 2022/08/22 23:14:57 ET
Table 'Achilles IV' 6-max Seat #5 is the button
Seat 1: BB ($3.23 in chips)
Seat 3: HJ ($2 in chips)
Seat 4: CO ($1.78 in chips)
Seat 5: BTN ($1.03 in chips)
Seat 6: SB ($4.57 in chips)
SB: posts small blind $0.01
BB: posts big blind $0.02
*** HOLE CARDS ***
HJ: folds
CO: folds
BTN: folds
SB: calls $0.01
BB: checks
*** FLOP *** [Jh Js Ts]
SB: checks
BB: checks
*** TURN *** [Jh Js Ts] [9s]
SB: checks
BB: checks
*** RIVER *** [Jh Js Ts 9s] [3s]
SB: bets $0.04
BB: folds
Uncalled bet ($0.04) returned to SB
SB collected $0.04 from pot
SB: doesn't show hand
*** SUMMARY ***
Total pot $0.04 | Rake $0
Board [Jh Js Ts 9s 3s]
Seat 1: BB (big blind) folded on the River
Seat 3: HJ folded before Flop (didn't bet)
Seat 4: CO folded before Flop (didn't bet)
Seat 5: BTN (button) folded before Flop (didn't bet)
Seat 6: SB (small blind) collected ($0.04)


PokerStars Hand #238160766079:  Hold'em No Limit ($0.01/$0.02 USD) - 2022/08/22 23:15:54 ET
Table 'Achilles IV' 6-max Seat #6 is the button
Seat 1: SB ($3.21 in chips)
Seat 4: BB ($1.78 in chips)
Seat 5: CO ($1.03 in chips)
Seat 6: BTN ($4.59 in chips)
SB: posts small blind $0.01
Christianzt1: is sitting out
BB: posts big blind $0.02
*** HOLE CARDS ***
Christianzt1 leaves the table
CO: raises $0.02 to $0.04
BTN: calls $0.04
sopapunk joins the table at seat #3
SB: folds
BB: folds
*** FLOP *** [Js 4h 7d]
CO: checks
BTN: checks
*** TURN *** [Js 4h 7d] [4s]
CO: checks
BTN: checks
*** RIVER *** [Js 4h 7d 4s] [Ad]
CO: bets $0.02
BTN: folds
Uncalled bet ($0.02) returned to CO
CO collected $0.11 from pot
CO: doesn't show hand
*** SUMMARY ***
Total pot $0.11 | Rake $0
Board [Js 4h 7d 4s Ad]
Seat 1: SB (small blind) folded before Flop
Seat 4: BB (big blind) folded before Flop
Seat 5: CO collected ($0.11)
Seat 6: BTN (button) folded on the River


PokerStars Hand #238160771232:  Hold'em No Limit ($0.01/$0.02 USD) - 2022/08/22 23:16:27 ET
Table 'Achilles IV' 6-max Seat #1 is the button
Seat 1: BTN ($3.20 in chips)
Seat 4: SB ($1.76 in chips)
Seat 5: BB ($1.10 in chips)
Seat 6: CO ($4.55 in chips)
SB: posts small blind $0.01
BB: posts big blind $0.02
*** HOLE CARDS ***
CO: folds
BTN: raises $0.03 to $0.05
SB: folds
BB: folds
Uncalled bet ($0.03) returned to BTN
BTN collected $0.05 from pot
*** SUMMARY ***
Total pot $0.05 | Rake $0
Seat 1: BTN (button) collected ($0.05)
Seat 4: SB (small blind) folded before Flop
Seat 5: BB (big blind) folded before Flop
Seat 6: CO folded before Flop (didn't bet)


PokerStars Hand #238160776578:  Hold'em No Limit ($0.01/$0.02 USD) - 2022/08/22 23:17:01 ET
Table 'Achilles IV' 6-max Seat #5 is the button
Seat 1: BB ($3.23 in chips)
Seat 4: CO ($1.75 in chips)
Seat 5: BTN ($1.04 in chips)
Seat 6: SB ($4.59 in chips)
SB: posts small blind $0.01
BB: posts big blind $0.02
sopapunk: sits out
*** HOLE CARDS ***
CO: raises $0.04 to $0.06
BTN: folds
SB: folds
BB: folds
Uncalled bet ($0.04) returned to CO
CO collected $0.05 from pot
*** SUMMARY ***
Total pot $0.05 | Rake $0
Seat 1: BB (big blind) folded before Flop
Seat 4: CO collected ($0.05)
Seat 5: BTN (button) folded before Flop (didn't bet)
Seat 6: SB (small blind) folded before Flop


PokerStars Hand #238160773218:  Hold'em No Limit ($0.01/$0.02 USD) - 2022/08/22 23:16:40 ET
Table 'Achilles IV' 6-max Seat #4 is the button
Seat 1: CO ($3.23 in chips)
Seat 4: BTN ($1.75 in chips)
Seat 5: SB ($1.08 in chips)
Seat 6: BB ($4.55 in chips)
SB: posts small blind $0.01
BB: posts big blind $0.02
sopapunk: sits out
*** HOLE CARDS ***
CO: folds
BTN: folds
SB: raises $0.02 to $0.04
BB: calls $0.02
*** FLOP *** [8h 5c 3c]
SB: checks
BB: bets $0.08
SB: folds
Uncalled bet ($0.08) returned to BB
BB collected $0.08 from pot
BB: doesn't show hand
*** SUMMARY ***
Total pot $0.08 | Rake $0
Board [8h 5c 3c]
Seat 1: CO folded before Flop (didn't bet)
Seat 4: BTN (button) folded before Flop (didn't bet)
Seat 5: SB (small blind) folded on the Flop
Seat 6: BB (big blind) collected ($0.08)


PokerStars Hand #238160779184:  Hold'em No Limit ($0.01/$0.02 USD) - 2022/08/22 23:17:18 ET
Table 'Achilles IV' 6-max Seat #6 is the button
Seat 1: SB ($3.21 in chips)
Seat 3: BB ($2 in chips)
Seat 4: HJ ($1.78 in chips)
Seat 5: CO ($1.04 in chips)
Seat 6: BTN ($4.58 in chips)
SB: posts small blind $0.01
BB: posts big blind $0.02
*** HOLE CARDS ***
HJ: folds
CO: folds
BTN: calls $0.02
SB: folds
BB: raises $0.08 to $0.10
BTN: folds
Uncalled bet ($0.08) returned to BB
BB collected $0.05 from pot
Lazypandas420 was removed from the table for failing to post
Lazypandas420 leaves the table
BB: doesn't show hand
*** SUMMARY ***
Total pot $0.05 | Rake $0
Seat 1: SB (small blind) folded before Flop
Seat 3: BB (big blind) collected ($0.05)
Seat 4: HJ folded before Flop (didn't bet)
Seat 5: CO folded before Flop (didn't bet)
Seat 6: BTN (button) folded before Flop


PokerStars Hand #238160784172:  Hold'em No Limit ($0.01/$0.02 USD) - 2022/08/22 23:17:50 ET
Table 'Achilles IV' 6-max Seat #1 is the button
Seat 1: BTN ($3.20 in chips)
Seat 3: SB ($2.03 in chips)
Seat 4: BB ($1.78 in chips)
Seat 5: HJ ($1.04 in chips)
Seat 6: CO ($4.56 in chips)
SB: posts small blind $0.01
BB: posts big blind $0.02
*** HOLE CARDS ***
HJ: folds
Bakhangya01 joins the table at seat #2
CO: calls $0.02
BTN: folds
SB: folds
BB: checks
*** FLOP *** [7d 7s Qd]
BB: checks
CO: checks
*** TURN *** [7d 7s Qd] [4h]
BB: checks
CO: checks
*** RIVER *** [7d 7s Qd 4h] [3h]
BB: bets $0.04
CO: calls $0.04
*** SHOW DOWN ***
BB: shows [5c 6c] (a straight, Three to Seven)
CO: mucks hand
BB collected $0.13 from pot
*** SUMMARY ***
Total pot $0.13 | Rake $0
Board [7d 7s Qd 4h 3h]
Seat 1: BTN (button) folded before Flop (didn't bet)
Seat 3: SB (small blind) folded before Flop
Seat 4: BB (big blind) showed [5c 6c] and won ($0.13) with a straight, Three to Seven
Seat 5: HJ folded before Flop (didn't bet)
Seat 6: CO mucked


PokerStars Hand #238160790503:  Hold'em No Limit ($0.01/$0.02 USD) - 2022/08/22 23:18:30 ET
Table 'Achilles IV' 6-max Seat #3 is the button
Seat 1: HJ ($3.20 in chips)
Seat 2: CO ($0.80 in chips)
Seat 3: BTN ($2.02 in chips)
Seat 4: SB ($1.85 in chips)
Seat 5: BB ($1.04 in chips)
Seat 6: UTG ($4.50 in chips)
SB: posts small blind $0.01
BB: posts big blind $0.02
CO: posts big blind $0.02
*** HOLE CARDS ***
UTG: calls $0.02
HJ: folds
CO: checks
BTN: folds
SB: folds
BB: raises $0.02 to $0.04
UTG: calls $0.02
CO: folds
*** FLOP *** [4h 4d 7d]
BB: checks
UTG: checks
*** TURN *** [4h 4d 7d] [6s]
BB: checks
UTG: bets $0.05
BB: raises $0.05 to $0.10
UTG: calls $0.05
*** RIVER *** [4h 4d 7d 6s] [Kd]
BB: bets $0.15
UTG: folds
Uncalled bet ($0.15) returned to BB
BB collected $0.30 from pot
BB: doesn't show hand
*** SUMMARY ***
Total pot $0.31 | Rake $0.01
Board [4h 4d 7d 6s Kd]
Seat 1: HJ folded before Flop (didn't bet)
Seat 2: CO folded before Flop (didn't bet)
Seat 3: BTN (button) folded before Flop (didn't bet)
Seat 4: SB (small blind) folded before Flop
Seat 5: BB (big blind) collected ($0.30)
Seat 6: UTG folded on the River


PokerStars Hand #238160801181:  Hold'em No Limit ($0.01/$0.02 USD) - 2022/08/22 23:19:38 ET
Table 'Achilles IV' 6-max Seat #4 is the button
Seat 2: HJ ($0.78 in chips)
Seat 3: CO ($2.02 in chips)
Seat 4: BTN ($1.84 in chips)
Seat 5: SB ($1.20 in chips)
Seat 6: BB ($4.36 in chips)
SB: posts small blind $0.01
BB: posts big blind $0.02
*** HOLE CARDS ***
HJ: folds
CO: raises $0.03 to $0.05
BTN: calls $0.05
SB: folds
BB: calls $0.03
*** FLOP *** [5d 4h 4c]
BB: checks
CO: checks
BTN: bets $0.11
BB: folds
CO: folds
Uncalled bet ($0.11) returned to BTN
BTN collected $0.15 from pot
*** SUMMARY ***
Total pot $0.16 | Rake $0.01
Board [5d 4h 4c]
Seat 2: HJ folded before Flop (didn't bet)
Seat 3: CO folded on the Flop
Seat 4: BTN (button) collected ($0.15)
Seat 5: SB (small blind) folded before Flop
Seat 6: BB (big blind) folded on the Flop


PokerStars Hand #238160808410:  Hold'em No Limit ($0.01/$0.02 USD) - 2022/08/22 23:20:24 ET
Table 'Achilles IV' 6-max Seat #6 is the button
Seat 2: SB ($0.78 in chips)
Seat 3: BB ($2 in chips)
Seat 4: CO ($1.94 in chips)
Seat 6: BTN ($4.31 in chips)
SB: posts small blind $0.01
BB: posts big blind $0.02
*** HOLE CARDS ***
CO: raises $0.04 to $0.06
BTN: folds
SB: folds
BB: folds
Uncalled bet ($0.04) returned to CO
CO collected $0.05 from pot
*** SUMMARY ***
Total pot $0.05 | Rake $0
Seat 2: SB (small blind) folded before Flop
Seat 3: BB (big blind) folded before Flop
Seat 4: CO collected ($0.05)
Seat 6: BTN (button) folded before Flop (didn't bet)


PokerStars Hand #238160811138:  Hold'em No Limit ($0.01/$0.02 USD) - 2022/08/22 23:20:41 ET
Table 'Achilles IV' 6-max Seat #2 is the button
Seat 2: BTN ($0.77 in chips)
Seat 3: SB ($2 in chips)
Seat 4: BB ($1.97 in chips)
Seat 6: CO ($4.31 in chips)
SB: posts small blind $0.01
BB: posts big blind $0.02
*** HOLE CARDS ***
CO: calls $0.02
BTN: folds
SB: folds
BB: checks
*** FLOP *** [8s 7c Qh]
BB: checks
BTN leaves the table
CO: checks
*** TURN *** [8s 7c Qh] [Ks]
BB: checks
CO: checks
*** RIVER *** [8s 7c Qh Ks] [2d]
BB: checks
CO: bets $0.05
BB: folds
Uncalled bet ($0.05) returned to CO
CO collected $0.05 from pot
*** SUMMARY ***
Total pot $0.05 | Rake $0
Board [8s 7c Qh Ks 2d]
Seat 2: BTN (button) folded before Flop (didn't bet)
Seat 3: SB (small blind) folded before Flop
Seat 4: BB (big blind) folded on the River
Seat 6: CO collected ($0.05)


PokerStars Hand #238160821938:  Hold'em No Limit ($0.01/$0.02 USD) - 2022/08/22 23:21:11 ET
Table 'Achilles IV' 6-max Seat #3 is the button
Seat 3: BTN ($2 in chips)
Seat 4: SB ($1.95 in chips)
Seat 5: BB ($1.19 in chips)
Seat 6: CO ($4.34 in chips)
SB: posts small blind $0.01
BB: posts big blind $0.02
*** HOLE CARDS ***
CO: calls $0.02
BTN: folds
SB: folds
BB: checks
*** FLOP *** [Kh 9c 3h]
BB: checks
CO: checks
*** TURN *** [Kh 9c 3h] [Qd]
BB: checks
BeeboXD joins the table at seat #2
CO: bets $0.05
BB: folds
Uncalled bet ($0.05) returned to CO
CO collected $0.05 from pot
*** SUMMARY ***
Total pot $0.05 | Rake $0
Board [Kh 9c 3h Qd]
Seat 3: BTN (button) folded before Flop (didn't bet)
Seat 4: SB (small blind) folded before Flop
Seat 5: BB (big blind) folded on the Turn
Seat 6: CO collected ($0.05)


PokerStars Hand #238160826564:  Hold'em No Limit ($0.01/$0.02 USD) - 2022/08/22 23:21:41 ET
Table 'Achilles IV' 6-max Seat #4 is the button
Seat 3: CO ($2 in chips)
Seat 4: BTN ($1.94 in chips)
Seat 5: SB ($1.17 in chips)
Seat 6: BB ($4.37 in chips)
SB: posts small blind $0.01
BB: posts big blind $0.02
BeeboXD: sits out
*** HOLE CARDS ***
CO: folds
BTN: folds
SB: raises $0.02 to $0.04
BB: calls $0.02
*** FLOP *** [9s 9d Js]
SB: checks
BB: checks
*** TURN *** [9s 9d Js] [4h]
SB: checks
BB: bets $0.04
SB: raises $0.04 to $0.08
BB: calls $0.04
*** RIVER *** [9s 9d Js 4h] [Qd]
SB: bets $0.11
BB: folds
Uncalled bet ($0.11) returned to SB
SB collected $0.23 from pot
SB: doesn't show hand
*** SUMMARY ***
Total pot $0.24 | Rake $0.01
Board [9s 9d Js 4h Qd]
Seat 3: CO folded before Flop (didn't bet)
Seat 4: BTN (button) folded before Flop (didn't bet)
Seat 5: SB (small blind) collected ($0.23)
Seat 6: BB (big blind) folded on the River


PokerStars Hand #238160840315:  Hold'em No Limit ($0.01/$0.02 USD) - 2022/08/22 23:22:36 ET
Table 'Achilles IV' 6-max Seat #5 is the button
Seat 2: BB ($2 in chips)
Seat 3: HJ ($2 in chips)
Seat 4: CO ($1.94 in chips)
Seat 5: BTN ($1.28 in chips)
Seat 6: SB ($4.25 in chips)
SB: posts small blind $0.01
BB: posts big blind $0.02
*** HOLE CARDS ***
HJ: folds
CO: folds
BTN: folds
SB: calls $0.01
BB: checks
*** FLOP *** [6d 5h 8c]
SB: checks
BB: checks
*** TURN *** [6d 5h 8c] [4c]
SB: checks
BB: bets $0.04
SB: calls $0.04
*** RIVER *** [6d 5h 8c 4c] [6h]
SB: checks
BB: bets $0.12
SB: folds
Uncalled bet ($0.12) returned to BB
BB collected $0.12 from pot
*** SUMMARY ***
Total pot $0.12 | Rake $0
Board [6d 5h 8c 4c 6h]
Seat 2: BB (big blind) collected ($0.12)
Seat 3: HJ folded before Flop (didn't bet)
Seat 4: CO folded before Flop (didn't bet)
Seat 5: BTN (button) folded before Flop (didn't bet)
Seat 6: SB (small blind) folded on the River


PokerStars Hand #238160848705:  Hold'em No Limit ($0.01/$0.02 USD) - 2022/08/22 23:23:31 ET
Table 'Achilles IV' 6-max Seat #6 is the button
Seat 2: SB ($2.06 in chips)
Seat 3: BB ($2 in chips)
Seat 4: HJ ($1.94 in chips)
Seat 5: CO ($1.28 in chips)
Seat 6: BTN ($4.19 in chips)
SB: posts small blind $0.01
BB: posts big blind $0.02
*** HOLE CARDS ***
HJ: folds
CO: folds
BTN: folds
SB: folds
Uncalled bet ($0.01) returned to BB
BB collected $0.02 from pot
BB: doesn't show hand
*** SUMMARY ***
Total pot $0.02 | Rake $0
Seat 2: SB (small blind) folded before Flop
Seat 3: BB (big blind) collected ($0.02)
Seat 4: HJ folded before Flop (didn't bet)
Seat 5: CO folded before Flop (didn't bet)
Seat 6: BTN (button) folded before Flop (didn't bet)


PokerStars Hand #238160850491:  Hold'em No Limit ($0.01/$0.02 USD) - 2022/08/22 23:23:42 ET
Table 'Achilles IV' 6-max Seat #2 is the button
Seat 2: BTN ($2.05 in chips)
Seat 3: SB ($2.01 in chips)
Seat 4: BB ($1.94 in chips)
Seat 5: HJ ($1.28 in chips)
Seat 6: CO ($4.19 in chips)
SB: posts small blind $0.01
BB: posts big blind $0.02
*** HOLE CARDS ***
HJ: folds
CO: folds
BTN: folds
SB: folds
Uncalled bet ($0.01) returned to BB
BB collected $0.02 from pot
*** SUMMARY ***
Total pot $0.02 | Rake $0
Seat 2: BTN (button) folded before Flop (didn't bet)
Seat 3: SB (small blind) folded before Flop
Seat 4: BB (big blind) collected ($0.02)
Seat 5: HJ folded before Flop (didn't bet)
Seat 6: CO folded before Flop (didn't bet)


PokerStars Hand #238160852887:  Hold'em No Limit ($0.01/$0.02 USD) - 2022/08/22 23:23:57 ET
Table 'Achilles IV' 6-max Seat #3 is the button
Seat 2: CO ($2.05 in chips)
Seat 3: BTN ($2 in chips)
Seat 4: SB ($1.95 in chips)
Seat 5: BB ($1.28 in chips)
Seat 6: HJ ($4.19 in chips)
SB: posts small blind $0.01
BB: posts big blind $0.02
*** HOLE CARDS ***
HJ: calls $0.02
CO: calls $0.02
BTN: folds
SB: folds
BB: raises $0.02 to $0.04
HJ: calls $0.02
CO: calls $0.02
*** FLOP *** [5c 5h 9s]
BB: checks
HJ: checks
CO: checks
*** TURN *** [5c 5h 9s] [8d]
BB: checks
HJ: bets $0.08
CO: folds
BB: folds
Uncalled bet ($0.08) returned to HJ
HJ collected $0.13 from pot
HJ: doesn't show hand
*** SUMMARY ***
Total pot $0.13 | Rake $0
Board [5c 5h 9s 8d]
Seat 2: CO folded on the Turn
Seat 3: BTN (button) folded before Flop (didn't bet)
Seat 4: SB (small blind) folded before Flop
Seat 5: BB (big blind) folded on the Turn
Seat 6: HJ collected ($0.13)


PokerStars Hand #238160860306:  Hold'em No Limit ($0.01/$0.02 USD) - 2022/08/22 23:24:46 ET
Table 'Achilles IV' 6-max Seat #4 is the button
Seat 2: HJ ($2.01 in chips)
Seat 3: CO ($2 in chips)
Seat 4: BTN ($1.94 in chips)
Seat 5: SB ($1.24 in chips)
Seat 6: BB ($4.28 in chips)
SB: posts small blind $0.01
BB: posts big blind $0.02
Ramirres: sits out
*** HOLE CARDS ***
HJ: folds
CO: folds
BTN: raises $0.04 to $0.06
SB: folds
BB: calls $0.04
*** FLOP *** [9c Kd 6s]
BB: checks
BTN: bets $0.04
BB: calls $0.04
*** TURN *** [9c Kd 6s] [Kc]
BB: checks
BTN: bets $0.08
BB: raises $0.08 to $0.16
BTN: calls $0.08
*** RIVER *** [9c Kd 6s Kc] [9h]
BB: bets $0.51
BTN: raises $1.17 to $1.68 and is all-in
BB: calls $1.17
*** SHOW DOWN ***
BTN: shows [Kh Qc] (a full house, Kings full of Nines)
BB: shows [9s Qs] (a full house, Nines full of Kings)
BTN collected $3.75 from pot
*** SUMMARY ***
Total pot $3.89 | Rake $0.14
Board [9c Kd 6s Kc 9h]
Seat 2: HJ folded before Flop (didn't bet)
Seat 3: CO folded before Flop (didn't bet)
Seat 4: BTN (button) showed [Kh Qc] and won ($3.75) with a full house, Kings full of Nines
Seat 5: SB (small blind) folded before Flop
Seat 6: BB (big blind) showed [9s Qs] and lost with a full house, Nines full of Kings


PokerStars Hand #238160878182:  Hold'em No Limit ($0.01/$0.02 USD) - 2022/08/22 23:26:22 ET
Table 'Achilles IV' 6-max Seat #5 is the button
Seat 1: BB ($3.20 in chips)
Seat 2: UTG ($2.01 in chips)
Seat 3: HJ ($2 in chips)
Seat 4: CO ($3.75 in chips)
Seat 5: BTN ($1.23 in chips)
Seat 6: SB ($2.34 in chips)
SB: posts small blind $0.01
BB: posts big blind $0.02
*** HOLE CARDS ***
UTG: folds
HJ: folds
CO: folds
BTN: raises $0.02 to $0.04
SB: calls $0.03
BB: folds
*** FLOP *** [2h Jh Td]
SB: bets $0.10
BTN: folds
Uncalled bet ($0.10) returned to SB
SB collected $0.10 from pot
SB: doesn't show hand
*** SUMMARY ***
Total pot $0.10 | Rake $0
Board [2h Jh Td]
Seat 1: BB (big blind) folded before Flop
Seat 2: UTG folded before Flop (didn't bet)
Seat 3: HJ folded before Flop (didn't bet)
Seat 4: CO folded before Flop (didn't bet)
Seat 5: BTN (button) folded on the Flop
Seat 6: SB (small blind) collected ($0.10)


PokerStars Hand #238160883678:  Hold'em No Limit ($0.01/$0.02 USD) - 2022/08/22 23:26:58 ET
Table 'Achilles IV' 6-max Seat #6 is the button
Seat 1: SB ($3.18 in chips)
Seat 2: BB ($2.01 in chips)
Seat 3: HJ ($2 in chips)
Seat 5: CO ($1.19 in chips)
Seat 6: BTN ($2.40 in chips)
SB: posts small blind $0.01
BB: posts big blind $0.02
*** HOLE CARDS ***
HJ: folds
CO: raises $0.02 to $0.04
BTN: calls $0.04
SB: folds
BB: calls $0.02
*** FLOP *** [7h Ts 8c]
BB: checks
CO: checks
BTN: checks
*** TURN *** [7h Ts 8c] [Tc]
BB: bets $0.10
CO: folds
BTN: raises $0.10 to $0.20
BB: calls $0.10
*** RIVER *** [7h Ts 8c Tc] [9d]
BB: checks
BTN: checks
*** SHOW DOWN ***
BB: shows [6s Js] (a straight, Seven to Jack)
BTN: mucks hand
BB collected $0.51 from pot
*** SUMMARY ***
Total pot $0.53 | Rake $0.02
Board [7h Ts 8c Tc 9d]
Seat 1: SB (small blind) folded before Flop
Seat 2: BB (big blind) showed [6s Js] and won ($0.51) with a straight, Seven to Jack
Seat 3: HJ folded before Flop (didn't bet)
Seat 5: CO folded on the Turn
Seat 6: BTN (button) mucked


PokerStars Hand #238160896322:  Hold'em No Limit ($0.01/$0.02 USD) - 2022/08/22 23:28:21 ET
Table 'Achilles IV' 6-max Seat #1 is the button
Seat 1: BTN ($3.17 in chips)
Seat 2: SB ($2.28 in chips)
Seat 3: BB ($2 in chips)
Seat 5: HJ ($1.15 in chips)
Seat 6: CO ($2.16 in chips)
SB: posts small blind $0.01
BB: posts big blind $0.02
*** HOLE CARDS ***
HJ: raises $0.02 to $0.04
CO: calls $0.04
BTN: folds
SB: folds
BB: folds
*** FLOP *** [2h As 9d]
HJ: checks
CO: checks
*** TURN *** [2h As 9d] [Ks]
HJ: checks
CO: checks
*** RIVER *** [2h As 9d Ks] [Ad]
HJ: bets $0.02
CO: folds
Uncalled bet ($0.02) returned to HJ
HJ collected $0.11 from pot
HJ: doesn't show hand
*** SUMMARY ***
Total pot $0.11 | Rake $0
Board [2h As 9d Ks Ad]
Seat 1: BTN (button) folded before Flop (didn't bet)
Seat 2: SB (small blind) folded before Flop
Seat 3: BB (big blind) folded before Flop
Seat 5: HJ collected ($0.11)
Seat 6: CO folded on the River


PokerStars Hand #238160905720:  Hold'em No Limit ($0.01/$0.02 USD) - 2022/08/22 23:29:23 ET
Table 'Achilles IV' 6-max Seat #2 is the button
Seat 1: CO ($3.17 in chips)
Seat 2: BTN ($2.27 in chips)
Seat 3: SB ($2 in chips)
Seat 4: BB ($3.75 in chips)
Seat 5: UTG ($1.22 in chips)
Seat 6: HJ ($2.12 in chips)
SB: posts small blind $0.01
BB: posts big blind $0.02
*** HOLE CARDS ***
UTG: folds
HJ: calls $0.02
CO: folds
BTN: raises $0.08 to $0.10
SB: raises $0.20 to $0.30
BB: folds
HJ: folds
BTN: folds
Uncalled bet ($0.20) returned to SB
SB collected $0.24 from pot
SB: doesn't show hand
*** SUMMARY ***
Total pot $0.24 | Rake $0
Seat 1: CO folded before Flop (didn't bet)
Seat 2: BTN (button) folded before Flop
Seat 3: SB (small blind) collected ($0.24)
Seat 4: BB (big blind) folded before Flop
Seat 5: UTG folded before Flop (didn't bet)
Seat 6: HJ folded before Flop


PokerStars Hand #238160911024:  Hold'em No Limit ($0.01/$0.02 USD) - 2022/08/22 23:29:59 ET
Table 'Achilles IV' 6-max Seat #3 is the button
Seat 1: HJ ($3.17 in chips)
Seat 2: CO ($2.17 in chips)
Seat 3: BTN ($2.14 in chips)
Seat 4: SB ($3.73 in chips)
Seat 5: BB ($1.22 in chips)
Seat 6: UTG ($2.10 in chips)
SB: posts small blind $0.01
BB: posts big blind $0.02
*** HOLE CARDS ***
UTG: folds
HJ: folds
CO: raises $0.04 to $0.06
BTN: folds
SB: calls $0.05
BB: folds
*** FLOP *** [Ah Td 5h]
SB: checks
CO: checks
*** TURN *** [Ah Td 5h] [4s]
SB: bets $0.06
CO: calls $0.06
*** RIVER *** [Ah Td 5h 4s] [7d]
SB: checks
CO: checks
*** SHOW DOWN ***
SB: shows [Jc 8h] (high card Ace)
CO: shows [Js Ts] (a pair of Tens)
CO collected $0.25 from pot
*** SUMMARY ***
Total pot $0.26 | Rake $0.01
Board [Ah Td 5h 4s 7d]
Seat 1: HJ folded before Flop (didn't bet)
Seat 2: CO showed [Js Ts] and won ($0.25) with a pair of Tens
Seat 3: BTN (button) folded before Flop (didn't bet)
Seat 4: SB (small blind) showed [Jc 8h] and lost with high card Ace
Seat 5: BB (big blind) folded before Flop
Seat 6: UTG folded before Flop (didn't bet)


PokerStars Hand #238160923744:  Hold'em No Limit ($0.01/$0.02 USD) - 2022/08/22 23:31:24 ET
Table 'Achilles IV' 6-max Seat #4 is the button
Seat 1: UTG ($3.17 in chips)
Seat 2: HJ ($2.30 in chips)
Seat 3: CO ($2.14 in chips)
Seat 4: BTN ($3.61 in chips)
Seat 5: SB ($1.20 in chips)
Seat 6: BB ($2.10 in chips)
SB: posts small blind $0.01
BB: posts big blind $0.02
*** HOLE CARDS ***
UTG: folds
HJ: folds
CO: folds
BTN: folds
SB: raises $0.02 to $0.04
BB: calls $0.02
*** FLOP *** [6s 8c Ad]
SB: checks
BB: checks
*** TURN *** [6s 8c Ad] [Kd]
SB: checks
BB: bets $0.08
SB: calls $0.08
*** RIVER *** [6s 8c Ad Kd] [Jh]
SB: bets $0.02
BB: calls $0.02
*** SHOW DOWN ***
SB: shows [7d 6d] (a pair of Sixes)
BB: shows [8h 7h] (a pair of Eights)
BB collected $0.27 from pot
*** SUMMARY ***
Total pot $0.28 | Rake $0.01
Board [6s 8c Ad Kd Jh]
Seat 1: UTG folded before Flop (didn't bet)
Seat 2: HJ folded before Flop (didn't bet)
Seat 3: CO folded before Flop (didn't bet)
Seat 4: BTN (button) folded before Flop (didn't bet)
Seat 5: SB (small blind) showed [7d 6d] and lost with a pair of Sixes
Seat 6: BB (big blind) showed [8h 7h] and won ($0.27) with a pair of Eights


PokerStars Hand #238160929853:  Hold'em No Limit ($0.01/$0.02 USD) - 2022/08/22 23:32:05 ET
Table 'Achilles IV' 6-max Seat #5 is the button
Seat 2: BB ($2.30 in chips)
Seat 3: HJ ($2.14 in chips)
Seat 4: CO ($3.61 in chips)
Seat 5: BTN ($1.06 in chips)
Seat 6: SB ($2.23 in chips)
SB: posts small blind $0.01
Ramirres: is sitting out
Ramirres leaves the table
BB: posts big blind $0.02
*** HOLE CARDS ***
HJ: folds
CO: folds
BTN: folds
SB: calls $0.01
BB: checks
*** FLOP *** [3h Ah 7s]
SB: checks
BB: checks
*** TURN *** [3h Ah 7s] [Kc]
Andy Oldani joins the table at seat #1
SB: bets $0.04
BB: folds
Uncalled bet ($0.04) returned to SB
SB collected $0.04 from pot
*** SUMMARY ***
Total pot $0.04 | Rake $0
Board [3h Ah 7s Kc]
Seat 2: BB (big blind) folded on the Turn
Seat 3: HJ folded before Flop (didn't bet)
Seat 4: CO folded before Flop (didn't bet)
Seat 5: BTN (button) folded before Flop (didn't bet)
Seat 6: SB (small blind) collected ($0.04)


PokerStars Hand #238160934569:  Hold'em No Limit ($0.01/$0.02 USD) - 2022/08/22 23:32:37 ET
Table 'Achilles IV' 6-max Seat #6 is the button
Seat 2: SB ($2.28 in chips)
Seat 3: BB ($2.14 in chips)
Seat 4: HJ ($3.61 in chips)
Seat 5: CO ($1.06 in chips)
Seat 6: BTN ($2.25 in chips)
SB: posts small blind $0.01
BB: posts big blind $0.02
*** HOLE CARDS ***
HJ: folds
CO: raises $0.02 to $0.04
BTN: calls $0.04
SB: folds
BB: calls $0.02
*** FLOP *** [6d 6c 2d]
BB: checks
CO: checks
BTN: checks
*** TURN *** [6d 6c 2d] [3s]
BB: checks
CO: checks
BTN: checks
*** RIVER *** [6d 6c 2d 3s] [4s]
BB: checks
CO: bets $0.02
BTN: raises $0.09 to $0.11
BB: folds
CO: folds
Uncalled bet ($0.09) returned to BTN
BTN collected $0.16 from pot
BTN: doesn't show hand
*** SUMMARY ***
Total pot $0.17 | Rake $0.01
Board [6d 6c 2d 3s 4s]
Seat 2: SB (small blind) folded before Flop
Seat 3: BB (big blind) folded on the River
Seat 4: HJ folded before Flop (didn't bet)
Seat 5: CO folded on the River
Seat 6: BTN (button) collected ($0.16)


PokerStars Hand #238160944990:  Hold'em No Limit ($0.01/$0.02 USD) - 2022/08/22 23:33:47 ET
Table 'Achilles IV' 6-max Seat #2 is the button
Seat 1: CO ($2 in chips)
Seat 2: BTN ($2.27 in chips)
Seat 3: SB ($2.10 in chips)
Seat 4: BB ($3.61 in chips)
Seat 5: UTG ($1 in chips)
Seat 6: HJ ($2.35 in chips)
SB: posts small blind $0.01
BB: posts big blind $0.02
CO: posts big blind $0.02
*** HOLE CARDS ***
UTG: folds
HJ: folds
CO: checks
BTN: folds
SB: raises $0.08 to $0.10
BB: folds
CO: folds
Uncalled bet ($0.08) returned to SB
SB collected $0.06 from pot
SB: doesn't show hand
*** SUMMARY ***
Total pot $0.06 | Rake $0
Seat 1: CO folded before Flop (didn't bet)
Seat 2: BTN (button) folded before Flop (didn't bet)
Seat 3: SB (small blind) collected ($0.06)
Seat 4: BB (big blind) folded before Flop
Seat 5: UTG folded before Flop (didn't bet)
Seat 6: HJ folded before Flop (didn't bet)


PokerStars Hand #238160949462:  Hold'em No Limit ($0.01/$0.02 USD) - 2022/08/22 23:34:18 ET
Table 'Achilles IV' 6-max Seat #3 is the button
Seat 1: HJ ($2 in chips)
Seat 2: CO ($2.27 in chips)
Seat 3: BTN ($2.14 in chips)
Seat 4: SB ($3.59 in chips)
Seat 5: BB ($1 in chips)
Seat 6: UTG ($2.35 in chips)
SB: posts small blind $0.01
BB: posts big blind $0.02
*** HOLE CARDS ***
UTG: calls $0.02
HJ: folds
CO: folds
BTN: folds
SB: raises $0.04 to $0.06
BB: folds
UTG: calls $0.04
*** FLOP *** [Jd Js 4h]
SB: checks
UTG: checks
*** TURN *** [Jd Js 4h] [Td]
SB: checks
UTG: checks
*** RIVER *** [Jd Js 4h Td] [3c]
SB: checks
UTG: bets $0.14
SB: calls $0.14
*** SHOW DOWN ***
UTG: shows [Jh 6h] (three of a kind, Jacks)
SB: mucks hand
UTG collected $0.41 from pot
*** SUMMARY ***
Total pot $0.42 | Rake $0.01
Board [Jd Js 4h Td 3c]
Seat 1: HJ folded before Flop (didn't bet)
Seat 2: CO folded before Flop (didn't bet)
Seat 3: BTN (button) folded before Flop (didn't bet)
Seat 4: SB (small blind) mucked
Seat 5: BB (big blind) folded before Flop
Seat 6: UTG showed [Jh 6h] and won ($0.41) with three of a kind, Jacks


PokerStars Hand #238160959715:  Hold'em No Limit ($0.01/$0.02 USD) - 2022/08/22 23:35:28 ET
Table 'Achilles IV' 6-max Seat #4 is the button
Seat 1: UTG ($2 in chips)
Seat 2: HJ ($2.27 in chips)
Seat 3: CO ($2.14 in chips)
Seat 4: BTN ($3.39 in chips)
Seat 5: SB ($0.98 in chips)
Seat 6: BB ($2.56 in chips)
SB: posts small blind $0.01
BB: posts big blind $0.02
*** HOLE CARDS ***
UTG: raises $0.04 to $0.06
HJ: folds
CO: folds
BTN: folds
SB: folds
BB: calls $0.04
*** FLOP *** [8c 8d 5d]
BB: checks
UTG: checks
*** TURN *** [8c 8d 5d] [9h]
BB: bets $0.06
UTG: folds
Uncalled bet ($0.06) returned to BB
BB collected $0.13 from pot
BB: doesn't show hand
*** SUMMARY ***
Total pot $0.13 | Rake $0
Board [8c 8d 5d 9h]
Seat 1: UTG folded on the Turn
Seat 2: HJ folded before Flop (didn't bet)
Seat 3: CO folded before Flop (didn't bet)
Seat 4: BTN (button) folded before Flop (didn't bet)
Seat 5: SB (small blind) folded before Flop
Seat 6: BB (big blind) collected ($0.13)


PokerStars Hand #238160970195:  Hold'em No Limit ($0.01/$0.02 USD) - 2022/08/22 23:36:11 ET
Table 'Achilles IV' 6-max Seat #5 is the button
Seat 1: BB ($2 in chips)
Seat 2: UTG ($2.27 in chips)
Seat 3: HJ ($2.14 in chips)
Seat 4: CO ($3.39 in chips)
Seat 5: BTN ($0.97 in chips)
Seat 6: SB ($2.63 in chips)
SB: posts small blind $0.01
BB: posts big blind $0.02
*** HOLE CARDS ***
UTG: folds
HJ: folds
CO: folds
BTN: folds
SB: calls $0.01
BB: checks
*** FLOP *** [5h 5d 7h]
SB: checks
BB: checks
*** TURN *** [5h 5d 7h] [Ac]
SB: checks
BB: checks
*** RIVER *** [5h 5d 7h Ac] [6h]
SB: checks
BB: checks
*** SHOW DOWN ***
SB: shows [2h Td] (a pair of Fives)
BB: shows [Kh 3d] (a pair of Fives - Ace+King kicker)
BB collected $0.04 from pot
*** SUMMARY ***
Total pot $0.04 | Rake $0
Board [5h 5d 7h Ac 6h]
Seat 1: BB (big blind) showed [Kh 3d] and won ($0.04) with a pair of Fives
Seat 2: UTG folded before Flop (didn't bet)
Seat 3: HJ folded before Flop (didn't bet)
Seat 4: CO folded before Flop (didn't bet)
Seat 5: BTN (button) folded before Flop (didn't bet)
Seat 6: SB (small blind) showed [2h Td] and lost with a pair of Fives


PokerStars Hand #238160976751:  Hold'em No Limit ($0.01/$0.02 USD) - 2022/08/22 23:36:55 ET
Table 'Achilles IV' 6-max Seat #6 is the button
Seat 1: SB ($2.02 in chips)
Seat 2: BB ($2.27 in chips)
Seat 3: UTG ($2.14 in chips)
Seat 4: HJ ($3.39 in chips)
Seat 5: CO ($0.97 in chips)
Seat 6: BTN ($2.61 in chips)
SB: posts small blind $0.01
BB: posts big blind $0.02
*** HOLE CARDS ***
UTG: folds
HJ: folds
CO: raises $0.02 to $0.04
BTN: folds
SB: folds
BB: calls $0.02
*** FLOP *** [Jh 5s 7s]
BB: checks
CO: checks
*** TURN *** [Jh 5s 7s] [4c]
BB: bets $0.04
CO: raises $0.04 to $0.08
BB: calls $0.04
*** RIVER *** [Jh 5s 7s 4c] [Ac]
BB: checks
CO: bets $0.12
BB: calls $0.12
*** SHOW DOWN ***
CO: shows [Qh 4h] (a pair of Fours)
BB: shows [6h As] (a pair of Aces)
BB collected $0.47 from pot
*** SUMMARY ***
Total pot $0.49 | Rake $0.02
Board [Jh 5s 7s 4c Ac]
Seat 1: SB (small blind) folded before Flop
Seat 2: BB (big blind) showed [6h As] and won ($0.47) with a pair of Aces
Seat 3: UTG folded before Flop (didn't bet)
Seat 4: HJ folded before Flop (didn't bet)
Seat 5: CO showed [Qh 4h] and lost with a pair of Fours
Seat 6: BTN (button) folded before Flop (didn't bet)


PokerStars Hand #238160987921:  Hold'em No Limit ($0.01/$0.02 USD) - 2022/08/22 23:38:10 ET
Table 'Achilles IV' 6-max Seat #1 is the button
Seat 1: BTN ($2.01 in chips)
Seat 2: SB ($2.50 in chips)
Seat 3: BB ($2.14 in chips)
Seat 4: UTG ($3.39 in chips)
Seat 5: HJ ($0.73 in chips)
Seat 6: CO ($2.61 in chips)
SB: posts small blind $0.01
BB: posts big blind $0.02
*** HOLE CARDS ***
UTG: folds
HJ: raises $0.02 to $0.04
CO: folds
BTN: calls $0.04
SB: folds
BB: folds
*** FLOP *** [9d 3c Ts]
HJ: checks
BTN: checks
*** TURN *** [9d 3c Ts] [Kh]
HJ: checks
BTN: checks
*** RIVER *** [9d 3c Ts Kh] [Tc]
HJ: bets $0.02
BTN: folds
Uncalled bet ($0.02) returned to HJ
HJ collected $0.11 from pot
HJ: doesn't show hand
*** SUMMARY ***
Total pot $0.11 | Rake $0
Board [9d 3c Ts Kh Tc]
Seat 1: BTN (button) folded on the River
Seat 2: SB (small blind) folded before Flop
Seat 3: BB (big blind) folded before Flop
Seat 4: UTG folded before Flop (didn't bet)
Seat 5: HJ collected ($0.11)
Seat 6: CO folded before Flop (didn't bet)


PokerStars Hand #238160993087:  Hold'em No Limit ($0.01/$0.02 USD) - 2022/08/22 23:38:45 ET
Table 'Achilles IV' 6-max Seat #2 is the button
Seat 1: CO ($2 in chips)
Seat 2: BTN ($2.49 in chips)
Seat 3: SB ($2.12 in chips)
Seat 4: BB ($3.39 in chips)
Seat 5: UTG ($0.80 in chips)
Seat 6: HJ ($2.61 in chips)
SB: posts small blind $0.01
BB: posts big blind $0.02
*** HOLE CARDS ***
UTG: folds
HJ: calls $0.02
CO: folds
BTN: folds
SB: folds
BB: checks
*** FLOP *** [4h 6c Jd]
BB: checks
HJ: checks
*** TURN *** [4h 6c Jd] [2h]
BB: checks
HJ: checks
*** RIVER *** [4h 6c Jd 2h] [2s]
BB: checks
HJ: bets $0.05
BB: folds
Uncalled bet ($0.05) returned to HJ
HJ collected $0.05 from pot
*** SUMMARY ***
Total pot $0.05 | Rake $0
Board [4h 6c Jd 2h 2s]
Seat 1: CO folded before Flop (didn't bet)
Seat 2: BTN (button) folded before Flop (didn't bet)
Seat 3: SB (small blind) folded before Flop
Seat 4: BB (big blind) folded on the River
Seat 5: UTG folded before Flop (didn't bet)
Seat 6: HJ collected ($0.05)


PokerStars Hand #238160999522:  Hold'em No Limit ($0.01/$0.02 USD) - 2022/08/22 23:39:30 ET
Table 'Achilles IV' 6-max Seat #3 is the button
Seat 1: HJ ($2 in chips)
Seat 2: CO ($2.49 in chips)
Seat 3: BTN ($2.11 in chips)
Seat 4: SB ($3.37 in chips)
Seat 5: BB ($0.80 in chips)
Seat 6: UTG ($2.64 in chips)
SB: posts small blind $0.01
BB: posts big blind $0.02
*** HOLE CARDS ***
UTG: calls $0.02
HJ: folds
CO: folds
BTN: folds
SB: folds
BB: checks
*** FLOP *** [7s 2c 8s]
BB: checks
UTG: checks
*** TURN *** [7s 2c 8s] [Jh]
BB: checks
UTG: checks
*** RIVER *** [7s 2c 8s Jh] [7c]
BB: bets $0.02
UTG: folds
Uncalled bet ($0.02) returned to BB
BB collected $0.05 from pot
BB: doesn't show hand
*** SUMMARY ***
Total pot $0.05 | Rake $0
Board [7s 2c 8s Jh 7c]
Seat 1: HJ folded before Flop (didn't bet)
Seat 2: CO folded before Flop (didn't bet)
Seat 3: BTN (button) folded before Flop (didn't bet)
Seat 4: SB (small blind) folded before Flop
Seat 5: BB (big blind) collected ($0.05)
Seat 6: UTG folded on the River


PokerStars Hand #238161012334:  Hold'em No Limit ($0.01/$0.02 USD) - 2022/08/22 23:40:07 ET
Table 'Achilles IV' 6-max Seat #4 is the button
Seat 1: UTG ($2 in chips)
Seat 2: HJ ($2.49 in chips)
Seat 3: CO ($2.11 in chips)
Seat 4: BTN ($3.36 in chips)
Seat 5: SB ($0.83 in chips)
Seat 6: BB ($2.62 in chips)
SB: posts small blind $0.01
BB: posts big blind $0.02
*** HOLE CARDS ***
UTG: folds
HJ: raises $0.04 to $0.06
CO: folds
BTN: folds
SB: raises $0.77 to $0.83 and is all-in
BB: folds
HJ: folds
Uncalled bet ($0.77) returned to SB
SB collected $0.14 from pot
SB: doesn't show hand
*** SUMMARY ***
Total pot $0.14 | Rake $0
Seat 1: UTG folded before Flop (didn't bet)
Seat 2: HJ folded before Flop
Seat 3: CO folded before Flop (didn't bet)
Seat 4: BTN (button) folded before Flop (didn't bet)
Seat 5: SB (small blind) collected ($0.14)
Seat 6: BB (big blind) folded before Flop


PokerStars Hand #238161015982:  Hold'em No Limit ($0.01/$0.02 USD) - 2022/08/22 23:40:33 ET
Table 'Achilles IV' 6-max Seat #5 is the button
Seat 1: BB ($2 in chips)
Seat 2: UTG ($2.43 in chips)
Seat 3: HJ ($2.11 in chips)
Seat 4: CO ($3.36 in chips)
Seat 5: BTN ($0.91 in chips)
Seat 6: SB ($2.60 in chips)
SB: posts small blind $0.01
BB: posts big blind $0.02
*** HOLE CARDS ***
UTG: folds
HJ: folds
CO: raises $0.04 to $0.06
BTN: folds
SB: folds
BB: calls $0.04
*** FLOP *** [5d Qs 8c]
BB: checks
CO: bets $0.08
BB: calls $0.08
*** TURN *** [5d Qs 8c] [2c]
BB: checks
CO: bets $0.16
BB: calls $0.16
*** RIVER *** [5d Qs 8c 2c] [Jc]
BB: checks
CO: checks
*** SHOW DOWN ***
BB: shows [Qh 9h] (a pair of Queens)
CO: mucks hand
BB collected $0.59 from pot
*** SUMMARY ***
Total pot $0.61 | Rake $0.02
Board [5d Qs 8c 2c Jc]
Seat 1: BB (big blind) showed [Qh 9h] and won ($0.59) with a pair of Queens
Seat 2: UTG folded before Flop (didn't bet)
Seat 3: HJ folded before Flop (didn't bet)
Seat 4: CO mucked
Seat 5: BTN (button) folded before Flop (didn't bet)
Seat 6: SB (small blind) folded before Flop


PokerStars Hand #238161024852:  Hold'em No Limit ($0.01/$0.02 USD) - 2022/08/22 23:41:35 ET
Table 'Achilles IV' 6-max Seat #6 is the button
Seat 1: SB ($2.29 in chips)
Seat 2: BB ($2.43 in chips)
Seat 3: UTG ($2.11 in chips)
Seat 4: HJ ($3.06 in chips)
Seat 5: CO ($0.91 in chips)
Seat 6: BTN ($2.59 in chips)
SB: posts small blind $0.01
BB: posts big blind $0.02
*** HOLE CARDS ***
UTG: folds
HJ: raises $0.04 to $0.06
CO: raises $0.85 to $0.91 and is all-in
BTN: folds
SB: folds
BB: folds
HJ: folds
Uncalled bet ($0.85) returned to CO
CO collected $0.15 from pot
CO: doesn't show hand
*** SUMMARY ***
Total pot $0.15 | Rake $0
Seat 1: SB (small blind) folded before Flop
Seat 2: BB (big blind) folded before Flop
Seat 3: UTG folded before Flop (didn't bet)
Seat 4: HJ folded before Flop
Seat 5: CO collected ($0.15)
Seat 6: BTN (button) folded before Flop (didn't bet)


PokerStars Hand #238161028182:  Hold'em No Limit ($0.01/$0.02 USD) - 2022/08/22 23:41:57 ET
Table 'Achilles IV' 6-max Seat #1 is the button
Seat 1: BTN ($2.28 in chips)
Seat 2: SB ($2.41 in chips)
Seat 3: BB ($2.11 in chips)
Seat 4: UTG ($3 in chips)
Seat 5: HJ ($1 in chips)
Seat 6: CO ($2.59 in chips)
SB: posts small blind $0.01
BB: posts big blind $0.02
*** HOLE CARDS ***
UTG: raises $0.04 to $0.06
HJ: folds
CO: calls $0.06
BTN: folds
SB: folds
BB: folds
*** FLOP *** [3s 7d Ts]
UTG: checks
CO: checks
*** TURN *** [3s 7d Ts] [Qh]
UTG: checks
CO: checks
*** RIVER *** [3s 7d Ts Qh] [Qd]
UTG: checks
CO: bets $0.14
UTG: folds
Uncalled bet ($0.14) returned to CO
CO collected $0.14 from pot
CO: doesn't show hand
*** SUMMARY ***
Total pot $0.15 | Rake $0.01
Board [3s 7d Ts Qh Qd]
Seat 1: BTN (button) folded before Flop (didn't bet)
Seat 2: SB (small blind) folded before Flop
Seat 3: BB (big blind) folded before Flop
Seat 4: UTG folded on the River
Seat 5: HJ folded before Flop (didn't bet)
Seat 6: CO collected ($0.14)


PokerStars Hand #238161033693:  Hold'em No Limit ($0.01/$0.02 USD) - 2022/08/22 23:42:36 ET
Table 'Achilles IV' 6-max Seat #2 is the button
Seat 1: CO ($2.28 in chips)
Seat 2: BTN ($2.40 in chips)
Seat 3: SB ($2.09 in chips)
Seat 4: BB ($2.94 in chips)
Seat 5: UTG ($1 in chips)
Seat 6: HJ ($2.67 in chips)
SB: posts small blind $0.01
BB: posts big blind $0.02
*** HOLE CARDS ***
UTG: folds
HJ: folds
CO: folds
BTN: folds
SB: raises $0.04 to $0.06
BB: calls $0.04
*** FLOP *** [3h As 4s]
SB: bets $0.09
BB: calls $0.09
*** TURN *** [3h As 4s] [8s]
SB: checks
BB: checks
*** RIVER *** [3h As 4s 8s] [3d]
SB: checks
BB: bets $0.10
SB: folds
Uncalled bet ($0.10) returned to BB
BB collected $0.29 from pot
*** SUMMARY ***
Total pot $0.30 | Rake $0.01
Board [3h As 4s 8s 3d]
Seat 1: CO folded before Flop (didn't bet)
Seat 2: BTN (button) folded before Flop (didn't bet)
Seat 3: SB (small blind) folded on the River
Seat 4: BB (big blind) collected ($0.29)
Seat 5: UTG folded before Flop (didn't bet)
Seat 6: HJ folded before Flop (didn't bet)


PokerStars Hand #238161043254:  Hold'em No Limit ($0.01/$0.02 USD) - 2022/08/22 23:43:43 ET
Table 'Achilles IV' 6-max Seat #3 is the button
Seat 1: HJ ($2.28 in chips)
Seat 2: CO ($2.40 in chips)
Seat 3: BTN ($2 in chips)
Seat 4: SB ($3.08 in chips)
Seat 5: BB ($1 in chips)
Seat 6: UTG ($2.67 in chips)
SB: posts small blind $0.01
BB: posts big blind $0.02
*** HOLE CARDS ***
UTG: calls $0.02
HJ: folds
CO: folds
BTN: raises $0.08 to $0.10
SB: calls $0.09
BB: folds
UTG: calls $0.08
*** FLOP *** [Ks Td 3h]
SB: checks
UTG: checks
BTN: checks
*** TURN *** [Ks Td 3h] [Qs]
SB: checks
UTG: bets $0.15
BTN: raises $0.25 to $0.40
SB: folds
UTG: calls $0.25
*** RIVER *** [Ks Td 3h Qs] [As]
UTG: checks
BTN: checks
*** SHOW DOWN ***
UTG: shows [5s 9s] (a flush, Ace high)
BTN: mucks hand
UTG collected $1.08 from pot
*** SUMMARY ***
Total pot $1.12 | Rake $0.04
Board [Ks Td 3h Qs As]
Seat 1: HJ folded before Flop (didn't bet)
Seat 2: CO folded before Flop (didn't bet)
Seat 3: BTN (button) mucked
Seat 4: SB (small blind) folded on the Turn
Seat 5: BB (big blind) folded before Flop
Seat 6: UTG showed [5s 9s] and won ($1.08) with a flush, Ace high


PokerStars Hand #238161054059:  Hold'em No Limit ($0.01/$0.02 USD) - 2022/08/22 23:44:59 ET
Table 'Achilles IV' 6-max Seat #4 is the button
Seat 1: UTG ($2.28 in chips)
Seat 2: HJ ($2.40 in chips)
Seat 3: CO ($2 in chips)
Seat 4: BTN ($2.98 in chips)
Seat 5: SB ($0.98 in chips)
Seat 6: BB ($3.25 in chips)
SB: posts small blind $0.01
BB: posts big blind $0.02
*** HOLE CARDS ***
UTG: folds
HJ: folds
CO: raises $0.03 to $0.05
BTN: folds
SB: calls $0.04
BB: folds
*** FLOP *** [6c As Qs]
SB: checks
CO: bets $0.09
SB: raises $0.09 to $0.18
CO: calls $0.09
*** TURN *** [6c As Qs] [8d]
SB: bets $0.23
CO: raises $0.63 to $0.86
SB: calls $0.52 and is all-in
Uncalled bet ($0.11) returned to CO
*** RIVER *** [6c As Qs 8d] [5d]
*** SHOW DOWN ***
SB: shows [4s Ah] (a pair of Aces)
CO: shows [8c 8s] (three of a kind, Eights)
CO collected $1.91 from pot
*** SUMMARY ***
Total pot $1.98 | Rake $0.07
Board [6c As Qs 8d 5d]
Seat 1: UTG folded before Flop (didn't bet)
Seat 2: HJ folded before Flop (didn't bet)
Seat 3: CO showed [8c 8s] and won ($1.91) with three of a kind, Eights
Seat 4: BTN (button) folded before Flop (didn't bet)
Seat 5: SB (small blind) showed [4s Ah] and lost with a pair of Aces
Seat 6: BB (big blind) folded before Flop


PokerStars Hand #238161061998:  Hold'em No Limit ($0.01/$0.02 USD) - 2022/08/22 23:45:54 ET
Table 'Achilles IV' 6-max Seat #6 is the button
Seat 1: SB ($2.28 in chips)
Seat 2: BB ($2.40 in chips)
Seat 3: HJ ($2.93 in chips)
Seat 4: CO ($2.98 in chips)
Seat 6: BTN ($3.23 in chips)
SB: posts small blind $0.01
BB: posts big blind $0.02
*** HOLE CARDS ***
HJ: folds
Roogrid is disconnected
CO: raises $0.04 to $0.06
BTN: calls $0.06
SB: folds
BB: folds
*** FLOP *** [Qc 3c Js]
CO: bets $0.09
BTN: folds
Uncalled bet ($0.09) returned to CO
CO collected $0.14 from pot
*** SUMMARY ***
Total pot $0.15 | Rake $0.01
Board [Qc 3c Js]
Seat 1: SB (small blind) folded before Flop
Seat 2: BB (big blind) folded before Flop
Seat 3: HJ folded before Flop (didn't bet)
Seat 4: CO collected ($0.14)
Seat 6: BTN (button) folded on the Flop


PokerStars Hand #238161067614:  Hold'em No Limit ($0.01/$0.02 USD) - 2022/08/22 23:46:34 ET
Table 'Achilles IV' 6-max Seat #1 is the button
Seat 1: BTN ($2.27 in chips)
Seat 2: SB ($2.38 in chips)
Seat 3: BB ($2.93 in chips)
Seat 4: HJ ($3.06 in chips)
Seat 6: CO ($3.17 in chips)
SB: posts small blind $0.01
BB: posts big blind $0.02
*** HOLE CARDS ***
HJ: folds
CO: calls $0.02
BTN: folds
SB: folds
BB: checks
*** FLOP *** [5s Qc Kc]
BB: checks
CO: checks
*** TURN *** [5s Qc Kc] [5d]
BB: checks
CO: checks
*** RIVER *** [5s Qc Kc 5d] [8c]
BB: checks
CO: bets $0.05
BB: folds
Uncalled bet ($0.05) returned to CO
CO collected $0.05 from pot
CO: doesn't show hand
*** SUMMARY ***
Total pot $0.05 | Rake $0
Board [5s Qc Kc 5d 8c]
Seat 1: BTN (button) folded before Flop (didn't bet)
Seat 2: SB (small blind) folded before Flop
Seat 3: BB (big blind) folded on the River
Seat 4: HJ folded before Flop (didn't bet)
Seat 6: CO collected ($0.05)


PokerStars Hand #238161073339:  Hold'em No Limit ($0.01/$0.02 USD) - 2022/08/22 23:47:15 ET
Table 'Achilles IV' 6-max Seat #2 is the button
Seat 1: CO ($2.27 in chips)
Seat 2: BTN ($2.37 in chips)
Seat 3: SB ($2.91 in chips)
Seat 4: BB ($3.06 in chips)
Seat 6: HJ ($3.20 in chips)
SB: posts small blind $0.01
BB: posts big blind $0.02
*** HOLE CARDS ***
HJ: calls $0.02
CO: folds
BTN: raises $0.08 to $0.10
SB: folds
BB: calls $0.08
HJ: calls $0.08
*** FLOP *** [Th 3c 9h]
BB: checks
HJ: checks
BTN: bets $0.21
BB: folds
HJ: folds
Uncalled bet ($0.21) returned to BTN
BTN collected $0.30 from pot
*** SUMMARY ***
Total pot $0.31 | Rake $0.01
Board [Th 3c 9h]
Seat 1: CO folded before Flop (didn't bet)
Seat 2: BTN (button) collected ($0.30)
Seat 3: SB (small blind) folded before Flop
Seat 4: BB (big blind) folded on the Flop
Seat 6: HJ folded on the Flop


PokerStars Hand #238161086152:  Hold'em No Limit ($0.01/$0.02 USD) - 2022/08/22 23:48:11 ET
Table 'Achilles IV' 6-max Seat #3 is the button
Seat 1: HJ ($2.27 in chips)
Seat 2: CO ($2.57 in chips)
Seat 3: BTN ($2.90 in chips)
Seat 4: SB ($2.96 in chips)
Seat 6: BB ($3.10 in chips)
SB: posts small blind $0.01
BB: posts big blind $0.02
*** HOLE CARDS ***
HJ: folds
CO: raises $0.04 to $0.06
BTN: folds
SB: folds
BB: calls $0.04
*** FLOP *** [9d Js Qc]
BB: checks
CO: bets $0.04
BB: folds
Uncalled bet ($0.04) returned to CO
CO collected $0.13 from pot
*** SUMMARY ***
Total pot $0.13 | Rake $0
Board [9d Js Qc]
Seat 1: HJ folded before Flop (didn't bet)
Seat 2: CO collected ($0.13)
Seat 3: BTN (button) folded before Flop (didn't bet)
Seat 4: SB (small blind) folded before Flop
Seat 6: BB (big blind) folded on the Flop


PokerStars Hand #238161096743:  Hold'em No Limit ($0.01/$0.02 USD) - 2022/08/22 23:49:25 ET
Table 'Achilles IV' 6-max Seat #6 is the button
Seat 1: SB ($2.25 in chips)
Seat 2: BB ($2.64 in chips)
Seat 3: HJ ($2.98 in chips)
Seat 4: CO ($2.90 in chips)
Seat 6: BTN ($3.03 in chips)
SB: posts small blind $0.01
BB: posts big blind $0.02
*** HOLE CARDS ***
HJ: folds
CO: folds
BTN: calls $0.02
SB: calls $0.01
BB: raises $0.12 to $0.14
BTN: folds
SB: folds
Uncalled bet ($0.12) returned to BB
BB collected $0.06 from pot
*** SUMMARY ***
Total pot $0.06 | Rake $0
Seat 1: SB (small blind) folded before Flop
Seat 2: BB (big blind) collected ($0.06)
Seat 3: HJ folded before Flop (didn't bet)
Seat 4: CO folded before Flop (didn't bet)
Seat 6: BTN (button) folded before Flop


PokerStars Hand #238161101194:  Hold'em No Limit ($0.01/$0.02 USD) - 2022/08/22 23:49:57 ET
Table 'Achilles IV' 6-max Seat #1 is the button
Seat 1: BTN ($2.23 in chips)
Seat 2: SB ($2.68 in chips)
Seat 3: BB ($2.98 in chips)
Seat 4: HJ ($2.90 in chips)
Seat 6: CO ($3.01 in chips)
SB: posts small blind $0.01
BB: posts big blind $0.02
*** HOLE CARDS ***
HJ: folds
CO: calls $0.02
BTN: folds
SB: raises $0.10 to $0.12
BB: folds
CO: folds
Uncalled bet ($0.10) returned to SB
SB collected $0.06 from pot
*** SUMMARY ***
Total pot $0.06 | Rake $0
Seat 1: BTN (button) folded before Flop (didn't bet)
Seat 2: SB (small blind) collected ($0.06)
Seat 3: BB (big blind) folded before Flop
Seat 4: HJ folded before Flop (didn't bet)
Seat 6: CO folded before Flop


PokerStars Hand #238161121769:  Hold'em No Limit ($0.01/$0.02 USD) - 2022/08/22 23:52:21 ET
Table 'Achilles IV' 6-max Seat #3 is the button
Seat 1: CO ($2.23 in chips)
Seat 3: BTN ($5.66 in chips)
Seat 4: SB ($2.72 in chips)
Seat 6: BB ($2.99 in chips)
SB: posts small blind $0.01
BB: posts big blind $0.02
*** HOLE CARDS ***
CO: folds
BTN: folds
SB: folds
Uncalled bet ($0.01) returned to BB
BB collected $0.02 from pot
*** SUMMARY ***
Total pot $0.02 | Rake $0
Seat 1: CO folded before Flop (didn't bet)
Seat 3: BTN (button) folded before Flop (didn't bet)
Seat 4: SB (small blind) folded before Flop
Seat 6: BB (big blind) collected ($0.02)


PokerStars Hand #238161105439:  Hold'em No Limit ($0.01/$0.02 USD) - 2022/08/22 23:50:27 ET
Table 'Achilles IV' 6-max Seat #2 is the button
Seat 1: CO ($2.23 in chips)
Seat 2: BTN ($2.72 in chips)
Seat 3: SB ($2.96 in chips)
Seat 4: BB ($2.90 in chips)
Seat 6: HJ ($2.99 in chips)
SB: posts small blind $0.01
BB: posts big blind $0.02
*** HOLE CARDS ***
HJ: folds
CO: folds
BTN: raises $0.04 to $0.06
SB: raises $0.12 to $0.18
BB: calls $0.16
BTN: calls $0.12
*** FLOP *** [Qd Ah 9s]
SB: bets $0.18
BB: folds
BTN: calls $0.18
*** TURN *** [Qd Ah 9s] [7c]
SB: bets $0.65
BTN: calls $0.65
*** RIVER *** [Qd Ah 9s 7c] [3c]
SB: bets $1.95 and is all-in
BTN: calls $1.71 and is all-in
Uncalled bet ($0.24) returned to SB
*** SHOW DOWN ***
SB: shows [As Ad] (three of a kind, Aces)
BTN: shows [Qc Ac] (two pair, Aces and Queens)
SB collected $5.42 from pot
*** SUMMARY ***
Total pot $5.62 | Rake $0.20
Board [Qd Ah 9s 7c 3c]
Seat 1: CO folded before Flop (didn't bet)
Seat 2: BTN (button) showed [Qc Ac] and lost with two pair, Aces and Queens
Seat 3: SB (small blind) showed [As Ad] and won ($5.42) with three of a kind, Aces
Seat 4: BB (big blind) folded on the Flop
Seat 6: HJ folded before Flop (didn't bet)


PokerStars Hand #238161123163:  Hold'em No Limit ($0.01/$0.02 USD) - 2022/08/22 23:52:31 ET
Table 'Achilles IV' 6-max Seat #4 is the button
Seat 1: BB ($2.23 in chips)
Seat 3: CO ($5.66 in chips)
Seat 4: BTN ($2.71 in chips)
Seat 6: SB ($3 in chips)
SB: posts small blind $0.01
BB: posts big blind $0.02
*** HOLE CARDS ***
CO: folds
BTN: folds
SB: folds
Uncalled bet ($0.01) returned to BB
BB collected $0.02 from pot
BB: doesn't show hand
*** SUMMARY ***
Total pot $0.02 | Rake $0
Seat 1: BB (big blind) collected ($0.02)
Seat 3: CO folded before Flop (didn't bet)
Seat 4: BTN (button) folded before Flop (didn't bet)
Seat 6: SB (small blind) folded before Flop


PokerStars Hand #238161125046:  Hold'em No Limit ($0.01/$0.02 USD) - 2022/08/22 23:52:44 ET
Table 'Achilles IV' 6-max Seat #6 is the button
Seat 1: SB ($2.24 in chips)
Seat 3: BB ($5.66 in chips)
Seat 4: CO ($2.71 in chips)
Seat 6: BTN ($2.99 in chips)
SB: posts small blind $0.01
BB: posts big blind $0.02
*** HOLE CARDS ***
CO: folds
BTN: calls $0.02
SB: folds
BB: checks
*** FLOP *** [2s Jd Ad]
BB: checks
BTN: checks
*** TURN *** [2s Jd Ad] [9d]
BB: checks
BTN: bets $0.05
BB: folds
Uncalled bet ($0.05) returned to BTN
BTN collected $0.05 from pot
BTN: doesn't show hand
*** SUMMARY ***
Total pot $0.05 | Rake $0
Board [2s Jd Ad 9d]
Seat 1: SB (small blind) folded before Flop
Seat 3: BB (big blind) folded on the Turn
Seat 4: CO folded before Flop (didn't bet)
Seat 6: BTN (button) collected ($0.05)


PokerStars Hand #238161130195:  Hold'em No Limit ($0.01/$0.02 USD) - 2022/08/22 23:53:21 ET
Table 'Achilles IV' 6-max Seat #1 is the button
Seat 1: BTN ($2.23 in chips)
Seat 3: SB ($5.64 in chips)
Seat 4: BB ($2.71 in chips)
Seat 6: CO ($3.02 in chips)
SB: posts small blind $0.01
BB: posts big blind $0.02
*** HOLE CARDS ***
CO: calls $0.02
BTN: folds
SB: raises $0.10 to $0.12
BB: folds
CO: folds
Uncalled bet ($0.10) returned to SB
SB collected $0.06 from pot
SB: doesn't show hand
*** SUMMARY ***
Total pot $0.06 | Rake $0
Seat 1: BTN (button) folded before Flop (didn't bet)
Seat 3: SB (small blind) collected ($0.06)
Seat 4: BB (big blind) folded before Flop
Seat 6: CO folded before Flop


PokerStars Hand #238161132747:  Hold'em No Limit ($0.01/$0.02 USD) - 2022/08/22 23:53:39 ET
Table 'Achilles IV' 6-max Seat #3 is the button
Seat 1: CO ($2.23 in chips)
Seat 3: BTN ($5.68 in chips)
Seat 4: SB ($2.69 in chips)
Seat 6: BB ($3 in chips)
SB: posts small blind $0.01
BB: posts big blind $0.02
*** HOLE CARDS ***
CO: folds
BTN: folds
SB: folds
Uncalled bet ($0.01) returned to BB
BB collected $0.02 from pot
BB: doesn't show hand
*** SUMMARY ***
Total pot $0.02 | Rake $0
Seat 1: CO folded before Flop (didn't bet)
Seat 3: BTN (button) folded before Flop (didn't bet)
Seat 4: SB (small blind) folded before Flop
Seat 6: BB (big blind) collected ($0.02)


PokerStars Hand #238161134284:  Hold'em No Limit ($0.01/$0.02 USD) - 2022/08/22 23:53:51 ET
Table 'Achilles IV' 6-max Seat #4 is the button
Seat 1: BB ($2.23 in chips)
Seat 2: HJ ($2 in chips)
Seat 3: CO ($5.68 in chips)
Seat 4: BTN ($2.68 in chips)
Seat 6: SB ($3.01 in chips)
SB: posts small blind $0.01
BB: posts big blind $0.02
HJ: posts small & big blinds $0.03
*** HOLE CARDS ***
HJ: checks
CO: folds
BTN: folds
SB: folds
BB: checks
*** FLOP *** [3c As 5c]
BB: checks
SB leaves the table
HJ: bets $0.04
BB: folds
Uncalled bet ($0.04) returned to HJ
HJ collected $0.06 from pot
*** SUMMARY ***
Total pot $0.06 | Rake $0
Board [3c As 5c]
Seat 1: BB (big blind) folded on the Flop
Seat 2: HJ collected ($0.06)
Seat 3: CO folded before Flop (didn't bet)
Seat 4: BTN (button) folded before Flop (didn't bet)
Seat 6: SB (small blind) folded before Flop


PokerStars Hand #238161138802:  Hold'em No Limit ($0.01/$0.02 USD) - 2022/08/22 23:54:23 ET
Table 'Achilles IV' 6-max Seat #1 is the button
Seat 1: BTN ($2.21 in chips)
Seat 2: SB ($2.03 in chips)
Seat 3: BB ($5.68 in chips)
Seat 4: CO ($2.68 in chips)
SB: posts small blind $0.01
BB: posts big blind $0.02
*** HOLE CARDS ***
CO: folds
BTN: raises $0.04 to $0.06
SB: raises $0.18 to $0.24
BB: folds
CO leaves the table
BTN: calls $0.18
*** FLOP *** [Qc Kc 2d]
SB: checks
BTN: checks
*** TURN *** [Qc Kc 2d] [4c]
SB: checks
BTN: bets $0.10
SB: calls $0.10
*** RIVER *** [Qc Kc 2d 4c] [Ks]
NZcardplayer joins the table at seat #6
Kalliminoy joins the table at seat #4
SB: checks
BTN: checks
*** SHOW DOWN ***
SB: shows [Qh Ah] (two pair, Kings and Queens)
BTN: mucks hand
SB collected $0.68 from pot
*** SUMMARY ***
Total pot $0.70 | Rake $0.02
Board [Qc Kc 2d 4c Ks]
Seat 1: BTN (button) mucked
Seat 2: SB (small blind) showed [Qh Ah] and won ($0.68) with two pair, Kings and Queens
Seat 3: BB (big blind) folded before Flop
Seat 4: CO folded before Flop (didn't bet)


PokerStars Hand #238161149837:  Hold'em No Limit ($0.01/$0.02 USD) - 2022/08/22 23:55:48 ET
Table 'Achilles IV' 6-max Seat #2 is the button
Seat 1: CO ($2 in chips)
Seat 2: BTN ($2.37 in chips)
Seat 3: SB ($5.66 in chips)
Seat 4: BB ($1.60 in chips)
SB: posts small blind $0.01
BB: posts big blind $0.02
NZcardplayer: sits out
*** HOLE CARDS ***
CO: raises $0.04 to $0.06
BTN: folds
Roogrid was removed from the table for failing to post
Roogrid leaves the table
SB: folds
BB: calls $0.04
*** FLOP *** [5d 9c 3d]
BB: bets $0.07
CO: raises $0.13 to $0.20
BB: calls $0.13
*** TURN *** [5d 9c 3d] [2s]
BB: checks
CO: bets $0.30
BB: folds
Uncalled bet ($0.30) returned to CO
CO collected $0.51 from pot
CO: doesn't show hand
*** SUMMARY ***
Total pot $0.53 | Rake $0.02
Board [5d 9c 3d 2s]
Seat 1: CO collected ($0.51)
Seat 2: BTN (button) folded before Flop (didn't bet)
Seat 3: SB (small blind) folded before Flop
Seat 4: BB (big blind) folded on the Turn


PokerStars Hand #238161160714:  Hold'em No Limit ($0.01/$0.02 USD) - 2022/08/22 23:57:19 ET
Table 'Achilles IV' 6-max Seat #6 is the button
Seat 1: SB ($2.37 in chips)
Seat 2: BB ($2.37 in chips)
Seat 3: CO ($5.65 in chips)
Seat 6: BTN ($0.87 in chips)
SB: posts small blind $0.01
BB: posts big blind $0.02
cordobes555: sits out
HenriquimDelas: sits out
*** HOLE CARDS ***
CO: folds
BTN: folds
SB: folds
Uncalled bet ($0.01) returned to BB
BB collected $0.02 from pot
*** SUMMARY ***
Total pot $0.02 | Rake $0
Seat 1: SB (small blind) folded before Flop
Seat 2: BB (big blind) collected ($0.02)
Seat 3: CO folded before Flop (didn't bet)
Seat 6: BTN (button) folded before Flop (didn't bet)


PokerStars Hand #238161155142:  Hold'em No Limit ($0.01/$0.02 USD) - 2022/08/22 23:56:33 ET
Table 'Achilles IV' 6-max Seat #3 is the button
Seat 1: HJ ($2.25 in chips)
Seat 2: CO ($2.37 in chips)
Seat 3: BTN ($5.65 in chips)
Seat 4: SB ($1.34 in chips)
Seat 6: BB ($0.99 in chips)
SB: posts small blind $0.01
BB: posts big blind $0.02
*** HOLE CARDS ***
HJ: raises $0.04 to $0.06
CO: folds
BTN: folds
SB: folds
BB: calls $0.04
*** FLOP *** [7s Qc Ah]
SB leaves the table
BB: checks
HJ: bets $0.06
BB: calls $0.06
*** TURN *** [7s Qc Ah] [5c]
BB: checks
HJ: checks
*** RIVER *** [7s Qc Ah 5c] [Kh]
HenriquimDelas joins the table at seat #5
cordobes555 joins the table at seat #4
BB: checks
HJ: checks
*** SHOW DOWN ***
BB: shows [4d 7d] (a pair of Sevens)
HJ: shows [6d Ad] (a pair of Aces)
HJ collected $0.24 from pot
*** SUMMARY ***
Total pot $0.25 | Rake $0.01
Board [7s Qc Ah 5c Kh]
Seat 1: HJ showed [6d Ad] and won ($0.24) with a pair of Aces
Seat 2: CO folded before Flop (didn't bet)
Seat 3: BTN (button) folded before Flop (didn't bet)
Seat 4: SB (small blind) folded before Flop
Seat 6: BB (big blind) showed [4d 7d] and lost with a pair of Sevens


PokerStars Hand #238161161861:  Hold'em No Limit ($0.01/$0.02 USD) - 2022/08/22 23:57:29 ET
Table 'Achilles IV' 6-max Seat #1 is the button
Seat 1: BTN ($2.36 in chips)
Seat 2: SB ($2.38 in chips)
Seat 3: BB ($5.65 in chips)
Seat 6: CO ($0.87 in chips)
SB: posts small blind $0.01
BB: posts big blind $0.02
cordobes555: sits out
HenriquimDelas: sits out
*** HOLE CARDS ***
CO: raises $0.08 to $0.10
BTN: folds
SB: folds
BB: folds
Uncalled bet ($0.08) returned to CO
CO collected $0.05 from pot
CO: doesn't show hand
*** SUMMARY ***
Total pot $0.05 | Rake $0
Seat 1: BTN (button) folded before Flop (didn't bet)
Seat 2: SB (small blind) folded before Flop
Seat 3: BB (big blind) folded before Flop
Seat 6: CO collected ($0.05)


PokerStars Hand #238161164410:  Hold'em No Limit ($0.01/$0.02 USD) - 2022/08/22 23:57:50 ET
Table 'Achilles IV' 6-max Seat #2 is the button
Seat 1: CO ($2.36 in chips)
Seat 2: BTN ($2.37 in chips)
Seat 3: SB ($5.63 in chips)
Seat 4: BB ($2 in chips)
Seat 6: HJ ($0.90 in chips)
SB: posts small blind $0.01
BB: posts big blind $0.02
HenriquimDelas: sits out
*** HOLE CARDS ***
HJ: folds
CO: folds
BTN: raises $0.04 to $0.06
SB: folds
BB: calls $0.04
*** FLOP *** [9c 7d Ks]
BB: checks
BTN: bets $0.06
BB: calls $0.06
*** TURN *** [9c 7d Ks] [Ad]
BB: checks
BTN: checks
*** RIVER *** [9c 7d Ks Ad] [Qc]
BB: bets $0.12
BTN: calls $0.12
*** SHOW DOWN ***
BB: shows [9s Qs] (two pair, Queens and Nines)
BTN: mucks hand
BB collected $0.47 from pot
*** SUMMARY ***
Total pot $0.49 | Rake $0.02
Board [9c 7d Ks Ad Qc]
Seat 1: CO folded before Flop (didn't bet)
Seat 2: BTN (button) mucked
Seat 3: SB (small blind) folded before Flop
Seat 4: BB (big blind) showed [9s Qs] and won ($0.47) with two pair, Queens and Nines
Seat 6: HJ folded before Flop (didn't bet)


PokerStars Hand #238161175285:  Hold'em No Limit ($0.01/$0.02 USD) - 2022/08/22 23:59:23 ET
Table 'Achilles IV' 6-max Seat #3 is the button
Seat 1: HJ ($2.36 in chips)
Seat 2: CO ($2.13 in chips)
Seat 3: BTN ($5.62 in chips)
Seat 4: SB ($2.23 in chips)
Seat 5: BB ($1 in chips)
Seat 6: UTG ($0.90 in chips)
SB: posts small blind $0.01
BB: posts big blind $0.02
*** HOLE CARDS ***
UTG: folds
HJ: folds
CO: folds
BTN: folds
SB: folds
Uncalled bet ($0.01) returned to BB
BB collected $0.02 from pot
BB: doesn't show hand
*** SUMMARY ***
Total pot $0.02 | Rake $0
Seat 1: HJ folded before Flop (didn't bet)
Seat 2: CO folded before Flop (didn't bet)
Seat 3: BTN (button) folded before Flop (didn't bet)
Seat 4: SB (small blind) folded before Flop
Seat 5: BB (big blind) collected ($0.02)
Seat 6: UTG folded before Flop (didn't bet)


PokerStars Hand #238161177349:  Hold'em No Limit ($0.01/$0.02 USD) - 2022/08/22 23:59:40 ET
Table 'Achilles IV' 6-max Seat #4 is the button
Seat 1: UTG ($2.36 in chips)
Seat 2: HJ ($2.13 in chips)
Seat 3: CO ($5.62 in chips)
Seat 4: BTN ($2.22 in chips)
Seat 5: SB ($1.01 in chips)
Seat 6: BB ($0.90 in chips)
SB: posts small blind $0.01
BB: posts big blind $0.02
*** HOLE CARDS ***
UTG: folds
HJ: folds
CO: folds
BTN has timed out
BTN: folds
SB: calls $0.01
BB: checks
*** FLOP *** [2d 8c 4h]
SB: bets $0.04
BB: calls $0.04
*** TURN *** [2d 8c 4h] [Ac]
SB: checks
BB: bets $0.12
SB: folds
Uncalled bet ($0.12) returned to BB
BB collected $0.12 from pot
BB: doesn't show hand
*** SUMMARY ***
Total pot $0.12 | Rake $0
Board [2d 8c 4h Ac]
Seat 1: UTG folded before Flop (didn't bet)
Seat 2: HJ folded before Flop (didn't bet)
Seat 3: CO folded before Flop (didn't bet)
Seat 4: BTN (button) folded before Flop (didn't bet)
Seat 5: SB (small blind) folded on the Turn
Seat 6: BB (big blind) collected ($0.12)


PokerStars Hand #238161184649:  Hold'em No Limit ($0.01/$0.02 USD) - 2022/08/23 0:00:41 ET
Table 'Achilles IV' 6-max Seat #5 is the button
Seat 1: BB ($2.36 in chips)
Seat 2: HJ ($2.13 in chips)
Seat 3: CO ($5.62 in chips)
Seat 5: BTN ($0.95 in chips)
Seat 6: SB ($0.96 in chips)
SB: posts small blind $0.01
BB: posts big blind $0.02
*** HOLE CARDS ***
HJ: folds
CO: raises $0.03 to $0.05
BTN: folds
SB: calls $0.04
BB: calls $0.03
*** FLOP *** [2d Ad 6s]
SB: checks
BB: checks
CO: checks
*** TURN *** [2d Ad 6s] [5c]
SB: bets $0.12
BB: folds
CO: folds
Uncalled bet ($0.12) returned to SB
SB collected $0.14 from pot
SB: doesn't show hand
*** SUMMARY ***
Total pot $0.15 | Rake $0.01
Board [2d Ad 6s 5c]
Seat 1: BB (big blind) folded on the Turn
Seat 2: HJ folded before Flop (didn't bet)
Seat 3: CO folded on the Turn
Seat 5: BTN (button) folded before Flop (didn't bet)
Seat 6: SB (small blind) collected ($0.14)


PokerStars Hand #238161190076:  Hold'em No Limit ($0.01/$0.02 USD) - 2022/08/23 0:01:23 ET
Table 'Achilles IV' 6-max Seat #6 is the button
Seat 1: SB ($2.31 in chips)
Seat 2: BB ($2.13 in chips)
Seat 3: HJ ($5.57 in chips)
Seat 5: CO ($0.95 in chips)
Seat 6: BTN ($1.05 in chips)
SB: posts small blind $0.01
BB: posts big blind $0.02
*** HOLE CARDS ***
HJ: raises $0.03 to $0.05
CO: calls $0.05
BTN: folds
SB: folds
BB: raises $0.21 to $0.26
HJ: raises $0.34 to $0.60
CO: folds
BB: folds
Uncalled bet ($0.34) returned to HJ
HJ collected $0.58 from pot
HJ: doesn't show hand
*** SUMMARY ***
Total pot $0.58 | Rake $0
Seat 1: SB (small blind) folded before Flop
Seat 2: BB (big blind) folded before Flop
Seat 3: HJ collected ($0.58)
Seat 5: CO folded before Flop
Seat 6: BTN (button) folded before Flop (didn't bet)


PokerStars Hand #238161201151:  Hold'em No Limit ($0.01/$0.02 USD) - 2022/08/23 0:02:19 ET
Table 'Achilles IV' 6-max Seat #1 is the button
Seat 1: BTN ($2.30 in chips)
Seat 2: SB ($1.87 in chips)
Seat 3: BB ($5.89 in chips)
Seat 4: UTG ($2.22 in chips)
Seat 5: HJ ($0.90 in chips)
Seat 6: CO ($1.05 in chips)
SB: posts small blind $0.01
BB: posts big blind $0.02
*** HOLE CARDS ***
UTG: raises $0.04 to $0.06
HJ: folds
CO: folds
BTN: raises $0.12 to $0.18
SB: folds
BB: folds
UTG: calls $0.12
*** FLOP *** [7d Td 9h]
UTG: checks
BTN: checks
*** TURN *** [7d Td 9h] [Th]
UTG: bets $0.15
BTN: calls $0.15
*** RIVER *** [7d Td 9h Th] [Kc]
UTG: bets $0.39
BTN: raises $1.58 to $1.97 and is all-in
UTG: folds
Uncalled bet ($1.58) returned to BTN
BTN collected $1.42 from pot
BTN: doesn't show hand
*** SUMMARY ***
Total pot $1.47 | Rake $0.05
Board [7d Td 9h Th Kc]
Seat 1: BTN (button) collected ($1.42)
Seat 2: SB (small blind) folded before Flop
Seat 3: BB (big blind) folded before Flop
Seat 4: UTG folded on the River
Seat 5: HJ folded before Flop (didn't bet)
Seat 6: CO folded before Flop (didn't bet)


PokerStars Hand #238161212303:  Hold'em No Limit ($0.01/$0.02 USD) - 2022/08/23 0:03:44 ET
Table 'Achilles IV' 6-max Seat #2 is the button
Seat 1: CO ($3 in chips)
Seat 2: BTN ($1.86 in chips)
Seat 3: SB ($5.87 in chips)
Seat 4: BB ($1.50 in chips)
Seat 5: UTG ($0.90 in chips)
Seat 6: HJ ($1.05 in chips)
SB: posts small blind $0.01
BB: posts big blind $0.02
*** HOLE CARDS ***
UTG: folds
HJ: folds
CO: folds
BTN: raises $0.04 to $0.06
SB: folds
BB: folds
Uncalled bet ($0.04) returned to BTN
BTN collected $0.05 from pot
*** SUMMARY ***
Total pot $0.05 | Rake $0
Seat 1: CO folded before Flop (didn't bet)
Seat 2: BTN (button) collected ($0.05)
Seat 3: SB (small blind) folded before Flop
Seat 4: BB (big blind) folded before Flop
Seat 5: UTG folded before Flop (didn't bet)
Seat 6: HJ folded before Flop (didn't bet)


PokerStars Hand #238161214372:  Hold'em No Limit ($0.01/$0.02 USD) - 2022/08/23 0:03:59 ET
Table 'Achilles IV' 6-max Seat #3 is the button
Seat 1: HJ ($3 in chips)
Seat 2: CO ($1.89 in chips)
Seat 3: BTN ($5.86 in chips)
Seat 4: SB ($1.48 in chips)
Seat 5: BB ($0.90 in chips)
Seat 6: UTG ($1.05 in chips)
SB: posts small blind $0.01
BB: posts big blind $0.02
*** HOLE CARDS ***
UTG: folds
HJ: folds
CO: folds
BTN: raises $0.03 to $0.05
SB: calls $0.04
BB: calls $0.03
*** FLOP *** [8h Jh 4c]
SB: checks
BB: bets $0.14
BTN: folds
SB: folds
Uncalled bet ($0.14) returned to BB
BB collected $0.14 from pot
BB: doesn't show hand
*** SUMMARY ***
Total pot $0.15 | Rake $0.01
Board [8h Jh 4c]
Seat 1: HJ folded before Flop (didn't bet)
Seat 2: CO folded before Flop (didn't bet)
Seat 3: BTN (button) folded on the Flop
Seat 4: SB (small blind) folded on the Flop
Seat 5: BB (big blind) collected ($0.14)
Seat 6: UTG folded before Flop (didn't bet)


PokerStars Hand #238161219353:  Hold'em No Limit ($0.01/$0.02 USD) - 2022/08/23 0:04:37 ET
Table 'Achilles IV' 6-max Seat #4 is the button
Seat 1: UTG ($3 in chips)
Seat 2: HJ ($1.89 in chips)
Seat 3: CO ($5.81 in chips)
Seat 4: BTN ($1.43 in chips)
Seat 5: SB ($0.99 in chips)
Seat 6: BB ($1.05 in chips)
SB: posts small blind $0.01
BB: posts big blind $0.02
*** HOLE CARDS ***
UTG: folds
HJ: raises $0.04 to $0.06
CO: folds
BTN: folds
SB: raises $0.93 to $0.99 and is all-in
BB: folds
HJ: calls $0.93
*** FLOP *** [4h 3d 3s]
*** TURN *** [4h 3d 3s] [4s]
*** RIVER *** [4h 3d 3s 4s] [5c]
*** SHOW DOWN ***
SB: shows [Qc Qd] (two pair, Queens and Fours)
HJ: shows [7d 7h] (two pair, Sevens and Fours)
SB collected $1.93 from pot
*** SUMMARY ***
Total pot $2 | Rake $0.07
Board [4h 3d 3s 4s 5c]
Seat 1: UTG folded before Flop (didn't bet)
Seat 2: HJ showed [7d 7h] and lost with two pair, Sevens and Fours
Seat 3: CO folded before Flop (didn't bet)
Seat 4: BTN (button) folded before Flop (didn't bet)
Seat 5: SB (small blind) showed [Qc Qd] and won ($1.93) with two pair, Queens and Fours
Seat 6: BB (big blind) folded before Flop


PokerStars Hand #238161234058:  Hold'em No Limit ($0.01/$0.02 USD) - 2022/08/23 0:05:14 ET
Table 'Achilles IV' 6-max Seat #5 is the button
Seat 1: BB ($3 in chips)
Seat 2: UTG ($0.90 in chips)
Seat 3: HJ ($5.81 in chips)
Seat 4: CO ($1.43 in chips)
Seat 5: BTN ($1.93 in chips)
Seat 6: SB ($1.03 in chips)
SB: posts small blind $0.01
BB: posts big blind $0.02
*** HOLE CARDS ***
UTG: raises $0.04 to $0.06
HJ: folds
CO: folds
BTN: calls $0.06
SB: folds
BB: folds
*** FLOP *** [Jd Ah Js]
UTG: checks
BTN: bets $0.14
UTG: folds
Uncalled bet ($0.14) returned to BTN
BTN collected $0.14 from pot
BTN: doesn't show hand
*** SUMMARY ***
Total pot $0.15 | Rake $0.01
Board [Jd Ah Js]
Seat 1: BB (big blind) folded before Flop
Seat 2: UTG folded on the Flop
Seat 3: HJ folded before Flop (didn't bet)
Seat 4: CO folded before Flop (didn't bet)
Seat 5: BTN (button) collected ($0.14)
Seat 6: SB (small blind) folded before Flop


PokerStars Hand #238161237083:  Hold'em No Limit ($0.01/$0.02 USD) - 2022/08/23 0:05:37 ET
Table 'Achilles IV' 6-max Seat #6 is the button
Seat 1: SB ($2.98 in chips)
Seat 2: BB ($0.84 in chips)
Seat 3: UTG ($5.81 in chips)
Seat 4: HJ ($1.43 in chips)
Seat 5: CO ($2.01 in chips)
Seat 6: BTN ($1.02 in chips)
SB: posts small blind $0.01
BB: posts big blind $0.02
*** HOLE CARDS ***
UTG: folds
HJ: raises $0.04 to $0.06
CO: folds
BTN: calls $0.06
SB: folds
BB: calls $0.04
*** FLOP *** [Qs Ts 9s]
BB: checks
HJ: checks
BTN: checks
*** TURN *** [Qs Ts 9s] [Th]
BB: checks
HJ: checks
BTN: checks
*** RIVER *** [Qs Ts 9s Th] [3d]
BB: bets $0.18
HJ: folds
BTN: folds
Uncalled bet ($0.18) returned to BB
BB collected $0.18 from pot
*** SUMMARY ***
Total pot $0.19 | Rake $0.01
Board [Qs Ts 9s Th 3d]
Seat 1: SB (small blind) folded before Flop
Seat 2: BB (big blind) collected ($0.18)
Seat 3: UTG folded before Flop (didn't bet)
Seat 4: HJ folded on the River
Seat 5: CO folded before Flop (didn't bet)
Seat 6: BTN (button) folded on the River


PokerStars Hand #238161243829:  Hold'em No Limit ($0.01/$0.02 USD) - 2022/08/23 0:06:29 ET
Table 'Achilles IV' 6-max Seat #1 is the button
Seat 1: BTN ($2.97 in chips)
Seat 2: SB ($0.96 in chips)
Seat 3: BB ($5.81 in chips)
Seat 4: UTG ($1.37 in chips)
Seat 5: HJ ($2.01 in chips)
Seat 6: CO ($0.96 in chips)
SB: posts small blind $0.01
BB: posts big blind $0.02
*** HOLE CARDS ***
UTG: folds
HJ: folds
CO: folds
BTN: folds
SB: folds
Uncalled bet ($0.01) returned to BB
SB leaves the table
BB collected $0.02 from pot
BB: doesn't show hand
*** SUMMARY ***
Total pot $0.02 | Rake $0
Seat 1: BTN (button) folded before Flop (didn't bet)
Seat 2: SB (small blind) folded before Flop
Seat 3: BB (big blind) collected ($0.02)
Seat 4: UTG folded before Flop (didn't bet)
Seat 5: HJ folded before Flop (didn't bet)
Seat 6: CO folded before Flop (didn't bet)


PokerStars Hand #238161245109:  Hold'em No Limit ($0.01/$0.02 USD) - 2022/08/23 0:06:39 ET
Table 'Achilles IV' 6-max Seat #3 is the button
Seat 1: CO ($2.97 in chips)
Seat 3: BTN ($5.82 in chips)
Seat 4: SB ($1.37 in chips)
Seat 5: BB ($2.01 in chips)
Seat 6: HJ ($0.96 in chips)
SB: posts small blind $0.01
BB: posts big blind $0.02
*** HOLE CARDS ***
HJ: folds
CO: folds
BTN: raises $0.03 to $0.05
emptytyty joins the table at seat #2
SB: folds
BB: calls $0.03
*** FLOP *** [3s 3d Td]
BB: checks
BTN: bets $0.06
BB: folds
Uncalled bet ($0.06) returned to BTN
BTN collected $0.11 from pot
BTN: doesn't show hand
*** SUMMARY ***
Total pot $0.11 | Rake $0
Board [3s 3d Td]
Seat 1: CO folded before Flop (didn't bet)
Seat 3: BTN (button) collected ($0.11)
Seat 4: SB (small blind) folded before Flop
Seat 5: BB (big blind) folded on the Flop
Seat 6: HJ folded before Flop (didn't bet)


PokerStars Hand #238161251919:  Hold'em No Limit ($0.01/$0.02 USD) - 2022/08/23 0:07:31 ET
Table 'Achilles IV' 6-max Seat #4 is the button
Seat 1: HJ ($2.97 in chips)
Seat 3: CO ($5.88 in chips)
Seat 4: BTN ($1.36 in chips)
Seat 5: SB ($1.96 in chips)
Seat 6: BB ($0.96 in chips)
SB: posts small blind $0.01
BB: posts big blind $0.02
emptytyty: sits out
*** HOLE CARDS ***
HJ: folds
CO: raises $0.03 to $0.05
BTN: folds
SB: folds
BB: folds
Uncalled bet ($0.03) returned to CO
CO collected $0.05 from pot
CO: doesn't show hand
*** SUMMARY ***
Total pot $0.05 | Rake $0
Seat 1: HJ folded before Flop (didn't bet)
Seat 3: CO collected ($0.05)
Seat 4: BTN (button) folded before Flop (didn't bet)
Seat 5: SB (small blind) folded before Flop
Seat 6: BB (big blind) folded before Flop


PokerStars Hand #238161255182:  Hold'em No Limit ($0.01/$0.02 USD) - 2022/08/23 0:07:56 ET
Table 'Achilles IV' 6-max Seat #5 is the button
Seat 1: BB ($2.97 in chips)
Seat 2: UTG ($1.23 in chips)
Seat 3: HJ ($5.91 in chips)
Seat 4: CO ($1.36 in chips)
Seat 5: BTN ($1.95 in chips)
Seat 6: SB ($0.94 in chips)
SB: posts small blind $0.01
BB: posts big blind $0.02
UTG: posts big blind $0.02
*** HOLE CARDS ***
UTG: checks
HJ: folds
CO has timed out
CO: folds
BTN: folds
SB: calls $0.01
BB: checks
*** FLOP *** [6s Kd 6h]
SB: checks
BB: checks
UTG: checks
*** TURN *** [6s Kd 6h] [7s]
SB: checks
BB: checks
UTG: checks
*** RIVER *** [6s Kd 6h 7s] [2d]
SB: checks
BB: checks
UTG: checks
*** SHOW DOWN ***
SB: shows [Qc Ts] (a pair of Sixes)
BB: shows [As 9d] (a pair of Sixes - Ace kicker)
UTG: mucks hand
BB collected $0.06 from pot
*** SUMMARY ***
Total pot $0.06 | Rake $0
Board [6s Kd 6h 7s 2d]
Seat 1: BB (big blind) showed [As 9d] and won ($0.06) with a pair of Sixes
Seat 2: UTG mucked
Seat 3: HJ folded before Flop (didn't bet)
Seat 4: CO folded before Flop (didn't bet)
Seat 5: BTN (button) folded before Flop (didn't bet)
Seat 6: SB (small blind) showed [Qc Ts] and lost with a pair of Sixes


PokerStars Hand #238161263484:  Hold'em No Limit ($0.01/$0.02 USD) - 2022/08/23 0:09:02 ET
Table 'Achilles IV' 6-max Seat #6 is the button
Seat 1: SB ($3.01 in chips)
Seat 2: BB ($1.21 in chips)
Seat 3: HJ ($5.91 in chips)
Seat 5: CO ($1.95 in chips)
Seat 6: BTN ($0.92 in chips)
SB: posts small blind $0.01
BB: posts big blind $0.02
*** HOLE CARDS ***
HJ: raises $0.03 to $0.05
CO: folds
BTN: folds
SB: raises $0.11 to $0.16
BB: folds
HJ: calls $0.11
*** FLOP *** [Ad Kc Tc]
SB: checks
HJ: checks
*** TURN *** [Ad Kc Tc] [7h]
SB: bets $0.14
HJ: calls $0.14
*** RIVER *** [Ad Kc Tc 7h] [4d]
SB: checks
HJ: bets $0.45
SB: folds
Uncalled bet ($0.45) returned to HJ
HJ collected $0.60 from pot
HJ: doesn't show hand
*** SUMMARY ***
Total pot $0.62 | Rake $0.02
Board [Ad Kc Tc 7h 4d]
Seat 1: SB (small blind) folded on the River
Seat 2: BB (big blind) folded before Flop
Seat 3: HJ collected ($0.60)
Seat 5: CO folded before Flop (didn't bet)
Seat 6: BTN (button) folded before Flop (didn't bet)


PokerStars Hand #238161273905:  Hold'em No Limit ($0.01/$0.02 USD) - 2022/08/23 0:10:22 ET
Table 'Achilles IV' 6-max Seat #1 is the button
Seat 1: BTN ($2.71 in chips)
Seat 2: SB ($1.19 in chips)
Seat 3: BB ($6.21 in chips)
Seat 4: UTG ($1.36 in chips)
Seat 5: HJ ($1.95 in chips)
Seat 6: CO ($0.92 in chips)
SB: posts small blind $0.01
BB: posts big blind $0.02
*** HOLE CARDS ***
UTG has timed out
UTG: folds
HJ: raises $0.12 to $0.14
CO: folds
BTN: folds
SB: calls $0.13
BB: folds
*** FLOP *** [3d 2s 7c]
SB: checks
HJ: bets $0.10
SB: calls $0.10
*** TURN *** [3d 2s 7c] [Qh]
SB: checks
HJ: checks
*** RIVER *** [3d 2s 7c Qh] [6h]
SB: checks
HJ: checks
*** SHOW DOWN ***
SB: shows [6c 5s] (a pair of Sixes)
HJ: mucks hand
SB collected $0.48 from pot
*** SUMMARY ***
Total pot $0.50 | Rake $0.02
Board [3d 2s 7c Qh 6h]
Seat 1: BTN (button) folded before Flop (didn't bet)
Seat 2: SB (small blind) showed [6c 5s] and won ($0.48) with a pair of Sixes
Seat 3: BB (big blind) folded before Flop
Seat 4: UTG folded before Flop (didn't bet)
Seat 5: HJ mucked
Seat 6: CO folded before Flop (didn't bet)


PokerStars Hand #238161281173:  Hold'em No Limit ($0.01/$0.02 USD) - 2022/08/23 0:11:19 ET
Table 'Achilles IV' 6-max Seat #2 is the button
Seat 1: CO ($2.71 in chips)
Seat 2: BTN ($1.43 in chips)
Seat 3: SB ($6.19 in chips)
Seat 5: BB ($1.71 in chips)
Seat 6: HJ ($0.92 in chips)
SB: posts small blind $0.01
BB: posts big blind $0.02
*** HOLE CARDS ***
HJ: folds
CO: folds
BTN: calls $0.02
SB: raises $0.08 to $0.10
BB: calls $0.08
BTN: calls $0.08
*** FLOP *** [As 4c 8c]
SB: checks
BB: bets $0.14
BTN: calls $0.14
SB: folds
*** TURN *** [As 4c 8c] [2c]
BB: bets $1.47 and is all-in
BTN: calls $1.19 and is all-in
Uncalled bet ($0.28) returned to BB
*** RIVER *** [As 4c 8c 2c] [3s]
*** SHOW DOWN ***
BB: shows [3c 5c] (a flush, Eight high)
BTN: shows [7c 5s] (a straight, Ace to Five)
BB collected $2.86 from pot
*** SUMMARY ***
Total pot $2.96 | Rake $0.10
Board [As 4c 8c 2c 3s]
Seat 1: CO folded before Flop (didn't bet)
Seat 2: BTN (button) showed [7c 5s] and lost with a straight, Ace to Five
Seat 3: SB (small blind) folded on the Flop
Seat 5: BB (big blind) showed [3c 5c] and won ($2.86) with a flush, Eight high
Seat 6: HJ folded before Flop (didn't bet)


PokerStars Hand #238161288366:  Hold'em No Limit ($0.01/$0.02 USD) - 2022/08/23 0:12:15 ET
Table 'Achilles IV' 6-max Seat #3 is the button
Seat 1: CO ($2.71 in chips)
Seat 3: BTN ($6.09 in chips)
Seat 5: SB ($3.14 in chips)
Seat 6: BB ($0.92 in chips)
SB: posts small blind $0.01
BB: posts big blind $0.02
*** HOLE CARDS ***
CO: raises $0.04 to $0.06
BTN: folds
SB: calls $0.05
BB: folds
*** FLOP *** [Kh 5h 8s]
SB: checks
CO: checks
*** TURN *** [Kh 5h 8s] [5d]
SB: bets $0.07
CO: calls $0.07
*** RIVER *** [Kh 5h 8s 5d] [4h]
SB: checks
CO: checks
*** SHOW DOWN ***
SB: shows [7d Js] (a pair of Fives)
CO: shows [Td Ts] (two pair, Tens and Fives)
CO collected $0.27 from pot
*** SUMMARY ***
Total pot $0.28 | Rake $0.01
Board [Kh 5h 8s 5d 4h]
Seat 1: CO showed [Td Ts] and won ($0.27) with two pair, Tens and Fives
Seat 3: BTN (button) folded before Flop (didn't bet)
Seat 5: SB (small blind) showed [7d Js] and lost with a pair of Fives
Seat 6: BB (big blind) folded before Flop


PokerStars Hand #238161292945:  Hold'em No Limit ($0.01/$0.02 USD) - 2022/08/23 0:12:51 ET
Table 'Achilles IV' 6-max Seat #5 is the button
Seat 1: BB ($2.85 in chips)
Seat 2: HJ ($1.21 in chips)
Seat 3: CO ($6.09 in chips)
Seat 5: BTN ($3.01 in chips)
Seat 6: SB ($0.90 in chips)
SB: posts small blind $0.01
BB: posts big blind $0.02
*** HOLE CARDS ***
HJ: calls $0.02
CO: folds
BTN: raises $2.99 to $3.01 and is all-in
SB: folds
BB: folds
HJ: folds
Uncalled bet ($2.99) returned to BTN
BTN collected $0.07 from pot
BTN: doesn't show hand
*** SUMMARY ***
Total pot $0.07 | Rake $0
Seat 1: BB (big blind) folded before Flop
Seat 2: HJ folded before Flop
Seat 3: CO folded before Flop (didn't bet)
Seat 5: BTN (button) collected ($0.07)
Seat 6: SB (small blind) folded before Flop


PokerStars Hand #238161296159:  Hold'em No Limit ($0.01/$0.02 USD) - 2022/08/23 0:13:16 ET
Table 'Achilles IV' 6-max Seat #6 is the button
Seat 1: SB ($2.83 in chips)
Seat 2: BB ($1.19 in chips)
Seat 3: HJ ($6.09 in chips)
Seat 5: CO ($3.06 in chips)
Seat 6: BTN ($0.89 in chips)
SB: posts small blind $0.01
BB: posts big blind $0.02
*** HOLE CARDS ***
HJ: folds
CO: folds
BTN: folds
SB: raises $0.04 to $0.06
BB: calls $0.04
*** FLOP *** [Js 8h 4d]
CO leaves the table
SB: checks
BB: checks
*** TURN *** [Js 8h 4d] [2h]
SB: checks
BB: checks
*** RIVER *** [Js 8h 4d 2h] [2d]
SB: bets $0.04
BB: calls $0.04
*** SHOW DOWN ***
SB: shows [9s 9h] (two pair, Nines and Deuces)
BB: mucks hand
SB collected $0.19 from pot
*** SUMMARY ***
Total pot $0.20 | Rake $0.01
Board [Js 8h 4d 2h 2d]
Seat 1: SB (small blind) showed [9s 9h] and won ($0.19) with two pair, Nines and Deuces
Seat 2: BB (big blind) mucked
Seat 3: HJ folded before Flop (didn't bet)
Seat 5: CO folded before Flop (didn't bet)
Seat 6: BTN (button) folded before Flop (didn't bet)


PokerStars Hand #238161304355:  Hold'em No Limit ($0.01/$0.02 USD) - 2022/08/23 0:13:55 ET
Table 'Achilles IV' 6-max Seat #1 is the button
Seat 1: BTN ($2.92 in chips)
Seat 2: SB ($1.09 in chips)
Seat 3: BB ($6.09 in chips)
Seat 6: CO ($0.89 in chips)
SB: posts small blind $0.01
BB: posts big blind $0.02
*** HOLE CARDS ***
CO: folds
ajrestrepo joins the table at seat #5
BTN: raises $0.04 to $0.06
SB: calls $0.05
BB: calls $0.04
*** FLOP *** [6s 2c 2h]
SB: checks
BB: checks
BTN: checks
*** TURN *** [6s 2c 2h] [3s]
SB: checks
BB: bets $0.13
BTN: calls $0.13
SB: folds
*** RIVER *** [6s 2c 2h 3s] [Jc]
BB: checks
BTN: checks
*** SHOW DOWN ***
BB: shows [7c 5c] (a pair of Deuces)
BTN: shows [As 4s] (a pair of Deuces - Ace kicker)
BTN collected $0.42 from pot
*** SUMMARY ***
Total pot $0.44 | Rake $0.02
Board [6s 2c 2h 3s Jc]
Seat 1: BTN (button) showed [As 4s] and won ($0.42) with a pair of Deuces
Seat 2: SB (small blind) folded on the Turn
Seat 3: BB (big blind) showed [7c 5c] and lost with a pair of Deuces
Seat 6: CO folded before Flop (didn't bet)


PokerStars Hand #238161309952:  Hold'em No Limit ($0.01/$0.02 USD) - 2022/08/23 0:14:40 ET
Table 'Achilles IV' 6-max Seat #2 is the button
Seat 1: CO ($3.15 in chips)
Seat 2: BTN ($1.03 in chips)
Seat 3: SB ($5.90 in chips)
Seat 5: BB ($2 in chips)
Seat 6: HJ ($0.89 in chips)
SB: posts small blind $0.01
BB: posts big blind $0.02
*** HOLE CARDS ***
HJ: folds
CO: raises $0.04 to $0.06
BTN: calls $0.06
SB: folds
BB: folds
*** FLOP *** [9h Jh 5h]
CO: checks
BTN: checks
*** TURN *** [9h Jh 5h] [Kd]
CO: checks
BTN: checks
*** RIVER *** [9h Jh 5h Kd] [8h]
CO: checks
BTN: checks
*** SHOW DOWN ***
CO: shows [As Qs] (high card Ace)
BTN: shows [7h 6c] (a flush, Jack high)
BTN collected $0.14 from pot
*** SUMMARY ***
Total pot $0.15 | Rake $0.01
Board [9h Jh 5h Kd 8h]
Seat 1: CO showed [As Qs] and lost with high card Ace
Seat 2: BTN (button) showed [7h 6c] and won ($0.14) with a flush, Jack high
Seat 3: SB (small blind) folded before Flop
Seat 5: BB (big blind) folded before Flop
Seat 6: HJ folded before Flop (didn't bet)


PokerStars Hand #238161313089:  Hold'em No Limit ($0.01/$0.02 USD) - 2022/08/23 0:15:04 ET
Table 'Achilles IV' 6-max Seat #3 is the button
Seat 1: HJ ($3.09 in chips)
Seat 2: CO ($1.11 in chips)
Seat 3: BTN ($5.89 in chips)
Seat 5: SB ($1.98 in chips)
Seat 6: BB ($0.89 in chips)
SB: posts small blind $0.01
BB: posts big blind $0.02
*** HOLE CARDS ***
HJ: folds
CO: calls $0.02
BTN: folds
SB: folds
BB: checks
*** FLOP *** [4s Qc 9c]
BB: bets $0.05
CO: folds
Uncalled bet ($0.05) returned to BB
BB collected $0.05 from pot
BB: doesn't show hand
*** SUMMARY ***
Total pot $0.05 | Rake $0
Board [4s Qc 9c]
Seat 1: HJ folded before Flop (didn't bet)
Seat 2: CO folded on the Flop
Seat 3: BTN (button) folded before Flop (didn't bet)
Seat 5: SB (small blind) folded before Flop
Seat 6: BB (big blind) collected ($0.05)


PokerStars Hand #238161317250:  Hold'em No Limit ($0.01/$0.02 USD) - 2022/08/23 0:15:37 ET
Table 'Achilles IV' 6-max Seat #5 is the button
Seat 1: BB ($3.09 in chips)
Seat 2: HJ ($1.09 in chips)
Seat 3: CO ($5.89 in chips)
Seat 5: BTN ($1.97 in chips)
Seat 6: SB ($0.92 in chips)
SB: posts small blind $0.01
BB: posts big blind $0.02
*** HOLE CARDS ***
HJ: calls $0.02
CO: folds
cordobes555 is disconnected
BTN: calls $0.02
SB: folds
BB: checks
*** FLOP *** [Kh 6s 8c]
BB: checks
HJ: checks
BTN: bets $0.06
BB: folds
HJ: folds
Uncalled bet ($0.06) returned to BTN
BTN collected $0.07 from pot
*** SUMMARY ***
Total pot $0.07 | Rake $0
Board [Kh 6s 8c]
Seat 1: BB (big blind) folded on the Flop
Seat 2: HJ folded on the Flop
Seat 3: CO folded before Flop (didn't bet)
Seat 5: BTN (button) collected ($0.07)
Seat 6: SB (small blind) folded before Flop


PokerStars Hand #238161321844:  Hold'em No Limit ($0.01/$0.02 USD) - 2022/08/23 0:16:13 ET
Table 'Achilles IV' 6-max Seat #6 is the button
Seat 1: SB ($3.07 in chips)
Seat 2: BB ($1.07 in chips)
Seat 3: HJ ($5.89 in chips)
Seat 5: CO ($2.02 in chips)
Seat 6: BTN ($0.91 in chips)
SB: posts small blind $0.01
BB: posts big blind $0.02
*** HOLE CARDS ***
HJ: folds
CO: calls $0.02
BTN: calls $0.02
SB: raises $0.08 to $0.10
BB: calls $0.08
CO: calls $0.08
BTN: calls $0.08
*** FLOP *** [6c Kd Qc]
SB: checks
BB: checks
CO: checks
BTN: checks
*** TURN *** [6c Kd Qc] [5h]
SB: checks
BB: checks
CO: checks
BTN: checks
*** RIVER *** [6c Kd Qc 5h] [4d]
SB: checks
BB: bets $0.12
CO: folds
BTN: folds
SB: folds
Uncalled bet ($0.12) returned to BB
BB collected $0.39 from pot
*** SUMMARY ***
Total pot $0.40 | Rake $0.01
Board [6c Kd Qc 5h 4d]
Seat 1: SB (small blind) folded on the River
Seat 2: BB (big blind) collected ($0.39)
Seat 3: HJ folded before Flop (didn't bet)
Seat 5: CO folded on the River
Seat 6: BTN (button) folded on the River


PokerStars Hand #238161329205:  Hold'em No Limit ($0.01/$0.02 USD) - 2022/08/23 0:17:12 ET
Table 'Achilles IV' 6-max Seat #1 is the button
Seat 1: BTN ($2.97 in chips)
Seat 2: SB ($1.36 in chips)
Seat 3: BB ($5.89 in chips)
Seat 5: HJ ($1.92 in chips)
Seat 6: CO ($0.81 in chips)
SB: posts small blind $0.01
BB: posts big blind $0.02
*** HOLE CARDS ***
HJ: folds
CO: folds
CO leaves the table
BTN: folds
SB: calls $0.01
BB: raises $0.08 to $0.10
SB: calls $0.08
*** FLOP *** [7s 9d Ks]
SB: checks
BB: bets $0.14
SB: calls $0.14
*** TURN *** [7s 9d Ks] [4c]
SB: checks
rsxcd479 joins the table at seat #6
BB: bets $0.35
SB: calls $0.35
*** RIVER *** [7s 9d Ks 4c] [Ad]
SB: checks
BB: checks
*** SHOW DOWN ***
SB: shows [3s 6s] (high card Ace)
BB: shows [Kd Td] (a pair of Kings)
BB collected $1.14 from pot
*** SUMMARY ***
Total pot $1.18 | Rake $0.04
Board [7s 9d Ks 4c Ad]
Seat 1: BTN (button) folded before Flop (didn't bet)
Seat 2: SB (small blind) showed [3s 6s] and lost with high card Ace
Seat 3: BB (big blind) showed [Kd Td] and won ($1.14) with a pair of Kings
Seat 5: HJ folded before Flop (didn't bet)
Seat 6: CO folded before Flop (didn't bet)


PokerStars Hand #238161333350:  Hold'em No Limit ($0.01/$0.02 USD) - 2022/08/23 0:17:44 ET
Table 'Achilles IV' 6-max Seat #2 is the button
Seat 1: CO ($2.97 in chips)
Seat 2: BTN ($0.77 in chips)
Seat 3: SB ($6.44 in chips)
Seat 5: BB ($1.92 in chips)
SB: posts small blind $0.01
BB: posts big blind $0.02
rsxcd479: sits out
*** HOLE CARDS ***
CO: folds
BTN: calls $0.02
SB: folds
BB: checks
*** FLOP *** [6h Kd Ad]
BB: checks
BTN: checks
*** TURN *** [6h Kd Ad] [7c]
BB: checks
BTN: checks
*** RIVER *** [6h Kd Ad 7c] [Ts]
BB: checks
BTN: checks
*** SHOW DOWN ***
BB: shows [Qd 6d] (a pair of Sixes)
BTN: mucks hand
BB collected $0.05 from pot
*** SUMMARY ***
Total pot $0.05 | Rake $0
Board [6h Kd Ad 7c Ts]
Seat 1: CO folded before Flop (didn't bet)
Seat 2: BTN (button) mucked
Seat 3: SB (small blind) folded before Flop
Seat 5: BB (big blind) showed [Qd 6d] and won ($0.05) with a pair of Sixes


PokerStars Hand #238161338272:  Hold'em No Limit ($0.01/$0.02 USD) - 2022/08/23 0:18:23 ET
Table 'Achilles IV' 6-max Seat #3 is the button
Seat 1: HJ ($2.97 in chips)
Seat 2: CO ($0.75 in chips)
Seat 3: BTN ($6.43 in chips)
Seat 5: SB ($1.95 in chips)
Seat 6: BB ($2 in chips)
SB: posts small blind $0.01
BB: posts big blind $0.02
*** HOLE CARDS ***
HJ: folds
CO: calls $0.02
BTN: folds
SB: raises $0.02 to $0.04
BB: calls $0.02
CO: calls $0.02
*** FLOP *** [Td Ad Tc]
SB: checks
BB: checks
CO: checks
*** TURN *** [Td Ad Tc] [Qs]
SB: bets $0.02
BB: raises $0.12 to $0.14
CO: calls $0.14
SB: calls $0.12
*** RIVER *** [Td Ad Tc Qs] [4c]
SB: checks
BB: bets $0.39
CO: calls $0.39
SB: calls $0.39
*** SHOW DOWN ***
BB: shows [Jd Ts] (three of a kind, Tens)
CO: mucks hand
SB: shows [Kh Jh] (a straight, Ten to Ace)
SB collected $1.65 from pot
*** SUMMARY ***
Total pot $1.71 | Rake $0.06
Board [Td Ad Tc Qs 4c]
Seat 1: HJ folded before Flop (didn't bet)
Seat 2: CO mucked
Seat 3: BTN (button) folded before Flop (didn't bet)
Seat 5: SB (small blind) showed [Kh Jh] and won ($1.65) with a straight, Ten to Ace
Seat 6: BB (big blind) showed [Jd Ts] and lost with three of a kind, Tens


PokerStars Hand #238161354477:  Hold'em No Limit ($0.01/$0.02 USD) - 2022/08/23 0:19:14 ET
Table 'Achilles IV' 6-max Seat #5 is the button
Seat 1: BB ($2.97 in chips)
Seat 2: HJ ($0.18 in chips)
Seat 3: CO ($6.43 in chips)
Seat 5: BTN ($3.03 in chips)
Seat 6: SB ($2 in chips)
SB: posts small blind $0.01
BB: posts big blind $0.02
*** HOLE CARDS ***
HJ: calls $0.02
CO: raises $0.08 to $0.10
BTN: folds
SB: calls $0.09
BB: folds
HJ: calls $0.08
*** FLOP *** [Ad 6s 9s]
SB: checks
HJ: checks
CO: checks
*** TURN *** [Ad 6s 9s] [8h]
SB: checks
HJ: checks
CO: checks
*** RIVER *** [Ad 6s 9s 8h] [9d]
SB: checks
HJ: checks
CO: bets $0.10
SB: folds
HJ: folds
Uncalled bet ($0.10) returned to CO
CO collected $0.31 from pot
CO: doesn't show hand
*** SUMMARY ***
Total pot $0.32 | Rake $0.01
Board [Ad 6s 9s 8h 9d]
Seat 1: BB (big blind) folded before Flop
Seat 2: HJ folded on the River
Seat 3: CO collected ($0.31)
Seat 5: BTN (button) folded before Flop (didn't bet)
Seat 6: SB (small blind) folded on the River


PokerStars Hand #238161359817:  Hold'em No Limit ($0.01/$0.02 USD) - 2022/08/23 0:19:56 ET
Table 'Achilles IV' 6-max Seat #6 is the button
Seat 1: SB ($2.95 in chips)
Seat 2: BB ($0.08 in chips)
Seat 3: HJ ($6.64 in chips)
Seat 5: CO ($3.03 in chips)
Seat 6: BTN ($2 in chips)
SB: posts small blind $0.01
BB: posts big blind $0.02
*** HOLE CARDS ***
HJ: folds
CO: folds
BTN: folds
SB: folds
Uncalled bet ($0.01) returned to BB
BB collected $0.02 from pot
*** SUMMARY ***
Total pot $0.02 | Rake $0
Seat 1: SB (small blind) folded before Flop
Seat 2: BB (big blind) collected ($0.02)
Seat 3: HJ folded before Flop (didn't bet)
Seat 5: CO folded before Flop (didn't bet)
Seat 6: BTN (button) folded before Flop (didn't bet)


PokerStars Hand #238161361510:  Hold'em No Limit ($0.01/$0.02 USD) - 2022/08/23 0:20:10 ET
Table 'Achilles IV' 6-max Seat #1 is the button
Seat 1: BTN ($2.94 in chips)
Seat 2: SB ($0.09 in chips)
Seat 3: BB ($6.64 in chips)
Seat 5: HJ ($3.03 in chips)
Seat 6: CO ($2 in chips)
SB: posts small blind $0.01
BB: posts big blind $0.02
*** HOLE CARDS ***
HJ: folds
CO has timed out
CO: folds
BTN: raises $0.04 to $0.06
SB: calls $0.05
BB: folds
*** FLOP *** [3s 9c 8h]
SB: checks
BTN: bets $0.07
SB: calls $0.03 and is all-in
Uncalled bet ($0.04) returned to BTN
*** TURN *** [3s 9c 8h] [8c]
*** RIVER *** [3s 9c 8h 8c] [5s]
*** SHOW DOWN ***
SB: shows [Jc 2d] (a pair of Eights)
BTN: shows [8d Qd] (three of a kind, Eights)
BTN collected $0.19 from pot
*** SUMMARY ***
Total pot $0.20 | Rake $0.01
Board [3s 9c 8h 8c 5s]
Seat 1: BTN (button) showed [8d Qd] and won ($0.19) with three of a kind, Eights
Seat 2: SB (small blind) showed [Jc 2d] and lost with a pair of Eights
Seat 3: BB (big blind) folded before Flop
Seat 5: HJ folded before Flop (didn't bet)
Seat 6: CO folded before Flop (didn't bet)


PokerStars Hand #238161368469:  Hold'em No Limit ($0.01/$0.02 USD) - 2022/08/23 0:21:06 ET
Table 'Achilles IV' 6-max Seat #3 is the button
Seat 1: CO ($3.04 in chips)
Seat 3: BTN ($6.62 in chips)
Seat 5: SB ($3.03 in chips)
Seat 6: BB ($2 in chips)
SB: posts small blind $0.01
BB: posts big blind $0.02
*** HOLE CARDS ***
CO: folds
emptytyty leaves the table
BTN: raises $0.03 to $0.05
SB: folds
BB: folds
Uncalled bet ($0.03) returned to BTN
BTN collected $0.05 from pot
BTN: doesn't show hand
*** SUMMARY ***
Total pot $0.05 | Rake $0
Seat 1: CO folded before Flop (didn't bet)
Seat 3: BTN (button) collected ($0.05)
Seat 5: SB (small blind) folded before Flop
Seat 6: BB (big blind) folded before Flop


PokerStars Hand #238161369916:  Hold'em No Limit ($0.01/$0.02 USD) - 2022/08/23 0:21:18 ET
Table 'Achilles IV' 6-max Seat #5 is the button
Seat 1: BB ($3.04 in chips)
Seat 3: CO ($6.65 in chips)
Seat 5: BTN ($3.02 in chips)
Seat 6: SB ($2 in chips)
SB: posts small blind $0.01
BB: posts big blind $0.02
*** HOLE CARDS ***
CO: folds
BTN: folds
black.pantherx joins the table at seat #2
SB: raises $0.05 to $0.07
BB: calls $0.05
*** FLOP *** [3d 6h 5c]
SB: checks
BB: checks
*** TURN *** [3d 6h 5c] [6c]
SB: checks
BB: checks
*** RIVER *** [3d 6h 5c 6c] [5d]
SB: checks
BB: checks
*** SHOW DOWN ***
SB: shows [Ah Ts] (two pair, Sixes and Fives)
BB: mucks hand
SB collected $0.14 from pot
*** SUMMARY ***
Total pot $0.14 | Rake $0
Board [3d 6h 5c 6c 5d]
Seat 1: BB (big blind) mucked
Seat 3: CO folded before Flop (didn't bet)
Seat 5: BTN (button) folded before Flop (didn't bet)
Seat 6: SB (small blind) showed [Ah Ts] and won ($0.14) with two pair, Sixes and Fives


PokerStars Hand #238161374729:  Hold'em No Limit ($0.01/$0.02 USD) - 2022/08/23 0:21:57 ET
Table 'Achilles IV' 6-max Seat #6 is the button
Seat 1: SB ($2.97 in chips)
Seat 2: BB ($2 in chips)
Seat 3: HJ ($6.65 in chips)
Seat 5: CO ($3.02 in chips)
Seat 6: BTN ($2.07 in chips)
SB: posts small blind $0.01
BB: posts big blind $0.02
*** HOLE CARDS ***
HJ: folds
CO: folds
BTN: folds
SB: raises $0.04 to $0.06
BB: folds
Uncalled bet ($0.04) returned to SB
SB collected $0.04 from pot
SB: doesn't show hand
*** SUMMARY ***
Total pot $0.04 | Rake $0
Seat 1: SB (small blind) collected ($0.04)
Seat 2: BB (big blind) folded before Flop
Seat 3: HJ folded before Flop (didn't bet)
Seat 5: CO folded before Flop (didn't bet)
Seat 6: BTN (button) folded before Flop (didn't bet)


PokerStars Hand #238161377758:  Hold'em No Limit ($0.01/$0.02 USD) - 2022/08/23 0:22:23 ET
Table 'Achilles IV' 6-max Seat #1 is the button
Seat 1: BTN ($2.99 in chips)
Seat 2: SB ($2 in chips)
Seat 3: BB ($6.65 in chips)
Seat 5: HJ ($3.02 in chips)
Seat 6: CO ($2.07 in chips)
SB: posts small blind $0.01
BB: posts big blind $0.02
*** HOLE CARDS ***
HJ: folds
CO: raises $0.04 to $0.06
BTN: folds
SB: folds
BB: folds
Uncalled bet ($0.04) returned to CO
CO collected $0.05 from pot
*** SUMMARY ***
Total pot $0.05 | Rake $0
Seat 1: BTN (button) folded before Flop (didn't bet)
Seat 2: SB (small blind) folded before Flop
Seat 3: BB (big blind) folded before Flop
Seat 5: HJ folded before Flop (didn't bet)
Seat 6: CO collected ($0.05)


PokerStars Hand #238161379470:  Hold'em No Limit ($0.01/$0.02 USD) - 2022/08/23 0:22:36 ET
Table 'Achilles IV' 6-max Seat #2 is the button
Seat 1: CO ($2.99 in chips)
Seat 2: BTN ($2 in chips)
Seat 3: SB ($6.63 in chips)
Seat 5: BB ($3.02 in chips)
Seat 6: HJ ($2.10 in chips)
SB: posts small blind $0.01
BB: posts big blind $0.02
*** HOLE CARDS ***
HJ: folds
CO: folds
BTN: folds
SB: folds
Uncalled bet ($0.01) returned to BB
BB collected $0.02 from pot
cordobes555 was removed from the table for failing to post
cordobes555 leaves the table
*** SUMMARY ***
Total pot $0.02 | Rake $0
Seat 1: CO folded before Flop (didn't bet)
Seat 2: BTN (button) folded before Flop (didn't bet)
Seat 3: SB (small blind) folded before Flop
Seat 5: BB (big blind) collected ($0.02)
Seat 6: HJ folded before Flop (didn't bet)


PokerStars Hand #238161381922:  Hold'em No Limit ($0.01/$0.02 USD) - 2022/08/23 0:22:56 ET
Table 'Achilles IV' 6-max Seat #3 is the button
Seat 1: HJ ($2.99 in chips)
Seat 2: CO ($2 in chips)
Seat 3: BTN ($6.62 in chips)
Seat 5: SB ($3.03 in chips)
Seat 6: BB ($2.10 in chips)
SB: posts small blind $0.01
BB: posts big blind $0.02
*** HOLE CARDS ***
HJ: folds
CO: folds
BTN: raises $0.03 to $0.05
SB: folds
BB: folds
Uncalled bet ($0.03) returned to BTN
BTN collected $0.05 from pot
BTN: doesn't show hand
*** SUMMARY ***
Total pot $0.05 | Rake $0
Seat 1: HJ folded before Flop (didn't bet)
Seat 2: CO folded before Flop (didn't bet)
Seat 3: BTN (button) collected ($0.05)
Seat 5: SB (small blind) folded before Flop
Seat 6: BB (big blind) folded before Flop


PokerStars Hand #238161383976:  Hold'em No Limit ($0.01/$0.02 USD) - 2022/08/23 0:23:13 ET
Table 'Achilles IV' 6-max Seat #5 is the button
Seat 1: BB ($2.99 in chips)
Seat 2: HJ ($2 in chips)
Seat 3: CO ($6.65 in chips)
Seat 5: BTN ($3.02 in chips)
Seat 6: SB ($2.08 in chips)
SB: posts small blind $0.01
BB: posts big blind $0.02
*** HOLE CARDS ***
HJ: folds
Recafer68 joins the table at seat #4
CO: folds
BTN: folds
SB: folds
Uncalled bet ($0.01) returned to BB
BB collected $0.02 from pot
BB: doesn't show hand
*** SUMMARY ***
Total pot $0.02 | Rake $0
Seat 1: BB (big blind) collected ($0.02)
Seat 2: HJ folded before Flop (didn't bet)
Seat 3: CO folded before Flop (didn't bet)
Seat 5: BTN (button) folded before Flop (didn't bet)
Seat 6: SB (small blind) folded before Flop


PokerStars Hand #238161386778:  Hold'em No Limit ($0.01/$0.02 USD) - 2022/08/23 0:23:36 ET
Table 'Achilles IV' 6-max Seat #6 is the button
Seat 1: SB ($3 in chips)
Seat 2: BB ($2 in chips)
Seat 3: UTG ($6.65 in chips)
Seat 4: HJ ($0.87 in chips)
Seat 5: CO ($3.02 in chips)
Seat 6: BTN ($2.07 in chips)
SB: posts small blind $0.01
BB: posts big blind $0.02
HJ: posts big blind $0.02
*** HOLE CARDS ***
UTG: folds
HJ: checks
CO: folds
BTN: folds
SB: folds
BB: checks
*** FLOP *** [Jd 5h 6d]
BB: checks
HJ: checks
*** TURN *** [Jd 5h 6d] [Qs]
BB: checks
HJ: checks
*** RIVER *** [Jd 5h 6d Qs] [8d]
BB: checks
HJ: checks
*** SHOW DOWN ***
BB: shows [9c As] (high card Ace)
HJ: mucks hand
BB collected $0.05 from pot
*** SUMMARY ***
Total pot $0.05 | Rake $0
Board [Jd 5h 6d Qs 8d]
Seat 1: SB (small blind) folded before Flop
Seat 2: BB (big blind) showed [9c As] and won ($0.05) with high card Ace
Seat 3: UTG folded before Flop (didn't bet)
Seat 4: HJ mucked
Seat 5: CO folded before Flop (didn't bet)
Seat 6: BTN (button) folded before Flop (didn't bet)


PokerStars Hand #238161391589:  Hold'em No Limit ($0.01/$0.02 USD) - 2022/08/23 0:24:10 ET
Table 'Achilles IV' 6-max Seat #1 is the button
Seat 1: BTN ($2.99 in chips)
Seat 2: SB ($2.03 in chips)
Seat 3: BB ($6.65 in chips)
Seat 4: UTG ($0.85 in chips)
Seat 5: HJ ($3.02 in chips)
Seat 6: CO ($2.07 in chips)
SB: posts small blind $0.01
BB: posts big blind $0.02
*** HOLE CARDS ***
UTG: calls $0.02
HJ: folds
CO: folds
BTN: folds
SB: calls $0.01
BB: checks
*** FLOP *** [Td 8d As]
SB: checks
BB: checks
UTG: bets $0.02
SB: folds
BB: calls $0.02
*** TURN *** [Td 8d As] [5h]
BB: checks
UTG: bets $0.02
BB: folds
Uncalled bet ($0.02) returned to UTG
UTG collected $0.10 from pot
*** SUMMARY ***
Total pot $0.10 | Rake $0
Board [Td 8d As 5h]
Seat 1: BTN (button) folded before Flop (didn't bet)
Seat 2: SB (small blind) folded on the Flop
Seat 3: BB (big blind) folded on the Turn
Seat 4: UTG collected ($0.10)
Seat 5: HJ folded before Flop (didn't bet)
Seat 6: CO folded before Flop (didn't bet)


PokerStars Hand #238161395872:  Hold'em No Limit ($0.01/$0.02 USD) - 2022/08/23 0:24:45 ET
Table 'Achilles IV' 6-max Seat #2 is the button
Seat 1: CO ($2.99 in chips)
Seat 2: BTN ($2.01 in chips)
Seat 3: SB ($6.61 in chips)
Seat 4: BB ($0.91 in chips)
Seat 5: UTG ($3.02 in chips)
Seat 6: HJ ($2.07 in chips)
SB: posts small blind $0.01
BB: posts big blind $0.02
*** HOLE CARDS ***
UTG: folds
HJ: raises $0.04 to $0.06
CO: folds
BTN: calls $0.06
SB: folds
BB: calls $0.04
*** FLOP *** [9s 7s 9h]
BB: bets $0.02
HJ: folds
BTN: raises $1.93 to $1.95 and is all-in
BB: calls $0.83 and is all-in
Uncalled bet ($1.10) returned to BTN
*** TURN *** [9s 7s 9h] [Ad]
*** RIVER *** [9s 7s 9h Ad] [7c]
*** SHOW DOWN ***
BB: shows [Qs 8s] (two pair, Nines and Sevens)
BTN: shows [Th Tc] (two pair, Tens and Nines)
BTN cashed out the hand for $1.06 | Cash Out Fee $0.01
*** SUMMARY ***
Total pot $1.89 | Rake $0.07
Board [9s 7s 9h Ad 7c]
Seat 1: CO folded before Flop (didn't bet)
Seat 2: BTN (button) showed [Th Tc] and won ($1.82) with two pair, Tens and Nines (pot not awarded as player cashed out)
Seat 3: SB (small blind) folded before Flop
Seat 4: BB (big blind) showed [Qs 8s] and lost with two pair, Nines and Sevens
Seat 5: UTG folded before Flop (didn't bet)
Seat 6: HJ folded on the Flop


PokerStars Hand #238161401836:  Hold'em No Limit ($0.01/$0.02 USD) - 2022/08/23 0:25:33 ET
Table 'Achilles IV' 6-max Seat #3 is the button
Seat 1: HJ ($2.99 in chips)
Seat 2: CO ($2.16 in chips)
Seat 3: BTN ($6.60 in chips)
Seat 5: SB ($3.02 in chips)
Seat 6: BB ($2.01 in chips)
SB: posts small blind $0.01
BB: posts big blind $0.02
*** HOLE CARDS ***
HJ: folds
CO: folds
BTN: raises $0.03 to $0.05
SB: folds
BB: folds
Uncalled bet ($0.03) returned to BTN
BTN collected $0.05 from pot
BTN: doesn't show hand
*** SUMMARY ***
Total pot $0.05 | Rake $0
Seat 1: HJ folded before Flop (didn't bet)
Seat 2: CO folded before Flop (didn't bet)
Seat 3: BTN (button) collected ($0.05)
Seat 5: SB (small blind) folded before Flop
Seat 6: BB (big blind) folded before Flop


PokerStars Hand #238161403711:  Hold'em No Limit ($0.01/$0.02 USD) - 2022/08/23 0:25:49 ET
Table 'Achilles IV' 6-max Seat #5 is the button
Seat 1: BB ($2.99 in chips)
Seat 2: UTG ($2.16 in chips)
Seat 3: HJ ($6.63 in chips)
Seat 4: CO ($0.80 in chips)
Seat 5: BTN ($3.01 in chips)
Seat 6: SB ($2 in chips)
SB: posts small blind $0.01
BB: posts big blind $0.02
CO: posts small blind $0.01
*** HOLE CARDS ***
UTG: folds
HJ: folds
CO: calls $0.02
BTN: calls $0.02
SB: calls $0.01
BB: checks
*** FLOP *** [4h 6c 8s]
SB: bets $0.07
BB: folds
CO: folds
BTN: calls $0.07
*** TURN *** [4h 6c 8s] [5h]
SB: checks
BTN: bets $0.22
SB: folds
Uncalled bet ($0.22) returned to BTN
BTN collected $0.22 from pot
*** SUMMARY ***
Total pot $0.23 | Rake $0.01
Board [4h 6c 8s 5h]
Seat 1: BB (big blind) folded on the Flop
Seat 2: UTG folded before Flop (didn't bet)
Seat 3: HJ folded before Flop (didn't bet)
Seat 4: CO folded on the Flop
Seat 5: BTN (button) collected ($0.22)
Seat 6: SB (small blind) folded on the Turn


PokerStars Hand #238161413238:  Hold'em No Limit ($0.01/$0.02 USD) - 2022/08/23 0:26:46 ET
Table 'Achilles IV' 6-max Seat #6 is the button
Seat 1: SB ($2.97 in chips)
Seat 2: BB ($2.16 in chips)
Seat 3: UTG ($6.63 in chips)
Seat 4: HJ ($0.77 in chips)
Seat 5: CO ($3.14 in chips)
Seat 6: BTN ($2 in chips)
SB: posts small blind $0.01
BB: posts big blind $0.02
*** HOLE CARDS ***
UTG: folds
HJ: calls $0.02
CO: folds
BTN: raises $0.10 to $0.12
SB: folds
BB: folds
HJ: folds
Uncalled bet ($0.10) returned to BTN
BTN collected $0.07 from pot
*** SUMMARY ***
Total pot $0.07 | Rake $0
Seat 1: SB (small blind) folded before Flop
Seat 2: BB (big blind) folded before Flop
Seat 3: UTG folded before Flop (didn't bet)
Seat 4: HJ folded before Flop
Seat 5: CO folded before Flop (didn't bet)
Seat 6: BTN (button) collected ($0.07)


PokerStars Hand #238161415181:  Hold'em No Limit ($0.01/$0.02 USD) - 2022/08/23 0:27:01 ET
Table 'Achilles IV' 6-max Seat #1 is the button
Seat 1: BTN ($2.96 in chips)
Seat 2: SB ($2.14 in chips)
Seat 3: BB ($6.63 in chips)
Seat 4: UTG ($0.75 in chips)
Seat 5: HJ ($3.14 in chips)
Seat 6: CO ($2.05 in chips)
SB: posts small blind $0.01
BB: posts big blind $0.02
*** HOLE CARDS ***
UTG: calls $0.02
HJ: folds
CO: folds
BTN: folds
SB: calls $0.01
BB: checks
*** FLOP *** [Th 3s Qh]
SB: checks
BB: checks
UTG: bets $0.04
SB: folds
BB: calls $0.04
*** TURN *** [Th 3s Qh] [6s]
BB: checks
UTG: bets $0.07
BB: folds
Uncalled bet ($0.07) returned to UTG
UTG collected $0.14 from pot
*** SUMMARY ***
Total pot $0.14 | Rake $0
Board [Th 3s Qh 6s]
Seat 1: BTN (button) folded before Flop (didn't bet)
Seat 2: SB (small blind) folded on the Flop
Seat 3: BB (big blind) folded on the Turn
Seat 4: UTG collected ($0.14)
Seat 5: HJ folded before Flop (didn't bet)
Seat 6: CO folded before Flop (didn't bet)


PokerStars Hand #238161420027:  Hold'em No Limit ($0.01/$0.02 USD) - 2022/08/23 0:27:41 ET
Table 'Achilles IV' 6-max Seat #2 is the button
Seat 1: CO ($2.96 in chips)
Seat 2: BTN ($2.12 in chips)
Seat 3: SB ($6.57 in chips)
Seat 4: BB ($0.83 in chips)
Seat 5: UTG ($3.14 in chips)
Seat 6: HJ ($2.05 in chips)
SB: posts small blind $0.01
BB: posts big blind $0.02
*** HOLE CARDS ***
UTG: folds
HJ: folds
CO: folds
BTN: raises $0.03 to $0.05
SB: raises $0.10 to $0.15
BB: calls $0.13
BTN: calls $0.10
*** FLOP *** [8c 4s Ac]
SB: bets $0.15
BB: raises $0.15 to $0.30
BTN: folds
SB: calls $0.15
*** TURN *** [8c 4s Ac] [5s]
SB: checks
BB: bets $0.38 and is all-in
SB: calls $0.38
*** RIVER *** [8c 4s Ac 5s] [9s]
*** SHOW DOWN ***
SB: shows [As Qh] (a pair of Aces)
BB: shows [Ah 7d] (a pair of Aces - lower kicker)
SB cashed out the hand for $1.47 | Cash Out Fee $0.01
BB cashed out the hand for $0.27
*** SUMMARY ***
Total pot $1.81 | Rake $0.06
Board [8c 4s Ac 5s 9s]
Seat 1: CO folded before Flop (didn't bet)
Seat 2: BTN (button) folded on the Flop
Seat 3: SB (small blind) showed [As Qh] and won ($1.75) with a pair of Aces (pot not awarded as player cashed out)
Seat 4: BB (big blind) showed [Ah 7d] and lost with a pair of Aces (cashed out).
Seat 5: UTG folded before Flop (didn't bet)
Seat 6: HJ folded before Flop (didn't bet)


PokerStars Hand #238161428327:  Hold'em No Limit ($0.01/$0.02 USD) - 2022/08/23 0:28:48 ET
Table 'Achilles IV' 6-max Seat #3 is the button
Seat 1: HJ ($2.96 in chips)
Seat 2: CO ($2 in chips)
Seat 3: BTN ($7.21 in chips)
Seat 4: SB ($0.27 in chips)
Seat 5: BB ($3.14 in chips)
Seat 6: UTG ($2.05 in chips)
SB: posts small blind $0.01
BB: posts big blind $0.02
*** HOLE CARDS ***
UTG: folds
HJ: raises $0.04 to $0.06
CO: folds
CO leaves the table
BTN: folds
SB: folds
BB: folds
Uncalled bet ($0.04) returned to HJ
HJ collected $0.05 from pot
HJ: doesn't show hand
*** SUMMARY ***
Total pot $0.05 | Rake $0
Seat 1: HJ collected ($0.05)
Seat 2: CO folded before Flop (didn't bet)
Seat 3: BTN (button) folded before Flop (didn't bet)
Seat 4: SB (small blind) folded before Flop
Seat 5: BB (big blind) folded before Flop
Seat 6: UTG folded before Flop (didn't bet)


PokerStars Hand #238161430376:  Hold'em No Limit ($0.01/$0.02 USD) - 2022/08/23 0:29:05 ET
Table 'Achilles IV' 6-max Seat #4 is the button
Seat 1: HJ ($2.99 in chips)
Seat 3: CO ($7.21 in chips)
Seat 4: BTN ($0.26 in chips)
Seat 5: SB ($3.12 in chips)
Seat 6: BB ($2.05 in chips)
SB: posts small blind $0.01
BB: posts big blind $0.02
*** HOLE CARDS ***
NicolasMitma17 joins the table at seat #2
HJ: raises $0.04 to $0.06
CO: folds
BTN: folds
SB: folds
BB: folds
Uncalled bet ($0.04) returned to HJ
HJ collected $0.05 from pot
HJ: doesn't show hand
*** SUMMARY ***
Total pot $0.05 | Rake $0
Seat 1: HJ collected ($0.05)
Seat 3: CO folded before Flop (didn't bet)
Seat 4: BTN (button) folded before Flop (didn't bet)
Seat 5: SB (small blind) folded before Flop
Seat 6: BB (big blind) folded before Flop


PokerStars Hand #238161434468:  Hold'em No Limit ($0.01/$0.02 USD) - 2022/08/23 0:29:38 ET
Table 'Achilles IV' 6-max Seat #5 is the button
Seat 1: BB ($3.02 in chips)
Seat 2: UTG ($1.60 in chips)
Seat 3: HJ ($7.21 in chips)
Seat 4: CO ($0.26 in chips)
Seat 5: BTN ($3.11 in chips)
Seat 6: SB ($2.03 in chips)
SB: posts small blind $0.01
BB: posts big blind $0.02
UTG: posts big blind $0.02
*** HOLE CARDS ***
UTG has timed out
UTG: checks
HJ: folds
CO: calls $0.02
BTN: folds
SB: folds
BB: checks
*** FLOP *** [Qs 6c Js]
BB: checks
UTG: checks
CO: bets $0.02
BB: calls $0.02
UTG: calls $0.02
*** TURN *** [Qs 6c Js] [Td]
BB: checks
UTG: checks
CO: bets $0.04
BB: folds
UTG: folds
Uncalled bet ($0.04) returned to CO
CO collected $0.13 from pot
*** SUMMARY ***
Total pot $0.13 | Rake $0
Board [Qs 6c Js Td]
Seat 1: BB (big blind) folded on the Turn
Seat 2: UTG folded on the Turn
Seat 3: HJ folded before Flop (didn't bet)
Seat 4: CO collected ($0.13)
Seat 5: BTN (button) folded before Flop (didn't bet)
Seat 6: SB (small blind) folded before Flop


PokerStars Hand #238161445363:  Hold'em No Limit ($0.01/$0.02 USD) - 2022/08/23 0:31:09 ET
Table 'Achilles IV' 6-max Seat #6 is the button
Seat 1: SB ($2.98 in chips)
Seat 2: BB ($1.56 in chips)
Seat 3: UTG ($7.21 in chips)
Seat 4: HJ ($0.35 in chips)
Seat 5: CO ($3.11 in chips)
Seat 6: BTN ($2.02 in chips)
SB: posts small blind $0.01
BB: posts big blind $0.02
*** HOLE CARDS ***
UTG: folds
HJ: calls $0.02
CO: folds
UTG leaves the table
BTN has timed out
BTN: folds
SB: folds
BB: checks
*** FLOP *** [6c Td 2h]
BB: checks
HJ: checks
*** TURN *** [6c Td 2h] [Kd]
BB: checks
HJ: bets $0.02
BB: folds
Uncalled bet ($0.02) returned to HJ
HJ collected $0.05 from pot
*** SUMMARY ***
Total pot $0.05 | Rake $0
Board [6c Td 2h Kd]
Seat 1: SB (small blind) folded before Flop
Seat 2: BB (big blind) folded on the Turn
Seat 3: UTG folded before Flop (didn't bet)
Seat 4: HJ collected ($0.05)
Seat 5: CO folded before Flop (didn't bet)
Seat 6: BTN (button) folded before Flop (didn't bet)


PokerStars Hand #238161452046:  Hold'em No Limit ($0.01/$0.02 USD) - 2022/08/23 0:32:04 ET
Table 'Achilles IV' 6-max Seat #1 is the button
Seat 1: BTN ($2.97 in chips)
Seat 2: SB ($1.54 in chips)
Seat 4: BB ($0.38 in chips)
Seat 5: CO ($3.11 in chips)
SB: posts small blind $0.01
BB: posts big blind $0.02
*** HOLE CARDS ***
CO: folds
BTN: folds
CO leaves the table
Numakin joins the table at seat #5
SB has timed out
SB: folds
Uncalled bet ($0.01) returned to BB
BB collected $0.02 from pot
*** SUMMARY ***
Total pot $0.02 | Rake $0
Seat 1: BTN (button) folded before Flop (didn't bet)
Seat 2: SB (small blind) folded before Flop
Seat 4: BB (big blind) collected ($0.02)
Seat 5: CO folded before Flop (didn't bet)


PokerStars Hand #238161456210:  Hold'em No Limit ($0.01/$0.02 USD) - 2022/08/23 0:32:39 ET
Table 'Achilles IV' 6-max Seat #1 is the button
Seat 1: BTN ($2.95 in chips)
Seat 4: SB ($0.41 in chips)
Seat 5: BB ($2 in chips)
SB: posts small blind $0.01
BB: posts big blind $0.02
*** HOLE CARDS ***
BigBen-AA1982 leaves the table
BTN: folds
Overdiewings joins the table at seat #3
SB: calls $0.01
Overdiewings leaves the table
BB: checks
*** FLOP *** [9h Jc 5c]
southalllegend joins the table at seat #3
SB: checks
BB: bets $0.02
SB: calls $0.02
*** TURN *** [9h Jc 5c] [8h]
SB: checks
BB: bets $0.04
SB: raises $0.33 to $0.37 and is all-in
BB: folds
Uncalled bet ($0.33) returned to SB
SB collected $0.15 from pot
*** SUMMARY ***
Total pot $0.16 | Rake $0.01
Board [9h Jc 5c 8h]
Seat 1: BTN (button) folded before Flop (didn't bet)
Seat 4: SB (small blind) collected ($0.15)
Seat 5: BB (big blind) folded on the Turn


PokerStars Hand #238161462179:  Hold'em No Limit ($0.01/$0.02 USD) - 2022/08/23 0:33:29 ET
Table 'Achilles IV' 6-max Seat #4 is the button
Seat 1: BB ($2.95 in chips)
Seat 2: HJ ($1.53 in chips)
Seat 3: CO ($0.80 in chips)
Seat 4: BTN ($0.48 in chips)
Seat 5: SB ($2 in chips)
SB: posts small blind $0.01
BB: posts big blind $0.02
HJ: posts small & big blinds $0.03
CO: posts big blind $0.02
*** HOLE CARDS ***
HJ: checks
CO: checks
BTN: raises $0.04 to $0.06
SB: folds
BB: folds
HJ: calls $0.04
CO: calls $0.04
*** FLOP *** [5c Tc 2c]
HJ: bets $0.04
CO: calls $0.04
BTN: raises $0.08 to $0.12
HJ: calls $0.08
CO: calls $0.08
*** TURN *** [5c Tc 2c] [6d]
HJ: checks
CO: checks
BTN: bets $0.28
HJ: calls $0.28
CO: calls $0.28
*** RIVER *** [5c Tc 2c 6d] [7s]
HJ: checks
CO: bets $0.34 and is all-in
BTN: calls $0.02 and is all-in
HJ: folds
Uncalled bet ($0.32) returned to CO
*** SHOW DOWN ***
CO: shows [4c 8s] (a straight, Four to Eight)
BTN: shows [5h 5d] (three of a kind, Fives)
CO collected $1.41 from pot
*** SUMMARY ***
Total pot $1.46 | Rake $0.05
Board [5c Tc 2c 6d 7s]
Seat 1: BB (big blind) folded before Flop
Seat 2: HJ folded on the River
Seat 3: CO showed [4c 8s] and won ($1.41) with a straight, Four to Eight
Seat 4: BTN (button) showed [5h 5d] and lost with three of a kind, Fives
Seat 5: SB (small blind) folded before Flop


PokerStars Hand #238161473145:  Hold'em No Limit ($0.01/$0.02 USD) - 2022/08/23 0:35:00 ET
Table 'Achilles IV' 6-max Seat #5 is the button
Seat 1: SB ($2.93 in chips)
Seat 2: BB ($1.06 in chips)
Seat 3: CO ($1.73 in chips)
Seat 5: BTN ($2 in chips)
SB: posts small blind $0.01
BB: posts big blind $0.02
*** HOLE CARDS ***
CO: calls $0.02
BTN: folds
SB: folds
BB: checks
*** FLOP *** [5s 3h 2c]
BB: checks
CO: checks
*** TURN *** [5s 3h 2c] [Qc]
BB: checks
CO: bets $0.56
BB: folds
Uncalled bet ($0.56) returned to CO
CO collected $0.05 from pot
CO: shows [4h 6c] (a straight, Deuce to Six)
*** SUMMARY ***
Total pot $0.05 | Rake $0
Board [5s 3h 2c Qc]
Seat 1: SB (small blind) folded before Flop
Seat 2: BB (big blind) folded on the Turn
Seat 3: CO collected ($0.05)
Seat 5: BTN (button) folded before Flop (didn't bet)


PokerStars Hand #238161483194:  Hold'em No Limit ($0.01/$0.02 USD) - 2022/08/23 0:35:37 ET
Table 'Achilles IV' 6-max Seat #1 is the button
Seat 1: BTN ($2.92 in chips)
Seat 2: SB ($1.04 in chips)
Seat 3: BB ($1.76 in chips)
Seat 5: CO ($2 in chips)
SB: posts small blind $0.01
BB: posts big blind $0.02
rsxcd479: sits out
*** HOLE CARDS ***
CO: raises $0.03 to $0.05
BTN: folds
Recafer68 leaves the table
SB: folds
BB: calls $0.03
*** FLOP *** [2d Ks 4d]
BB: checks
CO: bets $0.04
BB: calls $0.04
*** TURN *** [2d Ks 4d] [7d]
BB: checks
CO: checks
*** RIVER *** [2d Ks 4d 7d] [4h]
BB: checks
CO: checks
*** SHOW DOWN ***
BB: shows [Ts 2c] (two pair, Fours and Deuces)
CO: shows [8h 8c] (two pair, Eights and Fours)
CO collected $0.18 from pot
*** SUMMARY ***
Total pot $0.19 | Rake $0.01
Board [2d Ks 4d 7d 4h]
Seat 1: BTN (button) folded before Flop (didn't bet)
Seat 2: SB (small blind) folded before Flop
Seat 3: BB (big blind) showed [Ts 2c] and lost with two pair, Fours and Deuces
Seat 5: CO showed [8h 8c] and won ($0.18) with two pair, Eights and Fours


PokerStars Hand #238161486789:  Hold'em No Limit ($0.01/$0.02 USD) - 2022/08/23 0:36:06 ET
Table 'Achilles IV' 6-max Seat #2 is the button
Seat 1: CO ($2.92 in chips)
Seat 2: BTN ($1.03 in chips)
Seat 3: SB ($1.67 in chips)
Seat 5: BB ($2.09 in chips)
SB: posts small blind $0.01
BB: posts big blind $0.02
rsxcd479: sits out
*** HOLE CARDS ***
CO: folds
BTN: folds
SB: raises $0.04 to $0.06
LeMiguelo joins the table at seat #4
BB: calls $0.04
*** FLOP *** [Jh 2h 9c]
SB: checks
BB: bets $0.04
SB: raises $0.20 to $0.24
BB: raises $0.40 to $0.64
SB: calls $0.40
*** TURN *** [Jh 2h 9c] [4c]
SB: checks
BB: bets $1.22
SB: calls $0.97 and is all-in
Uncalled bet ($0.25) returned to BB
*** RIVER *** [Jh 2h 9c 4c] [4s]
*** SHOW DOWN ***
SB: shows [Js Ks] (two pair, Jacks and Fours)
BB: shows [2d 2c] (a full house, Deuces full of Fours)
BB collected $3.22 from pot
*** SUMMARY ***
Total pot $3.34 | Rake $0.12
Board [Jh 2h 9c 4c 4s]
Seat 1: CO folded before Flop (didn't bet)
Seat 2: BTN (button) folded before Flop (didn't bet)
Seat 3: SB (small blind) showed [Js Ks] and lost with two pair, Jacks and Fours
Seat 5: BB (big blind) showed [2d 2c] and won ($3.22) with a full house, Deuces full of Fours


PokerStars Hand #238161490172:  Hold'em No Limit ($0.01/$0.02 USD) - 2022/08/23 0:36:34 ET
Table 'Achilles IV' 6-max Seat #5 is the button
Seat 1: SB ($2.92 in chips)
Seat 2: BB ($1.03 in chips)
Seat 5: BTN ($3.64 in chips)
SB: posts small blind $0.01
BB: posts big blind $0.02
LeMiguelo: sits out
*** HOLE CARDS ***
BTN: raises $0.03 to $0.05
SB: folds
BB: folds
Uncalled bet ($0.03) returned to BTN
BTN collected $0.05 from pot
BTN: doesn't show hand
*** SUMMARY ***
Total pot $0.05 | Rake $0
Seat 1: SB (small blind) folded before Flop
Seat 2: BB (big blind) folded before Flop
Seat 5: BTN (button) collected ($0.05)


PokerStars Hand #238161491807:  Hold'em No Limit ($0.01/$0.02 USD) - 2022/08/23 0:36:48 ET
Table 'Achilles IV' 6-max Seat #1 is the button
Seat 1: BTN ($2.91 in chips)
Seat 2: SB ($1.01 in chips)
Seat 4: BB ($2 in chips)
Seat 5: CO ($3.67 in chips)
SB: posts small blind $0.01
BB: posts big blind $0.02
rsxcd479: sits out
*** HOLE CARDS ***
CO: raises $0.03 to $0.05
BTN: raises $0.09 to $0.14
SB: folds
BB: folds
CO: folds
Uncalled bet ($0.09) returned to BTN
BTN collected $0.13 from pot
BTN: doesn't show hand
*** SUMMARY ***
Total pot $0.13 | Rake $0
Seat 1: BTN (button) collected ($0.13)
Seat 2: SB (small blind) folded before Flop
Seat 4: BB (big blind) folded before Flop
Seat 5: CO folded before Flop


PokerStars Hand #238161495931:  Hold'em No Limit ($0.01/$0.02 USD) - 2022/08/23 0:37:22 ET
Table 'Achilles IV' 6-max Seat #2 is the button
Seat 1: CO ($2.99 in chips)
Seat 2: BTN ($1 in chips)
Seat 4: SB ($2 in chips)
Seat 5: BB ($3.62 in chips)
SB: posts small blind $0.01
BB: posts big blind $0.02
rsxcd479: sits out
*** HOLE CARDS ***
CO: calls $0.02
BTN: raises $0.06 to $0.08
SB: folds
BB: folds
CO: calls $0.06
*** FLOP *** [Kd Jh Kh]
CO: checks
BTN: checks
*** TURN *** [Kd Jh Kh] [6s]
CO: checks
BTN: bets $0.08
CO: folds
Uncalled bet ($0.08) returned to BTN
BTN collected $0.18 from pot
BTN: doesn't show hand
*** SUMMARY ***
Total pot $0.19 | Rake $0.01
Board [Kd Jh Kh 6s]
Seat 1: CO folded on the Turn
Seat 2: BTN (button) collected ($0.18)
Seat 4: SB (small blind) folded before Flop
Seat 5: BB (big blind) folded before Flop


PokerStars Hand #238161500477:  Hold'em No Limit ($0.01/$0.02 USD) - 2022/08/23 0:38:00 ET
Table 'Achilles IV' 6-max Seat #4 is the button
Seat 1: UTG ($2.91 in chips)
Seat 2: HJ ($1.10 in chips)
Seat 3: CO ($2 in chips)
Seat 4: BTN ($2 in chips)
Seat 5: SB ($3.60 in chips)
Seat 6: BB ($2.02 in chips)
SB: posts small blind $0.01
BB: posts big blind $0.02
CO: posts small & big blinds $0.03
*** HOLE CARDS ***
UTG: folds
HJ: folds
CO: checks
BTN: folds
SB: folds
BB: checks
*** FLOP *** [5c Qs 2h]
BB: checks
CO: checks
*** TURN *** [5c Qs 2h] [Ac]
BB: checks
CO: checks
*** RIVER *** [5c Qs 2h Ac] [7s]
BB: checks
CO: checks
*** SHOW DOWN ***
BB: shows [4d 8d] (high card Ace)
CO: shows [Tc 7h] (a pair of Sevens)
CO collected $0.06 from pot
*** SUMMARY ***
Total pot $0.06 | Rake $0
Board [5c Qs 2h Ac 7s]
Seat 1: UTG folded before Flop (didn't bet)
Seat 2: HJ folded before Flop (didn't bet)
Seat 3: CO showed [Tc 7h] and won ($0.06) with a pair of Sevens
Seat 4: BTN (button) folded before Flop (didn't bet)
Seat 5: SB (small blind) folded before Flop
Seat 6: BB (big blind) showed [4d 8d] and lost with high card Ace


PokerStars Hand #238161508454:  Hold'em No Limit ($0.01/$0.02 USD) - 2022/08/23 0:39:08 ET
Table 'Achilles IV' 6-max Seat #5 is the button
Seat 1: BB ($2.91 in chips)
Seat 2: UTG ($1.10 in chips)
Seat 3: HJ ($2.03 in chips)
Seat 4: CO ($2 in chips)
Seat 5: BTN ($3.59 in chips)
Seat 6: SB ($2 in chips)
SB: posts small blind $0.01
BB: posts big blind $0.02
*** HOLE CARDS ***
UTG: folds
HJ: raises $0.02 to $0.04
CO: folds
BTN: folds
SB: folds
BB: calls $0.02
*** FLOP *** [5h Th Ac]
BB: checks
HJ: bets $0.09
BB: folds
Uncalled bet ($0.09) returned to HJ
HJ collected $0.09 from pot
*** SUMMARY ***
Total pot $0.09 | Rake $0
Board [5h Th Ac]
Seat 1: BB (big blind) folded on the Flop
Seat 2: UTG folded before Flop (didn't bet)
Seat 3: HJ collected ($0.09)
Seat 4: CO folded before Flop (didn't bet)
Seat 5: BTN (button) folded before Flop (didn't bet)
Seat 6: SB (small blind) folded before Flop


PokerStars Hand #238161511682:  Hold'em No Limit ($0.01/$0.02 USD) - 2022/08/23 0:39:35 ET
Table 'Achilles IV' 6-max Seat #6 is the button
Seat 1: SB ($2.87 in chips)
Seat 2: BB ($1.10 in chips)
Seat 3: UTG ($2.08 in chips)
Seat 4: HJ ($2 in chips)
Seat 5: CO ($3.59 in chips)
Seat 6: BTN ($2 in chips)
SB: posts small blind $0.01
BB: posts big blind $0.02
*** HOLE CARDS ***
UTG: calls $0.02
HJ: folds
CO: folds
BTN: folds
SB: folds
BB: checks
*** FLOP *** [7h 5d 2h]
BB: checks
UTG: checks
*** TURN *** [7h 5d 2h] [Ac]
BB: checks
UTG: checks
*** RIVER *** [7h 5d 2h Ac] [Kd]
BB: checks
UTG: checks
*** SHOW DOWN ***
BB: shows [6h 9c] (high card Ace)
UTG: mucks hand
BB collected $0.05 from pot
*** SUMMARY ***
Total pot $0.05 | Rake $0
Board [7h 5d 2h Ac Kd]
Seat 1: SB (small blind) folded before Flop
Seat 2: BB (big blind) showed [6h 9c] and won ($0.05) with high card Ace
Seat 3: UTG mucked
Seat 4: HJ folded before Flop (didn't bet)
Seat 5: CO folded before Flop (didn't bet)
Seat 6: BTN (button) folded before Flop (didn't bet)


PokerStars Hand #238161515069:  Hold'em No Limit ($0.01/$0.02 USD) - 2022/08/23 0:40:04 ET
Table 'Achilles IV' 6-max Seat #1 is the button
Seat 1: BTN ($2.86 in chips)
Seat 2: SB ($1.13 in chips)
Seat 3: BB ($2.06 in chips)
Seat 4: UTG ($2 in chips)
Seat 5: HJ ($3.59 in chips)
Seat 6: CO ($2 in chips)
SB: posts small blind $0.01
BB: posts big blind $0.02
*** HOLE CARDS ***
UTG: folds
HJ: folds
CO: folds
BTN: folds
SB: folds
Uncalled bet ($0.01) returned to BB
BB collected $0.02 from pot
BB: shows [Qd Qc] (a pair of Queens)
*** SUMMARY ***
Total pot $0.02 | Rake $0
Seat 1: BTN (button) folded before Flop (didn't bet)
Seat 2: SB (small blind) folded before Flop
Seat 3: BB (big blind) collected ($0.02)
Seat 4: UTG folded before Flop (didn't bet)
Seat 5: HJ folded before Flop (didn't bet)
Seat 6: CO folded before Flop (didn't bet)


PokerStars Hand #238161517585:  Hold'em No Limit ($0.01/$0.02 USD) - 2022/08/23 0:40:25 ET
Table 'Achilles IV' 6-max Seat #2 is the button
Seat 1: CO ($2.86 in chips)
Seat 2: BTN ($1.12 in chips)
Seat 3: SB ($2.07 in chips)
Seat 4: BB ($2 in chips)
Seat 5: UTG ($3.59 in chips)
Seat 6: HJ ($2 in chips)
SB: posts small blind $0.01
BB: posts big blind $0.02
*** HOLE CARDS ***
UTG: folds
HJ: folds
CO: folds
BTN: folds
SB: calls $0.01
BB: checks
*** FLOP *** [Jc Qd 2c]
SB: checks
BB: bets $0.04
SB: calls $0.04
*** TURN *** [Jc Qd 2c] [8h]
SB: checks
BB: bets $0.09
SB: calls $0.09
*** RIVER *** [Jc Qd 2c 8h] [9c]
SB: checks
BB: checks
*** SHOW DOWN ***
SB: shows [2s 5d] (a pair of Deuces)
BB: shows [Jh 2d] (two pair, Jacks and Deuces)
BB collected $0.29 from pot
*** SUMMARY ***
Total pot $0.30 | Rake $0.01
Board [Jc Qd 2c 8h 9c]
Seat 1: CO folded before Flop (didn't bet)
Seat 2: BTN (button) folded before Flop (didn't bet)
Seat 3: SB (small blind) showed [2s 5d] and lost with a pair of Deuces
Seat 4: BB (big blind) showed [Jh 2d] and won ($0.29) with two pair, Jacks and Deuces
Seat 5: UTG folded before Flop (didn't bet)
Seat 6: HJ folded before Flop (didn't bet)


PokerStars Hand #238161522395:  Hold'em No Limit ($0.01/$0.02 USD) - 2022/08/23 0:41:06 ET
Table 'Achilles IV' 6-max Seat #3 is the button
Seat 1: HJ ($2.86 in chips)
Seat 2: CO ($1.12 in chips)
Seat 3: BTN ($1.92 in chips)
Seat 4: SB ($2.14 in chips)
Seat 5: BB ($3.59 in chips)
Seat 6: UTG ($2 in chips)
SB: posts small blind $0.01
BB: posts big blind $0.02
*** HOLE CARDS ***
UTG: folds
HJ: folds
CO: folds
BTN: calls $0.02
SB: raises $0.06 to $0.08
BB: folds
BTN: calls $0.06
*** FLOP *** [5c Qs 9h]
SB: checks
BTN: checks
*** TURN *** [5c Qs 9h] [Td]
SB: checks
BTN: bets $0.17
SB: folds
Uncalled bet ($0.17) returned to BTN
BTN collected $0.17 from pot
*** SUMMARY ***
Total pot $0.18 | Rake $0.01
Board [5c Qs 9h Td]
Seat 1: HJ folded before Flop (didn't bet)
Seat 2: CO folded before Flop (didn't bet)
Seat 3: BTN (button) collected ($0.17)
Seat 4: SB (small blind) folded on the Turn
Seat 5: BB (big blind) folded before Flop
Seat 6: UTG folded before Flop (didn't bet)


PokerStars Hand #238161528378:  Hold'em No Limit ($0.01/$0.02 USD) - 2022/08/23 0:41:56 ET
Table 'Achilles IV' 6-max Seat #4 is the button
Seat 1: UTG ($2.86 in chips)
Seat 2: HJ ($1.12 in chips)
Seat 3: CO ($2.01 in chips)
Seat 4: BTN ($2.06 in chips)
Seat 5: SB ($3.57 in chips)
Seat 6: BB ($2 in chips)
SB: posts small blind $0.01
BB: posts big blind $0.02
*** HOLE CARDS ***
UTG: folds
HJ: folds
CO: calls $0.02
BTN: folds
SB: raises $0.05 to $0.07
BB: folds
CO: calls $0.05
*** FLOP *** [8h 3s 5c]
SB: bets $0.05
CO: calls $0.05
*** TURN *** [8h 3s 5c] [6s]
SB: bets $0.08
CO: calls $0.08
*** RIVER *** [8h 3s 5c 6s] [Ad]
SB: checks
CO: checks
*** SHOW DOWN ***
SB: shows [Kh Kd] (a pair of Kings)
CO: mucks hand
SB collected $0.41 from pot
*** SUMMARY ***
Total pot $0.42 | Rake $0.01
Board [8h 3s 5c 6s Ad]
Seat 1: UTG folded before Flop (didn't bet)
Seat 2: HJ folded before Flop (didn't bet)
Seat 3: CO mucked
Seat 4: BTN (button) folded before Flop (didn't bet)
Seat 5: SB (small blind) showed [Kh Kd] and won ($0.41) with a pair of Kings
Seat 6: BB (big blind) folded before Flop


PokerStars Hand #238161532330:  Hold'em No Limit ($0.01/$0.02 USD) - 2022/08/23 0:42:29 ET
Table 'Achilles IV' 6-max Seat #5 is the button
Seat 1: BB ($2.86 in chips)
Seat 2: UTG ($1.12 in chips)
Seat 3: HJ ($1.81 in chips)
Seat 4: CO ($2.06 in chips)
Seat 5: BTN ($3.78 in chips)
Seat 6: SB ($2 in chips)
SB: posts small blind $0.01
BB: posts big blind $0.02
*** HOLE CARDS ***
UTG: folds
HJ: calls $0.02
CO: folds
BTN: folds
SB: folds
BB: raises $0.04 to $0.06
HJ: calls $0.04
*** FLOP *** [Jh Ac 8d]
BB: checks
HJ: checks
*** TURN *** [Jh Ac 8d] [Qh]
BB: bets $0.10
HJ: calls $0.10
*** RIVER *** [Jh Ac 8d Qh] [Qc]
BB: bets $0.38
HJ: calls $0.38
*** SHOW DOWN ***
BB: shows [8s 8c] (a full house, Eights full of Queens)
HJ: mucks hand
BB collected $1.05 from pot
*** SUMMARY ***
Total pot $1.09 | Rake $0.04
Board [Jh Ac 8d Qh Qc]
Seat 1: BB (big blind) showed [8s 8c] and won ($1.05) with a full house, Eights full of Queens
Seat 2: UTG folded before Flop (didn't bet)
Seat 3: HJ mucked
Seat 4: CO folded before Flop (didn't bet)
Seat 5: BTN (button) folded before Flop (didn't bet)
Seat 6: SB (small blind) folded before Flop


PokerStars Hand #238161537792:  Hold'em No Limit ($0.01/$0.02 USD) - 2022/08/23 0:43:16 ET
Table 'Achilles IV' 6-max Seat #6 is the button
Seat 1: SB ($3.37 in chips)
Seat 2: BB ($1.12 in chips)
Seat 3: UTG ($1.27 in chips)
Seat 4: HJ ($2.06 in chips)
Seat 5: CO ($3.78 in chips)
Seat 6: BTN ($2 in chips)
SB: posts small blind $0.01
BB: posts big blind $0.02
*** HOLE CARDS ***
UTG: calls $0.02
HJ: folds
HJ leaves the table
CO: folds
BTN has timed out
BTN: folds
SB: folds
BB: checks
*** FLOP *** [6c Kh 2c]
BB: checks
UTG: checks
*** TURN *** [6c Kh 2c] [7s]
BB: checks
UTG: checks
*** RIVER *** [6c Kh 2c 7s] [4d]
BB: checks
jeckarliyo joins the table at seat #4
UTG: checks
*** SHOW DOWN ***
BB: shows [8d 2s] (a pair of Deuces)
UTG: mucks hand
BB collected $0.05 from pot
*** SUMMARY ***
Total pot $0.05 | Rake $0
Board [6c Kh 2c 7s 4d]
Seat 1: SB (small blind) folded before Flop
Seat 2: BB (big blind) showed [8d 2s] and won ($0.05) with a pair of Deuces
Seat 3: UTG mucked
Seat 4: HJ folded before Flop (didn't bet)
Seat 5: CO folded before Flop (didn't bet)
Seat 6: BTN (button) folded before Flop (didn't bet)


PokerStars Hand #238161543207:  Hold'em No Limit ($0.01/$0.02 USD) - 2022/08/23 0:44:03 ET
Table 'Achilles IV' 6-max Seat #1 is the button
Seat 1: BTN ($3.36 in chips)
Seat 2: SB ($1.15 in chips)
Seat 3: BB ($1.25 in chips)
Seat 4: UTG ($0.80 in chips)
Seat 5: HJ ($3.78 in chips)
Seat 6: CO ($2 in chips)
SB: posts small blind $0.01
BB: posts big blind $0.02
UTG: posts big blind $0.02
*** HOLE CARDS ***
UTG: checks
HJ: folds
CO: folds
BTN: folds
SB: folds
BB: checks
*** FLOP *** [Qc Ah 8h]
BB: checks
UTG: checks
*** TURN *** [Qc Ah 8h] [3c]
BB: checks
UTG: bets $0.04
BB: calls $0.04
*** RIVER *** [Qc Ah 8h 3c] [Jd]
BB: checks
UTG: bets $0.04
BB: calls $0.04
*** SHOW DOWN ***
UTG: shows [Jc Td] (a pair of Jacks)
BB: mucks hand
UTG collected $0.20 from pot
*** SUMMARY ***
Total pot $0.21 | Rake $0.01
Board [Qc Ah 8h 3c Jd]
Seat 1: BTN (button) folded before Flop (didn't bet)
Seat 2: SB (small blind) folded before Flop
Seat 3: BB (big blind) mucked
Seat 4: UTG showed [Jc Td] and won ($0.20) with a pair of Jacks
Seat 5: HJ folded before Flop (didn't bet)
Seat 6: CO folded before Flop (didn't bet)


PokerStars Hand #238161547791:  Hold'em No Limit ($0.01/$0.02 USD) - 2022/08/23 0:44:42 ET
Table 'Achilles IV' 6-max Seat #2 is the button
Seat 1: CO ($3.36 in chips)
Seat 2: BTN ($1.14 in chips)
Seat 3: SB ($1.15 in chips)
Seat 4: BB ($0.90 in chips)
Seat 5: UTG ($3.78 in chips)
Seat 6: HJ ($2 in chips)
SB: posts small blind $0.01
BB: posts big blind $0.02
*** HOLE CARDS ***
UTG: folds
HJ has timed out
HJ: folds
CO: folds
BTN: calls $0.02
SB: calls $0.01
BB: checks
*** FLOP *** [2s As 2d]
SB: checks
BB: checks
BTN: checks
*** TURN *** [2s As 2d] [8s]
SB: bets $0.06
BB: folds
BTN: folds
Uncalled bet ($0.06) returned to SB
SB collected $0.06 from pot
SB: shows [5h 2c] (three of a kind, Deuces)
*** SUMMARY ***
Total pot $0.06 | Rake $0
Board [2s As 2d 8s]
Seat 1: CO folded before Flop (didn't bet)
Seat 2: BTN (button) folded on the Turn
Seat 3: SB (small blind) collected ($0.06)
Seat 4: BB (big blind) folded on the Turn
Seat 5: UTG folded before Flop (didn't bet)
Seat 6: HJ folded before Flop (didn't bet)


PokerStars Hand #238161552231:  Hold'em No Limit ($0.01/$0.02 USD) - 2022/08/23 0:45:20 ET
Table 'Achilles IV' 6-max Seat #3 is the button
Seat 1: HJ ($3.36 in chips)
Seat 2: CO ($1.12 in chips)
Seat 3: BTN ($1.19 in chips)
Seat 4: SB ($0.88 in chips)
Seat 5: BB ($3.78 in chips)
Seat 6: UTG ($2 in chips)
SB: posts small blind $0.01
BB: posts big blind $0.02
*** HOLE CARDS ***
UTG: folds
HJ: folds
CO: folds
BTN: calls $0.02
SB: calls $0.01
BB: checks
*** FLOP *** [Td Jh 6d]
SB: checks
BB: checks
BTN: checks
*** TURN *** [Td Jh 6d] [3d]
SB: checks
BB: checks
BTN: checks
*** RIVER *** [Td Jh 6d 3d] [2s]
SB: checks
BB: checks
BTN: checks
*** SHOW DOWN ***
SB: shows [Kc 9s] (high card King)
BB: shows [4c 6s] (a pair of Sixes)
BTN: shows [Ts 5c] (a pair of Tens)
BTN collected $0.06 from pot
*** SUMMARY ***
Total pot $0.06 | Rake $0
Board [Td Jh 6d 3d 2s]
Seat 1: HJ folded before Flop (didn't bet)
Seat 2: CO folded before Flop (didn't bet)
Seat 3: BTN (button) showed [Ts 5c] and won ($0.06) with a pair of Tens
Seat 4: SB (small blind) showed [Kc 9s] and lost with high card King
Seat 5: BB (big blind) showed [4c 6s] and lost with a pair of Sixes
Seat 6: UTG folded before Flop (didn't bet)


PokerStars Hand #238161557313:  Hold'em No Limit ($0.01/$0.02 USD) - 2022/08/23 0:46:03 ET
Table 'Achilles IV' 6-max Seat #4 is the button
Seat 1: UTG ($3.36 in chips)
Seat 2: HJ ($1.12 in chips)
Seat 3: CO ($1.23 in chips)
Seat 4: BTN ($0.86 in chips)
Seat 5: SB ($3.76 in chips)
Seat 6: BB ($2 in chips)
SB: posts small blind $0.01
BB: posts big blind $0.02
*** HOLE CARDS ***
UTG: folds
HJ: folds
CO: calls $0.02
BTN: raises $0.02 to $0.04
SB: folds
BB: calls $0.02
CO: calls $0.02
*** FLOP *** [5d Jc Kd]
BB: checks
CO: checks
BTN: bets $0.04
BB: folds
CO: calls $0.04
*** TURN *** [5d Jc Kd] [4d]
CO: checks
BTN: bets $0.04
CO: calls $0.04
*** RIVER *** [5d Jc Kd 4d] [8d]
CO: checks
BTN: bets $0.06
CO: calls $0.06
*** SHOW DOWN ***
BTN: shows [Jd Ah] (a flush, King high)
CO: mucks hand
BTN collected $0.40 from pot
*** SUMMARY ***
Total pot $0.41 | Rake $0.01
Board [5d Jc Kd 4d 8d]
Seat 1: UTG folded before Flop (didn't bet)
Seat 2: HJ folded before Flop (didn't bet)
Seat 3: CO mucked
Seat 4: BTN (button) showed [Jd Ah] and won ($0.40) with a flush, King high
Seat 5: SB (small blind) folded before Flop
Seat 6: BB (big blind) folded on the Flop


PokerStars Hand #238161562869:  Hold'em No Limit ($0.01/$0.02 USD) - 2022/08/23 0:46:50 ET
Table 'Achilles IV' 6-max Seat #5 is the button
Seat 1: BB ($3.36 in chips)
Seat 2: UTG ($1.12 in chips)
Seat 3: HJ ($1.05 in chips)
Seat 4: CO ($1.08 in chips)
Seat 5: BTN ($3.75 in chips)
Seat 6: SB ($2 in chips)
SB: posts small blind $0.01
BB: posts big blind $0.02
*** HOLE CARDS ***
UTG: folds
HJ: calls $0.02
CO: folds
BTN: folds
SB: raises $0.08 to $0.10
BB: folds
HJ: calls $0.08
*** FLOP *** [5s 4s 2s]
SB: checks
HJ: checks
*** TURN *** [5s 4s 2s] [Ks]
SB: checks
HJ: checks
*** RIVER *** [5s 4s 2s Ks] [2h]
SB: checks
HJ: checks
*** SHOW DOWN ***
SB: shows [9c 8h] (a pair of Deuces)
HJ: shows [4h Qc] (two pair, Fours and Deuces)
HJ collected $0.21 from pot
*** SUMMARY ***
Total pot $0.22 | Rake $0.01
Board [5s 4s 2s Ks 2h]
Seat 1: BB (big blind) folded before Flop
Seat 2: UTG folded before Flop (didn't bet)
Seat 3: HJ showed [4h Qc] and won ($0.21) with two pair, Fours and Deuces
Seat 4: CO folded before Flop (didn't bet)
Seat 5: BTN (button) folded before Flop (didn't bet)
Seat 6: SB (small blind) showed [9c 8h] and lost with a pair of Deuces


PokerStars Hand #238161568901:  Hold'em No Limit ($0.01/$0.02 USD) - 2022/08/23 0:47:42 ET
Table 'Achilles IV' 6-max Seat #6 is the button
Seat 1: SB ($3.34 in chips)
Seat 2: BB ($1.12 in chips)
Seat 3: UTG ($1.16 in chips)
Seat 4: HJ ($1.08 in chips)
Seat 5: CO ($3.75 in chips)
Seat 6: BTN ($2 in chips)
SB: posts small blind $0.01
BB: posts big blind $0.02
*** HOLE CARDS ***
UTG: calls $0.02
HJ: calls $0.02
CO: folds
BTN: raises $0.11 to $0.13
SB: folds
BB: calls $0.11
UTG: calls $0.11
HJ: folds
*** FLOP *** [9d Ad 2s]
BB: checks
UTG: checks
BTN: checks
*** TURN *** [9d Ad 2s] [Kd]
BB: checks
UTG: checks
BTN: checks
*** RIVER *** [9d Ad 2s Kd] [5h]
BB: checks
UTG: bets $0.41
BTN: folds
BB: folds
Uncalled bet ($0.41) returned to UTG
UTG collected $0.41 from pot
*** SUMMARY ***
Total pot $0.42 | Rake $0.01
Board [9d Ad 2s Kd 5h]
Seat 1: SB (small blind) folded before Flop
Seat 2: BB (big blind) folded on the River
Seat 3: UTG collected ($0.41)
Seat 4: HJ folded before Flop
Seat 5: CO folded before Flop (didn't bet)
Seat 6: BTN (button) folded on the River


PokerStars Hand #238161578193:  Hold'em No Limit ($0.01/$0.02 USD) - 2022/08/23 0:49:00 ET
Table 'Achilles IV' 6-max Seat #1 is the button
Seat 1: BTN ($3.33 in chips)
Seat 2: SB ($0.99 in chips)
Seat 3: BB ($1.44 in chips)
Seat 4: UTG ($1.06 in chips)
Seat 5: HJ ($3.75 in chips)
Seat 6: CO ($2 in chips)
SB: posts small blind $0.01
BB: posts big blind $0.02
*** HOLE CARDS ***
UTG: calls $0.02
HJ: folds
CO has timed out
CO: folds
BTN: folds
SB: folds
BB: checks
*** FLOP *** [6s 6c 2s]
BB: checks
UTG: checks
*** TURN *** [6s 6c 2s] [3s]
BB: checks
UTG: checks
*** RIVER *** [6s 6c 2s 3s] [4s]
BB: bets $1.42 and is all-in
UTG: folds
Uncalled bet ($1.42) returned to BB
BB collected $0.05 from pot
*** SUMMARY ***
Total pot $0.05 | Rake $0
Board [6s 6c 2s 3s 4s]
Seat 1: BTN (button) folded before Flop (didn't bet)
Seat 2: SB (small blind) folded before Flop
Seat 3: BB (big blind) collected ($0.05)
Seat 4: UTG folded on the River
Seat 5: HJ folded before Flop (didn't bet)
Seat 6: CO folded before Flop (didn't bet)


PokerStars Hand #238161582606:  Hold'em No Limit ($0.01/$0.02 USD) - 2022/08/23 0:49:38 ET
Table 'Achilles IV' 6-max Seat #2 is the button
Seat 1: CO ($3.33 in chips)
Seat 2: BTN ($0.98 in chips)
Seat 3: SB ($1.47 in chips)
Seat 4: BB ($1.04 in chips)
Seat 5: UTG ($3.75 in chips)
Seat 6: HJ ($2 in chips)
SB: posts small blind $0.01
BB: posts big blind $0.02
*** HOLE CARDS ***
UTG: raises $0.03 to $0.05
HJ has timed out
HJ: folds
CO: folds
BTN: folds
SB: calls $0.04
BB: calls $0.03
*** FLOP *** [5d 4s Ts]
SB: checks
BB: checks
UTG: checks
*** TURN *** [5d 4s Ts] [As]
SB: checks
BB: bets $0.06
UTG: folds
SB: calls $0.06
*** RIVER *** [5d 4s Ts As] [9c]
SB: checks
BB: bets $0.12
SB: folds
Uncalled bet ($0.12) returned to BB
BB collected $0.26 from pot
BB: doesn't show hand
*** SUMMARY ***
Total pot $0.27 | Rake $0.01
Board [5d 4s Ts As 9c]
Seat 1: CO folded before Flop (didn't bet)
Seat 2: BTN (button) folded before Flop (didn't bet)
Seat 3: SB (small blind) folded on the River
Seat 4: BB (big blind) collected ($0.26)
Seat 5: UTG folded on the Turn
Seat 6: HJ folded before Flop (didn't bet)


PokerStars Hand #238161588900:  Hold'em No Limit ($0.01/$0.02 USD) - 2022/08/23 0:50:33 ET
Table 'Achilles IV' 6-max Seat #3 is the button
Seat 1: HJ ($3.33 in chips)
Seat 2: CO ($0.98 in chips)
Seat 3: BTN ($1.36 in chips)
Seat 4: SB ($1.19 in chips)
Seat 5: BB ($3.70 in chips)
Seat 6: UTG ($2 in chips)
SB: posts small blind $0.01
BB: posts big blind $0.02
*** HOLE CARDS ***
UTG: folds
HJ: folds
CO: folds
BTN: calls $0.02
SB: calls $0.01
BB: checks
*** FLOP *** [Qd Jd 2c]
SB: checks
BB: checks
BTN: checks
*** TURN *** [Qd Jd 2c] [7c]
SB: checks
BB: checks
BTN: checks
*** RIVER *** [Qd Jd 2c 7c] [Ts]
SB: bets $0.06
BB: folds
BTN: folds
Uncalled bet ($0.06) returned to SB
SB collected $0.06 from pot
SB: doesn't show hand
*** SUMMARY ***
Total pot $0.06 | Rake $0
Board [Qd Jd 2c 7c Ts]
Seat 1: HJ folded before Flop (didn't bet)
Seat 2: CO folded before Flop (didn't bet)
Seat 3: BTN (button) folded on the River
Seat 4: SB (small blind) collected ($0.06)
Seat 5: BB (big blind) folded on the River
Seat 6: UTG folded before Flop (didn't bet)


PokerStars Hand #238161593069:  Hold'em No Limit ($0.01/$0.02 USD) - 2022/08/23 0:51:09 ET
Table 'Achilles IV' 6-max Seat #4 is the button
Seat 1: UTG ($3.33 in chips)
Seat 2: HJ ($0.98 in chips)
Seat 3: CO ($1.34 in chips)
Seat 4: BTN ($1.23 in chips)
Seat 5: SB ($3.68 in chips)
Seat 6: BB ($2 in chips)
SB: posts small blind $0.01
BB: posts big blind $0.02
*** HOLE CARDS ***
UTG: raises $0.04 to $0.06
HJ: folds
CO: calls $0.06
BTN: calls $0.06
SB: folds
BB: folds
*** FLOP *** [6s 2h Qd]
UTG: checks
CO: checks
BTN: bets $0.08
UTG: calls $0.08
CO: calls $0.08
*** TURN *** [6s 2h Qd] [8h]
UTG: checks
CO: bets $0.43
BTN: calls $0.43
UTG: folds
*** RIVER *** [6s 2h Qd 8h] [Qs]
CO: checks
BTN: bets $0.32
CO: calls $0.32
*** SHOW DOWN ***
BTN: shows [Qc Kc] (three of a kind, Queens)
CO: mucks hand
BTN collected $1.88 from pot
*** SUMMARY ***
Total pot $1.95 | Rake $0.07
Board [6s 2h Qd 8h Qs]
Seat 1: UTG folded on the Turn
Seat 2: HJ folded before Flop (didn't bet)
Seat 3: CO mucked
Seat 4: BTN (button) showed [Qc Kc] and won ($1.88) with three of a kind, Queens
Seat 5: SB (small blind) folded before Flop
Seat 6: BB (big blind) folded before Flop


PokerStars Hand #238161598103:  Hold'em No Limit ($0.01/$0.02 USD) - 2022/08/23 0:51:53 ET
Table 'Achilles IV' 6-max Seat #5 is the button
Seat 1: BB ($3.19 in chips)
Seat 2: UTG ($0.98 in chips)
Seat 3: HJ ($0.45 in chips)
Seat 4: CO ($2.22 in chips)
Seat 5: BTN ($3.67 in chips)
Seat 6: SB ($2 in chips)
SB: posts small blind $0.01
BB: posts big blind $0.02
*** HOLE CARDS ***
UTG: folds
HJ: calls $0.02
CO: folds
BTN: raises $0.06 to $0.08
SB: folds
BB: calls $0.06
HJ: calls $0.06
*** FLOP *** [9s 2s 9h]
BB: checks
HJ: checks
BTN: checks
*** TURN *** [9s 2s 9h] [Qd]
BB: bets $0.16
HJ: calls $0.16
BTN: calls $0.16
*** RIVER *** [9s 2s 9h Qd] [5d]
BB: checks
HJ: bets $0.21 and is all-in
BTN: folds
BB: calls $0.21
*** SHOW DOWN ***
HJ: shows [Kd 6d] (a pair of Nines)
BB: shows [Qs Ks] (two pair, Queens and Nines)
BB collected $1.11 from pot
*** SUMMARY ***
Total pot $1.15 | Rake $0.04
Board [9s 2s 9h Qd 5d]
Seat 1: BB (big blind) showed [Qs Ks] and won ($1.11) with two pair, Queens and Nines
Seat 2: UTG folded before Flop (didn't bet)
Seat 3: HJ showed [Kd 6d] and lost with a pair of Nines
Seat 4: CO folded before Flop (didn't bet)
Seat 5: BTN (button) folded on the River
Seat 6: SB (small blind) folded before Flop


PokerStars Hand #238161605230:  Hold'em No Limit ($0.01/$0.02 USD) - 2022/08/23 0:52:55 ET
Table 'Achilles IV' 6-max Seat #6 is the button
Seat 1: SB ($3.85 in chips)
Seat 2: BB ($0.98 in chips)
Seat 3: UTG ($1.05 in chips)
Seat 4: HJ ($2.22 in chips)
Seat 5: CO ($3.43 in chips)
Seat 6: BTN ($2 in chips)
SB: posts small blind $0.01
BB: posts big blind $0.02
*** HOLE CARDS ***
UTG: calls $0.02
HJ: folds
CO: raises $0.06 to $0.08
BTN: folds
SB: folds
BB: folds
UTG: calls $0.06
*** FLOP *** [Ac 6h Kc]
UTG: checks
BB leaves the table
CO: bets $0.12
UTG: calls $0.12
*** TURN *** [Ac 6h Kc] [8c]
UTG: bets $0.41
CO: raises $1.11 to $1.52
UTG: calls $0.44 and is all-in
Uncalled bet ($0.67) returned to CO
*** RIVER *** [Ac 6h Kc 8c] [6c]
*** SHOW DOWN ***
UTG: shows [5s 3d] (a pair of Sixes)
CO: shows [Qh As] (two pair, Aces and Sixes)
CO collected $2.06 from pot
*** SUMMARY ***
Total pot $2.13 | Rake $0.07
Board [Ac 6h Kc 8c 6c]
Seat 1: SB (small blind) folded before Flop
Seat 2: BB (big blind) folded before Flop
Seat 3: UTG showed [5s 3d] and lost with a pair of Sixes
Seat 4: HJ folded before Flop (didn't bet)
Seat 5: CO showed [Qh As] and won ($2.06) with two pair, Aces and Sixes
Seat 6: BTN (button) folded before Flop (didn't bet)


PokerStars Hand #238161610320:  Hold'em No Limit ($0.01/$0.02 USD) - 2022/08/23 0:53:39 ET
Table 'Achilles IV' 6-max Seat #1 is the button
Seat 1: BTN ($3.84 in chips)
Seat 3: SB ($0.80 in chips)
Seat 4: BB ($2.22 in chips)
Seat 5: HJ ($4.44 in chips)
Seat 6: CO ($2 in chips)
SB: posts small blind $0.01
0.zika joins the table at seat #2
BB: posts big blind $0.02
*** HOLE CARDS ***
HJ: folds
CO: folds
BTN: folds
SB: calls $0.01
BB: checks
*** FLOP *** [Ad 4s 3d]
SB: checks
BB: checks
*** TURN *** [Ad 4s 3d] [Ac]
SB: bets $0.04
BB: calls $0.04
*** RIVER *** [Ad 4s 3d Ac] [3h]
BTN leaves the table
SB: bets $0.74 and is all-in
BB: folds
Uncalled bet ($0.74) returned to SB
SB collected $0.12 from pot
*** SUMMARY ***
Total pot $0.12 | Rake $0
Board [Ad 4s 3d Ac 3h]
Seat 1: BTN (button) folded before Flop (didn't bet)
Seat 3: SB (small blind) collected ($0.12)
Seat 4: BB (big blind) folded on the River
Seat 5: HJ folded before Flop (didn't bet)
Seat 6: CO folded before Flop (didn't bet)


PokerStars Hand #238161614987:  Hold'em No Limit ($0.01/$0.02 USD) - 2022/08/23 0:54:20 ET
Table 'Achilles IV' 6-max Seat #3 is the button
Seat 3: BTN ($0.86 in chips)
Seat 4: SB ($2.16 in chips)
Seat 5: BB ($4.44 in chips)
Seat 6: CO ($2 in chips)
SB: posts small blind $0.01
BB: posts big blind $0.02
0.zika: sits out
*** HOLE CARDS ***
CO: folds
CO leaves the table
BTN: folds
SB: calls $0.01
BB: checks
*** FLOP *** [7c 3s 4c]
SB: checks
BB: checks
*** TURN *** [7c 3s 4c] [Js]
SB: checks
BB: checks
*** RIVER *** [7c 3s 4c Js] [4d]
SB: checks
BB: checks
*** SHOW DOWN ***
SB: shows [Kd 9s] (a pair of Fours)
BB: mucks hand
SB collected $0.04 from pot
*** SUMMARY ***
Total pot $0.04 | Rake $0
Board [7c 3s 4c Js 4d]
Seat 3: BTN (button) folded before Flop (didn't bet)
Seat 4: SB (small blind) showed [Kd 9s] and won ($0.04) with a pair of Fours
Seat 5: BB (big blind) mucked
Seat 6: CO folded before Flop (didn't bet)


PokerStars Hand #238161618942:  Hold'em No Limit ($0.01/$0.02 USD) - 2022/08/23 0:54:54 ET
Table 'Achilles IV' 6-max Seat #4 is the button
Seat 2: BB ($0.80 in chips)
Seat 3: CO ($0.86 in chips)
Seat 4: BTN ($2.18 in chips)
Seat 5: SB ($4.42 in chips)
SB: posts small blind $0.01
BB: posts big blind $0.02
*** HOLE CARDS ***
CO: calls $0.02
BTN: calls $0.02
SB: folds
BB: checks
*** FLOP *** [9d 4h 9s]
BB: checks
CO: checks
BTN: checks
*** TURN *** [9d 4h 9s] [5h]
BB: checks
CO: checks
BTN: checks
*** RIVER *** [9d 4h 9s 5h] [Qs]
BB: checks
CO: checks
BTN: checks
*** SHOW DOWN ***
BB: shows [3s 8d] (a pair of Nines)
CO: shows [Js 8c] (a pair of Nines - Queen+Jack kicker)
BTN: shows [Td Jc] (a pair of Nines - Queen+Jack+Ten kicker)
BTN collected $0.07 from pot
*** SUMMARY ***
Total pot $0.07 | Rake $0
Board [9d 4h 9s 5h Qs]
Seat 2: BB (big blind) showed [3s 8d] and lost with a pair of Nines
Seat 3: CO showed [Js 8c] and lost with a pair of Nines
Seat 4: BTN (button) showed [Td Jc] and won ($0.07) with a pair of Nines
Seat 5: SB (small blind) folded before Flop


PokerStars Hand #238161622973:  Hold'em No Limit ($0.01/$0.02 USD) - 2022/08/23 0:55:32 ET
Table 'Achilles IV' 6-max Seat #5 is the button
Seat 2: SB ($0.78 in chips)
Seat 3: BB ($0.84 in chips)
Seat 4: CO ($2.23 in chips)
Seat 5: BTN ($4.41 in chips)
SB: posts small blind $0.01
BB: posts big blind $0.02
*** HOLE CARDS ***
CO: raises $0.02 to $0.04
BTN: folds
SB: calls $0.03
BB: calls $0.02
*** FLOP *** [Kd 5s 6s]
SB: checks
BB: checks
CO: bets $0.06
SB: calls $0.06
BB: calls $0.06
*** TURN *** [Kd 5s 6s] [8h]
SB: checks
BB: checks
CO: checks
*** RIVER *** [Kd 5s 6s 8h] [3c]
SB: checks
Koresh153 joins the table at seat #6
BB: checks
CO: bets $0.10
SB: folds
BB: calls $0.10
*** SHOW DOWN ***
CO: shows [Kc Js] (a pair of Kings)
BB: shows [6c Ts] (a pair of Sixes)
CO collected $0.48 from pot
*** SUMMARY ***
Total pot $0.50 | Rake $0.02
Board [Kd 5s 6s 8h 3c]
Seat 2: SB (small blind) folded on the River
Seat 3: BB (big blind) showed [6c Ts] and lost with a pair of Sixes
Seat 4: CO showed [Kc Js] and won ($0.48) with a pair of Kings
Seat 5: BTN (button) folded before Flop (didn't bet)


PokerStars Hand #238161629714:  Hold'em No Limit ($0.01/$0.02 USD) - 2022/08/23 0:56:37 ET
Table 'Achilles IV' 6-max Seat #2 is the button
Seat 2: BTN ($0.68 in chips)
Seat 3: SB ($0.64 in chips)
Seat 4: BB ($2.51 in chips)
Seat 5: CO ($4.41 in chips)
SB: posts small blind $0.01
BB: posts big blind $0.02
Koresh153: sits out
*** HOLE CARDS ***
CO: folds
BTN: calls $0.02
SB: calls $0.01
BB: checks
*** FLOP *** [8c Tc As]
SB: bets $0.62 and is all-in
BB: folds
BTN: folds
Uncalled bet ($0.62) returned to SB
SB collected $0.06 from pot
*** SUMMARY ***
Total pot $0.06 | Rake $0
Board [8c Tc As]
Seat 2: BTN (button) folded on the Flop
Seat 3: SB (small blind) collected ($0.06)
Seat 4: BB (big blind) folded on the Flop
Seat 5: CO folded before Flop (didn't bet)


PokerStars Hand #238161632860:  Hold'em No Limit ($0.01/$0.02 USD) - 2022/08/23 0:57:08 ET
Table 'Achilles IV' 6-max Seat #3 is the button
Seat 2: CO ($0.66 in chips)
Seat 3: BTN ($0.68 in chips)
Seat 4: SB ($2.49 in chips)
Seat 5: BB ($4.41 in chips)
SB: posts small blind $0.01
BB: posts big blind $0.02
Koresh153: sits out
*** HOLE CARDS ***
CO: folds
BTN: calls $0.02
SB: folds
Vlao joins the table at seat #1
BB: checks
*** FLOP *** [Jh Qd 6h]
BB: checks
BTN: checks
*** TURN *** [Jh Qd 6h] [Tc]
BB: checks
BTN: checks
*** RIVER *** [Jh Qd 6h Tc] [4h]
BB: checks
BTN: checks
*** SHOW DOWN ***
BB: shows [7c 8s] (high card Queen)
BTN: shows [Th 7d] (a pair of Tens)
BTN collected $0.05 from pot
*** SUMMARY ***
Total pot $0.05 | Rake $0
Board [Jh Qd 6h Tc 4h]
Seat 2: CO folded before Flop (didn't bet)
Seat 3: BTN (button) showed [Th 7d] and won ($0.05) with a pair of Tens
Seat 4: SB (small blind) folded before Flop
Seat 5: BB (big blind) showed [7c 8s] and lost with high card Queen


PokerStars Hand #238161641018:  Hold'em No Limit ($0.01/$0.02 USD) - 2022/08/23 0:57:29 ET
Table 'Achilles IV' 6-max Seat #4 is the button
Seat 2: HJ ($0.66 in chips)
Seat 3: CO ($0.71 in chips)
Seat 4: BTN ($2.48 in chips)
Seat 5: SB ($4.39 in chips)
Seat 6: BB ($0.80 in chips)
SB: posts small blind $0.01
BB: posts big blind $0.02
Vlao: sits out
*** HOLE CARDS ***
HJ: calls $0.02
CO: calls $0.02
BTN: calls $0.02
SB: folds
BB: checks
*** FLOP *** [Jc 6d 8s]
BB: checks
HJ: checks
CO: checks
BTN: bets $0.06
BB: folds
HJ: folds
CO: calls $0.06
*** TURN *** [Jc 6d 8s] [3h]
CO: checks
BTN: bets $0.06
CO: calls $0.06
*** RIVER *** [Jc 6d 8s 3h] [9h]
CO: checks
BTN: checks
*** SHOW DOWN ***
CO: shows [Ks 8h] (a pair of Eights)
BTN: mucks hand
CO collected $0.32 from pot
*** SUMMARY ***
Total pot $0.33 | Rake $0.01
Board [Jc 6d 8s 3h 9h]
Seat 2: HJ folded on the Flop
Seat 3: CO showed [Ks 8h] and won ($0.32) with a pair of Eights
Seat 4: BTN (button) mucked
Seat 5: SB (small blind) folded before Flop
Seat 6: BB (big blind) folded on the Flop


PokerStars Hand #238161646759:  Hold'em No Limit ($0.01/$0.02 USD) - 2022/08/23 0:58:25 ET
Table 'Achilles IV' 6-max Seat #5 is the button
Seat 1: BB ($2 in chips)
Seat 2: UTG ($0.64 in chips)
Seat 3: HJ ($0.89 in chips)
Seat 4: CO ($2.34 in chips)
Seat 5: BTN ($4.38 in chips)
Seat 6: SB ($0.80 in chips)
SB: posts small blind $0.01
BB: posts big blind $0.02
*** HOLE CARDS ***
UTG: folds
HJ: calls $0.02
CO: folds
BTN: folds
SB: folds
BB: checks
*** FLOP *** [2c 6h 4s]
BB: checks
HJ: checks
*** TURN *** [2c 6h 4s] [Th]
BB: checks
HJ: checks
*** RIVER *** [2c 6h 4s Th] [3d]
BB: bets $0.04
HJ: raises $0.83 to $0.87 and is all-in
BB: calls $0.83
*** SHOW DOWN ***
HJ: shows [Qd 5s] (a straight, Deuce to Six)
BB: shows [Kh 5h] (a straight, Deuce to Six)
BB collected $0.87 from pot
HJ collected $0.86 from pot
*** SUMMARY ***
Total pot $1.79 | Rake $0.06
Board [2c 6h 4s Th 3d]
Seat 1: BB (big blind) showed [Kh 5h] and won ($0.87) with a straight, Deuce to Six
Seat 2: UTG folded before Flop (didn't bet)
Seat 3: HJ showed [Qd 5s] and won ($0.86) with a straight, Deuce to Six
Seat 4: CO folded before Flop (didn't bet)
Seat 5: BTN (button) folded before Flop (didn't bet)
Seat 6: SB (small blind) folded before Flop


PokerStars Hand #238161650798:  Hold'em No Limit ($0.01/$0.02 USD) - 2022/08/23 0:59:04 ET
Table 'Achilles IV' 6-max Seat #6 is the button
Seat 1: SB ($2 in chips)
Seat 2: BB ($0.64 in chips)
Seat 3: UTG ($0.86 in chips)
Seat 4: HJ ($2.34 in chips)
Seat 5: CO ($4.38 in chips)
Seat 6: BTN ($0.80 in chips)
SB: posts small blind $0.01
BB: posts big blind $0.02
*** HOLE CARDS ***
UTG: calls $0.02
HJ: raises $0.02 to $0.04
CO: folds
BTN: folds
SB: folds
BB: folds
UTG: calls $0.02
*** FLOP *** [5h Jc Ah]
UTG: checks
HJ: checks
*** TURN *** [5h Jc Ah] [8s]
UTG: checks
HJ: bets $0.06
UTG: calls $0.06
*** RIVER *** [5h Jc Ah 8s] [7d]
UTG: checks
HJ: bets $0.06
UTG: calls $0.06
*** SHOW DOWN ***
HJ: shows [Kd Kh] (a pair of Kings)
UTG: mucks hand
HJ collected $0.34 from pot
*** SUMMARY ***
Total pot $0.35 | Rake $0.01
Board [5h Jc Ah 8s 7d]
Seat 1: SB (small blind) folded before Flop
Seat 2: BB (big blind) folded before Flop
Seat 3: UTG mucked
Seat 4: HJ showed [Kd Kh] and won ($0.34) with a pair of Kings
Seat 5: CO folded before Flop (didn't bet)
Seat 6: BTN (button) folded before Flop (didn't bet)


PokerStars Hand #238161654203:  Hold'em No Limit ($0.01/$0.02 USD) - 2022/08/23 0:59:38 ET
Table 'Achilles IV' 6-max Seat #1 is the button
Seat 1: BTN ($2 in chips)
Seat 2: SB ($0.62 in chips)
Seat 3: BB ($0.70 in chips)
Seat 4: UTG ($2.52 in chips)
Seat 5: HJ ($4.38 in chips)
Seat 6: CO ($2 in chips)
SB: posts small blind $0.01
BB: posts big blind $0.02
*** HOLE CARDS ***
UTG: calls $0.02
HJ: raises $0.06 to $0.08
CO: folds
BTN: raises $0.22 to $0.30
SB: folds
BB: calls $0.28
UTG: folds
HJ: calls $0.22
*** FLOP *** [Tc 3s 7d]
BB: checks
HJ: checks
BTN: checks
*** TURN *** [Tc 3s 7d] [4s]
BB: checks
HJ: checks
BTN: checks
*** RIVER *** [Tc 3s 7d 4s] [7s]
BB: checks
HJ: checks
BTN: checks
*** SHOW DOWN ***
BB: shows [Kc Qc] (a pair of Sevens)
HJ: shows [Kh As] (a pair of Sevens - Ace kicker)
BTN: shows [Ac Kd] (a pair of Sevens)
HJ collected $0.45 from pot
BTN collected $0.45 from pot
*** SUMMARY ***
Total pot $0.93 | Rake $0.03
Board [Tc 3s 7d 4s 7s]
Seat 1: BTN (button) showed [Ac Kd] and won ($0.45) with a pair of Sevens
Seat 2: SB (small blind) folded before Flop
Seat 3: BB (big blind) showed [Kc Qc] and lost with a pair of Sevens
Seat 4: UTG folded before Flop
Seat 5: HJ showed [Kh As] and won ($0.45) with a pair of Sevens
Seat 6: CO folded before Flop (didn't bet)


PokerStars Hand #238161661138:  Hold'em No Limit ($0.01/$0.02 USD) - 2022/08/23 1:00:44 ET
Table 'Achilles IV' 6-max Seat #2 is the button
Seat 1: CO ($2.15 in chips)
Seat 2: BTN ($0.61 in chips)
Seat 3: SB ($0.40 in chips)
Seat 4: BB ($2.50 in chips)
Seat 5: UTG ($4.53 in chips)
Seat 6: HJ ($2 in chips)
SB: posts small blind $0.01
BB: posts big blind $0.02
*** HOLE CARDS ***
UTG: folds
HJ: folds
CO: folds
BTN: folds
SB: calls $0.01
BB: checks
*** FLOP *** [Kd Js Qd]
SB: bets $0.04
BB: calls $0.04
*** TURN *** [Kd Js Qd] [9s]
SB: checks
BB: bets $0.06
SB: raises $0.28 to $0.34 and is all-in
BB: calls $0.28
*** RIVER *** [Kd Js Qd 9s] [5s]
*** SHOW DOWN ***
SB: shows [9d Th] (a straight, Nine to King)
BB: shows [7c Td] (a straight, Nine to King)
SB collected $0.39 from pot
BB collected $0.38 from pot
*** SUMMARY ***
Total pot $0.80 | Rake $0.03
Board [Kd Js Qd 9s 5s]
Seat 1: CO folded before Flop (didn't bet)
Seat 2: BTN (button) folded before Flop (didn't bet)
Seat 3: SB (small blind) showed [9d Th] and won ($0.39) with a straight, Nine to King
Seat 4: BB (big blind) showed [7c Td] and won ($0.38) with a straight, Nine to King
Seat 5: UTG folded before Flop (didn't bet)
Seat 6: HJ folded before Flop (didn't bet)


PokerStars Hand #238161664558:  Hold'em No Limit ($0.01/$0.02 USD) - 2022/08/23 1:01:16 ET
Table 'Achilles IV' 6-max Seat #3 is the button
Seat 1: HJ ($2.15 in chips)
Seat 2: CO ($0.61 in chips)
Seat 3: BTN ($0.39 in chips)
Seat 4: SB ($2.48 in chips)
Seat 5: BB ($4.53 in chips)
Seat 6: UTG ($2 in chips)
SB: posts small blind $0.01
BB: posts big blind $0.02
*** HOLE CARDS ***
UTG: folds
HJ: raises $0.03 to $0.05
CO: folds
BTN: calls $0.05
SB: folds
BB: folds
*** FLOP *** [Qd Jh Kh]
HJ: bets $0.38
BTN: folds
Uncalled bet ($0.38) returned to HJ
HJ collected $0.13 from pot
*** SUMMARY ***
Total pot $0.13 | Rake $0
Board [Qd Jh Kh]
Seat 1: HJ collected ($0.13)
Seat 2: CO folded before Flop (didn't bet)
Seat 3: BTN (button) folded on the Flop
Seat 4: SB (small blind) folded before Flop
Seat 5: BB (big blind) folded before Flop
Seat 6: UTG folded before Flop (didn't bet)


PokerStars Hand #238161668853:  Hold'em No Limit ($0.01/$0.02 USD) - 2022/08/23 1:01:54 ET
Table 'Achilles IV' 6-max Seat #4 is the button
Seat 1: UTG ($2.23 in chips)
Seat 2: HJ ($0.61 in chips)
Seat 3: CO ($0.34 in chips)
Seat 4: BTN ($2.47 in chips)
Seat 5: SB ($4.51 in chips)
Seat 6: BB ($2 in chips)
SB: posts small blind $0.01
BB: posts big blind $0.02
*** HOLE CARDS ***
UTG: folds
HJ: folds
CO: calls $0.02
BTN: calls $0.02
SB: folds
BB: checks
*** FLOP *** [6c Qs As]
BB: checks
CO: checks
BTN: checks
*** TURN *** [6c Qs As] [9c]
BB: checks
CO: checks
BTN: bets $0.06
BB: folds
CO: calls $0.06
*** RIVER *** [6c Qs As 9c] [5d]
CO: bets $0.18
BTN: calls $0.18
*** SHOW DOWN ***
CO: shows [2h 7c] (high card Ace)
BTN: shows [Jc Qc] (a pair of Queens)
BTN collected $0.53 from pot
*** SUMMARY ***
Total pot $0.55 | Rake $0.02
Board [6c Qs As 9c 5d]
Seat 1: UTG folded before Flop (didn't bet)
Seat 2: HJ folded before Flop (didn't bet)
Seat 3: CO showed [2h 7c] and lost with high card Ace
Seat 4: BTN (button) showed [Jc Qc] and won ($0.53) with a pair of Queens
Seat 5: SB (small blind) folded before Flop
Seat 6: BB (big blind) folded on the Turn


PokerStars Hand #238161673416:  Hold'em No Limit ($0.01/$0.02 USD) - 2022/08/23 1:02:36 ET
Table 'Achilles IV' 6-max Seat #5 is the button
Seat 1: BB ($2.23 in chips)
Seat 2: UTG ($0.61 in chips)
Seat 3: HJ ($0.08 in chips)
Seat 4: CO ($2.74 in chips)
Seat 5: BTN ($4.50 in chips)
Seat 6: SB ($1.98 in chips)
SB: posts small blind $0.01
BB: posts big blind $0.02
*** HOLE CARDS ***
UTG: folds
HJ: calls $0.02
CO: calls $0.02
BTN: folds
SB: folds
BB: checks
*** FLOP *** [Th 2d Tc]
BB: checks
HJ: bets $0.06 and is all-in
CO: folds
BB: folds
Uncalled bet ($0.06) returned to HJ
HJ collected $0.07 from pot
*** SUMMARY ***
Total pot $0.07 | Rake $0
Board [Th 2d Tc]
Seat 1: BB (big blind) folded on the Flop
Seat 2: UTG folded before Flop (didn't bet)
Seat 3: HJ collected ($0.07)
Seat 4: CO folded on the Flop
Seat 5: BTN (button) folded before Flop (didn't bet)
Seat 6: SB (small blind) folded before Flop


PokerStars Hand #238161676850:  Hold'em No Limit ($0.01/$0.02 USD) - 2022/08/23 1:03:07 ET
Table 'Achilles IV' 6-max Seat #6 is the button
Seat 1: SB ($2.21 in chips)
Seat 2: BB ($0.61 in chips)
Seat 3: UTG ($0.13 in chips)
Seat 4: HJ ($2.72 in chips)
Seat 5: CO ($4.50 in chips)
Seat 6: BTN ($1.97 in chips)
SB: posts small blind $0.01
BB: posts big blind $0.02
*** HOLE CARDS ***
UTG: calls $0.02
HJ: calls $0.02
CO: folds
BTN: folds
SB: folds
BB: checks
*** FLOP *** [8d Jh Kh]
BB: checks
UTG: checks
HJ: checks
*** TURN *** [8d Jh Kh] [Th]
BB: checks
UTG: checks
HJ: checks
*** RIVER *** [8d Jh Kh Th] [Kd]
BB: checks
UTG: checks
HJ: checks
*** SHOW DOWN ***
BB: shows [Ks 9c] (three of a kind, Kings)
UTG: shows [8s 7d] (two pair, Kings and Eights)
HJ: mucks hand
BB collected $0.07 from pot
*** SUMMARY ***
Total pot $0.07 | Rake $0
Board [8d Jh Kh Th Kd]
Seat 1: SB (small blind) folded before Flop
Seat 2: BB (big blind) showed [Ks 9c] and won ($0.07) with three of a kind, Kings
Seat 3: UTG showed [8s 7d] and lost with two pair, Kings and Eights
Seat 4: HJ mucked
Seat 5: CO folded before Flop (didn't bet)
Seat 6: BTN (button) folded before Flop (didn't bet)


PokerStars Hand #238161681055:  Hold'em No Limit ($0.01/$0.02 USD) - 2022/08/23 1:03:46 ET
Table 'Achilles IV' 6-max Seat #1 is the button
Seat 1: BTN ($2.20 in chips)
Seat 2: SB ($0.66 in chips)
Seat 3: BB ($0.11 in chips)
Seat 4: UTG ($2.70 in chips)
Seat 5: HJ ($4.50 in chips)
Seat 6: CO ($1.97 in chips)
SB: posts small blind $0.01
BB: posts big blind $0.02
*** HOLE CARDS ***
UTG: folds
HJ: folds
CO: folds
BTN: folds
SB: calls $0.01
BB: checks
*** FLOP *** [7d 8h 4c]
SB: checks
BB: checks
*** TURN *** [7d 8h 4c] [3c]
SB: checks
BB: bets $0.09 and is all-in
SB: folds
Uncalled bet ($0.09) returned to BB
BB collected $0.04 from pot
*** SUMMARY ***
Total pot $0.04 | Rake $0
Board [7d 8h 4c 3c]
Seat 1: BTN (button) folded before Flop (didn't bet)
Seat 2: SB (small blind) folded on the Turn
Seat 3: BB (big blind) collected ($0.04)
Seat 4: UTG folded before Flop (didn't bet)
Seat 5: HJ folded before Flop (didn't bet)
Seat 6: CO folded before Flop (didn't bet)


PokerStars Hand #238161683881:  Hold'em No Limit ($0.01/$0.02 USD) - 2022/08/23 1:04:11 ET
Table 'Achilles IV' 6-max Seat #2 is the button
Seat 1: CO ($2.20 in chips)
Seat 2: BTN ($0.64 in chips)
Seat 3: SB ($0.13 in chips)
Seat 4: BB ($2.70 in chips)
Seat 5: UTG ($4.50 in chips)
Seat 6: HJ ($1.97 in chips)
SB: posts small blind $0.01
BB: posts big blind $0.02
*** HOLE CARDS ***
UTG: folds
HJ: folds
CO: folds
BTN: calls $0.02
SB: calls $0.01
BB: checks
*** FLOP *** [2c 5d Qd]
SB: checks
BB: checks
BTN: checks
*** TURN *** [2c 5d Qd] [3h]
SB: checks
BB: bets $0.04
BTN: calls $0.04
SB: calls $0.04
*** RIVER *** [2c 5d Qd 3h] [7h]
SB: checks
BB: bets $0.10
BTN: folds
SB: calls $0.07 and is all-in
Uncalled bet ($0.03) returned to BB
*** SHOW DOWN ***
BB: shows [3c Qc] (two pair, Queens and Threes)
SB: shows [Jh Ac] (high card Ace)
BB collected $0.31 from pot
*** SUMMARY ***
Total pot $0.32 | Rake $0.01
Board [2c 5d Qd 3h 7h]
Seat 1: CO folded before Flop (didn't bet)
Seat 2: BTN (button) folded on the River
Seat 3: SB (small blind) showed [Jh Ac] and lost with high card Ace
Seat 4: BB (big blind) showed [3c Qc] and won ($0.31) with two pair, Queens and Threes
Seat 5: UTG folded before Flop (didn't bet)
Seat 6: HJ folded before Flop (didn't bet)


PokerStars Hand #238161688521:  Hold'em No Limit ($0.01/$0.02 USD) - 2022/08/23 1:04:53 ET
Table 'Achilles IV' 6-max Seat #4 is the button
Seat 1: HJ ($2.20 in chips)
Seat 2: CO ($0.58 in chips)
Seat 4: BTN ($2.88 in chips)
Seat 5: SB ($4.50 in chips)
Seat 6: BB ($1.97 in chips)
SB: posts small blind $0.01
BB: posts big blind $0.02
*** HOLE CARDS ***
southalllegend leaves the table
HJ: folds
CO: calls $0.02
BTN: folds
SB: folds
killervzla28 joins the table at seat #3
BB: checks
*** FLOP *** [Th 3s Ks]
BB: checks
CO: checks
*** TURN *** [Th 3s Ks] [Qh]
BB: checks
CO: checks
*** RIVER *** [Th 3s Ks Qh] [7s]
BB: checks
CO: checks
*** SHOW DOWN ***
BB: shows [5s 8d] (high card King)
CO: shows [Qd 2h] (a pair of Queens)
CO collected $0.05 from pot
*** SUMMARY ***
Total pot $0.05 | Rake $0
Board [Th 3s Ks Qh 7s]
Seat 1: HJ folded before Flop (didn't bet)
Seat 2: CO showed [Qd 2h] and won ($0.05) with a pair of Queens
Seat 4: BTN (button) folded before Flop (didn't bet)
Seat 5: SB (small blind) folded before Flop
Seat 6: BB (big blind) showed [5s 8d] and lost with high card King


PokerStars Hand #238161692260:  Hold'em No Limit ($0.01/$0.02 USD) - 2022/08/23 1:05:27 ET
Table 'Achilles IV' 6-max Seat #5 is the button
Seat 1: BB ($2.20 in chips)
Seat 2: HJ ($0.61 in chips)
Seat 4: CO ($2.88 in chips)
Seat 5: BTN ($4.49 in chips)
Seat 6: SB ($1.95 in chips)
SB: posts small blind $0.01
BB: posts big blind $0.02
killervzla28: sits out
*** HOLE CARDS ***
HJ: folds
CO: raises $0.02 to $0.04
BTN: folds
SB: folds
BB: calls $0.02
*** FLOP *** [3c As 6h]
BB: checks
CO: checks
*** TURN *** [3c As 6h] [Ks]
BB: checks
CO: checks
*** RIVER *** [3c As 6h Ks] [4s]
BB: checks
CO: checks
*** SHOW DOWN ***
BB: shows [Qh Tc] (high card Ace)
CO: mucks hand
BB collected $0.09 from pot
*** SUMMARY ***
Total pot $0.09 | Rake $0
Board [3c As 6h Ks 4s]
Seat 1: BB (big blind) showed [Qh Tc] and won ($0.09) with high card Ace
Seat 2: HJ folded before Flop (didn't bet)
Seat 4: CO mucked
Seat 5: BTN (button) folded before Flop (didn't bet)
Seat 6: SB (small blind) folded before Flop


PokerStars Hand #238161695255:  Hold'em No Limit ($0.01/$0.02 USD) - 2022/08/23 1:05:56 ET
Table 'Achilles IV' 6-max Seat #6 is the button
Seat 1: SB ($2.25 in chips)
Seat 2: BB ($0.61 in chips)
Seat 4: HJ ($2.84 in chips)
Seat 5: CO ($4.49 in chips)
Seat 6: BTN ($1.94 in chips)
SB: posts small blind $0.01
BB: posts big blind $0.02
killervzla28: sits out
*** HOLE CARDS ***
HJ: folds
CO: folds
BTN: folds
SB: folds
Uncalled bet ($0.01) returned to BB
BB collected $0.02 from pot
*** SUMMARY ***
Total pot $0.02 | Rake $0
Seat 1: SB (small blind) folded before Flop
Seat 2: BB (big blind) collected ($0.02)
Seat 4: HJ folded before Flop (didn't bet)
Seat 5: CO folded before Flop (didn't bet)
Seat 6: BTN (button) folded before Flop (didn't bet)


PokerStars Hand #238161696309:  Hold'em No Limit ($0.01/$0.02 USD) - 2022/08/23 1:06:05 ET
Table 'Achilles IV' 6-max Seat #1 is the button
Seat 1: BTN ($2.24 in chips)
Seat 2: SB ($0.62 in chips)
Seat 3: BB ($2 in chips)
Seat 4: UTG ($2.84 in chips)
Seat 5: HJ ($4.49 in chips)
Seat 6: CO ($1.94 in chips)
SB: posts small blind $0.01
BB: posts big blind $0.02
*** HOLE CARDS ***
UTG: calls $0.02
HJ: calls $0.02
CO: folds
BTN: folds
SB: folds
BB: checks
*** FLOP *** [4s 7s 9c]
BB: checks
UTG: bets $0.04
HJ: folds
BB: folds
Uncalled bet ($0.04) returned to UTG
BB leaves the table
UTG collected $0.07 from pot
UTG: doesn't show hand
*** SUMMARY ***
Total pot $0.07 | Rake $0
Board [4s 7s 9c]
Seat 1: BTN (button) folded before Flop (didn't bet)
Seat 2: SB (small blind) folded before Flop
Seat 3: BB (big blind) folded on the Flop
Seat 4: UTG collected ($0.07)
Seat 5: HJ folded on the Flop
Seat 6: CO folded before Flop (didn't bet)


PokerStars Hand #238161699795:  Hold'em No Limit ($0.01/$0.02 USD) - 2022/08/23 1:06:36 ET
Table 'Achilles IV' 6-max Seat #2 is the button
Seat 1: CO ($2.24 in chips)
Seat 2: BTN ($0.61 in chips)
Seat 4: SB ($2.89 in chips)
Seat 5: BB ($4.47 in chips)
Seat 6: HJ ($1.94 in chips)
SB: posts small blind $0.01
BB: posts big blind $0.02
*** HOLE CARDS ***
HJ: folds
CO: folds
BTN: calls $0.02
SB: calls $0.01
ketomaldonado joins the table at seat #3
BB: checks
*** FLOP *** [As 9d 3d]
SB: checks
BB: checks
BTN: checks
*** TURN *** [As 9d 3d] [Kh]
SB: checks
BB: checks
BTN: bets $0.02
SB: calls $0.02
BB: folds
*** RIVER *** [As 9d 3d Kh] [7h]
SB: checks
BTN: bets $0.10
SB: folds
Uncalled bet ($0.10) returned to BTN
BTN collected $0.10 from pot
BTN: doesn't show hand
*** SUMMARY ***
Total pot $0.10 | Rake $0
Board [As 9d 3d Kh 7h]
Seat 1: CO folded before Flop (didn't bet)
Seat 2: BTN (button) collected ($0.10)
Seat 4: SB (small blind) folded on the River
Seat 5: BB (big blind) folded on the Turn
Seat 6: HJ folded before Flop (didn't bet)


PokerStars Hand #238161704277:  Hold'em No Limit ($0.01/$0.02 USD) - 2022/08/23 1:07:17 ET
Table 'Achilles IV' 6-max Seat #4 is the button
Seat 1: UTG ($2.24 in chips)
Seat 2: HJ ($0.67 in chips)
Seat 3: CO ($2 in chips)
Seat 4: BTN ($2.85 in chips)
Seat 5: SB ($4.45 in chips)
Seat 6: BB ($1.94 in chips)
SB: posts small blind $0.01
BB: posts big blind $0.02
CO: posts big blind $0.02
*** HOLE CARDS ***
UTG: folds
HJ: calls $0.02
CO: checks
BTN: folds
SB: calls $0.01
BB: checks
*** FLOP *** [Ah 5s 4c]
SB: checks
BB: checks
HJ: checks
CO: bets $0.03
SB: folds
BB: folds
HJ: folds
Uncalled bet ($0.03) returned to CO
CO collected $0.08 from pot
*** SUMMARY ***
Total pot $0.08 | Rake $0
Board [Ah 5s 4c]
Seat 1: UTG folded before Flop (didn't bet)
Seat 2: HJ folded on the Flop
Seat 3: CO collected ($0.08)
Seat 4: BTN (button) folded before Flop (didn't bet)
Seat 5: SB (small blind) folded on the Flop
Seat 6: BB (big blind) folded on the Flop


PokerStars Hand #238161708839:  Hold'em No Limit ($0.01/$0.02 USD) - 2022/08/23 1:07:58 ET
Table 'Achilles IV' 6-max Seat #5 is the button
Seat 1: BB ($2.24 in chips)
Seat 2: UTG ($0.65 in chips)
Seat 3: HJ ($2.06 in chips)
Seat 4: CO ($2.85 in chips)
Seat 5: BTN ($4.43 in chips)
Seat 6: SB ($1.92 in chips)
SB: posts small blind $0.01
BB: posts big blind $0.02
*** HOLE CARDS ***
UTG: folds
HJ: raises $0.03 to $0.05
CO: folds
BTN: folds
SB: folds
BB: folds
Uncalled bet ($0.03) returned to HJ
HJ collected $0.05 from pot
*** SUMMARY ***
Total pot $0.05 | Rake $0
Seat 1: BB (big blind) folded before Flop
Seat 2: UTG folded before Flop (didn't bet)
Seat 3: HJ collected ($0.05)
Seat 4: CO folded before Flop (didn't bet)
Seat 5: BTN (button) folded before Flop (didn't bet)
Seat 6: SB (small blind) folded before Flop


PokerStars Hand #238161711140:  Hold'em No Limit ($0.01/$0.02 USD) - 2022/08/23 1:08:19 ET
Table 'Achilles IV' 6-max Seat #6 is the button
Seat 1: SB ($2.22 in chips)
Seat 2: BB ($0.65 in chips)
Seat 3: UTG ($2.09 in chips)
Seat 4: HJ ($2.85 in chips)
Seat 5: CO ($4.43 in chips)
Seat 6: BTN ($1.91 in chips)
SB: posts small blind $0.01
BB: posts big blind $0.02
*** HOLE CARDS ***
UTG: folds
HJ: folds
CO: raises $0.03 to $0.05
BTN: folds
SB: folds
BB: folds
Uncalled bet ($0.03) returned to CO
CO collected $0.05 from pot
CO: doesn't show hand
*** SUMMARY ***
Total pot $0.05 | Rake $0
Seat 1: SB (small blind) folded before Flop
Seat 2: BB (big blind) folded before Flop
Seat 3: UTG folded before Flop (didn't bet)
Seat 4: HJ folded before Flop (didn't bet)
Seat 5: CO collected ($0.05)
Seat 6: BTN (button) folded before Flop (didn't bet)


PokerStars Hand #238161714102:  Hold'em No Limit ($0.01/$0.02 USD) - 2022/08/23 1:08:47 ET
Table 'Achilles IV' 6-max Seat #1 is the button
Seat 1: BTN ($2.21 in chips)
Seat 2: SB ($0.63 in chips)
Seat 3: BB ($2.09 in chips)
Seat 4: UTG ($2.85 in chips)
Seat 5: HJ ($4.46 in chips)
Seat 6: CO ($1.91 in chips)
SB: posts small blind $0.01
BB: posts big blind $0.02
*** HOLE CARDS ***
UTG: folds
HJ: folds
CO: folds
BTN: folds
SB: calls $0.01
BB: checks
*** FLOP *** [9h Jd 7d]
SB: checks
BB: bets $0.03
SB: calls $0.03
*** TURN *** [9h Jd 7d] [4c]
SB: checks
BB: bets $0.03
SB: calls $0.03
*** RIVER *** [9h Jd 7d 4c] [8c]
SB: checks
BB: bets $0.11
SB: folds
Uncalled bet ($0.11) returned to BB
BB collected $0.15 from pot
*** SUMMARY ***
Total pot $0.16 | Rake $0.01
Board [9h Jd 7d 4c 8c]
Seat 1: BTN (button) folded before Flop (didn't bet)
Seat 2: SB (small blind) folded on the River
Seat 3: BB (big blind) collected ($0.15)
Seat 4: UTG folded before Flop (didn't bet)
Seat 5: HJ folded before Flop (didn't bet)
Seat 6: CO folded before Flop (didn't bet)


PokerStars Hand #238161720532:  Hold'em No Limit ($0.01/$0.02 USD) - 2022/08/23 1:09:46 ET
Table 'Achilles IV' 6-max Seat #2 is the button
Seat 1: CO ($2.21 in chips)
Seat 2: BTN ($0.55 in chips)
Seat 3: SB ($2.16 in chips)
Seat 4: BB ($2.85 in chips)
Seat 5: UTG ($4.46 in chips)
Seat 6: HJ ($1.91 in chips)
SB: posts small blind $0.01
BB: posts big blind $0.02
*** HOLE CARDS ***
UTG: folds
HJ: folds
CO: folds
BTN: folds
SB: raises $0.04 to $0.06
BB: folds
Uncalled bet ($0.04) returned to SB
SB collected $0.04 from pot
*** SUMMARY ***
Total pot $0.04 | Rake $0
Seat 1: CO folded before Flop (didn't bet)
Seat 2: BTN (button) folded before Flop (didn't bet)
Seat 3: SB (small blind) collected ($0.04)
Seat 4: BB (big blind) folded before Flop
Seat 5: UTG folded before Flop (didn't bet)
Seat 6: HJ folded before Flop (didn't bet)


PokerStars Hand #238161726303:  Hold'em No Limit ($0.01/$0.02 USD) - 2022/08/23 1:10:37 ET
Table 'Achilles IV' 6-max Seat #4 is the button
Seat 1: UTG ($2.21 in chips)
Seat 2: HJ ($0.49 in chips)
Seat 3: CO ($2.18 in chips)
Seat 4: BTN ($2.77 in chips)
Seat 5: SB ($4.40 in chips)
Seat 6: BB ($2.08 in chips)
SB: posts small blind $0.01
BB: posts big blind $0.02
*** HOLE CARDS ***
UTG: folds
HJ: folds
CO: raises $0.03 to $0.05
BTN: folds
SB: folds
BB: folds
Uncalled bet ($0.03) returned to CO
CO collected $0.05 from pot
*** SUMMARY ***
Total pot $0.05 | Rake $0
Seat 1: UTG folded before Flop (didn't bet)
Seat 2: HJ folded before Flop (didn't bet)
Seat 3: CO collected ($0.05)
Seat 4: BTN (button) folded before Flop (didn't bet)
Seat 5: SB (small blind) folded before Flop
Seat 6: BB (big blind) folded before Flop


PokerStars Hand #238161722476:  Hold'em No Limit ($0.01/$0.02 USD) - 2022/08/23 1:10:03 ET
Table 'Achilles IV' 6-max Seat #3 is the button
Seat 1: HJ ($2.21 in chips)
Seat 2: CO ($0.55 in chips)
Seat 3: BTN ($2.18 in chips)
Seat 4: SB ($2.83 in chips)
Seat 5: BB ($4.46 in chips)
Seat 6: UTG ($1.91 in chips)
SB: posts small blind $0.01
BB: posts big blind $0.02
*** HOLE CARDS ***
UTG: raises $0.04 to $0.06
HJ: folds
CO: calls $0.06
BTN: folds
SB: calls $0.05
BB: calls $0.04
*** FLOP *** [2c 5s Ah]
SB: checks
BB: checks
UTG: bets $0.15
CO: folds
SB: folds
BB: folds
Uncalled bet ($0.15) returned to UTG
UTG collected $0.23 from pot
UTG: doesn't show hand
*** SUMMARY ***
Total pot $0.24 | Rake $0.01
Board [2c 5s Ah]
Seat 1: HJ folded before Flop (didn't bet)
Seat 2: CO folded on the Flop
Seat 3: BTN (button) folded before Flop (didn't bet)
Seat 4: SB (small blind) folded on the Flop
Seat 5: BB (big blind) folded on the Flop
Seat 6: UTG collected ($0.23)


PokerStars Hand #238161732190:  Hold'em No Limit ($0.01/$0.02 USD) - 2022/08/23 1:11:30 ET
Table 'Achilles IV' 6-max Seat #6 is the button
Seat 1: SB ($2.11 in chips)
Seat 2: BB ($0.49 in chips)
Seat 3: UTG ($2.21 in chips)
Seat 4: HJ ($2.87 in chips)
Seat 5: CO ($4.39 in chips)
Seat 6: BTN ($2.05 in chips)
SB: posts small blind $0.01
BB: posts big blind $0.02
*** HOLE CARDS ***
UTG: folds
HJ: folds
CO: folds
BTN: folds
SB: folds
Uncalled bet ($0.01) returned to BB
BB collected $0.02 from pot
*** SUMMARY ***
Total pot $0.02 | Rake $0
Seat 1: SB (small blind) folded before Flop
Seat 2: BB (big blind) collected ($0.02)
Seat 3: UTG folded before Flop (didn't bet)
Seat 4: HJ folded before Flop (didn't bet)
Seat 5: CO folded before Flop (didn't bet)
Seat 6: BTN (button) folded before Flop (didn't bet)


PokerStars Hand #238161728335:  Hold'em No Limit ($0.01/$0.02 USD) - 2022/08/23 1:10:55 ET
Table 'Achilles IV' 6-max Seat #5 is the button
Seat 1: BB ($2.21 in chips)
Seat 2: UTG ($0.49 in chips)
Seat 3: HJ ($2.21 in chips)
Seat 4: CO ($2.77 in chips)
Seat 5: BTN ($4.39 in chips)
Seat 6: SB ($2.06 in chips)
SB: posts small blind $0.01
BB: posts big blind $0.02
*** HOLE CARDS ***
UTG: folds
HJ: folds
CO: raises $0.02 to $0.04
BTN: folds
SB: folds
BB: calls $0.02
*** FLOP *** [8c Td 8h]
BB: checks
CO: bets $0.06
BB: calls $0.06
*** TURN *** [8c Td 8h] [4h]
BB: checks
CO: bets $0.16
BB: folds
Uncalled bet ($0.16) returned to CO
CO collected $0.20 from pot
CO: doesn't show hand
*** SUMMARY ***
Total pot $0.21 | Rake $0.01
Board [8c Td 8h 4h]
Seat 1: BB (big blind) folded on the Turn
Seat 2: UTG folded before Flop (didn't bet)
Seat 3: HJ folded before Flop (didn't bet)
Seat 4: CO collected ($0.20)
Seat 5: BTN (button) folded before Flop (didn't bet)
Seat 6: SB (small blind) folded before Flop


PokerStars Hand #238161733529:  Hold'em No Limit ($0.01/$0.02 USD) - 2022/08/23 1:11:42 ET
Table 'Achilles IV' 6-max Seat #1 is the button
Seat 1: BTN ($2.10 in chips)
Seat 2: SB ($0.50 in chips)
Seat 3: BB ($2.21 in chips)
Seat 4: UTG ($2.87 in chips)
Seat 5: HJ ($4.39 in chips)
Seat 6: CO ($2.05 in chips)
SB: posts small blind $0.01
BB: posts big blind $0.02
*** HOLE CARDS ***
UTG: raises $0.04 to $0.06
HJ: folds
CO: folds
BTN: folds
SB: folds
BB: calls $0.04
*** FLOP *** [Qd 6d Qc]
BB: checks
UTG: checks
*** TURN *** [Qd 6d Qc] [Js]
BB: checks
UTG: checks
*** RIVER *** [Qd 6d Qc Js] [7d]
BB: checks
UTG: checks
*** SHOW DOWN ***
BB: shows [Jc 9c] (two pair, Queens and Jacks)
UTG: mucks hand
BB collected $0.13 from pot
*** SUMMARY ***
Total pot $0.13 | Rake $0
Board [Qd 6d Qc Js 7d]
Seat 1: BTN (button) folded before Flop (didn't bet)
Seat 2: SB (small blind) folded before Flop
Seat 3: BB (big blind) showed [Jc 9c] and won ($0.13) with two pair, Queens and Jacks
Seat 4: UTG mucked
Seat 5: HJ folded before Flop (didn't bet)
Seat 6: CO folded before Flop (didn't bet)


PokerStars Hand #238161738339:  Hold'em No Limit ($0.01/$0.02 USD) - 2022/08/23 1:12:26 ET
Table 'Achilles IV' 6-max Seat #2 is the button
Seat 1: CO ($2.10 in chips)
Seat 2: BTN ($0.49 in chips)
Seat 3: SB ($2.28 in chips)
Seat 4: BB ($2.81 in chips)
Seat 5: UTG ($4.39 in chips)
Seat 6: HJ ($2.05 in chips)
SB: posts small blind $0.01
BB: posts big blind $0.02
*** HOLE CARDS ***
UTG: folds
HJ: folds
CO: folds
BTN: folds
SB: raises $0.04 to $0.06
BB: folds
Uncalled bet ($0.04) returned to SB
SB collected $0.04 from pot
*** SUMMARY ***
Total pot $0.04 | Rake $0
Seat 1: CO folded before Flop (didn't bet)
Seat 2: BTN (button) folded before Flop (didn't bet)
Seat 3: SB (small blind) collected ($0.04)
Seat 4: BB (big blind) folded before Flop
Seat 5: UTG folded before Flop (didn't bet)
Seat 6: HJ folded before Flop (didn't bet)


PokerStars Hand #238161740586:  Hold'em No Limit ($0.01/$0.02 USD) - 2022/08/23 1:12:46 ET
Table 'Achilles IV' 6-max Seat #3 is the button
Seat 1: HJ ($2.10 in chips)
Seat 2: CO ($0.49 in chips)
Seat 3: BTN ($2.30 in chips)
Seat 4: SB ($2.79 in chips)
Seat 5: BB ($4.39 in chips)
Seat 6: UTG ($2.05 in chips)
SB: posts small blind $0.01
BB: posts big blind $0.02
*** HOLE CARDS ***
UTG: folds
HJ: folds
CO: folds
BTN: folds
SB: raises $0.02 to $0.04
BB: folds
Uncalled bet ($0.02) returned to SB
SB collected $0.04 from pot
SB: doesn't show hand
*** SUMMARY ***
Total pot $0.04 | Rake $0
Seat 1: HJ folded before Flop (didn't bet)
Seat 2: CO folded before Flop (didn't bet)
Seat 3: BTN (button) folded before Flop (didn't bet)
Seat 4: SB (small blind) collected ($0.04)
Seat 5: BB (big blind) folded before Flop
Seat 6: UTG folded before Flop (didn't bet)


PokerStars Hand #238161742574:  Hold'em No Limit ($0.01/$0.02 USD) - 2022/08/23 1:13:05 ET
Table 'Achilles IV' 6-max Seat #4 is the button
Seat 1: UTG ($2.10 in chips)
Seat 2: HJ ($0.49 in chips)
Seat 3: CO ($2.30 in chips)
Seat 4: BTN ($2.81 in chips)
Seat 5: SB ($4.37 in chips)
Seat 6: BB ($2.05 in chips)
SB: posts small blind $0.01
BB: posts big blind $0.02
*** HOLE CARDS ***
UTG: folds
HJ: calls $0.02
CO: folds
BTN: calls $0.02
SB: folds
BB: raises $0.10 to $0.12
HJ: calls $0.10
BTN: folds
*** FLOP *** [7s As 6s]
BB: bets $1.93 and is all-in
HJ: calls $0.37 and is all-in
Uncalled bet ($1.56) returned to BB
*** TURN *** [7s As 6s] [8d]
*** RIVER *** [7s As 6s 8d] [6h]
*** SHOW DOWN ***
BB: shows [Js Jh] (two pair, Jacks and Sixes)
HJ: shows [4d Ad] (two pair, Aces and Sixes)
HJ collected $0.97 from pot
BB cashed out the hand for $0.42
*** SUMMARY ***
Total pot $1.01 | Rake $0.04
Board [7s As 6s 8d 6h]
Seat 1: UTG folded before Flop (didn't bet)
Seat 2: HJ showed [4d Ad] and won ($0.97) with two pair, Aces and Sixes
Seat 3: CO folded before Flop (didn't bet)
Seat 4: BTN (button) folded before Flop
Seat 5: SB (small blind) folded before Flop
Seat 6: BB (big blind) showed [Js Jh] and lost with two pair, Jacks and Sixes (cashed out).


PokerStars Hand #238161749121:  Hold'em No Limit ($0.01/$0.02 USD) - 2022/08/23 1:14:05 ET
Table 'Achilles IV' 6-max Seat #5 is the button
Seat 1: BB ($2.10 in chips)
Seat 2: UTG ($0.97 in chips)
Seat 3: HJ ($2.30 in chips)
Seat 4: CO ($2.79 in chips)
Seat 5: BTN ($4.36 in chips)
Seat 6: SB ($1.98 in chips)
SB: posts small blind $0.01
BB: posts big blind $0.02
*** HOLE CARDS ***
UTG: folds
HJ: folds
CO: calls $0.02
BTN: folds
SB: folds
BB: checks
*** FLOP *** [5s 5c 3s]
BB: checks
CO: checks
*** TURN *** [5s 5c 3s] [8h]
BB: checks
CO: checks
*** RIVER *** [5s 5c 3s 8h] [4h]
BB: checks
CO: checks
*** SHOW DOWN ***
BB: shows [6s Ts] (a pair of Fives)
CO: shows [Kh 6d] (a pair of Fives - King kicker)
CO collected $0.05 from pot
*** SUMMARY ***
Total pot $0.05 | Rake $0
Board [5s 5c 3s 8h 4h]
Seat 1: BB (big blind) showed [6s Ts] and lost with a pair of Fives
Seat 2: UTG folded before Flop (didn't bet)
Seat 3: HJ folded before Flop (didn't bet)
Seat 4: CO showed [Kh 6d] and won ($0.05) with a pair of Fives
Seat 5: BTN (button) folded before Flop (didn't bet)
Seat 6: SB (small blind) folded before Flop


PokerStars Hand #238161753532:  Hold'em No Limit ($0.01/$0.02 USD) - 2022/08/23 1:14:46 ET
Table 'Achilles IV' 6-max Seat #6 is the button
Seat 1: SB ($2.08 in chips)
Seat 2: BB ($0.97 in chips)
Seat 3: UTG ($2.30 in chips)
Seat 4: HJ ($2.82 in chips)
Seat 5: CO ($4.36 in chips)
Seat 6: BTN ($1.97 in chips)
SB: posts small blind $0.01
BB: posts big blind $0.02
*** HOLE CARDS ***
UTG: folds
HJ: folds
CO: folds
BTN: raises $0.04 to $0.06
SB: folds
BB: folds
Uncalled bet ($0.04) returned to BTN
BTN collected $0.05 from pot
BTN: doesn't show hand
*** SUMMARY ***
Total pot $0.05 | Rake $0
Seat 1: SB (small blind) folded before Flop
Seat 2: BB (big blind) folded before Flop
Seat 3: UTG folded before Flop (didn't bet)
Seat 4: HJ folded before Flop (didn't bet)
Seat 5: CO folded before Flop (didn't bet)
Seat 6: BTN (button) collected ($0.05)


PokerStars Hand #238161756143:  Hold'em No Limit ($0.01/$0.02 USD) - 2022/08/23 1:15:10 ET
Table 'Achilles IV' 6-max Seat #1 is the button
Seat 1: BTN ($2.07 in chips)
Seat 2: SB ($0.95 in chips)
Seat 3: BB ($2.30 in chips)
Seat 4: UTG ($2.82 in chips)
Seat 5: HJ ($4.36 in chips)
Seat 6: CO ($2 in chips)
SB: posts small blind $0.01
BB: posts big blind $0.02
*** HOLE CARDS ***
UTG: calls $0.02
HJ: folds
CO: folds
BTN: folds
SB: folds
BB: checks
*** FLOP *** [7h 8c 3s]
BB: checks
UTG: checks
*** TURN *** [7h 8c 3s] [Qc]
BB: checks
UTG: checks
*** RIVER *** [7h 8c 3s Qc] [7s]
BB: checks
UTG: checks
*** SHOW DOWN ***
BB: shows [4d Kh] (a pair of Sevens)
UTG: mucks hand
BB collected $0.05 from pot
*** SUMMARY ***
Total pot $0.05 | Rake $0
Board [7h 8c 3s Qc 7s]
Seat 1: BTN (button) folded before Flop (didn't bet)
Seat 2: SB (small blind) folded before Flop
Seat 3: BB (big blind) showed [4d Kh] and won ($0.05) with a pair of Sevens
Seat 4: UTG mucked
Seat 5: HJ folded before Flop (didn't bet)
Seat 6: CO folded before Flop (didn't bet)


PokerStars Hand #238161759802:  Hold'em No Limit ($0.01/$0.02 USD) - 2022/08/23 1:15:45 ET
Table 'Achilles IV' 6-max Seat #2 is the button
Seat 1: CO ($2.07 in chips)
Seat 2: BTN ($0.94 in chips)
Seat 3: SB ($2.33 in chips)
Seat 4: BB ($2.80 in chips)
Seat 5: UTG ($4.36 in chips)
Seat 6: HJ ($2 in chips)
SB: posts small blind $0.01
BB: posts big blind $0.02
*** HOLE CARDS ***
UTG: folds
HJ has timed out
HJ: folds
CO: folds
BTN: calls $0.02
SB: folds
BB: checks
*** FLOP *** [Tc 9h 5d]
BB: bets $0.04
BTN: calls $0.04
*** TURN *** [Tc 9h 5d] [Qd]
BB: checks
BTN: checks
*** RIVER *** [Tc 9h 5d Qd] [4c]
BB: bets $0.06
BTN: calls $0.06
*** SHOW DOWN ***
BB: shows [Td 3h] (a pair of Tens)
BTN: mucks hand
BB collected $0.24 from pot
*** SUMMARY ***
Total pot $0.25 | Rake $0.01
Board [Tc 9h 5d Qd 4c]
Seat 1: CO folded before Flop (didn't bet)
Seat 2: BTN (button) mucked
Seat 3: SB (small blind) folded before Flop
Seat 4: BB (big blind) showed [Td 3h] and won ($0.24) with a pair of Tens
Seat 5: UTG folded before Flop (didn't bet)
Seat 6: HJ folded before Flop (didn't bet)


PokerStars Hand #238161765751:  Hold'em No Limit ($0.01/$0.02 USD) - 2022/08/23 1:16:40 ET
Table 'Achilles IV' 6-max Seat #3 is the button
Seat 1: HJ ($2.07 in chips)
Seat 2: CO ($0.82 in chips)
Seat 3: BTN ($2.32 in chips)
Seat 4: SB ($2.92 in chips)
Seat 5: BB ($4.36 in chips)
Seat 6: UTG ($2 in chips)
SB: posts small blind $0.01
BB: posts big blind $0.02
*** HOLE CARDS ***
UTG: raises $0.04 to $0.06
HJ: folds
CO: folds
BTN: folds
SB: folds
BB: folds
Uncalled bet ($0.04) returned to UTG
UTG collected $0.05 from pot
UTG: doesn't show hand
*** SUMMARY ***
Total pot $0.05 | Rake $0
Seat 1: HJ folded before Flop (didn't bet)
Seat 2: CO folded before Flop (didn't bet)
Seat 3: BTN (button) folded before Flop (didn't bet)
Seat 4: SB (small blind) folded before Flop
Seat 5: BB (big blind) folded before Flop
Seat 6: UTG collected ($0.05)


PokerStars Hand #238161767552:  Hold'em No Limit ($0.01/$0.02 USD) - 2022/08/23 1:16:57 ET
Table 'Achilles IV' 6-max Seat #4 is the button
Seat 1: UTG ($2.07 in chips)
Seat 2: HJ ($0.82 in chips)
Seat 3: CO ($2.32 in chips)
Seat 4: BTN ($2.91 in chips)
Seat 5: SB ($4.34 in chips)
Seat 6: BB ($2.03 in chips)
SB: posts small blind $0.01
BB: posts big blind $0.02
*** HOLE CARDS ***
UTG: folds
HJ: folds
CO: folds
BTN: calls $0.02
SB: folds
BB: checks
*** FLOP *** [5h Tc 5d]
BB: checks
BTN: checks
*** TURN *** [5h Tc 5d] [Qd]
BB: checks
BTN: bets $0.04
BB: folds
Uncalled bet ($0.04) returned to BTN
BB leaves the table
BTN collected $0.05 from pot
BTN: doesn't show hand
*** SUMMARY ***
Total pot $0.05 | Rake $0
Board [5h Tc 5d Qd]
Seat 1: UTG folded before Flop (didn't bet)
Seat 2: HJ folded before Flop (didn't bet)
Seat 3: CO folded before Flop (didn't bet)
Seat 4: BTN (button) collected ($0.05)
Seat 5: SB (small blind) folded before Flop
Seat 6: BB (big blind) folded on the Turn


PokerStars Hand #238161771746:  Hold'em No Limit ($0.01/$0.02 USD) - 2022/08/23 1:17:36 ET
Table 'Achilles IV' 6-max Seat #5 is the button
Seat 1: SB ($2.07 in chips)
Seat 2: BB ($0.82 in chips)
Seat 4: CO ($2.94 in chips)
Seat 5: BTN ($4.33 in chips)
SB: posts small blind $0.01
BB: posts big blind $0.02
*** HOLE CARDS ***
CO: calls $0.02
BTN: folds
SB: raises $0.06 to $0.08
BB: folds
CO: folds
Uncalled bet ($0.06) returned to SB
SB collected $0.06 from pot
*** SUMMARY ***
Total pot $0.06 | Rake $0
Seat 1: SB (small blind) collected ($0.06)
Seat 2: BB (big blind) folded before Flop
Seat 4: CO folded before Flop
Seat 5: BTN (button) folded before Flop (didn't bet)


PokerStars Hand #238161773371:  Hold'em No Limit ($0.01/$0.02 USD) - 2022/08/23 1:17:51 ET
Table 'Achilles IV' 6-max Seat #1 is the button
Seat 1: BTN ($2.11 in chips)
Seat 2: SB ($0.80 in chips)
Seat 4: BB ($2.92 in chips)
Seat 5: CO ($4.33 in chips)
SB: posts small blind $0.01
BB: posts big blind $0.02
*** HOLE CARDS ***
CO: folds
BTN: folds
SB: calls $0.01
BB: checks
*** FLOP *** [Ad Jh 4c]
SB: checks
BB: checks
*** TURN *** [Ad Jh 4c] [4d]
SB: checks
BB: checks
*** RIVER *** [Ad Jh 4c 4d] [Qs]
SB: bets $0.04
BB: raises $0.08 to $0.12
SB: folds
Uncalled bet ($0.08) returned to BB
BB collected $0.12 from pot
BB: doesn't show hand
*** SUMMARY ***
Total pot $0.12 | Rake $0
Board [Ad Jh 4c 4d Qs]
Seat 1: BTN (button) folded before Flop (didn't bet)
Seat 2: SB (small blind) folded on the River
Seat 4: BB (big blind) collected ($0.12)
Seat 5: CO folded before Flop (didn't bet)


PokerStars Hand #238161777897:  Hold'em No Limit ($0.01/$0.02 USD) - 2022/08/23 1:18:33 ET
Table 'Achilles IV' 6-max Seat #2 is the button
Seat 1: CO ($2.11 in chips)
Seat 2: BTN ($0.74 in chips)
Seat 4: SB ($2.98 in chips)
Seat 5: BB ($4.33 in chips)
SB: posts small blind $0.01
BB: posts big blind $0.02
*** HOLE CARDS ***
CO: folds
BTN: folds
SB: raises $0.02 to $0.04
BB: calls $0.02
*** FLOP *** [Qs 8d Ah]
SB: bets $0.04
BB: folds
Uncalled bet ($0.04) returned to SB
SB collected $0.08 from pot
SB: doesn't show hand
*** SUMMARY ***
Total pot $0.08 | Rake $0
Board [Qs 8d Ah]
Seat 1: CO folded before Flop (didn't bet)
Seat 2: BTN (button) folded before Flop (didn't bet)
Seat 4: SB (small blind) collected ($0.08)
Seat 5: BB (big blind) folded on the Flop


PokerStars Hand #238161779827:  Hold'em No Limit ($0.01/$0.02 USD) - 2022/08/23 1:18:52 ET
Table 'Achilles IV' 6-max Seat #4 is the button
Seat 1: BB ($2.11 in chips)
Seat 2: CO ($0.74 in chips)
Seat 4: BTN ($3.02 in chips)
Seat 5: SB ($4.29 in chips)
SB: posts small blind $0.01
BB: posts big blind $0.02
*** HOLE CARDS ***
azall joins the table at seat #6
CO: calls $0.02
BTN: folds
SB: folds
BB: checks
*** FLOP *** [Ks 8h Kh]
BB: checks
CO: checks
*** TURN *** [Ks 8h Kh] [Ac]
BB: checks
CO: checks
*** RIVER *** [Ks 8h Kh Ac] [Ts]
BB: checks
CO: checks
*** SHOW DOWN ***
BB: shows [9c 4c] (a pair of Kings)
CO: shows [Qs 2s] (a pair of Kings - Ace+Queen kicker)
CO collected $0.05 from pot
*** SUMMARY ***
Total pot $0.05 | Rake $0
Board [Ks 8h Kh Ac Ts]
Seat 1: BB (big blind) showed [9c 4c] and lost with a pair of Kings
Seat 2: CO showed [Qs 2s] and won ($0.05) with a pair of Kings
Seat 4: BTN (button) folded before Flop (didn't bet)
Seat 5: SB (small blind) folded before Flop


PokerStars Hand #238161783078:  Hold'em No Limit ($0.01/$0.02 USD) - 2022/08/23 1:19:23 ET
Table 'Achilles IV' 6-max Seat #5 is the button
Seat 1: SB ($2.09 in chips)
Seat 2: BB ($0.77 in chips)
Seat 3: HJ ($2.32 in chips)
Seat 4: CO ($3.02 in chips)
Seat 5: BTN ($4.28 in chips)
SB: posts small blind $0.01
BB: posts big blind $0.02
HJ: posts small & big blinds $0.03
*** HOLE CARDS ***
HJ: checks
CO: folds
BTN: folds
SB: folds
BB: checks
*** FLOP *** [Qs Ad 4s]
BB: checks
HJ: checks
*** TURN *** [Qs Ad 4s] [Ks]
BB: checks
HJ: bets $0.08
BB: raises $0.08 to $0.16
HJ: calls $0.08
*** RIVER *** [Qs Ad 4s Ks] [Qd]
BB: bets $0.18
HJ: calls $0.18
*** SHOW DOWN ***
BB: shows [Kd 8s] (two pair, Kings and Queens)
HJ: shows [As 4d] (two pair, Aces and Queens)
HJ collected $0.71 from pot
*** SUMMARY ***
Total pot $0.74 | Rake $0.03
Board [Qs Ad 4s Ks Qd]
Seat 1: SB (small blind) folded before Flop
Seat 2: BB (big blind) showed [Kd 8s] and lost with two pair, Kings and Queens
Seat 3: HJ showed [As 4d] and won ($0.71) with two pair, Aces and Queens
Seat 4: CO folded before Flop (didn't bet)
Seat 5: BTN (button) folded before Flop (didn't bet)


PokerStars Hand #238161786582:  Hold'em No Limit ($0.01/$0.02 USD) - 2022/08/23 1:19:55 ET
Table 'Achilles IV' 6-max Seat #1 is the button
Seat 1: BTN ($2.08 in chips)
Seat 2: SB ($0.41 in chips)
Seat 3: BB ($2.66 in chips)
Seat 4: HJ ($3.02 in chips)
Seat 5: CO ($4.28 in chips)
SB: posts small blind $0.01
BB: posts big blind $0.02
azall: sits out
*** HOLE CARDS ***
HJ: folds
CO: folds
BTN: folds
SB: raises $0.04 to $0.06
BB: raises $0.15 to $0.21
SB: raises $0.20 to $0.41 and is all-in
BB: calls $0.20
*** FLOP *** [4c Ks 3c]
*** TURN *** [4c Ks 3c] [7c]
*** RIVER *** [4c Ks 3c 7c] [9c]
*** SHOW DOWN ***
SB: shows [8d 8c] (a flush, Nine high)
BB: shows [Ac Ah] (a flush, Ace high)
BB collected $0.79 from pot
*** SUMMARY ***
Total pot $0.82 | Rake $0.03
Board [4c Ks 3c 7c 9c]
Seat 1: BTN (button) folded before Flop (didn't bet)
Seat 2: SB (small blind) showed [8d 8c] and lost with a flush, Nine high
Seat 3: BB (big blind) showed [Ac Ah] and won ($0.79) with a flush, Ace high
Seat 4: HJ folded before Flop (didn't bet)
Seat 5: CO folded before Flop (didn't bet)


PokerStars Hand #238161789995:  Hold'em No Limit ($0.01/$0.02 USD) - 2022/08/23 1:20:27 ET
Table 'Achilles IV' 6-max Seat #3 is the button
Seat 1: CO ($2.08 in chips)
Seat 3: BTN ($3.04 in chips)
Seat 4: SB ($3.02 in chips)
Seat 5: BB ($4.28 in chips)
SB: posts small blind $0.01
BB: posts big blind $0.02
azall: sits out
*** HOLE CARDS ***
CO: folds
BTN: folds
0.zika leaves the table
SB: calls $0.01
BB: checks
*** FLOP *** [4s 7d 7c]
SB: checks
BB: checks
*** TURN *** [4s 7d 7c] [Kh]
SB: checks
BB: checks
*** RIVER *** [4s 7d 7c Kh] [5h]
SB: bets $0.04
BB: folds
Uncalled bet ($0.04) returned to SB
SB collected $0.04 from pot
SB: doesn't show hand
*** SUMMARY ***
Total pot $0.04 | Rake $0
Board [4s 7d 7c Kh 5h]
Seat 1: CO folded before Flop (didn't bet)
Seat 3: BTN (button) folded before Flop (didn't bet)
Seat 4: SB (small blind) collected ($0.04)
Seat 5: BB (big blind) folded on the River


PokerStars Hand #238161793990:  Hold'em No Limit ($0.01/$0.02 USD) - 2022/08/23 1:21:04 ET
Table 'Achilles IV' 6-max Seat #4 is the button
Seat 1: HJ ($2.08 in chips)
Seat 3: CO ($3.04 in chips)
Seat 4: BTN ($3.04 in chips)
Seat 5: SB ($4.26 in chips)
Seat 6: BB ($2 in chips)
SB: posts small blind $0.01
BB: posts big blind $0.02
*** HOLE CARDS ***
HJ: folds
CO: folds
BTN: folds
SB: raises $0.04 to $0.06
BB: folds
Uncalled bet ($0.04) returned to SB
SB collected $0.04 from pot
SB: doesn't show hand
*** SUMMARY ***
Total pot $0.04 | Rake $0
Seat 1: HJ folded before Flop (didn't bet)
Seat 3: CO folded before Flop (didn't bet)
Seat 4: BTN (button) folded before Flop (didn't bet)
Seat 5: SB (small blind) collected ($0.04)
Seat 6: BB (big blind) folded before Flop


PokerStars Hand #238161795265:  Hold'em No Limit ($0.01/$0.02 USD) - 2022/08/23 1:21:17 ET
Table 'Achilles IV' 6-max Seat #5 is the button
Seat 1: BB ($2.08 in chips)
Seat 3: HJ ($3.04 in chips)
Seat 4: CO ($3.04 in chips)
Seat 5: BTN ($4.28 in chips)
Seat 6: SB ($2 in chips)
SB: posts small blind $0.01
BB: posts big blind $0.02
*** HOLE CARDS ***
HJ: folds
CO: calls $0.02
BTN: folds
SB: folds
BB: checks
*** FLOP *** [Kc 6s 8c]
SnahGod joins the table at seat #2
BB: checks
CO: checks
*** TURN *** [Kc 6s 8c] [As]
BB: checks
CO: checks
*** RIVER *** [Kc 6s 8c As] [2h]
BB: checks
CO: checks
*** SHOW DOWN ***
BB: shows [4s 7c] (high card Ace)
CO: shows [Tc Js] (high card Ace - King+Jack kicker)
CO collected $0.05 from pot
*** SUMMARY ***
Total pot $0.05 | Rake $0
Board [Kc 6s 8c As 2h]
Seat 1: BB (big blind) showed [4s 7c] and lost with high card Ace
Seat 3: HJ folded before Flop (didn't bet)
Seat 4: CO showed [Tc Js] and won ($0.05) with high card Ace
Seat 5: BTN (button) folded before Flop (didn't bet)
Seat 6: SB (small blind) folded before Flop


PokerStars Hand #238161799419:  Hold'em No Limit ($0.01/$0.02 USD) - 2022/08/23 1:21:56 ET
Table 'Achilles IV' 6-max Seat #6 is the button
Seat 1: SB ($2.06 in chips)
Seat 2: BB ($1.60 in chips)
Seat 3: UTG ($3.04 in chips)
Seat 4: HJ ($3.07 in chips)
Seat 5: CO ($4.28 in chips)
Seat 6: BTN ($2 in chips)
SB: posts small blind $0.01
BB: posts big blind $0.02
*** HOLE CARDS ***
UTG: folds
HJ: folds
CO: raises $0.03 to $0.05
BTN: folds
SB: raises $0.17 to $0.22
BB: folds
CO: raises $0.28 to $0.50
SB: calls $0.28
*** FLOP *** [Ks Qs Jh]
SB: checks
CO: checks
*** TURN *** [Ks Qs Jh] [9h]
SB: bets $1.56 and is all-in
CO: folds
Uncalled bet ($1.56) returned to SB
SB collected $0.98 from pot
*** SUMMARY ***
Total pot $1.02 | Rake $0.04
Board [Ks Qs Jh 9h]
Seat 1: SB (small blind) collected ($0.98)
Seat 2: BB (big blind) folded before Flop
Seat 3: UTG folded before Flop (didn't bet)
Seat 4: HJ folded before Flop (didn't bet)
Seat 5: CO folded on the Turn
Seat 6: BTN (button) folded before Flop (didn't bet)


PokerStars Hand #238161804858:  Hold'em No Limit ($0.01/$0.02 USD) - 2022/08/23 1:22:47 ET
Table 'Achilles IV' 6-max Seat #1 is the button
Seat 1: BTN ($2.54 in chips)
Seat 2: SB ($1.58 in chips)
Seat 3: BB ($3.04 in chips)
Seat 4: UTG ($3.07 in chips)
Seat 5: HJ ($3.78 in chips)
Seat 6: CO ($2 in chips)
SB: posts small blind $0.01
BB: posts big blind $0.02
*** HOLE CARDS ***
UTG: calls $0.02
HJ: raises $0.06 to $0.08
CO: folds
BTN: folds
SB: calls $0.07
BB: folds
UTG: folds
*** FLOP *** [Td 5c 2c]
SB: bets $0.10
HJ: raises $0.26 to $0.36
SB: raises $1.14 to $1.50 and is all-in
HJ: folds
Uncalled bet ($1.14) returned to SB
SB collected $0.89 from pot
SB: doesn't show hand
*** SUMMARY ***
Total pot $0.92 | Rake $0.03
Board [Td 5c 2c]
Seat 1: BTN (button) folded before Flop (didn't bet)
Seat 2: SB (small blind) collected ($0.89)
Seat 3: BB (big blind) folded before Flop
Seat 4: UTG folded before Flop
Seat 5: HJ folded on the Flop
Seat 6: CO folded before Flop (didn't bet)


PokerStars Hand #238161809756:  Hold'em No Limit ($0.01/$0.02 USD) - 2022/08/23 1:23:32 ET
Table 'Achilles IV' 6-max Seat #2 is the button
Seat 1: CO ($2.54 in chips)
Seat 2: BTN ($2.03 in chips)
Seat 3: SB ($3.02 in chips)
Seat 4: BB ($3.05 in chips)
Seat 5: UTG ($3.34 in chips)
Seat 6: HJ ($2 in chips)
SB: posts small blind $0.01
BB: posts big blind $0.02
*** HOLE CARDS ***
UTG: folds
HJ: folds
CO: folds
BTN: calls $0.02
SB: folds
BB: checks
*** FLOP *** [5d 8d Ah]
BB: checks
BTN: checks
*** TURN *** [5d 8d Ah] [Kh]
BB: checks
BTN: checks
*** RIVER *** [5d 8d Ah Kh] [7c]
BB: checks
BTN: bets $0.04
BB: folds
Uncalled bet ($0.04) returned to BTN
BTN collected $0.05 from pot
BTN: doesn't show hand
*** SUMMARY ***
Total pot $0.05 | Rake $0
Board [5d 8d Ah Kh 7c]
Seat 1: CO folded before Flop (didn't bet)
Seat 2: BTN (button) collected ($0.05)
Seat 3: SB (small blind) folded before Flop
Seat 4: BB (big blind) folded on the River
Seat 5: UTG folded before Flop (didn't bet)
Seat 6: HJ folded before Flop (didn't bet)


PokerStars Hand #238161813397:  Hold'em No Limit ($0.01/$0.02 USD) - 2022/08/23 1:24:07 ET
Table 'Achilles IV' 6-max Seat #3 is the button
Seat 1: HJ ($2.54 in chips)
Seat 2: CO ($2.06 in chips)
Seat 3: BTN ($3.01 in chips)
Seat 4: SB ($3.03 in chips)
Seat 5: BB ($3.34 in chips)
Seat 6: UTG ($2 in chips)
SB: posts small blind $0.01
BB: posts big blind $0.02
*** HOLE CARDS ***
UTG: folds
HJ: raises $0.03 to $0.05
CO: calls $0.05
BTN: folds
SB: calls $0.04
BB: folds
*** FLOP *** [2h 5c Qc]
SB: checks
HJ: checks
CO: bets $0.12
SB: folds
HJ: calls $0.12
*** TURN *** [2h 5c Qc] [As]
HJ: bets $0.27
CO: folds
Uncalled bet ($0.27) returned to HJ
HJ collected $0.40 from pot
*** SUMMARY ***
Total pot $0.41 | Rake $0.01
Board [2h 5c Qc As]
Seat 1: HJ collected ($0.40)
Seat 2: CO folded on the Turn
Seat 3: BTN (button) folded before Flop (didn't bet)
Seat 4: SB (small blind) folded on the Flop
Seat 5: BB (big blind) folded before Flop
Seat 6: UTG folded before Flop (didn't bet)


PokerStars Hand #238161823950:  Hold'em No Limit ($0.01/$0.02 USD) - 2022/08/23 1:24:57 ET
Table 'Achilles IV' 6-max Seat #4 is the button
Seat 1: UTG ($2.77 in chips)
Seat 2: HJ ($1.89 in chips)
Seat 3: CO ($3.01 in chips)
Seat 4: BTN ($2.98 in chips)
Seat 5: SB ($3.32 in chips)
Seat 6: BB ($2 in chips)
SB: posts small blind $0.01
BB: posts big blind $0.02
*** HOLE CARDS ***
UTG: folds
HJ: calls $0.02
CO: folds
BTN: folds
SB: raises $0.05 to $0.07
BB: raises $0.19 to $0.26
HJ: folds
SB: folds
Uncalled bet ($0.19) returned to BB
BB collected $0.16 from pot
*** SUMMARY ***
Total pot $0.16 | Rake $0
Seat 1: UTG folded before Flop (didn't bet)
Seat 2: HJ folded before Flop
Seat 3: CO folded before Flop (didn't bet)
Seat 4: BTN (button) folded before Flop (didn't bet)
Seat 5: SB (small blind) folded before Flop
Seat 6: BB (big blind) collected ($0.16)


PokerStars Hand #238161826978:  Hold'em No Limit ($0.01/$0.02 USD) - 2022/08/23 1:25:26 ET
Table 'Achilles IV' 6-max Seat #5 is the button
Seat 1: BB ($2.77 in chips)
Seat 2: UTG ($1.87 in chips)
Seat 3: HJ ($3.01 in chips)
Seat 4: CO ($2.98 in chips)
Seat 5: BTN ($3.25 in chips)
Seat 6: SB ($2.09 in chips)
SB: posts small blind $0.01
BB: posts big blind $0.02
*** HOLE CARDS ***
UTG: calls $0.02
HJ: raises $0.08 to $0.10
CO: calls $0.10
BTN: folds
SB: folds
BB: folds
UTG: calls $0.08
*** FLOP *** [8s 8d Jh]
UTG: checks
HJ: bets $0.11
CO: folds
UTG: folds
Uncalled bet ($0.11) returned to HJ
HJ collected $0.32 from pot
*** SUMMARY ***
Total pot $0.33 | Rake $0.01
Board [8s 8d Jh]
Seat 1: BB (big blind) folded before Flop
Seat 2: UTG folded on the Flop
Seat 3: HJ collected ($0.32)
Seat 4: CO folded on the Flop
Seat 5: BTN (button) folded before Flop (didn't bet)
Seat 6: SB (small blind) folded before Flop


PokerStars Hand #238161833632:  Hold'em No Limit ($0.01/$0.02 USD) - 2022/08/23 1:26:29 ET
Table 'Achilles IV' 6-max Seat #6 is the button
Seat 1: SB ($2.75 in chips)
Seat 2: BB ($1.77 in chips)
Seat 3: UTG ($3.23 in chips)
Seat 4: HJ ($2.88 in chips)
Seat 5: CO ($3.25 in chips)
Seat 6: BTN ($2.08 in chips)
SB: posts small blind $0.01
BB: posts big blind $0.02
*** HOLE CARDS ***
UTG: raises $0.03 to $0.05
HJ: folds
CO: folds
BTN: folds
SB: folds
BB: calls $0.03
*** FLOP *** [Jc 8h 6d]
BB: checks
UTG: bets $0.04
BB: calls $0.04
*** TURN *** [Jc 8h 6d] [Kc]
BB: checks
UTG: checks
*** RIVER *** [Jc 8h 6d Kc] [3h]
BB: bets $0.20
UTG: folds
Uncalled bet ($0.20) returned to BB
BB collected $0.18 from pot
BB: doesn't show hand
*** SUMMARY ***
Total pot $0.19 | Rake $0.01
Board [Jc 8h 6d Kc 3h]
Seat 1: SB (small blind) folded before Flop
Seat 2: BB (big blind) collected ($0.18)
Seat 3: UTG folded on the River
Seat 4: HJ folded before Flop (didn't bet)
Seat 5: CO folded before Flop (didn't bet)
Seat 6: BTN (button) folded before Flop (didn't bet)


PokerStars Hand #238161839618:  Hold'em No Limit ($0.01/$0.02 USD) - 2022/08/23 1:27:26 ET
Table 'Achilles IV' 6-max Seat #1 is the button
Seat 1: BTN ($2.74 in chips)
Seat 2: SB ($1.86 in chips)
Seat 3: BB ($3.14 in chips)
Seat 4: UTG ($2.88 in chips)
Seat 5: HJ ($3.25 in chips)
Seat 6: CO ($2.08 in chips)
SB: posts small blind $0.01
BB: posts big blind $0.02
*** HOLE CARDS ***
UTG: calls $0.02
HJ: folds
CO: folds
BTN: folds
SB: calls $0.01
BB: checks
*** FLOP *** [5c 5h 2c]
SB: checks
BB: checks
UTG: checks
*** TURN *** [5c 5h 2c] [Jh]
SB: checks
BB: checks
UTG: checks
*** RIVER *** [5c 5h 2c Jh] [2d]
SB: bets $0.06
BB: raises $0.26 to $0.32
UTG: folds
SB: raises $0.26 to $0.58
BB: raises $2.54 to $3.12 and is all-in
SB: calls $1.26 and is all-in
Uncalled bet ($1.28) returned to BB
*** SHOW DOWN ***
BB: shows [5d As] (a full house, Fives full of Deuces)
SB: shows [5s 8h] (a full house, Fives full of Deuces)
SB collected $1.81 from pot
BB collected $1.80 from pot
*** SUMMARY ***
Total pot $3.74 | Rake $0.13
Board [5c 5h 2c Jh 2d]
Seat 1: BTN (button) folded before Flop (didn't bet)
Seat 2: SB (small blind) showed [5s 8h] and won ($1.81) with a full house, Fives full of Deuces
Seat 3: BB (big blind) showed [5d As] and won ($1.80) with a full house, Fives full of Deuces
Seat 4: UTG folded on the River
Seat 5: HJ folded before Flop (didn't bet)
Seat 6: CO folded before Flop (didn't bet)


PokerStars Hand #238161851830:  Hold'em No Limit ($0.01/$0.02 USD) - 2022/08/23 1:28:30 ET
Table 'Achilles IV' 6-max Seat #2 is the button
Seat 1: CO ($2.74 in chips)
Seat 2: BTN ($1.81 in chips)
Seat 3: SB ($3.08 in chips)
Seat 4: BB ($2.86 in chips)
Seat 5: UTG ($3.25 in chips)
Seat 6: HJ ($2.08 in chips)
SB: posts small blind $0.01
BB: posts big blind $0.02
*** HOLE CARDS ***
UTG: raises $0.03 to $0.05
HJ: folds
CO: folds
BTN: calls $0.05
SB: folds
BB: calls $0.03
*** FLOP *** [8c 4d Tc]
BB: bets $0.06
UTG: folds
BTN: folds
Uncalled bet ($0.06) returned to BB
BB collected $0.15 from pot
BB: doesn't show hand
*** SUMMARY ***
Total pot $0.16 | Rake $0.01
Board [8c 4d Tc]
Seat 1: CO folded before Flop (didn't bet)
Seat 2: BTN (button) folded on the Flop
Seat 3: SB (small blind) folded before Flop
Seat 4: BB (big blind) collected ($0.15)
Seat 5: UTG folded on the Flop
Seat 6: HJ folded before Flop (didn't bet)


PokerStars Hand #238161857090:  Hold'em No Limit ($0.01/$0.02 USD) - 2022/08/23 1:29:21 ET
Table 'Achilles IV' 6-max Seat #3 is the button
Seat 1: HJ ($2.74 in chips)
Seat 2: CO ($1.76 in chips)
Seat 3: BTN ($3.07 in chips)
Seat 4: SB ($2.96 in chips)
Seat 5: BB ($3.20 in chips)
Seat 6: UTG ($2.08 in chips)
SB: posts small blind $0.01
BB: posts big blind $0.02
*** HOLE CARDS ***
UTG: folds
HJ: folds
CO: calls $0.02
BTN: folds
SB: folds
BB: checks
*** FLOP *** [Ac Ks 5s]
BB: checks
CO: bets $0.02
BB: calls $0.02
*** TURN *** [Ac Ks 5s] [9s]
BB: checks
CO: bets $0.10
BB: folds
Uncalled bet ($0.10) returned to CO
CO collected $0.09 from pot
CO: doesn't show hand
*** SUMMARY ***
Total pot $0.09 | Rake $0
Board [Ac Ks 5s 9s]
Seat 1: HJ folded before Flop (didn't bet)
Seat 2: CO collected ($0.09)
Seat 3: BTN (button) folded before Flop (didn't bet)
Seat 4: SB (small blind) folded before Flop
Seat 5: BB (big blind) folded on the Turn
Seat 6: UTG folded before Flop (didn't bet)


PokerStars Hand #238161861187:  Hold'em No Limit ($0.01/$0.02 USD) - 2022/08/23 1:30:01 ET
Table 'Achilles IV' 6-max Seat #4 is the button
Seat 1: UTG ($2.74 in chips)
Seat 2: HJ ($1.81 in chips)
Seat 3: CO ($3.07 in chips)
Seat 4: BTN ($2.95 in chips)
Seat 5: SB ($3.16 in chips)
Seat 6: BB ($2.08 in chips)
SB: posts small blind $0.01
BB: posts big blind $0.02
*** HOLE CARDS ***
UTG: folds
HJ: calls $0.02
CO: raises $0.08 to $0.10
BTN: calls $0.10
SB: folds
BB: folds
HJ: calls $0.08
*** FLOP *** [5d Kd Jd]
HJ: checks
CO: checks
BTN: checks
*** TURN *** [5d Kd Jd] [4h]
HJ: checks
CO: bets $0.16
BTN: calls $0.16
HJ: folds
*** RIVER *** [5d Kd Jd 4h] [4d]
CO: checks
BTN: bets $0.22
CO: folds
Uncalled bet ($0.22) returned to BTN
BTN collected $0.63 from pot
BTN: doesn't show hand
*** SUMMARY ***
Total pot $0.65 | Rake $0.02
Board [5d Kd Jd 4h 4d]
Seat 1: UTG folded before Flop (didn't bet)
Seat 2: HJ folded on the Turn
Seat 3: CO folded on the River
Seat 4: BTN (button) collected ($0.63)
Seat 5: SB (small blind) folded before Flop
Seat 6: BB (big blind) folded before Flop


PokerStars Hand #238161867489:  Hold'em No Limit ($0.01/$0.02 USD) - 2022/08/23 1:31:02 ET
Table 'Achilles IV' 6-max Seat #5 is the button
Seat 1: BB ($2.74 in chips)
Seat 2: UTG ($1.71 in chips)
Seat 3: HJ ($2.81 in chips)
Seat 4: CO ($3.32 in chips)
Seat 5: BTN ($3.15 in chips)
Seat 6: SB ($2.06 in chips)
SB: posts small blind $0.01
BB: posts big blind $0.02
*** HOLE CARDS ***
UTG: calls $0.02
HJ: folds
CO: calls $0.02
BTN: folds
SB: folds
BB: checks
*** FLOP *** [5s 5d 6s]
BB: checks
UTG: checks
CO: checks
*** TURN *** [5s 5d 6s] [Jd]
BB: checks
UTG: checks
CO: checks
*** RIVER *** [5s 5d 6s Jd] [6h]
BB: checks
UTG: checks
CO: checks
*** SHOW DOWN ***
BB: shows [2c 4c] (two pair, Sixes and Fives)
UTG: shows [9h 8d] (two pair, Sixes and Fives)
CO: shows [Kh 9c] (two pair, Sixes and Fives - King kicker)
CO collected $0.07 from pot
*** SUMMARY ***
Total pot $0.07 | Rake $0
Board [5s 5d 6s Jd 6h]
Seat 1: BB (big blind) showed [2c 4c] and lost with two pair, Sixes and Fives
Seat 2: UTG showed [9h 8d] and lost with two pair, Sixes and Fives
Seat 3: HJ folded before Flop (didn't bet)
Seat 4: CO showed [Kh 9c] and won ($0.07) with two pair, Sixes and Fives
Seat 5: BTN (button) folded before Flop (didn't bet)
Seat 6: SB (small blind) folded before Flop


PokerStars Hand #238161873766:  Hold'em No Limit ($0.01/$0.02 USD) - 2022/08/23 1:32:03 ET
Table 'Achilles IV' 6-max Seat #6 is the button
Seat 1: SB ($2.72 in chips)
Seat 2: BB ($1.69 in chips)
Seat 3: UTG ($2.81 in chips)
Seat 4: HJ ($3.37 in chips)
Seat 5: CO ($3.15 in chips)
Seat 6: BTN ($2.05 in chips)
SB: posts small blind $0.01
BB: posts big blind $0.02
*** HOLE CARDS ***
UTG: folds
HJ: folds
CO: folds
BTN: raises $0.04 to $0.06
SB: folds
BB: calls $0.04
*** FLOP *** [5s Ks Jh]
BB: bets $0.10
BTN: calls $0.10
*** TURN *** [5s Ks Jh] [Kd]
BB: checks
BTN: checks
*** RIVER *** [5s Ks Jh Kd] [4h]
BB: bets $0.02
BTN: folds
Uncalled bet ($0.02) returned to BB
BB collected $0.32 from pot
BB: doesn't show hand
*** SUMMARY ***
Total pot $0.33 | Rake $0.01
Board [5s Ks Jh Kd 4h]
Seat 1: SB (small blind) folded before Flop
Seat 2: BB (big blind) collected ($0.32)
Seat 3: UTG folded before Flop (didn't bet)
Seat 4: HJ folded before Flop (didn't bet)
Seat 5: CO folded before Flop (didn't bet)
Seat 6: BTN (button) folded on the River


PokerStars Hand #238161879036:  Hold'em No Limit ($0.01/$0.02 USD) - 2022/08/23 1:32:53 ET
Table 'Achilles IV' 6-max Seat #1 is the button
Seat 1: BTN ($2.71 in chips)
Seat 2: SB ($1.85 in chips)
Seat 3: BB ($2.81 in chips)
Seat 4: UTG ($3.37 in chips)
Seat 5: HJ ($3.15 in chips)
Seat 6: CO ($2 in chips)
SB: posts small blind $0.01
BB: posts big blind $0.02
*** HOLE CARDS ***
UTG: calls $0.02
HJ: folds
CO: folds
BTN: folds
SB: calls $0.01
BB: checks
*** FLOP *** [7d 2c 2h]
SB: checks
BB: checks
UTG: checks
*** TURN *** [7d 2c 2h] [7c]
SB: checks
BB: checks
UTG: checks
*** RIVER *** [7d 2c 2h 7c] [Kc]
SB: checks
BB: checks
UTG: checks
*** SHOW DOWN ***
SB: shows [Tc Jd] (two pair, Sevens and Deuces)
BB: shows [9d 6d] (two pair, Sevens and Deuces)
UTG: shows [4d 3d] (two pair, Sevens and Deuces)
SB collected $0.02 from pot
BB collected $0.02 from pot
UTG collected $0.02 from pot
*** SUMMARY ***
Total pot $0.06 | Rake $0
Board [7d 2c 2h 7c Kc]
Seat 1: BTN (button) folded before Flop (didn't bet)
Seat 2: SB (small blind) showed [Tc Jd] and won ($0.02) with two pair, Sevens and Deuces
Seat 3: BB (big blind) showed [9d 6d] and won ($0.02) with two pair, Sevens and Deuces
Seat 4: UTG showed [4d 3d] and won ($0.02) with two pair, Sevens and Deuces
Seat 5: HJ folded before Flop (didn't bet)
Seat 6: CO folded before Flop (didn't bet)


PokerStars Hand #238161883872:  Hold'em No Limit ($0.01/$0.02 USD) - 2022/08/23 1:33:38 ET
Table 'Achilles IV' 6-max Seat #2 is the button
Seat 1: CO ($2.71 in chips)
Seat 2: BTN ($1.85 in chips)
Seat 3: SB ($2.81 in chips)
Seat 4: BB ($3.37 in chips)
Seat 5: UTG ($3.15 in chips)
Seat 6: HJ ($2 in chips)
SB: posts small blind $0.01
BB: posts big blind $0.02
*** HOLE CARDS ***
UTG: folds
HJ: folds
CO: raises $0.03 to $0.05
BTN: calls $0.05
SB: calls $0.04
BB: folds
*** FLOP *** [8d 5d 4c]
SB: checks
CO: checks
BTN: bets $0.10
SB: calls $0.10
CO: folds
*** TURN *** [8d 5d 4c] [3c]
SB: checks
BTN: bets $1.70 and is all-in
SB: folds
Uncalled bet ($1.70) returned to BTN
BTN collected $0.36 from pot
BTN: doesn't show hand
*** SUMMARY ***
Total pot $0.37 | Rake $0.01
Board [8d 5d 4c 3c]
Seat 1: CO folded on the Flop
Seat 2: BTN (button) collected ($0.36)
Seat 3: SB (small blind) folded on the Turn
Seat 4: BB (big blind) folded before Flop
Seat 5: UTG folded before Flop (didn't bet)
Seat 6: HJ folded before Flop (didn't bet)


PokerStars Hand #238161890334:  Hold'em No Limit ($0.01/$0.02 USD) - 2022/08/23 1:34:40 ET
Table 'Achilles IV' 6-max Seat #3 is the button
Seat 1: HJ ($2.66 in chips)
Seat 2: CO ($2.06 in chips)
Seat 3: BTN ($2.66 in chips)
Seat 4: SB ($3.35 in chips)
Seat 5: BB ($3.15 in chips)
Seat 6: UTG ($2 in chips)
SB: posts small blind $0.01
BB: posts big blind $0.02
*** HOLE CARDS ***
UTG: folds
HJ: folds
CO: calls $0.02
BTN: folds
SB: folds
BB: checks
*** FLOP *** [3s As 5s]
BB: checks
CO: bets $0.08
BB: folds
Uncalled bet ($0.08) returned to CO
CO collected $0.05 from pot
CO: doesn't show hand
*** SUMMARY ***
Total pot $0.05 | Rake $0
Board [3s As 5s]
Seat 1: HJ folded before Flop (didn't bet)
Seat 2: CO collected ($0.05)
Seat 3: BTN (button) folded before Flop (didn't bet)
Seat 4: SB (small blind) folded before Flop
Seat 5: BB (big blind) folded on the Flop
Seat 6: UTG folded before Flop (didn't bet)


PokerStars Hand #238161893002:  Hold'em No Limit ($0.01/$0.02 USD) - 2022/08/23 1:35:05 ET
Table 'Achilles IV' 6-max Seat #4 is the button
Seat 1: UTG ($2.66 in chips)
Seat 2: HJ ($2.09 in chips)
Seat 3: CO ($2.66 in chips)
Seat 4: BTN ($3.34 in chips)
Seat 5: SB ($3.13 in chips)
Seat 6: BB ($2 in chips)
SB: posts small blind $0.01
BB: posts big blind $0.02
*** HOLE CARDS ***
UTG: raises $0.03 to $0.05
HJ: calls $0.05
CO: folds
BTN: folds
SB: folds
BB: calls $0.03
*** FLOP *** [3s 3h 7c]
BB: checks
UTG: checks
HJ: checks
*** TURN *** [3s 3h 7c] [7d]
BB: bets $0.07
UTG: calls $0.07
HJ: folds
*** RIVER *** [3s 3h 7c 7d] [7s]
BB: bets $0.14
UTG: calls $0.14
*** SHOW DOWN ***
BB: shows [7h 9h] (four of a kind, Sevens)
UTG: mucks hand
BB collected $0.56 from pot
*** SUMMARY ***
Total pot $0.58 | Rake $0.02
Board [3s 3h 7c 7d 7s]
Seat 1: UTG mucked
Seat 2: HJ folded on the Turn
Seat 3: CO folded before Flop (didn't bet)
Seat 4: BTN (button) folded before Flop (didn't bet)
Seat 5: SB (small blind) folded before Flop
Seat 6: BB (big blind) showed [7h 9h] and won ($0.56) with four of a kind, Sevens


PokerStars Hand #238161898615:  Hold'em No Limit ($0.01/$0.02 USD) - 2022/08/23 1:35:59 ET
Table 'Achilles IV' 6-max Seat #5 is the button
Seat 1: BB ($2.40 in chips)
Seat 2: UTG ($2.04 in chips)
Seat 3: HJ ($2.66 in chips)
Seat 4: CO ($3.34 in chips)
Seat 5: BTN ($3.12 in chips)
Seat 6: SB ($2.30 in chips)
SB: posts small blind $0.01
BB: posts big blind $0.02
*** HOLE CARDS ***
UTG: calls $0.02
HJ: folds
CO: folds
BTN: folds
SB: folds
BB: checks
*** FLOP *** [6h 8s 2h]
BB: checks
UTG: checks
*** TURN *** [6h 8s 2h] [Jd]
BB: checks
UTG: checks
*** RIVER *** [6h 8s 2h Jd] [Ad]
BB: checks
UTG: bets $0.04
BB: folds
Uncalled bet ($0.04) returned to UTG
UTG collected $0.05 from pot
UTG: doesn't show hand
*** SUMMARY ***
Total pot $0.05 | Rake $0
Board [6h 8s 2h Jd Ad]
Seat 1: BB (big blind) folded on the River
Seat 2: UTG collected ($0.05)
Seat 3: HJ folded before Flop (didn't bet)
Seat 4: CO folded before Flop (didn't bet)
Seat 5: BTN (button) folded before Flop (didn't bet)
Seat 6: SB (small blind) folded before Flop


PokerStars Hand #238161902057:  Hold'em No Limit ($0.01/$0.02 USD) - 2022/08/23 1:36:32 ET
Table 'Achilles IV' 6-max Seat #6 is the button
Seat 1: SB ($2.38 in chips)
Seat 2: BB ($2.07 in chips)
Seat 3: UTG ($2.66 in chips)
Seat 4: HJ ($3.34 in chips)
Seat 5: CO ($3.12 in chips)
Seat 6: BTN ($2.29 in chips)
SB: posts small blind $0.01
BB: posts big blind $0.02
*** HOLE CARDS ***
UTG: raises $0.03 to $0.05
HJ: calls $0.05
CO: raises $0.16 to $0.21
BTN: folds
SB: folds
BB: folds
UTG: folds
HJ: folds
Uncalled bet ($0.16) returned to CO
CO collected $0.18 from pot
CO: doesn't show hand
*** SUMMARY ***
Total pot $0.18 | Rake $0
Seat 1: SB (small blind) folded before Flop
Seat 2: BB (big blind) folded before Flop
Seat 3: UTG folded before Flop
Seat 4: HJ folded before Flop
Seat 5: CO collected ($0.18)
Seat 6: BTN (button) folded before Flop (didn't bet)


PokerStars Hand #238161904754:  Hold'em No Limit ($0.01/$0.02 USD) - 2022/08/23 1:36:58 ET
Table 'Achilles IV' 6-max Seat #1 is the button
Seat 1: BTN ($2.37 in chips)
Seat 2: SB ($2.05 in chips)
Seat 3: BB ($2.61 in chips)
Seat 4: UTG ($3.29 in chips)
Seat 5: HJ ($3.25 in chips)
Seat 6: CO ($2.29 in chips)
SB: posts small blind $0.01
BB: posts big blind $0.02
*** HOLE CARDS ***
UTG: calls $0.02
HJ: folds
CO: folds
BTN: folds
SB: calls $0.01
BB: checks
*** FLOP *** [9c 6s 7c]
SB: checks
BB: bets $0.04
UTG: calls $0.04
SB: folds
*** TURN *** [9c 6s 7c] [5c]
BB: checks
UTG: checks
*** RIVER *** [9c 6s 7c 5c] [9s]
BB: checks
UTG: checks
*** SHOW DOWN ***
BB: shows [3s 5d] (two pair, Nines and Fives)
UTG: shows [7h 8d] (a straight, Five to Nine)
UTG collected $0.14 from pot
*** SUMMARY ***
Total pot $0.14 | Rake $0
Board [9c 6s 7c 5c 9s]
Seat 1: BTN (button) folded before Flop (didn't bet)
Seat 2: SB (small blind) folded on the Flop
Seat 3: BB (big blind) showed [3s 5d] and lost with two pair, Nines and Fives
Seat 4: UTG showed [7h 8d] and won ($0.14) with a straight, Five to Nine
Seat 5: HJ folded before Flop (didn't bet)
Seat 6: CO folded before Flop (didn't bet)


PokerStars Hand #238161914024:  Hold'em No Limit ($0.01/$0.02 USD) - 2022/08/23 1:37:54 ET
Table 'Achilles IV' 6-max Seat #2 is the button
Seat 1: CO ($2.37 in chips)
Seat 2: BTN ($2.03 in chips)
Seat 3: SB ($2.55 in chips)
Seat 6: BB ($2.29 in chips)
SB: posts small blind $0.01
Numakin: is sitting out
BB: posts big blind $0.02
*** HOLE CARDS ***
CO: folds
jeckarliyo leaves the table
BTN: calls $0.02
SB: folds
killervzla28 joins the table at seat #4
Numakin leaves the table
BB: raises $0.08 to $0.10
BTN: calls $0.08
*** FLOP *** [Td 4d Qc]
BB: checks
BTN: bets $0.10
BB: folds
Uncalled bet ($0.10) returned to BTN
BTN collected $0.20 from pot
BTN: doesn't show hand
*** SUMMARY ***
Total pot $0.21 | Rake $0.01
Board [Td 4d Qc]
Seat 1: CO folded before Flop (didn't bet)
Seat 2: BTN (button) collected ($0.20)
Seat 3: SB (small blind) folded before Flop
Seat 6: BB (big blind) folded on the Flop


PokerStars Hand #238161918087:  Hold'em No Limit ($0.01/$0.02 USD) - 2022/08/23 1:38:32 ET
Table 'Achilles IV' 6-max Seat #3 is the button
Seat 1: BB ($2.37 in chips)
Seat 2: CO ($2.13 in chips)
Seat 3: BTN ($2.54 in chips)
Seat 6: SB ($2.19 in chips)
SB: posts small blind $0.01
BB: posts big blind $0.02
*** HOLE CARDS ***
CO: calls $0.02
BTN: folds
SB: folds
BB: checks
*** FLOP *** [Tc 6s 8d]
BB: checks
CO: checks
*** TURN *** [Tc 6s 8d] [6d]
BB: checks
CO: checks
*** RIVER *** [Tc 6s 8d 6d] [Jc]
BB: checks
CO: bets $0.06
BB: folds
Uncalled bet ($0.06) returned to CO
CO collected $0.05 from pot
CO: doesn't show hand
*** SUMMARY ***
Total pot $0.05 | Rake $0
Board [Tc 6s 8d 6d Jc]
Seat 1: BB (big blind) folded on the River
Seat 2: CO collected ($0.05)
Seat 3: BTN (button) folded before Flop (didn't bet)
Seat 6: SB (small blind) folded before Flop


PokerStars Hand #238161920697:  Hold'em No Limit ($0.01/$0.02 USD) - 2022/08/23 1:38:58 ET
Table 'Achilles IV' 6-max Seat #6 is the button
Seat 1: SB ($2.35 in chips)
Seat 2: BB ($2.16 in chips)
Seat 3: CO ($2.54 in chips)
Seat 6: BTN ($2.18 in chips)
SB: posts small blind $0.01
BB: posts big blind $0.02
killervzla28: sits out
*** HOLE CARDS ***
CO: folds
BTN: folds
SB: folds
Uncalled bet ($0.01) returned to BB
BB collected $0.02 from pot
BB: doesn't show hand
*** SUMMARY ***
Total pot $0.02 | Rake $0
Seat 1: SB (small blind) folded before Flop
Seat 2: BB (big blind) collected ($0.02)
Seat 3: CO folded before Flop (didn't bet)
Seat 6: BTN (button) folded before Flop (didn't bet)


PokerStars Hand #238161921971:  Hold'em No Limit ($0.01/$0.02 USD) - 2022/08/23 1:39:10 ET
Table 'Achilles IV' 6-max Seat #1 is the button
Seat 1: BTN ($2.34 in chips)
Seat 2: SB ($2.17 in chips)
Seat 3: BB ($2.54 in chips)
Seat 6: CO ($2.18 in chips)
SB: posts small blind $0.01
BB: posts big blind $0.02
killervzla28: sits out
*** HOLE CARDS ***
CO: folds
BTN: folds
SB: calls $0.01
BB: checks
*** FLOP *** [Kd 7h 6d]
falcao25 joins the table at seat #5
SB: bets $0.06
BB: folds
Uncalled bet ($0.06) returned to SB
SB collected $0.04 from pot
SB: doesn't show hand
*** SUMMARY ***
Total pot $0.04 | Rake $0
Board [Kd 7h 6d]
Seat 1: BTN (button) folded before Flop (didn't bet)
Seat 2: SB (small blind) collected ($0.04)
Seat 3: BB (big blind) folded on the Flop
Seat 6: CO folded before Flop (didn't bet)


PokerStars Hand #238161924313:  Hold'em No Limit ($0.01/$0.02 USD) - 2022/08/23 1:39:32 ET
Table 'Achilles IV' 6-max Seat #2 is the button
Seat 1: CO ($2.34 in chips)
Seat 2: BTN ($2.19 in chips)
Seat 3: SB ($2.52 in chips)
Seat 4: BB ($2 in chips)
Seat 6: HJ ($2.18 in chips)
SB: posts small blind $0.01
BB: posts big blind $0.02
falcao25: sits out
*** HOLE CARDS ***
HJ: folds
CO: folds
BTN: calls $0.02
SB: folds
BB: checks
*** FLOP *** [Td Ac 9d]
BB: checks
BTN: bets $0.10
BB: folds
Uncalled bet ($0.10) returned to BTN
BTN collected $0.05 from pot
BTN: doesn't show hand
*** SUMMARY ***
Total pot $0.05 | Rake $0
Board [Td Ac 9d]
Seat 1: CO folded before Flop (didn't bet)
Seat 2: BTN (button) collected ($0.05)
Seat 3: SB (small blind) folded before Flop
Seat 4: BB (big blind) folded on the Flop
Seat 6: HJ folded before Flop (didn't bet)


PokerStars Hand #238161926270:  Hold'em No Limit ($0.01/$0.02 USD) - 2022/08/23 1:39:50 ET
Table 'Achilles IV' 6-max Seat #3 is the button
Seat 1: HJ ($2.34 in chips)
Seat 2: CO ($2.22 in chips)
Seat 3: BTN ($2.51 in chips)
Seat 4: SB ($2 in chips)
Seat 5: BB ($2 in chips)
Seat 6: UTG ($2.18 in chips)
SB: posts small blind $0.01
BB: posts big blind $0.02
*** HOLE CARDS ***
UTG: folds
HJ: folds
CO: calls $0.02
BTN: folds
SB: folds
BB: checks
*** FLOP *** [6h 5c 5h]
BB: checks
CO: checks
*** TURN *** [6h 5c 5h] [4s]
BB: checks
CO: checks
*** RIVER *** [6h 5c 5h 4s] [4d]
BB: checks
CO: bets $0.10
BB: calls $0.10
*** SHOW DOWN ***
CO: shows [Jd Jc] (two pair, Jacks and Fives)
BB: mucks hand
CO collected $0.24 from pot
*** SUMMARY ***
Total pot $0.25 | Rake $0.01
Board [6h 5c 5h 4s 4d]
Seat 1: HJ folded before Flop (didn't bet)
Seat 2: CO showed [Jd Jc] and won ($0.24) with two pair, Jacks and Fives
Seat 3: BTN (button) folded before Flop (didn't bet)
Seat 4: SB (small blind) folded before Flop
Seat 5: BB (big blind) mucked
Seat 6: UTG folded before Flop (didn't bet)


PokerStars Hand #238161931033:  Hold'em No Limit ($0.01/$0.02 USD) - 2022/08/23 1:40:35 ET
Table 'Achilles IV' 6-max Seat #4 is the button
Seat 1: UTG ($2.34 in chips)
Seat 2: HJ ($2.34 in chips)
Seat 3: CO ($2.51 in chips)
Seat 4: BTN ($2 in chips)
Seat 5: SB ($2 in chips)
Seat 6: BB ($2.18 in chips)
SB: posts small blind $0.01
BB: posts big blind $0.02
*** HOLE CARDS ***
UTG: folds
HJ: calls $0.02
CO: folds
BTN: raises $0.06 to $0.08
SB: folds
BB: folds
HJ: folds
Uncalled bet ($0.06) returned to BTN
BTN collected $0.07 from pot
BTN: doesn't show hand
*** SUMMARY ***
Total pot $0.07 | Rake $0
Seat 1: UTG folded before Flop (didn't bet)
Seat 2: HJ folded before Flop
Seat 3: CO folded before Flop (didn't bet)
Seat 4: BTN (button) collected ($0.07)
Seat 5: SB (small blind) folded before Flop
Seat 6: BB (big blind) folded before Flop


PokerStars Hand #238161934771:  Hold'em No Limit ($0.01/$0.02 USD) - 2022/08/23 1:41:12 ET
Table 'Achilles IV' 6-max Seat #5 is the button
Seat 1: BB ($2.34 in chips)
Seat 2: UTG ($2.32 in chips)
Seat 3: HJ ($2.51 in chips)
Seat 4: CO ($2.05 in chips)
Seat 5: BTN ($2 in chips)
Seat 6: SB ($2.16 in chips)
SB: posts small blind $0.01
BB: posts big blind $0.02
*** HOLE CARDS ***
UTG: calls $0.02
HJ: folds
CO: folds
BTN: raises $0.04 to $0.06
SB: folds
BB: calls $0.04
UTG: calls $0.04
*** FLOP *** [As 5c 5h]
BB: checks
UTG: bets $0.10
BTN: calls $0.10
BB: folds
*** TURN *** [As 5c 5h] [Js]
UTG: checks
BTN: bets $0.19
UTG: folds
Uncalled bet ($0.19) returned to BTN
BTN collected $0.38 from pot
*** SUMMARY ***
Total pot $0.39 | Rake $0.01
Board [As 5c 5h Js]
Seat 1: BB (big blind) folded on the Flop
Seat 2: UTG folded on the Turn
Seat 3: HJ folded before Flop (didn't bet)
Seat 4: CO folded before Flop (didn't bet)
Seat 5: BTN (button) collected ($0.38)
Seat 6: SB (small blind) folded before Flop


PokerStars Hand #238161940247:  Hold'em No Limit ($0.01/$0.02 USD) - 2022/08/23 1:42:04 ET
Table 'Achilles IV' 6-max Seat #6 is the button
Seat 1: SB ($2.28 in chips)
Seat 2: BB ($2.16 in chips)
Seat 3: UTG ($2.51 in chips)
Seat 4: HJ ($2.05 in chips)
Seat 5: CO ($2.22 in chips)
Seat 6: BTN ($2.15 in chips)
SB: posts small blind $0.01
BB: posts big blind $0.02
*** HOLE CARDS ***
UTG: folds
HJ: folds
CO: folds
BTN: raises $0.04 to $0.06
SB: folds
BB: calls $0.04
*** FLOP *** [5s 9s 3c]
BB: bets $0.06
BTN: raises $0.12 to $0.18
BB: folds
Uncalled bet ($0.12) returned to BTN
BTN collected $0.24 from pot
*** SUMMARY ***
Total pot $0.25 | Rake $0.01
Board [5s 9s 3c]
Seat 1: SB (small blind) folded before Flop
Seat 2: BB (big blind) folded on the Flop
Seat 3: UTG folded before Flop (didn't bet)
Seat 4: HJ folded before Flop (didn't bet)
Seat 5: CO folded before Flop (didn't bet)
Seat 6: BTN (button) collected ($0.24)


PokerStars Hand #238161944608:  Hold'em No Limit ($0.01/$0.02 USD) - 2022/08/23 1:42:46 ET
Table 'Achilles IV' 6-max Seat #1 is the button
Seat 1: BTN ($2.27 in chips)
Seat 2: SB ($2.04 in chips)
Seat 3: BB ($2.51 in chips)
Seat 4: UTG ($2.05 in chips)
Seat 5: HJ ($2.22 in chips)
Seat 6: CO ($2.27 in chips)
SB: posts small blind $0.01
BB: posts big blind $0.02
*** HOLE CARDS ***
UTG: folds
HJ: folds
CO: raises $0.04 to $0.06
BTN: folds
SB: calls $0.05
BB: folds
*** FLOP *** [5c 9c Qs]
SB: checks
CO: checks
*** TURN *** [5c 9c Qs] [2d]
SB: bets $0.06
CO: calls $0.06
*** RIVER *** [5c 9c Qs 2d] [Ks]
SB: bets $0.02
CO: calls $0.02
*** SHOW DOWN ***
SB: shows [Js 2s] (a pair of Deuces)
CO: shows [Ad 5d] (a pair of Fives)
CO collected $0.29 from pot
*** SUMMARY ***
Total pot $0.30 | Rake $0.01
Board [5c 9c Qs 2d Ks]
Seat 1: BTN (button) folded before Flop (didn't bet)
Seat 2: SB (small blind) showed [Js 2s] and lost with a pair of Deuces
Seat 3: BB (big blind) folded before Flop
Seat 4: UTG folded before Flop (didn't bet)
Seat 5: HJ folded before Flop (didn't bet)
Seat 6: CO showed [Ad 5d] and won ($0.29) with a pair of Fives


PokerStars Hand #238161950064:  Hold'em No Limit ($0.01/$0.02 USD) - 2022/08/23 1:43:37 ET
Table 'Achilles IV' 6-max Seat #2 is the button
Seat 1: CO ($2.27 in chips)
Seat 2: BTN ($1.90 in chips)
Seat 3: SB ($2.49 in chips)
Seat 4: BB ($2.05 in chips)
Seat 5: UTG ($2.22 in chips)
Seat 6: HJ ($2.42 in chips)
SB: posts small blind $0.01
BB: posts big blind $0.02
*** HOLE CARDS ***
UTG: folds
HJ: folds
CO: folds
BTN: calls $0.02
SB: calls $0.01
BB: checks
*** FLOP *** [8d Qd Jh]
SB: checks
BB: checks
BTN: checks
*** TURN *** [8d Qd Jh] [Tc]
SB: checks
BB: bets $0.06
BTN: folds
SB: calls $0.06
*** RIVER *** [8d Qd Jh Tc] [Kh]
SB: bets $2.41 and is all-in
BB: folds
Uncalled bet ($2.41) returned to SB
SB collected $0.17 from pot
*** SUMMARY ***
Total pot $0.18 | Rake $0.01
Board [8d Qd Jh Tc Kh]
Seat 1: CO folded before Flop (didn't bet)
Seat 2: BTN (button) folded on the Turn
Seat 3: SB (small blind) collected ($0.17)
Seat 4: BB (big blind) folded on the River
Seat 5: UTG folded before Flop (didn't bet)
Seat 6: HJ folded before Flop (didn't bet)


PokerStars Hand #238161957161:  Hold'em No Limit ($0.01/$0.02 USD) - 2022/08/23 1:44:44 ET
Table 'Achilles IV' 6-max Seat #3 is the button
Seat 1: HJ ($2.27 in chips)
Seat 2: CO ($1.88 in chips)
Seat 3: BTN ($2.58 in chips)
Seat 4: SB ($2 in chips)
Seat 5: BB ($2.22 in chips)
Seat 6: UTG ($2.42 in chips)
SB: posts small blind $0.01
BB: posts big blind $0.02
*** HOLE CARDS ***
UTG: folds
HJ: folds
CO: calls $0.02
BTN: folds
SB: folds
BB: checks
*** FLOP *** [Ah 2c Qs]
BB: checks
CO: checks
*** TURN *** [Ah 2c Qs] [6d]
BB: checks
CO: bets $0.08
BB: folds
Uncalled bet ($0.08) returned to CO
CO collected $0.05 from pot
CO: doesn't show hand
*** SUMMARY ***
Total pot $0.05 | Rake $0
Board [Ah 2c Qs 6d]
Seat 1: HJ folded before Flop (didn't bet)
Seat 2: CO collected ($0.05)
Seat 3: BTN (button) folded before Flop (didn't bet)
Seat 4: SB (small blind) folded before Flop
Seat 5: BB (big blind) folded on the Turn
Seat 6: UTG folded before Flop (didn't bet)


PokerStars Hand #238161960322:  Hold'em No Limit ($0.01/$0.02 USD) - 2022/08/23 1:45:15 ET
Table 'Achilles IV' 6-max Seat #4 is the button
Seat 1: UTG ($2.27 in chips)
Seat 2: HJ ($1.91 in chips)
Seat 3: CO ($2.58 in chips)
Seat 4: BTN ($2 in chips)
Seat 5: SB ($2.20 in chips)
Seat 6: BB ($2.42 in chips)
SB: posts small blind $0.01
BB: posts big blind $0.02
*** HOLE CARDS ***
UTG: folds
HJ: folds
CO: folds
BTN: folds
SB: folds
Uncalled bet ($0.01) returned to BB
BB collected $0.02 from pot
*** SUMMARY ***
Total pot $0.02 | Rake $0
Seat 1: UTG folded before Flop (didn't bet)
Seat 2: HJ folded before Flop (didn't bet)
Seat 3: CO folded before Flop (didn't bet)
Seat 4: BTN (button) folded before Flop (didn't bet)
Seat 5: SB (small blind) folded before Flop
Seat 6: BB (big blind) collected ($0.02)


PokerStars Hand #238161962418:  Hold'em No Limit ($0.01/$0.02 USD) - 2022/08/23 1:45:35 ET
Table 'Achilles IV' 6-max Seat #5 is the button
Seat 1: BB ($2.27 in chips)
Seat 2: UTG ($1.91 in chips)
Seat 3: HJ ($2.58 in chips)
Seat 4: CO ($2 in chips)
Seat 5: BTN ($2.19 in chips)
Seat 6: SB ($2.43 in chips)
SB: posts small blind $0.01
BB: posts big blind $0.02
*** HOLE CARDS ***
UTG: folds
HJ: folds
CO: folds
UTG leaves the table
BTN: folds
SB: raises $0.04 to $0.06
BB: folds
Uncalled bet ($0.04) returned to SB
SB collected $0.04 from pot
*** SUMMARY ***
Total pot $0.04 | Rake $0
Seat 1: BB (big blind) folded before Flop
Seat 2: UTG folded before Flop (didn't bet)
Seat 3: HJ folded before Flop (didn't bet)
Seat 4: CO folded before Flop (didn't bet)
Seat 5: BTN (button) folded before Flop (didn't bet)
Seat 6: SB (small blind) collected ($0.04)


PokerStars Hand #238161964114:  Hold'em No Limit ($0.01/$0.02 USD) - 2022/08/23 1:45:51 ET
Table 'Achilles IV' 6-max Seat #6 is the button
Seat 1: SB ($2.25 in chips)
Seat 3: BB ($2.58 in chips)
Seat 4: HJ ($2 in chips)
Seat 5: CO ($2.19 in chips)
Seat 6: BTN ($2.45 in chips)
SB: posts small blind $0.01
BB: posts big blind $0.02
*** HOLE CARDS ***
HJ: raises $0.04 to $0.06
CO: calls $0.06
BTN: folds
SB: calls $0.05
BB: folds
*** FLOP *** [Ts 7c 3s]
SB: checks
HJ: bets $0.13
CO: folds
SB: calls $0.13
*** TURN *** [Ts 7c 3s] [Qc]
msmbenz9900 joins the table at seat #2
SB: checks
HJ: checks
*** RIVER *** [Ts 7c 3s Qc] [Kh]
SB: checks
HJ: checks
*** SHOW DOWN ***
SB: shows [As 5s] (high card Ace)
HJ: shows [9c 9h] (a pair of Nines)
HJ collected $0.44 from pot
*** SUMMARY ***
Total pot $0.46 | Rake $0.02
Board [Ts 7c 3s Qc Kh]
Seat 1: SB (small blind) showed [As 5s] and lost with high card Ace
Seat 3: BB (big blind) folded before Flop
Seat 4: HJ showed [9c 9h] and won ($0.44) with a pair of Nines
Seat 5: CO folded on the Flop
Seat 6: BTN (button) folded before Flop (didn't bet)


PokerStars Hand #238161969806:  Hold'em No Limit ($0.01/$0.02 USD) - 2022/08/23 1:46:47 ET
Table 'Achilles IV' 6-max Seat #1 is the button
Seat 1: BTN ($2.06 in chips)
Seat 3: SB ($2.56 in chips)
Seat 4: BB ($2.25 in chips)
Seat 5: HJ ($2.13 in chips)
Seat 6: CO ($2.45 in chips)
SB: posts small blind $0.01
BB: posts big blind $0.02
*** HOLE CARDS ***
HJ: folds
CO: folds
BTN: folds
SB: folds
Uncalled bet ($0.01) returned to BB
BB collected $0.02 from pot
BB: doesn't show hand
*** SUMMARY ***
Total pot $0.02 | Rake $0
Seat 1: BTN (button) folded before Flop (didn't bet)
Seat 3: SB (small blind) folded before Flop
Seat 4: BB (big blind) collected ($0.02)
Seat 5: HJ folded before Flop (didn't bet)
Seat 6: CO folded before Flop (didn't bet)


PokerStars Hand #238161971070:  Hold'em No Limit ($0.01/$0.02 USD) - 2022/08/23 1:46:59 ET
Table 'Achilles IV' 6-max Seat #3 is the button
Seat 1: HJ ($2.06 in chips)
Seat 2: CO ($1.51 in chips)
Seat 3: BTN ($2.55 in chips)
Seat 4: SB ($2.26 in chips)
Seat 5: BB ($2.13 in chips)
Seat 6: UTG ($2.45 in chips)
SB: posts small blind $0.01
BB: posts big blind $0.02
CO: posts big blind $0.02
*** HOLE CARDS ***
UTG: folds
HJ: folds
CO: checks
BTN: raises $0.08 to $0.10
SB: folds
BB: folds
CO: folds
Uncalled bet ($0.08) returned to BTN
BTN collected $0.07 from pot
*** SUMMARY ***
Total pot $0.07 | Rake $0
Seat 1: HJ folded before Flop (didn't bet)
Seat 2: CO folded before Flop (didn't bet)
Seat 3: BTN (button) collected ($0.07)
Seat 4: SB (small blind) folded before Flop
Seat 5: BB (big blind) folded before Flop
Seat 6: UTG folded before Flop (didn't bet)


PokerStars Hand #238161974749:  Hold'em No Limit ($0.01/$0.02 USD) - 2022/08/23 1:47:34 ET
Table 'Achilles IV' 6-max Seat #4 is the button
Seat 1: UTG ($2.06 in chips)
Seat 2: HJ ($1.49 in chips)
Seat 3: CO ($2.60 in chips)
Seat 4: BTN ($2.25 in chips)
Seat 5: SB ($2.11 in chips)
Seat 6: BB ($2.45 in chips)
SB: posts small blind $0.01
BB: posts big blind $0.02
*** HOLE CARDS ***
UTG: folds
HJ: calls $0.02
CO: folds
BTN: folds
BTN was removed from the table for failing to post
BTN leaves the table
Overdiewings joins the table at seat #4
SB: folds
Overdiewings leaves the table
BB: checks
*** FLOP *** [7c Js Jd]
BB: checks
HJ: checks
*** TURN *** [7c Js Jd] [2s]
BB: checks
HJ: checks
*** RIVER *** [7c Js Jd 2s] [9c]
BB: checks
HJ: checks
*** SHOW DOWN ***
BB: shows [5c Qc] (a pair of Jacks)
HJ: mucks hand
BB collected $0.05 from pot
*** SUMMARY ***
Total pot $0.05 | Rake $0
Board [7c Js Jd 2s 9c]
Seat 1: UTG folded before Flop (didn't bet)
Seat 2: HJ mucked
Seat 3: CO folded before Flop (didn't bet)
Seat 4: BTN (button) folded before Flop (didn't bet)
Seat 5: SB (small blind) folded before Flop
Seat 6: BB (big blind) showed [5c Qc] and won ($0.05) with a pair of Jacks


PokerStars Hand #238161978426:  Hold'em No Limit ($0.01/$0.02 USD) - 2022/08/23 1:48:10 ET
Table 'Achilles IV' 6-max Seat #5 is the button
Seat 1: BB ($2.06 in chips)
Seat 2: HJ ($1.47 in chips)
Seat 3: CO ($2.60 in chips)
Seat 5: BTN ($2.10 in chips)
Seat 6: SB ($2.48 in chips)
SB: posts small blind $0.01
BB: posts big blind $0.02
*** HOLE CARDS ***
HJ: folds
CO: folds
BTN: folds
SB: folds
Uncalled bet ($0.01) returned to BB
BB collected $0.02 from pot
*** SUMMARY ***
Total pot $0.02 | Rake $0
Seat 1: BB (big blind) collected ($0.02)
Seat 2: HJ folded before Flop (didn't bet)
Seat 3: CO folded before Flop (didn't bet)
Seat 5: BTN (button) folded before Flop (didn't bet)
Seat 6: SB (small blind) folded before Flop


PokerStars Hand #238161979988:  Hold'em No Limit ($0.01/$0.02 USD) - 2022/08/23 1:48:25 ET
Table 'Achilles IV' 6-max Seat #6 is the button
Seat 1: SB ($2.07 in chips)
Seat 2: BB ($1.47 in chips)
Seat 3: HJ ($2.60 in chips)
Seat 5: CO ($2.10 in chips)
Seat 6: BTN ($2.47 in chips)
SB: posts small blind $0.01
BB: posts big blind $0.02
*** HOLE CARDS ***
HJ: folds
CO: folds
BTN: folds
SB: raises $0.03 to $0.05
BB: calls $0.03
*** FLOP *** [Kh 7c 2s]
SB: bets $0.07
BB: calls $0.07
*** TURN *** [Kh 7c 2s] [Qh]
SB: bets $0.15
BB: calls $0.15
*** RIVER *** [Kh 7c 2s Qh] [6s]
SB: checks
BB: checks
*** SHOW DOWN ***
SB: shows [Ah Kc] (a pair of Kings)
BB: mucks hand
SB collected $0.52 from pot
*** SUMMARY ***
Total pot $0.54 | Rake $0.02
Board [Kh 7c 2s Qh 6s]
Seat 1: SB (small blind) showed [Ah Kc] and won ($0.52) with a pair of Kings
Seat 2: BB (big blind) mucked
Seat 3: HJ folded before Flop (didn't bet)
Seat 5: CO folded before Flop (didn't bet)
Seat 6: BTN (button) folded before Flop (didn't bet)


PokerStars Hand #238161983494:  Hold'em No Limit ($0.01/$0.02 USD) - 2022/08/23 1:49:00 ET
Table 'Achilles IV' 6-max Seat #1 is the button
Seat 1: BTN ($2.32 in chips)
Seat 2: SB ($1.20 in chips)
Seat 3: BB ($2.60 in chips)
Seat 5: HJ ($2.10 in chips)
Seat 6: CO ($2.47 in chips)
SB: posts small blind $0.01
BB: posts big blind $0.02
*** HOLE CARDS ***
HJ: folds
CO: folds
BTN: raises $0.03 to $0.05
SB: folds
BB: folds
Uncalled bet ($0.03) returned to BTN
BTN collected $0.05 from pot
*** SUMMARY ***
Total pot $0.05 | Rake $0
Seat 1: BTN (button) collected ($0.05)
Seat 2: SB (small blind) folded before Flop
Seat 3: BB (big blind) folded before Flop
Seat 5: HJ folded before Flop (didn't bet)
Seat 6: CO folded before Flop (didn't bet)


PokerStars Hand #238161985728:  Hold'em No Limit ($0.01/$0.02 USD) - 2022/08/23 1:49:21 ET
Table 'Achilles IV' 6-max Seat #2 is the button
Seat 1: CO ($2.35 in chips)
Seat 2: BTN ($1.19 in chips)
Seat 3: SB ($2.58 in chips)
Seat 5: BB ($2.10 in chips)
Seat 6: HJ ($2.47 in chips)
SB: posts small blind $0.01
BB: posts big blind $0.02
*** HOLE CARDS ***
HJ: folds
Sabaka777 joins the table at seat #4
CO: raises $0.03 to $0.05
BTN: calls $0.05
SB: folds
BB: folds
*** FLOP *** [9s Qh 6c]
CO: bets $0.10
BTN: folds
Uncalled bet ($0.10) returned to CO
CO collected $0.13 from pot
*** SUMMARY ***
Total pot $0.13 | Rake $0
Board [9s Qh 6c]
Seat 1: CO collected ($0.13)
Seat 2: BTN (button) folded on the Flop
Seat 3: SB (small blind) folded before Flop
Seat 5: BB (big blind) folded before Flop
Seat 6: HJ folded before Flop (didn't bet)


PokerStars Hand #238161990710:  Hold'em No Limit ($0.01/$0.02 USD) - 2022/08/23 1:50:10 ET
Table 'Achilles IV' 6-max Seat #5 is the button
Seat 2: BB ($1.14 in chips)
Seat 3: CO ($2.60 in chips)
Seat 5: BTN ($2.07 in chips)
Seat 6: SB ($2.45 in chips)
SB: posts small blind $0.01
BB: posts big blind $0.02
Sabaka777: sits out
*** HOLE CARDS ***
CO: folds
BTN: folds
CO leaves the table
SB: raises $0.04 to $0.06
BB: folds
Uncalled bet ($0.04) returned to SB
SB collected $0.04 from pot
*** SUMMARY ***
Total pot $0.04 | Rake $0
Seat 2: BB (big blind) folded before Flop
Seat 3: CO folded before Flop (didn't bet)
Seat 5: BTN (button) folded before Flop (didn't bet)
Seat 6: SB (small blind) collected ($0.04)


PokerStars Hand #238161988522:  Hold'em No Limit ($0.01/$0.02 USD) - 2022/08/23 1:49:48 ET
Table 'Achilles IV' 6-max Seat #3 is the button
Seat 1: HJ ($2.43 in chips)
Seat 2: CO ($1.14 in chips)
Seat 3: BTN ($2.57 in chips)
Seat 5: SB ($2.08 in chips)
Seat 6: BB ($2.47 in chips)
SB: posts small blind $0.01
BB: posts big blind $0.02
*** HOLE CARDS ***
HJ: folds
CO: folds
BTN: raises $0.03 to $0.05
SB: folds
BB: folds
Uncalled bet ($0.03) returned to BTN
BTN collected $0.05 from pot
*** SUMMARY ***
Total pot $0.05 | Rake $0
Seat 1: HJ folded before Flop (didn't bet)
Seat 2: CO folded before Flop (didn't bet)
Seat 3: BTN (button) collected ($0.05)
Seat 5: SB (small blind) folded before Flop
Seat 6: BB (big blind) folded before Flop


PokerStars Hand #238161992403:  Hold'em No Limit ($0.01/$0.02 USD) - 2022/08/23 1:50:26 ET
Table 'Achilles IV' 6-max Seat #6 is the button
Seat 2: SB ($1.12 in chips)
Seat 4: BB ($2 in chips)
Seat 5: CO ($2.07 in chips)
Seat 6: BTN ($2.47 in chips)
SB: posts small blind $0.01
BB: posts big blind $0.02
*** HOLE CARDS ***
CO: folds
d1ablo84 joins the table at seat #3
BTN: raises $0.04 to $0.06
SB: folds
BB: folds
Uncalled bet ($0.04) returned to BTN
BTN collected $0.05 from pot
*** SUMMARY ***
Total pot $0.05 | Rake $0
Seat 2: SB (small blind) folded before Flop
Seat 4: BB (big blind) folded before Flop
Seat 5: CO folded before Flop (didn't bet)
Seat 6: BTN (button) collected ($0.05)


PokerStars Hand #238162000995:  Hold'em No Limit ($0.01/$0.02 USD) - 2022/08/23 1:50:40 ET
Table 'Achilles IV' 6-max Seat #2 is the button
Seat 2: BTN ($1.11 in chips)
Seat 4: SB ($1.98 in chips)
Seat 5: BB ($2.07 in chips)
Seat 6: CO ($2.50 in chips)
SB: posts small blind $0.01
BB: posts big blind $0.02
*** HOLE CARDS ***
CO: folds
BTN: raises $0.02 to $0.04
SB: folds
BB: folds
Uncalled bet ($0.02) returned to BTN
BTN collected $0.05 from pot
*** SUMMARY ***
Total pot $0.05 | Rake $0
Seat 2: BTN (button) collected ($0.05)
Seat 4: SB (small blind) folded before Flop
Seat 5: BB (big blind) folded before Flop
Seat 6: CO folded before Flop (didn't bet)


PokerStars Hand #238162002517:  Hold'em No Limit ($0.01/$0.02 USD) - 2022/08/23 1:50:54 ET
Table 'Achilles IV' 6-max Seat #4 is the button
Seat 2: CO ($1.14 in chips)
Seat 4: BTN ($1.97 in chips)
Seat 5: SB ($2.05 in chips)
Seat 6: BB ($2.50 in chips)
SB: posts small blind $0.01
BB: posts big blind $0.02
d1ablo84: sits out
*** HOLE CARDS ***
CO: calls $0.02
BTN: raises $0.02 to $0.04
SB: folds
BB: folds
CO: calls $0.02
*** FLOP *** [2h Js 5s]
CO: bets $0.02
BTN: calls $0.02
*** TURN *** [2h Js 5s] [6s]
CO: bets $0.02
BTN: raises $0.04 to $0.06
CO: calls $0.04
*** RIVER *** [2h Js 5s 6s] [9h]
CO: checks
BTN: bets $0.08
CO: calls $0.08
*** SHOW DOWN ***
BTN: shows [As 2s] (a flush, Ace high)
CO: mucks hand
BTN collected $0.41 from pot
*** SUMMARY ***
Total pot $0.43 | Rake $0.02
Board [2h Js 5s 6s 9h]
Seat 2: CO mucked
Seat 4: BTN (button) showed [As 2s] and won ($0.41) with a flush, Ace high
Seat 5: SB (small blind) folded before Flop
Seat 6: BB (big blind) folded before Flop


PokerStars Hand #238162007102:  Hold'em No Limit ($0.01/$0.02 USD) - 2022/08/23 1:51:39 ET
Table 'Achilles IV' 6-max Seat #5 is the button
Seat 2: BB ($0.94 in chips)
Seat 4: CO ($2.18 in chips)
Seat 5: BTN ($2.04 in chips)
Seat 6: SB ($2.48 in chips)
SB: posts small blind $0.01
BB: posts big blind $0.02
d1ablo84: sits out
*** HOLE CARDS ***
CO: folds
BTN: folds
SB: raises $0.04 to $0.06
BB: raises $0.04 to $0.10
SB: folds
Uncalled bet ($0.04) returned to BB
BB collected $0.12 from pot
*** SUMMARY ***
Total pot $0.12 | Rake $0
Seat 2: BB (big blind) collected ($0.12)
Seat 4: CO folded before Flop (didn't bet)
Seat 5: BTN (button) folded before Flop (didn't bet)
Seat 6: SB (small blind) folded before Flop


PokerStars Hand #238162008891:  Hold'em No Limit ($0.01/$0.02 USD) - 2022/08/23 1:51:56 ET
Table 'Achilles IV' 6-max Seat #6 is the button
Seat 2: SB ($1 in chips)
Seat 3: BB ($2 in chips)
Seat 4: HJ ($2.18 in chips)
Seat 5: CO ($2.04 in chips)
Seat 6: BTN ($2.42 in chips)
SB: posts small blind $0.01
BB: posts big blind $0.02
*** HOLE CARDS ***
HJ: folds
CO: folds
BTN: folds
SB: folds
Uncalled bet ($0.01) returned to BB
BB collected $0.02 from pot
BB: doesn't show hand
*** SUMMARY ***
Total pot $0.02 | Rake $0
Seat 2: SB (small blind) folded before Flop
Seat 3: BB (big blind) collected ($0.02)
Seat 4: HJ folded before Flop (didn't bet)
Seat 5: CO folded before Flop (didn't bet)
Seat 6: BTN (button) folded before Flop (didn't bet)


PokerStars Hand #238162009920:  Hold'em No Limit ($0.01/$0.02 USD) - 2022/08/23 1:52:05 ET
Table 'Achilles IV' 6-max Seat #2 is the button
Seat 2: BTN ($0.99 in chips)
Seat 3: SB ($2.01 in chips)
Seat 4: BB ($2.18 in chips)
Seat 5: HJ ($2.04 in chips)
Seat 6: CO ($2.42 in chips)
SB: posts small blind $0.01
BB: posts big blind $0.02
*** HOLE CARDS ***
HJ: raises $0.04 to $0.06
CO: folds
BTN: folds
SB: folds
BB: folds
Uncalled bet ($0.04) returned to HJ
HJ collected $0.05 from pot
*** SUMMARY ***
Total pot $0.05 | Rake $0
Seat 2: BTN (button) folded before Flop (didn't bet)
Seat 3: SB (small blind) folded before Flop
Seat 4: BB (big blind) folded before Flop
Seat 5: HJ collected ($0.05)
Seat 6: CO folded before Flop (didn't bet)


PokerStars Hand #238162011495:  Hold'em No Limit ($0.01/$0.02 USD) - 2022/08/23 1:52:20 ET
Table 'Achilles IV' 6-max Seat #3 is the button
Seat 2: CO ($0.99 in chips)
Seat 3: BTN ($2 in chips)
Seat 4: SB ($2.16 in chips)
Seat 5: BB ($2.07 in chips)
Seat 6: HJ ($2.42 in chips)
SB: posts small blind $0.01
BB: posts big blind $0.02
*** HOLE CARDS ***
HJ: folds
CO: calls $0.02
BTN: folds
SB: folds
BB: checks
*** FLOP *** [As Ks 6h]
BB: checks
CO: bets $0.02
BB: folds
Uncalled bet ($0.02) returned to CO
CO collected $0.05 from pot
*** SUMMARY ***
Total pot $0.05 | Rake $0
Board [As Ks 6h]
Seat 2: CO collected ($0.05)
Seat 3: BTN (button) folded before Flop (didn't bet)
Seat 4: SB (small blind) folded before Flop
Seat 5: BB (big blind) folded on the Flop
Seat 6: HJ folded before Flop (didn't bet)


PokerStars Hand #238162013669:  Hold'em No Limit ($0.01/$0.02 USD) - 2022/08/23 1:52:41 ET
Table 'Achilles IV' 6-max Seat #4 is the button
Seat 2: HJ ($1.02 in chips)
Seat 3: CO ($2 in chips)
Seat 4: BTN ($2.15 in chips)
Seat 5: SB ($2.05 in chips)
Seat 6: BB ($2.42 in chips)
SB: posts small blind $0.01
BB: posts big blind $0.02
*** HOLE CARDS ***
HJ: folds
CO: folds
BTN: folds
SB: raises $0.04 to $0.06
BB: folds
Uncalled bet ($0.04) returned to SB
SB collected $0.04 from pot
*** SUMMARY ***
Total pot $0.04 | Rake $0
Seat 2: HJ folded before Flop (didn't bet)
Seat 3: CO folded before Flop (didn't bet)
Seat 4: BTN (button) folded before Flop (didn't bet)
Seat 5: SB (small blind) collected ($0.04)
Seat 6: BB (big blind) folded before Flop


PokerStars Hand #238162018335:  Hold'em No Limit ($0.01/$0.02 USD) - 2022/08/23 1:53:26 ET
Table 'Achilles IV' 6-max Seat #6 is the button
Seat 2: SB ($1 in chips)
Seat 3: BB ($2 in chips)
Seat 4: HJ ($2.18 in chips)
Seat 5: CO ($2.07 in chips)
Seat 6: BTN ($2.39 in chips)
SB: posts small blind $0.01
BB: posts big blind $0.02
*** HOLE CARDS ***
HJ: folds
CO: folds
BTN: folds
SB: folds
Uncalled bet ($0.01) returned to BB
BB collected $0.02 from pot
BB: doesn't show hand
*** SUMMARY ***
Total pot $0.02 | Rake $0
Seat 2: SB (small blind) folded before Flop
Seat 3: BB (big blind) collected ($0.02)
Seat 4: HJ folded before Flop (didn't bet)
Seat 5: CO folded before Flop (didn't bet)
Seat 6: BTN (button) folded before Flop (didn't bet)


PokerStars Hand #238162017097:  Hold'em No Limit ($0.01/$0.02 USD) - 2022/08/23 1:53:14 ET
Table 'Achilles IV' 6-max Seat #5 is the button
Seat 2: BB ($1.02 in chips)
Seat 3: HJ ($2 in chips)
Seat 4: CO ($2.15 in chips)
Seat 5: BTN ($2.07 in chips)
Seat 6: SB ($2.40 in chips)
SB: posts small blind $0.01
BB: posts big blind $0.02
*** HOLE CARDS ***
HJ: folds
CO: raises $0.02 to $0.04
BTN: folds
SB: folds
BB: folds
Uncalled bet ($0.02) returned to CO
CO collected $0.05 from pot
CO: doesn't show hand
*** SUMMARY ***
Total pot $0.05 | Rake $0
Seat 2: BB (big blind) folded before Flop
Seat 3: HJ folded before Flop (didn't bet)
Seat 4: CO collected ($0.05)
Seat 5: BTN (button) folded before Flop (didn't bet)
Seat 6: SB (small blind) folded before Flop


PokerStars Hand #238162019354:  Hold'em No Limit ($0.01/$0.02 USD) - 2022/08/23 1:53:36 ET
Table 'Achilles IV' 6-max Seat #2 is the button
Seat 2: BTN ($0.99 in chips)
Seat 3: SB ($2.01 in chips)
Seat 4: BB ($2.18 in chips)
Seat 5: HJ ($2.07 in chips)
Seat 6: CO ($2.39 in chips)
SB: posts small blind $0.01
BB: posts big blind $0.02
Vlao: sits out
*** HOLE CARDS ***
HJ: folds
CO: folds
BTN: calls $0.02
SB: folds
BB: checks
*** FLOP *** [As Qs 7d]
BB: checks
BTN: bets $0.02
BB: folds
Uncalled bet ($0.02) returned to BTN
BTN collected $0.05 from pot
*** SUMMARY ***
Total pot $0.05 | Rake $0
Board [As Qs 7d]
Seat 2: BTN (button) collected ($0.05)
Seat 3: SB (small blind) folded before Flop
Seat 4: BB (big blind) folded on the Flop
Seat 5: HJ folded before Flop (didn't bet)
Seat 6: CO folded before Flop (didn't bet)


PokerStars Hand #238162022093:  Hold'em No Limit ($0.01/$0.02 USD) - 2022/08/23 1:54:02 ET
Table 'Achilles IV' 6-max Seat #3 is the button
Seat 2: CO ($1.02 in chips)
Seat 3: BTN ($2 in chips)
Seat 4: SB ($2.16 in chips)
Seat 5: BB ($2.07 in chips)
Seat 6: HJ ($2.39 in chips)
SB: posts small blind $0.01
BB: posts big blind $0.02
Vlao: sits out
*** HOLE CARDS ***
HJ: folds
CO: folds
BTN: raises $0.03 to $0.05
SB: folds
BB: folds
Uncalled bet ($0.03) returned to BTN
BTN collected $0.05 from pot
BTN: doesn't show hand
*** SUMMARY ***
Total pot $0.05 | Rake $0
Seat 2: CO folded before Flop (didn't bet)
Seat 3: BTN (button) collected ($0.05)
Seat 4: SB (small blind) folded before Flop
Seat 5: BB (big blind) folded before Flop
Seat 6: HJ folded before Flop (didn't bet)


PokerStars Hand #238162023350:  Hold'em No Limit ($0.01/$0.02 USD) - 2022/08/23 1:54:14 ET
Table 'Achilles IV' 6-max Seat #4 is the button
Seat 1: BB ($2.43 in chips)
Seat 2: HJ ($1.02 in chips)
Seat 3: CO ($2.03 in chips)
Seat 4: BTN ($2.15 in chips)
Seat 5: SB ($2.05 in chips)
SB: posts small blind $0.01
azall: is sitting out
BB: posts big blind $0.02
*** HOLE CARDS ***
HJ: folds
CO: raises $0.04 to $0.06
BTN: folds
SB: folds
BB: folds
Uncalled bet ($0.04) returned to CO
CO collected $0.05 from pot
CO: doesn't show hand
*** SUMMARY ***
Total pot $0.05 | Rake $0
Seat 1: BB (big blind) folded before Flop
Seat 2: HJ folded before Flop (didn't bet)
Seat 3: CO collected ($0.05)
Seat 4: BTN (button) folded before Flop (didn't bet)
Seat 5: SB (small blind) folded before Flop


PokerStars Hand #238162025467:  Hold'em No Limit ($0.01/$0.02 USD) - 2022/08/23 1:54:35 ET
Table 'Achilles IV' 6-max Seat #5 is the button
Seat 1: SB ($2.41 in chips)
Seat 2: BB ($1.02 in chips)
Seat 3: HJ ($2.06 in chips)
Seat 4: CO ($2.15 in chips)
Seat 5: BTN ($2.04 in chips)
SB: posts small blind $0.01
BB: posts big blind $0.02
*** HOLE CARDS ***
HJ: folds
CO: folds
BTN: folds
SB: folds
Uncalled bet ($0.01) returned to BB
BB collected $0.02 from pot
*** SUMMARY ***
Total pot $0.02 | Rake $0
Seat 1: SB (small blind) folded before Flop
Seat 2: BB (big blind) collected ($0.02)
Seat 3: HJ folded before Flop (didn't bet)
Seat 4: CO folded before Flop (didn't bet)
Seat 5: BTN (button) folded before Flop (didn't bet)


PokerStars Hand #238162027132:  Hold'em No Limit ($0.01/$0.02 USD) - 2022/08/23 1:54:51 ET
Table 'Achilles IV' 6-max Seat #1 is the button
Seat 1: BTN ($2.40 in chips)
Seat 2: SB ($1.03 in chips)
Seat 3: BB ($2.06 in chips)
Seat 4: HJ ($2.15 in chips)
Seat 5: CO ($2.04 in chips)
SB: posts small blind $0.01
BB: posts big blind $0.02
*** HOLE CARDS ***
HJ: folds
azall leaves the table
CO: folds
BTN: folds
SB: calls $0.01
BB: checks
*** FLOP *** [3d 6c 4c]
SB: checks
BB: checks
*** TURN *** [3d 6c 4c] [Js]
SB: checks
BB: checks
*** RIVER *** [3d 6c 4c Js] [Jc]
SB: checks
BB: checks
*** SHOW DOWN ***
SB: shows [4d 5h] (two pair, Jacks and Fours)
BB: mucks hand
SB collected $0.04 from pot
*** SUMMARY ***
Total pot $0.04 | Rake $0
Board [3d 6c 4c Js Jc]
Seat 1: BTN (button) folded before Flop (didn't bet)
Seat 2: SB (small blind) showed [4d 5h] and won ($0.04) with two pair, Jacks and Fours
Seat 3: BB (big blind) mucked
Seat 4: HJ folded before Flop (didn't bet)
Seat 5: CO folded before Flop (didn't bet)


PokerStars Hand #238162030423:  Hold'em No Limit ($0.01/$0.02 USD) - 2022/08/23 1:55:24 ET
Table 'Achilles IV' 6-max Seat #2 is the button
Seat 1: CO ($2.40 in chips)
Seat 2: BTN ($1.05 in chips)
Seat 3: SB ($2.04 in chips)
Seat 4: BB ($2.15 in chips)
Seat 5: HJ ($2.04 in chips)
SB: posts small blind $0.01
BB: posts big blind $0.02
*** HOLE CARDS ***
HJ: folds
CO: folds
BTN: folds
SB: folds
Uncalled bet ($0.01) returned to BB
BB collected $0.02 from pot
BB: doesn't show hand
*** SUMMARY ***
Total pot $0.02 | Rake $0
Seat 1: CO folded before Flop (didn't bet)
Seat 2: BTN (button) folded before Flop (didn't bet)
Seat 3: SB (small blind) folded before Flop
Seat 4: BB (big blind) collected ($0.02)
Seat 5: HJ folded before Flop (didn't bet)


PokerStars Hand #238162031395:  Hold'em No Limit ($0.01/$0.02 USD) - 2022/08/23 1:55:35 ET
Table 'Achilles IV' 6-max Seat #3 is the button
Seat 1: HJ ($2.40 in chips)
Seat 2: CO ($1.05 in chips)
Seat 3: BTN ($2.03 in chips)
Seat 4: SB ($2.16 in chips)
Seat 5: BB ($2.04 in chips)
SB: posts small blind $0.01
BB: posts big blind $0.02
*** HOLE CARDS ***
HJ: folds
CO: calls $0.02
BTN: folds
SB: raises $0.04 to $0.06
BB: folds
CO: calls $0.04
*** FLOP *** [9c 8s Jd]
SB: bets $0.04
CO: calls $0.04
*** TURN *** [9c 8s Jd] [7h]
florin.cbtr joins the table at seat #6
SB: bets $0.12
CO: calls $0.12
*** RIVER *** [9c 8s Jd 7h] [Qh]
SB: checks
CO: checks
*** SHOW DOWN ***
SB: shows [Js Ad] (a pair of Jacks)
CO: mucks hand
SB collected $0.44 from pot
*** SUMMARY ***
Total pot $0.46 | Rake $0.02
Board [9c 8s Jd 7h Qh]
Seat 1: HJ folded before Flop (didn't bet)
Seat 2: CO mucked
Seat 3: BTN (button) folded before Flop (didn't bet)
Seat 4: SB (small blind) showed [Js Ad] and won ($0.44) with a pair of Jacks
Seat 5: BB (big blind) folded before Flop


PokerStars Hand #238162036093:  Hold'em No Limit ($0.01/$0.02 USD) - 2022/08/23 1:56:26 ET
Table 'Achilles IV' 6-max Seat #4 is the button
Seat 1: UTG ($2.40 in chips)
Seat 2: HJ ($0.83 in chips)
Seat 3: CO ($2.03 in chips)
Seat 4: BTN ($2.38 in chips)
Seat 5: SB ($2.02 in chips)
Seat 6: BB ($2 in chips)
SB: posts small blind $0.01
BB: posts big blind $0.02
*** HOLE CARDS ***
UTG: folds
HJ: folds
CO: raises $0.04 to $0.06
BTN: folds
SB: folds
BB: calls $0.04
*** FLOP *** [Qs 6d Jc]
BB: checks
CO: bets $0.04
BB: calls $0.04
*** TURN *** [Qs 6d Jc] [Qh]
BB: checks
CO: checks
*** RIVER *** [Qs 6d Jc Qh] [2d]
BB: bets $0.14
CO: calls $0.14
*** SHOW DOWN ***
BB: shows [9d Ac] (a pair of Queens)
CO: shows [7d 7s] (two pair, Queens and Sevens)
CO collected $0.47 from pot
*** SUMMARY ***
Total pot $0.49 | Rake $0.02
Board [Qs 6d Jc Qh 2d]
Seat 1: UTG folded before Flop (didn't bet)
Seat 2: HJ folded before Flop (didn't bet)
Seat 3: CO showed [7d 7s] and won ($0.47) with two pair, Queens and Sevens
Seat 4: BTN (button) folded before Flop (didn't bet)
Seat 5: SB (small blind) folded before Flop
Seat 6: BB (big blind) showed [9d Ac] and lost with a pair of Queens


PokerStars Hand #238162040058:  Hold'em No Limit ($0.01/$0.02 USD) - 2022/08/23 1:57:09 ET
Table 'Achilles IV' 6-max Seat #5 is the button
Seat 1: BB ($2.40 in chips)
Seat 2: UTG ($0.83 in chips)
Seat 3: HJ ($2.26 in chips)
Seat 4: CO ($2.38 in chips)
Seat 5: BTN ($2.01 in chips)
Seat 6: SB ($1.76 in chips)
SB: posts small blind $0.01
BB: posts big blind $0.02
*** HOLE CARDS ***
UTG: folds
HJ: raises $0.04 to $0.06
CO: folds
BTN: folds
SB: calls $0.05
BB: folds
*** FLOP *** [3s 6s 4h]
SB: bets $0.04
HJ: calls $0.04
*** TURN *** [3s 6s 4h] [Kd]
SB: bets $0.08
HJ: raises $0.22 to $0.30
SB: folds
Uncalled bet ($0.22) returned to HJ
HJ collected $0.37 from pot
HJ: doesn't show hand
*** SUMMARY ***
Total pot $0.38 | Rake $0.01
Board [3s 6s 4h Kd]
Seat 1: BB (big blind) folded before Flop
Seat 2: UTG folded before Flop (didn't bet)
Seat 3: HJ collected ($0.37)
Seat 4: CO folded before Flop (didn't bet)
Seat 5: BTN (button) folded before Flop (didn't bet)
Seat 6: SB (small blind) folded on the Turn


PokerStars Hand #238162045234:  Hold'em No Limit ($0.01/$0.02 USD) - 2022/08/23 1:58:05 ET
Table 'Achilles IV' 6-max Seat #6 is the button
Seat 1: SB ($2.38 in chips)
Seat 2: BB ($0.83 in chips)
Seat 3: UTG ($2.45 in chips)
Seat 4: HJ ($2.38 in chips)
Seat 5: CO ($2.01 in chips)
Seat 6: BTN ($1.58 in chips)
SB: posts small blind $0.01
BB: posts big blind $0.02
*** HOLE CARDS ***
UTG: folds
HJ: folds
CO: folds
BTN: raises $0.04 to $0.06
SB: folds
BB: calls $0.04
*** FLOP *** [As 2c 7s]
BB: checks
BTN: bets $0.04
BB: folds
Uncalled bet ($0.04) returned to BTN
BTN collected $0.13 from pot
BTN: doesn't show hand
*** SUMMARY ***
Total pot $0.13 | Rake $0
Board [As 2c 7s]
Seat 1: SB (small blind) folded before Flop
Seat 2: BB (big blind) folded on the Flop
Seat 3: UTG folded before Flop (didn't bet)
Seat 4: HJ folded before Flop (didn't bet)
Seat 5: CO folded before Flop (didn't bet)
Seat 6: BTN (button) collected ($0.13)


PokerStars Hand #238162047915:  Hold'em No Limit ($0.01/$0.02 USD) - 2022/08/23 1:58:34 ET
Table 'Achilles IV' 6-max Seat #1 is the button
Seat 1: BTN ($2.37 in chips)
Seat 2: SB ($0.77 in chips)
Seat 3: BB ($2.45 in chips)
Seat 4: UTG ($2.38 in chips)
Seat 5: HJ ($2.01 in chips)
Seat 6: CO ($1.65 in chips)
SB: posts small blind $0.01
BB: posts big blind $0.02
*** HOLE CARDS ***
UTG: raises $0.04 to $0.06
HJ: folds
CO: folds
BTN: folds
SB: raises $0.71 to $0.77 and is all-in
BB: folds
UTG: calls $0.71
*** FLOP *** [4s Td 6c]
*** TURN *** [4s Td 6c] [8c]
*** RIVER *** [4s Td 6c 8c] [4h]
*** SHOW DOWN ***
SB: shows [5c As] (a pair of Fours)
UTG: shows [Tc 9c] (two pair, Tens and Fours)
UTG collected $1.51 from pot
*** SUMMARY ***
Total pot $1.56 | Rake $0.05
Board [4s Td 6c 8c 4h]
Seat 1: BTN (button) folded before Flop (didn't bet)
Seat 2: SB (small blind) showed [5c As] and lost with a pair of Fours
Seat 3: BB (big blind) folded before Flop
Seat 4: UTG showed [Tc 9c] and won ($1.51) with two pair, Tens and Fours
Seat 5: HJ folded before Flop (didn't bet)
Seat 6: CO folded before Flop (didn't bet)


PokerStars Hand #238162050973:  Hold'em No Limit ($0.01/$0.02 USD) - 2022/08/23 1:59:07 ET
Table 'Achilles IV' 6-max Seat #3 is the button
Seat 1: CO ($2.37 in chips)
Seat 3: BTN ($2.43 in chips)
Seat 4: SB ($3.12 in chips)
Seat 5: BB ($2.01 in chips)
Seat 6: HJ ($1.65 in chips)
SB: posts small blind $0.01
BB: posts big blind $0.02
*** HOLE CARDS ***
HJ: folds
msmbenz9900 is disconnected
CO: folds
BTN: folds
SB: folds
Uncalled bet ($0.01) returned to BB
BB collected $0.02 from pot
*** SUMMARY ***
Total pot $0.02 | Rake $0
Seat 1: CO folded before Flop (didn't bet)
Seat 3: BTN (button) folded before Flop (didn't bet)
Seat 4: SB (small blind) folded before Flop
Seat 5: BB (big blind) collected ($0.02)
Seat 6: HJ folded before Flop (didn't bet)


PokerStars Hand #238162052333:  Hold'em No Limit ($0.01/$0.02 USD) - 2022/08/23 1:59:21 ET
Table 'Achilles IV' 6-max Seat #4 is the button
Seat 1: HJ ($2.37 in chips)
Seat 3: CO ($2.43 in chips)
Seat 4: BTN ($3.11 in chips)
Seat 5: SB ($2.02 in chips)
Seat 6: BB ($1.65 in chips)
SB: posts small blind $0.01
BB: posts big blind $0.02
*** HOLE CARDS ***
HJ: folds
CO: raises $0.04 to $0.06
BTN: folds
SB: folds
BB: calls $0.04
*** FLOP *** [4h 6h Qc]
BB: checks
CO: checks
*** TURN *** [4h 6h Qc] [9h]
BB: bets $0.04
CO: calls $0.04
*** RIVER *** [4h 6h Qc 9h] [2d]
BB: bets $0.10
CO: calls $0.10
*** SHOW DOWN ***
BB: shows [Ts 5s] (high card Queen)
CO: shows [8c 8h] (a pair of Eights)
CO collected $0.40 from pot
*** SUMMARY ***
Total pot $0.41 | Rake $0.01
Board [4h 6h Qc 9h 2d]
Seat 1: HJ folded before Flop (didn't bet)
Seat 3: CO showed [8c 8h] and won ($0.40) with a pair of Eights
Seat 4: BTN (button) folded before Flop (didn't bet)
Seat 5: SB (small blind) folded before Flop
Seat 6: BB (big blind) showed [Ts 5s] and lost with high card Queen


PokerStars Hand #238162060505:  Hold'em No Limit ($0.01/$0.02 USD) - 2022/08/23 2:00:46 ET
Table 'Achilles IV' 6-max Seat #5 is the button
Seat 1: BB ($2.37 in chips)
Seat 3: HJ ($2.63 in chips)
Seat 4: CO ($3.11 in chips)
Seat 5: BTN ($2.01 in chips)
Seat 6: SB ($1.45 in chips)
SB: posts small blind $0.01
BB: posts big blind $0.02
*** HOLE CARDS ***
HJ: folds
CO: raises $0.04 to $0.06
BTN: folds
SB: folds
BB: folds
Uncalled bet ($0.04) returned to CO
CO collected $0.05 from pot
CO: doesn't show hand
*** SUMMARY ***
Total pot $0.05 | Rake $0
Seat 1: BB (big blind) folded before Flop
Seat 3: HJ folded before Flop (didn't bet)
Seat 4: CO collected ($0.05)
Seat 5: BTN (button) folded before Flop (didn't bet)
Seat 6: SB (small blind) folded before Flop


PokerStars Hand #238162061880:  Hold'em No Limit ($0.01/$0.02 USD) - 2022/08/23 2:01:00 ET
Table 'Achilles IV' 6-max Seat #6 is the button
Seat 1: SB ($2.35 in chips)
Seat 3: BB ($2.63 in chips)
Seat 4: HJ ($3.14 in chips)
Seat 5: CO ($2.01 in chips)
Seat 6: BTN ($1.44 in chips)
SB: posts small blind $0.01
BB: posts big blind $0.02
*** HOLE CARDS ***
HJ: raises $0.02 to $0.04
CO: folds
BTN: raises $0.02 to $0.06
SB: folds
BB: folds
HJ: calls $0.02
*** FLOP *** [Ad 2c 7s]
HJ: checks
BTN: bets $0.07
HJ: calls $0.07
*** TURN *** [Ad 2c 7s] [6d]
HJ: bets $0.14
BTN: folds
Uncalled bet ($0.14) returned to HJ
HJ collected $0.28 from pot
HJ: doesn't show hand
*** SUMMARY ***
Total pot $0.29 | Rake $0.01
Board [Ad 2c 7s 6d]
Seat 1: SB (small blind) folded before Flop
Seat 3: BB (big blind) folded before Flop
Seat 4: HJ collected ($0.28)
Seat 5: CO folded before Flop (didn't bet)
Seat 6: BTN (button) folded on the Turn


PokerStars Hand #238162065364:  Hold'em No Limit ($0.01/$0.02 USD) - 2022/08/23 2:01:33 ET
Table 'Achilles IV' 6-max Seat #1 is the button
Seat 1: BTN ($2.34 in chips)
Seat 3: SB ($2.61 in chips)
Seat 4: BB ($3.29 in chips)
Seat 5: HJ ($2.01 in chips)
Seat 6: CO ($1.31 in chips)
SB: posts small blind $0.01
BB: posts big blind $0.02
*** HOLE CARDS ***
HJ: raises $0.04 to $0.06
CO: raises $0.12 to $0.18
BTN: folds
SB: folds
BB: folds
HJ: folds
Uncalled bet ($0.12) returned to CO
CO collected $0.15 from pot
CO: doesn't show hand
*** SUMMARY ***
Total pot $0.15 | Rake $0
Seat 1: BTN (button) folded before Flop (didn't bet)
Seat 3: SB (small blind) folded before Flop
Seat 4: BB (big blind) folded before Flop
Seat 5: HJ folded before Flop
Seat 6: CO collected ($0.15)


PokerStars Hand #238162067352:  Hold'em No Limit ($0.01/$0.02 USD) - 2022/08/23 2:01:52 ET
Table 'Achilles IV' 6-max Seat #3 is the button
Seat 1: CO ($2.34 in chips)
Seat 3: BTN ($2.60 in chips)
Seat 4: SB ($3.27 in chips)
Seat 5: BB ($2 in chips)
Seat 6: HJ ($1.40 in chips)
SB: posts small blind $0.01
BB: posts big blind $0.02
*** HOLE CARDS ***
HJ: folds
CO: folds
BTN: raises $0.03 to $0.05
SB: folds
BB: folds
Uncalled bet ($0.03) returned to BTN
BTN collected $0.05 from pot
BTN: doesn't show hand
*** SUMMARY ***
Total pot $0.05 | Rake $0
Seat 1: CO folded before Flop (didn't bet)
Seat 3: BTN (button) collected ($0.05)
Seat 4: SB (small blind) folded before Flop
Seat 5: BB (big blind) folded before Flop
Seat 6: HJ folded before Flop (didn't bet)


PokerStars Hand #238162069579:  Hold'em No Limit ($0.01/$0.02 USD) - 2022/08/23 2:02:13 ET
Table 'Achilles IV' 6-max Seat #4 is the button
Seat 1: HJ ($2.34 in chips)
Seat 3: CO ($2.63 in chips)
Seat 4: BTN ($3.26 in chips)
Seat 5: SB ($2 in chips)
Seat 6: BB ($1.40 in chips)
SB: posts small blind $0.01
BB: posts big blind $0.02
*** HOLE CARDS ***
HJ: folds
CO: folds
BTN: folds
SB: folds
Uncalled bet ($0.01) returned to BB
BB collected $0.02 from pot
BB: doesn't show hand
*** SUMMARY ***
Total pot $0.02 | Rake $0
Seat 1: HJ folded before Flop (didn't bet)
Seat 3: CO folded before Flop (didn't bet)
Seat 4: BTN (button) folded before Flop (didn't bet)
Seat 5: SB (small blind) folded before Flop
Seat 6: BB (big blind) collected ($0.02)


PokerStars Hand #238162071269:  Hold'em No Limit ($0.01/$0.02 USD) - 2022/08/23 2:02:30 ET
Table 'Achilles IV' 6-max Seat #5 is the button
Seat 1: BB ($2.34 in chips)
Seat 3: HJ ($2.63 in chips)
Seat 4: CO ($3.26 in chips)
Seat 5: BTN ($2 in chips)
Seat 6: SB ($1.41 in chips)
SB: posts small blind $0.01
BB: posts big blind $0.02
*** HOLE CARDS ***
HJ: folds
CO: raises $0.04 to $0.06
BTN: folds
SB: folds
BB: calls $0.04
*** FLOP *** [5h 2d 7h]
BB: checks
CO: bets $0.06
BB: raises $0.17 to $0.23
CO: calls $0.17
*** TURN *** [5h 2d 7h] [3s]
BB: bets $0.38
CO: calls $0.38
*** RIVER *** [5h 2d 7h 3s] [Qs]
BB: checks
CO: checks
*** SHOW DOWN ***
BB: shows [8h Kh] (high card King)
CO: shows [9s 9c] (a pair of Nines)
CO collected $1.30 from pot
*** SUMMARY ***
Total pot $1.35 | Rake $0.05
Board [5h 2d 7h 3s Qs]
Seat 1: BB (big blind) showed [8h Kh] and lost with high card King
Seat 3: HJ folded before Flop (didn't bet)
Seat 4: CO showed [9s 9c] and won ($1.30) with a pair of Nines
Seat 5: BTN (button) folded before Flop (didn't bet)
Seat 6: SB (small blind) folded before Flop


PokerStars Hand #238162076516:  Hold'em No Limit ($0.01/$0.02 USD) - 2022/08/23 2:03:21 ET
Table 'Achilles IV' 6-max Seat #6 is the button
Seat 1: SB ($2 in chips)
Seat 3: BB ($2.63 in chips)
Seat 4: HJ ($3.89 in chips)
Seat 5: CO ($2 in chips)
Seat 6: BTN ($1.40 in chips)
SB: posts small blind $0.01
BB: posts big blind $0.02
*** HOLE CARDS ***
HJ: raises $0.02 to $0.04
CO: folds
BTN: calls $0.04
SB: calls $0.03
BB: raises $0.22 to $0.26
HJ: folds
BTN: folds
SB: calls $0.22
*** FLOP *** [7c Ks 4d]
SB: checks
BB: bets $0.18
SB: calls $0.18
*** TURN *** [7c Ks 4d] [Qh]
SB: checks
BB: bets $0.40
SB: folds
Uncalled bet ($0.40) returned to BB
BB collected $0.93 from pot
BB: doesn't show hand
*** SUMMARY ***
Total pot $0.96 | Rake $0.03
Board [7c Ks 4d Qh]
Seat 1: SB (small blind) folded on the Turn
Seat 3: BB (big blind) collected ($0.93)
Seat 4: HJ folded before Flop
Seat 5: CO folded before Flop (didn't bet)
Seat 6: BTN (button) folded before Flop


PokerStars Hand #238162087026:  Hold'em No Limit ($0.01/$0.02 USD) - 2022/08/23 2:05:03 ET
Table 'Achilles IV' 6-max Seat #3 is the button
Seat 1: CO ($2 in chips)
Seat 3: BTN ($3.11 in chips)
Seat 4: SB ($3.83 in chips)
Seat 5: BB ($2 in chips)
Seat 6: HJ ($1.39 in chips)
SB: posts small blind $0.01
BB: posts big blind $0.02
*** HOLE CARDS ***
HJ: raises $0.04 to $0.06
CO: folds
BTN: folds
SB: folds
BB: folds
Uncalled bet ($0.04) returned to HJ
HJ collected $0.05 from pot
HJ: doesn't show hand
*** SUMMARY ***
Total pot $0.05 | Rake $0
Seat 1: CO folded before Flop (didn't bet)
Seat 3: BTN (button) folded before Flop (didn't bet)
Seat 4: SB (small blind) folded before Flop
Seat 5: BB (big blind) folded before Flop
Seat 6: HJ collected ($0.05)


PokerStars Hand #238162084799:  Hold'em No Limit ($0.01/$0.02 USD) - 2022/08/23 2:04:41 ET
Table 'Achilles IV' 6-max Seat #1 is the button
Seat 1: BTN ($2 in chips)
Seat 3: SB ($3.12 in chips)
Seat 4: BB ($3.85 in chips)
Seat 5: HJ ($2 in chips)
Seat 6: CO ($1.36 in chips)
SB: posts small blind $0.01
BB: posts big blind $0.02
*** HOLE CARDS ***
HJ: folds
CO: raises $0.04 to $0.06
BTN: folds
SB: folds
BB: folds
Uncalled bet ($0.04) returned to CO
CO collected $0.05 from pot
CO: doesn't show hand
*** SUMMARY ***
Total pot $0.05 | Rake $0
Seat 1: BTN (button) folded before Flop (didn't bet)
Seat 3: SB (small blind) folded before Flop
Seat 4: BB (big blind) folded before Flop
Seat 5: HJ folded before Flop (didn't bet)
Seat 6: CO collected ($0.05)


PokerStars Hand #238162088254:  Hold'em No Limit ($0.01/$0.02 USD) - 2022/08/23 2:05:15 ET
Table 'Achilles IV' 6-max Seat #4 is the button
Seat 1: HJ ($2 in chips)
Seat 3: CO ($3.11 in chips)
Seat 4: BTN ($3.82 in chips)
Seat 5: SB ($2 in chips)
Seat 6: BB ($1.42 in chips)
SB: posts small blind $0.01
BB: posts big blind $0.02
*** HOLE CARDS ***
HJ: folds
CO: folds
BTN: folds
SB: folds
Uncalled bet ($0.01) returned to BB
BB collected $0.02 from pot
BB: doesn't show hand
*** SUMMARY ***
Total pot $0.02 | Rake $0
Seat 1: HJ folded before Flop (didn't bet)
Seat 3: CO folded before Flop (didn't bet)
Seat 4: BTN (button) folded before Flop (didn't bet)
Seat 5: SB (small blind) folded before Flop
Seat 6: BB (big blind) collected ($0.02)


PokerStars Hand #238162089500:  Hold'em No Limit ($0.01/$0.02 USD) - 2022/08/23 2:05:28 ET
Table 'Achilles IV' 6-max Seat #5 is the button
Seat 1: BB ($2 in chips)
Seat 3: HJ ($3.11 in chips)
Seat 4: CO ($3.82 in chips)
Seat 5: BTN ($2 in chips)
Seat 6: SB ($1.43 in chips)
SB: posts small blind $0.01
BB: posts big blind $0.02
*** HOLE CARDS ***
HJ: folds
CO: folds
BTN: raises $0.04 to $0.06
SB: folds
BB: folds
Uncalled bet ($0.04) returned to BTN
BTN collected $0.05 from pot
*** SUMMARY ***
Total pot $0.05 | Rake $0
Seat 1: BB (big blind) folded before Flop
Seat 3: HJ folded before Flop (didn't bet)
Seat 4: CO folded before Flop (didn't bet)
Seat 5: BTN (button) collected ($0.05)
Seat 6: SB (small blind) folded before Flop


PokerStars Hand #238162091775:  Hold'em No Limit ($0.01/$0.02 USD) - 2022/08/23 2:05:49 ET
Table 'Achilles IV' 6-max Seat #6 is the button
Seat 1: SB ($2 in chips)
Seat 3: BB ($3.11 in chips)
Seat 4: HJ ($3.82 in chips)
Seat 5: CO ($2.03 in chips)
Seat 6: BTN ($1.42 in chips)
SB: posts small blind $0.01
BB: posts big blind $0.02
*** HOLE CARDS ***
HJ: folds
CO: folds
BTN: calls $0.02
SB: calls $0.01
BB: raises $0.10 to $0.12
BTN: folds
SB: folds
Uncalled bet ($0.10) returned to BB
BB collected $0.06 from pot
BB: doesn't show hand
*** SUMMARY ***
Total pot $0.06 | Rake $0
Seat 1: SB (small blind) folded before Flop
Seat 3: BB (big blind) collected ($0.06)
Seat 4: HJ folded before Flop (didn't bet)
Seat 5: CO folded before Flop (didn't bet)
Seat 6: BTN (button) folded before Flop


PokerStars Hand #238162094742:  Hold'em No Limit ($0.01/$0.02 USD) - 2022/08/23 2:06:18 ET
Table 'Achilles IV' 6-max Seat #1 is the button
Seat 1: BTN ($2 in chips)
Seat 3: SB ($3.15 in chips)
Seat 5: BB ($2.03 in chips)
Seat 6: CO ($1.40 in chips)
SB: posts small blind $0.01
Sabaka777: is sitting out
BB: posts big blind $0.02
*** HOLE CARDS ***
CO: calls $0.02
Sabaka777 leaves the table
BTN: folds
SB: folds
BB: checks
*** FLOP *** [Kd Qc Jh]
BB: checks
CO: checks
*** TURN *** [Kd Qc Jh] [Ts]
BB: checks
CO: bets $0.04
BB: folds
Uncalled bet ($0.04) returned to CO
CO collected $0.05 from pot
CO: doesn't show hand
*** SUMMARY ***
Total pot $0.05 | Rake $0
Board [Kd Qc Jh Ts]
Seat 1: BTN (button) folded before Flop (didn't bet)
Seat 3: SB (small blind) folded before Flop
Seat 5: BB (big blind) folded on the Turn
Seat 6: CO collected ($0.05)


PokerStars Hand #238162097102:  Hold'em No Limit ($0.01/$0.02 USD) - 2022/08/23 2:06:41 ET
Table 'Achilles IV' 6-max Seat #3 is the button
Seat 1: CO ($2 in chips)
Seat 3: BTN ($3.14 in chips)
Seat 5: SB ($2.01 in chips)
Seat 6: BB ($1.43 in chips)
SB: posts small blind $0.01
BB: posts big blind $0.02
*** HOLE CARDS ***
CO: folds
BTN: folds
SB: calls $0.01
BB: checks
*** FLOP *** [3d 5d 2d]
SB: checks
BB: bets $0.04
SB: folds
Uncalled bet ($0.04) returned to BB
BB collected $0.04 from pot
BB: doesn't show hand
*** SUMMARY ***
Total pot $0.04 | Rake $0
Board [3d 5d 2d]
Seat 1: CO folded before Flop (didn't bet)
Seat 3: BTN (button) folded before Flop (didn't bet)
Seat 5: SB (small blind) folded on the Flop
Seat 6: BB (big blind) collected ($0.04)


PokerStars Hand #238162100205:  Hold'em No Limit ($0.01/$0.02 USD) - 2022/08/23 2:07:11 ET
Table 'Achilles IV' 6-max Seat #5 is the button
Seat 1: BB ($2 in chips)
Seat 3: CO ($3.14 in chips)
Seat 5: BTN ($2 in chips)
Seat 6: SB ($1.45 in chips)
SB: posts small blind $0.01
BB: posts big blind $0.02
*** HOLE CARDS ***
CO: raises $0.04 to $0.06
kizzle72 joins the table at seat #4
BTN: raises $0.09 to $0.15
SB: folds
BB: folds
CO: raises $0.27 to $0.42
BTN: folds
Uncalled bet ($0.27) returned to CO
CO collected $0.33 from pot
CO: doesn't show hand
*** SUMMARY ***
Total pot $0.33 | Rake $0
Seat 1: BB (big blind) folded before Flop
Seat 3: CO collected ($0.33)
Seat 5: BTN (button) folded before Flop
Seat 6: SB (small blind) folded before Flop


PokerStars Hand #238162104842:  Hold'em No Limit ($0.01/$0.02 USD) - 2022/08/23 2:07:55 ET
Table 'Achilles IV' 6-max Seat #1 is the button
Seat 1: BTN ($2 in chips)
Seat 3: SB ($3.33 in chips)
Seat 4: BB ($1.29 in chips)
Seat 5: HJ ($2 in chips)
Seat 6: CO ($1.44 in chips)
SB: posts small blind $0.01
BB: posts big blind $0.02
*** HOLE CARDS ***
HJ: folds
CO: folds
BTN: folds
SB: folds
Uncalled bet ($0.01) returned to BB
BB collected $0.02 from pot
*** SUMMARY ***
Total pot $0.02 | Rake $0
Seat 1: BTN (button) folded before Flop (didn't bet)
Seat 3: SB (small blind) folded before Flop
Seat 4: BB (big blind) collected ($0.02)
Seat 5: HJ folded before Flop (didn't bet)
Seat 6: CO folded before Flop (didn't bet)


PokerStars Hand #238162103804:  Hold'em No Limit ($0.01/$0.02 USD) - 2022/08/23 2:07:45 ET
Table 'Achilles IV' 6-max Seat #6 is the button
Seat 1: SB ($2 in chips)
Seat 3: BB ($3.32 in chips)
Seat 5: CO ($2 in chips)
Seat 6: BTN ($1.44 in chips)
SB: posts small blind $0.01
BB: posts big blind $0.02
kizzle72: sits out
*** HOLE CARDS ***
CO: folds
BTN: folds
SB: folds
Uncalled bet ($0.01) returned to BB
BB collected $0.02 from pot
msmbenz9900 was removed from the table for failing to post
msmbenz9900 leaves the table
BB: doesn't show hand
*** SUMMARY ***
Total pot $0.02 | Rake $0
Seat 1: SB (small blind) folded before Flop
Seat 3: BB (big blind) collected ($0.02)
Seat 5: CO folded before Flop (didn't bet)
Seat 6: BTN (button) folded before Flop (didn't bet)


PokerStars Hand #238162106304:  Hold'em No Limit ($0.01/$0.02 USD) - 2022/08/23 2:08:09 ET
Table 'Achilles IV' 6-max Seat #3 is the button
Seat 1: CO ($2 in chips)
Seat 3: BTN ($3.32 in chips)
Seat 4: SB ($1.30 in chips)
Seat 5: BB ($2 in chips)
Seat 6: HJ ($1.44 in chips)
SB: posts small blind $0.01
BB: posts big blind $0.02
*** HOLE CARDS ***
spider568 joins the table at seat #2
HJ: calls $0.02
CO: folds
BTN: folds
SB: folds
BB: checks
*** FLOP *** [Tc 2h 2d]
BB: checks
HJ: bets $0.04
BB: folds
Uncalled bet ($0.04) returned to HJ
HJ collected $0.05 from pot
HJ: doesn't show hand
*** SUMMARY ***
Total pot $0.05 | Rake $0
Board [Tc 2h 2d]
Seat 1: CO folded before Flop (didn't bet)
Seat 3: BTN (button) folded before Flop (didn't bet)
Seat 4: SB (small blind) folded before Flop
Seat 5: BB (big blind) folded on the Flop
Seat 6: HJ collected ($0.05)


PokerStars Hand #238162109812:  Hold'em No Limit ($0.01/$0.02 USD) - 2022/08/23 2:08:43 ET
Table 'Achilles IV' 6-max Seat #4 is the button
Seat 1: UTG ($2 in chips)
Seat 2: HJ ($2 in chips)
Seat 3: CO ($3.32 in chips)
Seat 4: BTN ($1.29 in chips)
Seat 5: SB ($2 in chips)
Seat 6: BB ($1.47 in chips)
SB: posts small blind $0.01
BB: posts big blind $0.02
HJ: posts big blind $0.02
*** HOLE CARDS ***
UTG: folds
HJ: checks
CO: raises $0.06 to $0.08
BTN: folds
SB: folds
BB: folds
HJ: folds
Uncalled bet ($0.06) returned to CO
CO collected $0.07 from pot
CO: doesn't show hand
*** SUMMARY ***
Total pot $0.07 | Rake $0
Seat 1: UTG folded before Flop (didn't bet)
Seat 2: HJ folded before Flop (didn't bet)
Seat 3: CO collected ($0.07)
Seat 4: BTN (button) folded before Flop (didn't bet)
Seat 5: SB (small blind) folded before Flop
Seat 6: BB (big blind) folded before Flop


PokerStars Hand #238162111626:  Hold'em No Limit ($0.01/$0.02 USD) - 2022/08/23 2:09:01 ET
Table 'Achilles IV' 6-max Seat #5 is the button
Seat 1: BB ($2 in chips)
Seat 2: UTG ($2 in chips)
Seat 3: HJ ($3.37 in chips)
Seat 4: CO ($1.29 in chips)
Seat 5: BTN ($2 in chips)
Seat 6: SB ($1.45 in chips)
SB: posts small blind $0.01
BB: posts big blind $0.02
*** HOLE CARDS ***
UTG: calls $0.02
HJ: folds
CO: raises $0.07 to $0.09
BTN: folds
SB: folds
BB: folds
UTG: folds
Uncalled bet ($0.07) returned to CO
CO collected $0.07 from pot
*** SUMMARY ***
Total pot $0.07 | Rake $0
Seat 1: BB (big blind) folded before Flop
Seat 2: UTG folded before Flop
Seat 3: HJ folded before Flop (didn't bet)
Seat 4: CO collected ($0.07)
Seat 5: BTN (button) folded before Flop (didn't bet)
Seat 6: SB (small blind) folded before Flop


PokerStars Hand #238162113679:  Hold'em No Limit ($0.01/$0.02 USD) - 2022/08/23 2:09:21 ET
Table 'Achilles IV' 6-max Seat #6 is the button
Seat 1: SB ($2 in chips)
Seat 2: BB ($2 in chips)
Seat 3: UTG ($3.37 in chips)
Seat 4: HJ ($1.34 in chips)
Seat 5: CO ($2 in chips)
Seat 6: BTN ($1.44 in chips)
SB: posts small blind $0.01
BB: posts big blind $0.02
*** HOLE CARDS ***
UTG: folds
HJ: folds
CO: folds
BTN: raises $0.04 to $0.06
SB: folds
BB: raises $0.08 to $0.14
BTN: calls $0.08
*** FLOP *** [Ac Td 7d]
BB: bets $0.30
BTN: folds
Uncalled bet ($0.30) returned to BB
BB collected $0.28 from pot
*** SUMMARY ***
Total pot $0.29 | Rake $0.01
Board [Ac Td 7d]
Seat 1: SB (small blind) folded before Flop
Seat 2: BB (big blind) collected ($0.28)
Seat 3: UTG folded before Flop (didn't bet)
Seat 4: HJ folded before Flop (didn't bet)
Seat 5: CO folded before Flop (didn't bet)
Seat 6: BTN (button) folded on the Flop


PokerStars Hand #238162116359:  Hold'em No Limit ($0.01/$0.02 USD) - 2022/08/23 2:09:47 ET
Table 'Achilles IV' 6-max Seat #1 is the button
Seat 1: BTN ($2 in chips)
Seat 2: SB ($2.14 in chips)
Seat 3: BB ($3.37 in chips)
Seat 4: UTG ($1.34 in chips)
Seat 5: HJ ($2 in chips)
Seat 6: CO ($1.30 in chips)
SB: posts small blind $0.01
BB: posts big blind $0.02
*** HOLE CARDS ***
UTG: folds
HJ: folds
CO: calls $0.02
BTN: folds
SB: calls $0.01
BB: checks
*** FLOP *** [4s 2d Qh]
SB: checks
BB: checks
CO: checks
*** TURN *** [4s 2d Qh] [As]
SB: bets $0.06
BB: folds
CO: folds
Uncalled bet ($0.06) returned to SB
SB collected $0.06 from pot
*** SUMMARY ***
Total pot $0.06 | Rake $0
Board [4s 2d Qh As]
Seat 1: BTN (button) folded before Flop (didn't bet)
Seat 2: SB (small blind) collected ($0.06)
Seat 3: BB (big blind) folded on the Turn
Seat 4: UTG folded before Flop (didn't bet)
Seat 5: HJ folded before Flop (didn't bet)
Seat 6: CO folded on the Turn


PokerStars Hand #238162122428:  Hold'em No Limit ($0.01/$0.02 USD) - 2022/08/23 2:10:48 ET
Table 'Achilles IV' 6-max Seat #2 is the button
Seat 1: CO ($2 in chips)
Seat 2: BTN ($2.18 in chips)
Seat 3: SB ($3.35 in chips)
Seat 4: BB ($1.34 in chips)
Seat 5: UTG ($2 in chips)
Seat 6: HJ ($1.28 in chips)
SB: posts small blind $0.01
BB: posts big blind $0.02
*** HOLE CARDS ***
UTG: folds
HJ: calls $0.02
CO: folds
BTN: folds
SB: folds
BB: checks
*** FLOP *** [7d 4s Js]
BB: checks
HJ: bets $0.04
BB: calls $0.04
*** TURN *** [7d 4s Js] [9c]
BB: checks
HJ: bets $0.08
BB: calls $0.08
*** RIVER *** [7d 4s Js 9c] [Kc]
BB: checks
HJ: bets $0.14
BB: folds
Uncalled bet ($0.14) returned to HJ
HJ collected $0.28 from pot
HJ: doesn't show hand
*** SUMMARY ***
Total pot $0.29 | Rake $0.01
Board [7d 4s Js 9c Kc]
Seat 1: CO folded before Flop (didn't bet)
Seat 2: BTN (button) folded before Flop (didn't bet)
Seat 3: SB (small blind) folded before Flop
Seat 4: BB (big blind) folded on the River
Seat 5: UTG folded before Flop (didn't bet)
Seat 6: HJ collected ($0.28)


PokerStars Hand #238162127280:  Hold'em No Limit ($0.01/$0.02 USD) - 2022/08/23 2:11:36 ET
Table 'Achilles IV' 6-max Seat #3 is the button
Seat 1: HJ ($2 in chips)
Seat 2: CO ($2.18 in chips)
Seat 3: BTN ($3.34 in chips)
Seat 4: SB ($1.20 in chips)
Seat 5: BB ($2 in chips)
Seat 6: UTG ($1.42 in chips)
SB: posts small blind $0.01
BB: posts big blind $0.02
*** HOLE CARDS ***
UTG: folds
HJ: folds
CO: calls $0.02
BTN: folds
SB: folds
BB: checks
*** FLOP *** [Kd Qs 9s]
BB: checks
CO: bets $0.05
BB: folds
Uncalled bet ($0.05) returned to CO
CO collected $0.05 from pot
*** SUMMARY ***
Total pot $0.05 | Rake $0
Board [Kd Qs 9s]
Seat 1: HJ folded before Flop (didn't bet)
Seat 2: CO collected ($0.05)
Seat 3: BTN (button) folded before Flop (didn't bet)
Seat 4: SB (small blind) folded before Flop
Seat 5: BB (big blind) folded on the Flop
Seat 6: UTG folded before Flop (didn't bet)


PokerStars Hand #238162129863:  Hold'em No Limit ($0.01/$0.02 USD) - 2022/08/23 2:12:02 ET
Table 'Achilles IV' 6-max Seat #4 is the button
Seat 1: UTG ($2 in chips)
Seat 2: HJ ($2.21 in chips)
Seat 3: CO ($3.34 in chips)
Seat 4: BTN ($1.19 in chips)
Seat 5: SB ($2 in chips)
Seat 6: BB ($1.42 in chips)
SB: posts small blind $0.01
BB: posts big blind $0.02
*** HOLE CARDS ***
UTG: folds
HJ: calls $0.02
CO: folds
BTN: folds
SB: folds
BB: raises $0.04 to $0.06
HJ: folds
Uncalled bet ($0.04) returned to BB
BB collected $0.05 from pot
BB: doesn't show hand
*** SUMMARY ***
Total pot $0.05 | Rake $0
Seat 1: UTG folded before Flop (didn't bet)
Seat 2: HJ folded before Flop
Seat 3: CO folded before Flop (didn't bet)
Seat 4: BTN (button) folded before Flop (didn't bet)
Seat 5: SB (small blind) folded before Flop
Seat 6: BB (big blind) collected ($0.05)


PokerStars Hand #238162132139:  Hold'em No Limit ($0.01/$0.02 USD) - 2022/08/23 2:12:24 ET
Table 'Achilles IV' 6-max Seat #5 is the button
Seat 1: BB ($2 in chips)
Seat 2: UTG ($2.19 in chips)
Seat 3: HJ ($3.34 in chips)
Seat 4: CO ($1.19 in chips)
Seat 5: BTN ($2 in chips)
Seat 6: SB ($1.45 in chips)
SB: posts small blind $0.01
BB: posts big blind $0.02
*** HOLE CARDS ***
UTG: calls $0.02
HJ: folds
CO: calls $0.02
BTN: folds
SB: calls $0.01
BB: checks
*** FLOP *** [2s Qs 3h]
SB: checks
BB: checks
UTG: bets $0.04
CO: calls $0.04
SB: calls $0.04
BB: calls $0.04
*** TURN *** [2s Qs 3h] [Jh]
SB: checks
BB: checks
UTG: checks
CO: bets $0.23
SB: folds
BB: folds
UTG: calls $0.23
*** RIVER *** [2s Qs 3h Jh] [Qd]
UTG: bets $0.10
CO: calls $0.10
*** SHOW DOWN ***
UTG: shows [4s Ts] (a pair of Queens)
CO: shows [3s Js] (two pair, Queens and Jacks)
CO collected $0.87 from pot
*** SUMMARY ***
Total pot $0.90 | Rake $0.03
Board [2s Qs 3h Jh Qd]
Seat 1: BB (big blind) folded on the Turn
Seat 2: UTG showed [4s Ts] and lost with a pair of Queens
Seat 3: HJ folded before Flop (didn't bet)
Seat 4: CO showed [3s Js] and won ($0.87) with two pair, Queens and Jacks
Seat 5: BTN (button) folded before Flop (didn't bet)
Seat 6: SB (small blind) folded on the Turn


PokerStars Hand #238162140955:  Hold'em No Limit ($0.01/$0.02 USD) - 2022/08/23 2:13:51 ET
Table 'Achilles IV' 6-max Seat #6 is the button
Seat 1: SB ($2 in chips)
Seat 2: BB ($2 in chips)
Seat 3: UTG ($3.34 in chips)
Seat 4: HJ ($1.67 in chips)
Seat 5: CO ($2 in chips)
Seat 6: BTN ($1.39 in chips)
SB: posts small blind $0.01
BB: posts big blind $0.02
*** HOLE CARDS ***
UTG: folds
HJ: calls $0.02
CO: folds
BTN: calls $0.02
SB: calls $0.01
BB: checks
*** FLOP *** [3h Kd 2h]
SB: checks
BB: checks
HJ: checks
BTN: checks
*** TURN *** [3h Kd 2h] [Js]
SB: checks
BB: bets $0.04
HJ: folds
BTN: folds
SB: folds
Uncalled bet ($0.04) returned to BB
BB collected $0.08 from pot
*** SUMMARY ***
Total pot $0.08 | Rake $0
Board [3h Kd 2h Js]
Seat 1: SB (small blind) folded on the Turn
Seat 2: BB (big blind) collected ($0.08)
Seat 3: UTG folded before Flop (didn't bet)
Seat 4: HJ folded on the Turn
Seat 5: CO folded before Flop (didn't bet)
Seat 6: BTN (button) folded on the Turn


PokerStars Hand #238162146676:  Hold'em No Limit ($0.01/$0.02 USD) - 2022/08/23 2:14:46 ET
Table 'Achilles IV' 6-max Seat #1 is the button
Seat 1: BTN ($2 in chips)
Seat 2: SB ($2.06 in chips)
Seat 3: BB ($3.34 in chips)
Seat 4: UTG ($1.65 in chips)
Seat 5: HJ ($2 in chips)
Seat 6: CO ($1.37 in chips)
SB: posts small blind $0.01
BB: posts big blind $0.02
*** HOLE CARDS ***
UTG: calls $0.02
HJ: folds
CO: calls $0.02
BTN: folds
SB: calls $0.01
BB: checks
*** FLOP *** [2c 4s Js]
SB: bets $0.08
BB: folds
UTG: calls $0.08
CO: folds
*** TURN *** [2c 4s Js] [Ac]
SB: checks
UTG: checks
*** RIVER *** [2c 4s Js Ac] [Qd]
SB: bets $0.11
UTG: folds
Uncalled bet ($0.11) returned to SB
SB collected $0.23 from pot
*** SUMMARY ***
Total pot $0.24 | Rake $0.01
Board [2c 4s Js Ac Qd]
Seat 1: BTN (button) folded before Flop (didn't bet)
Seat 2: SB (small blind) collected ($0.23)
Seat 3: BB (big blind) folded on the Flop
Seat 4: UTG folded on the River
Seat 5: HJ folded before Flop (didn't bet)
Seat 6: CO folded on the Flop


PokerStars Hand #238162152461:  Hold'em No Limit ($0.01/$0.02 USD) - 2022/08/23 2:15:42 ET
Table 'Achilles IV' 6-max Seat #2 is the button
Seat 1: CO ($2 in chips)
Seat 2: BTN ($2.19 in chips)
Seat 3: SB ($3.32 in chips)
Seat 5: BB ($2 in chips)
Seat 6: HJ ($1.35 in chips)
SB: posts small blind $0.01
BB: posts big blind $0.02
*** HOLE CARDS ***
HJ: calls $0.02
CO: folds
BTN: calls $0.02
SB: folds
BB: raises $0.04 to $0.06
HJ: calls $0.04
BTN: calls $0.04
*** FLOP *** [7h Ts 8c]
BB: bets $0.09
HJ: calls $0.09
BTN: folds
*** TURN *** [7h Ts 8c] [Js]
BB: checks
HJ: bets $0.18
BB: calls $0.18
*** RIVER *** [7h Ts 8c Js] [Ah]
BB: bets $0.02
HJ: raises $1 to $1.02 and is all-in
BB: folds
Uncalled bet ($1) returned to HJ
HJ collected $0.74 from pot
HJ: doesn't show hand
*** SUMMARY ***
Total pot $0.77 | Rake $0.03
Board [7h Ts 8c Js Ah]
Seat 1: CO folded before Flop (didn't bet)
Seat 2: BTN (button) folded on the Flop
Seat 3: SB (small blind) folded before Flop
Seat 5: BB (big blind) folded on the River
Seat 6: HJ collected ($0.74)


PokerStars Hand #238162160513:  Hold'em No Limit ($0.01/$0.02 USD) - 2022/08/23 2:17:00 ET
Table 'Achilles IV' 6-max Seat #3 is the button
Seat 1: HJ ($2 in chips)
Seat 2: CO ($2.13 in chips)
Seat 3: BTN ($3.31 in chips)
Seat 5: SB ($2 in chips)
Seat 6: BB ($1.74 in chips)
SB: posts small blind $0.01
BB: posts big blind $0.02
*** HOLE CARDS ***
HJ: raises $0.03 to $0.05
CO: folds
BTN: folds
SB: folds
BB: calls $0.03
*** FLOP *** [3c 6d 5d]
BB: checks
HJ: checks
*** TURN *** [3c 6d 5d] [Jd]
BB: checks
HJ: checks
*** RIVER *** [3c 6d 5d Jd] [4s]
BB: bets $0.05
HJ: folds
Uncalled bet ($0.05) returned to BB
BB collected $0.11 from pot
BB: doesn't show hand
*** SUMMARY ***
Total pot $0.11 | Rake $0
Board [3c 6d 5d Jd 4s]
Seat 1: HJ folded on the River
Seat 2: CO folded before Flop (didn't bet)
Seat 3: BTN (button) folded before Flop (didn't bet)
Seat 5: SB (small blind) folded before Flop
Seat 6: BB (big blind) collected ($0.11)


PokerStars Hand #238162163925:  Hold'em No Limit ($0.01/$0.02 USD) - 2022/08/23 2:17:32 ET
Table 'Achilles IV' 6-max Seat #5 is the button
Seat 1: BB ($2 in chips)
Seat 2: HJ ($2.13 in chips)
Seat 3: CO ($3.31 in chips)
Seat 5: BTN ($2 in chips)
Seat 6: SB ($1.80 in chips)
SB: posts small blind $0.01
BB: posts big blind $0.02
*** HOLE CARDS ***
HJ: folds
CO: raises $0.04 to $0.06
BTN: raises $0.09 to $0.15
SB: folds
BB: folds
CO: raises $0.25 to $0.40
BTN: raises $1.60 to $2 and is all-in
CO: folds
Uncalled bet ($1.60) returned to BTN
BTN collected $0.83 from pot
*** SUMMARY ***
Total pot $0.83 | Rake $0
Seat 1: BB (big blind) folded before Flop
Seat 2: HJ folded before Flop (didn't bet)
Seat 3: CO folded before Flop
Seat 5: BTN (button) collected ($0.83)
Seat 6: SB (small blind) folded before Flop


PokerStars Hand #238162169367:  Hold'em No Limit ($0.01/$0.02 USD) - 2022/08/23 2:18:25 ET
Table 'Achilles IV' 6-max Seat #6 is the button
Seat 1: SB ($2 in chips)
Seat 2: BB ($2.13 in chips)
Seat 3: HJ ($2.91 in chips)
Seat 5: CO ($2.43 in chips)
Seat 6: BTN ($1.79 in chips)
SB: posts small blind $0.01
BB: posts big blind $0.02
*** HOLE CARDS ***
HJ: folds
CO: folds
kizzle72 is disconnected
BTN: raises $0.04 to $0.06
SB: folds
BB: folds
Uncalled bet ($0.04) returned to BTN
BTN collected $0.05 from pot
BTN: doesn't show hand
*** SUMMARY ***
Total pot $0.05 | Rake $0
Seat 1: SB (small blind) folded before Flop
Seat 2: BB (big blind) folded before Flop
Seat 3: HJ folded before Flop (didn't bet)
Seat 5: CO folded before Flop (didn't bet)
Seat 6: BTN (button) collected ($0.05)


PokerStars Hand #238162171555:  Hold'em No Limit ($0.01/$0.02 USD) - 2022/08/23 2:18:47 ET
Table 'Achilles IV' 6-max Seat #1 is the button
Seat 1: BTN ($2 in chips)
Seat 2: SB ($2.11 in chips)
Seat 3: BB ($2.91 in chips)
Seat 5: HJ ($2.43 in chips)
Seat 6: CO ($1.82 in chips)
SB: posts small blind $0.01
BB: posts big blind $0.02
*** HOLE CARDS ***
HJ: folds
CO: calls $0.02
BTN: folds
SB: calls $0.01
BB: checks
*** FLOP *** [3h 9s 3c]
SB: bets $0.03
BB: folds
CO: calls $0.03
*** TURN *** [3h 9s 3c] [Kd]
SB: checks
CO: bets $0.06
SB: calls $0.06
*** RIVER *** [3h 9s 3c Kd] [As]
SB: bets $0.62
CO: folds
Uncalled bet ($0.62) returned to SB
SB collected $0.23 from pot
*** SUMMARY ***
Total pot $0.24 | Rake $0.01
Board [3h 9s 3c Kd As]
Seat 1: BTN (button) folded before Flop (didn't bet)
Seat 2: SB (small blind) collected ($0.23)
Seat 3: BB (big blind) folded on the Flop
Seat 5: HJ folded before Flop (didn't bet)
Seat 6: CO folded on the River


PokerStars Hand #238162175365:  Hold'em No Limit ($0.01/$0.02 USD) - 2022/08/23 2:19:25 ET
Table 'Achilles IV' 6-max Seat #2 is the button
Seat 1: CO ($2 in chips)
Seat 2: BTN ($2.23 in chips)
Seat 3: SB ($2.89 in chips)
Seat 6: BB ($1.71 in chips)
SB: posts small blind $0.01
falcao25: is sitting out
BB: posts big blind $0.02
*** HOLE CARDS ***
CO: folds
BTN: calls $0.02
SB: folds
BB: checks
*** FLOP *** [Ac Jh 9d]
BB: checks
BTN: bets $0.05
BB: raises $0.11 to $0.16
BTN: calls $0.11
*** TURN *** [Ac Jh 9d] [Ks]
BB: bets $0.20
falcao25 leaves the table
BTN: calls $0.20
*** RIVER *** [Ac Jh 9d Ks] [2d]
BB: bets $1.33 and is all-in
BTN: folds
Uncalled bet ($1.33) returned to BB
BB collected $0.74 from pot
BB: doesn't show hand
*** SUMMARY ***
Total pot $0.77 | Rake $0.03
Board [Ac Jh 9d Ks 2d]
Seat 1: CO folded before Flop (didn't bet)
Seat 2: BTN (button) folded on the River
Seat 3: SB (small blind) folded before Flop
Seat 6: BB (big blind) collected ($0.74)


PokerStars Hand #238162179984:  Hold'em No Limit ($0.01/$0.02 USD) - 2022/08/23 2:20:10 ET
Table 'Achilles IV' 6-max Seat #3 is the button
Seat 1: BB ($2 in chips)
Seat 2: CO ($2 in chips)
Seat 3: BTN ($2.88 in chips)
Seat 6: SB ($2.07 in chips)
SB: posts small blind $0.01
BB: posts big blind $0.02
*** HOLE CARDS ***
CO: calls $0.02
BTN: folds
SB: raises $0.04 to $0.06
BB: folds
CO: calls $0.04
*** FLOP *** [Qh Td Ts]
SB: bets $0.07
CO: calls $0.07
*** TURN *** [Qh Td Ts] [Ah]
SB: checks
CO: bets $0.13
Noah_D@vid joins the table at seat #5
SB: raises $0.27 to $0.40
CO: folds
Uncalled bet ($0.27) returned to SB
SB collected $0.52 from pot
SB: doesn't show hand
*** SUMMARY ***
Total pot $0.54 | Rake $0.02
Board [Qh Td Ts Ah]
Seat 1: BB (big blind) folded before Flop
Seat 2: CO folded on the Turn
Seat 3: BTN (button) folded before Flop (didn't bet)
Seat 6: SB (small blind) collected ($0.52)


PokerStars Hand #238162185895:  Hold'em No Limit ($0.01/$0.02 USD) - 2022/08/23 2:21:08 ET
Table 'Achilles IV' 6-max Seat #6 is the button
Seat 1: SB ($2 in chips)
Seat 2: BB ($2 in chips)
Seat 3: HJ ($2.88 in chips)
Seat 5: CO ($0.80 in chips)
Seat 6: BTN ($2.33 in chips)
SB: posts small blind $0.01
BB: posts big blind $0.02
CO: posts big blind $0.02
*** HOLE CARDS ***
HJ: folds
CO: checks
BTN: calls $0.02
SB: calls $0.01
BB: checks
*** FLOP *** [8d 4h Ad]
SB: checks
BB: checks
CO: checks
BTN: checks
*** TURN *** [8d 4h Ad] [Ah]
SB: checks
BB: checks
CO: checks
BTN: checks
*** RIVER *** [8d 4h Ad Ah] [Td]
SB: checks
BB: checks
CO: checks
BTN: checks
*** SHOW DOWN ***
SB: shows [2s 5c] (a pair of Aces)
BB: shows [Th 5s] (two pair, Aces and Tens)
CO: mucks hand
BTN: mucks hand
BB collected $0.08 from pot
*** SUMMARY ***
Total pot $0.08 | Rake $0
Board [8d 4h Ad Ah Td]
Seat 1: SB (small blind) showed [2s 5c] and lost with a pair of Aces
Seat 2: BB (big blind) showed [Th 5s] and won ($0.08) with two pair, Aces and Tens
Seat 3: HJ folded before Flop (didn't bet)
Seat 5: CO mucked
Seat 6: BTN (button) mucked


PokerStars Hand #238162191172:  Hold'em No Limit ($0.01/$0.02 USD) - 2022/08/23 2:21:58 ET
Table 'Achilles IV' 6-max Seat #1 is the button
Seat 1: BTN ($2 in chips)
Seat 2: SB ($2.06 in chips)
Seat 3: BB ($2.88 in chips)
Seat 5: HJ ($0.78 in chips)
Seat 6: CO ($2.31 in chips)
SB: posts small blind $0.01
BB: posts big blind $0.02
*** HOLE CARDS ***
HJ: folds
CO: raises $0.04 to $0.06
BTN: folds
SB: folds
BB: folds
Uncalled bet ($0.04) returned to CO
CO collected $0.05 from pot
CO: doesn't show hand
*** SUMMARY ***
Total pot $0.05 | Rake $0
Seat 1: BTN (button) folded before Flop (didn't bet)
Seat 2: SB (small blind) folded before Flop
Seat 3: BB (big blind) folded before Flop
Seat 5: HJ folded before Flop (didn't bet)
Seat 6: CO collected ($0.05)


PokerStars Hand #238162193476:  Hold'em No Limit ($0.01/$0.02 USD) - 2022/08/23 2:22:21 ET
Table 'Achilles IV' 6-max Seat #2 is the button
Seat 1: CO ($2 in chips)
Seat 2: BTN ($2.05 in chips)
Seat 3: SB ($2.86 in chips)
Seat 5: BB ($0.78 in chips)
Seat 6: HJ ($2.34 in chips)
SB: posts small blind $0.01
BB: posts big blind $0.02
*** HOLE CARDS ***
HJ: raises $0.06 to $0.08
CO: folds
BTN: calls $0.08
SB: folds
BB: folds
*** FLOP *** [Qs Ad 3d]
HJ: checks
BTN: checks
*** TURN *** [Qs Ad 3d] [8h]
HJ: bets $0.09
BTN: calls $0.09
*** RIVER *** [Qs Ad 3d 8h] [6s]
HJ: bets $0.36
BTN: folds
Uncalled bet ($0.36) returned to HJ
HJ collected $0.36 from pot
HJ: doesn't show hand
*** SUMMARY ***
Total pot $0.37 | Rake $0.01
Board [Qs Ad 3d 8h 6s]
Seat 1: CO folded before Flop (didn't bet)
Seat 2: BTN (button) folded on the River
Seat 3: SB (small blind) folded before Flop
Seat 5: BB (big blind) folded before Flop
Seat 6: HJ collected ($0.36)


PokerStars Hand #238162196921:  Hold'em No Limit ($0.01/$0.02 USD) - 2022/08/23 2:22:55 ET
Table 'Achilles IV' 6-max Seat #3 is the button
Seat 1: HJ ($2 in chips)
Seat 2: CO ($2 in chips)
Seat 3: BTN ($2.85 in chips)
Seat 5: SB ($0.76 in chips)
Seat 6: BB ($2.53 in chips)
SB: posts small blind $0.01
BB: posts big blind $0.02
*** HOLE CARDS ***
HJ: folds
CO: calls $0.02
BTN: folds
SB: folds
BB: checks
*** FLOP *** [7s 8s Ad]
BB: checks
CO: checks
*** TURN *** [7s 8s Ad] [6s]
BB: checks
CO: checks
*** RIVER *** [7s 8s Ad 6s] [4s]
BB: checks
CO: checks
*** SHOW DOWN ***
BB: shows [3s 2c] (a flush, Eight high)
CO: mucks hand
BB collected $0.05 from pot
*** SUMMARY ***
Total pot $0.05 | Rake $0
Board [7s 8s Ad 6s 4s]
Seat 1: HJ folded before Flop (didn't bet)
Seat 2: CO mucked
Seat 3: BTN (button) folded before Flop (didn't bet)
Seat 5: SB (small blind) folded before Flop
Seat 6: BB (big blind) showed [3s 2c] and won ($0.05) with a flush, Eight high


PokerStars Hand #238162200021:  Hold'em No Limit ($0.01/$0.02 USD) - 2022/08/23 2:23:25 ET
Table 'Achilles IV' 6-max Seat #5 is the button
Seat 1: BB ($2 in chips)
Seat 2: HJ ($2 in chips)
Seat 3: CO ($2.85 in chips)
Seat 5: BTN ($0.75 in chips)
Seat 6: SB ($2.56 in chips)
SB: posts small blind $0.01
BB: posts big blind $0.02
*** HOLE CARDS ***
HJ: calls $0.02
CO: folds
BTN: folds
SB: calls $0.01
BB: checks
*** FLOP *** [5c Qd 3c]
SB: checks
BB: checks
HJ: checks
*** TURN *** [5c Qd 3c] [Ac]
SB: checks
BB: checks
HJ: checks
*** RIVER *** [5c Qd 3c Ac] [Ts]
SB: checks
BB: checks
HJ: checks
*** SHOW DOWN ***
SB: shows [4s 6s] (high card Ace)
BB: shows [9s 5d] (a pair of Fives)
HJ: shows [Jd Qs] (a pair of Queens)
HJ collected $0.06 from pot
*** SUMMARY ***
Total pot $0.06 | Rake $0
Board [5c Qd 3c Ac Ts]
Seat 1: BB (big blind) showed [9s 5d] and lost with a pair of Fives
Seat 2: HJ showed [Jd Qs] and won ($0.06) with a pair of Queens
Seat 3: CO folded before Flop (didn't bet)
Seat 5: BTN (button) folded before Flop (didn't bet)
Seat 6: SB (small blind) showed [4s 6s] and lost with high card Ace


PokerStars Hand #238162203086:  Hold'em No Limit ($0.01/$0.02 USD) - 2022/08/23 2:23:55 ET
Table 'Achilles IV' 6-max Seat #6 is the button
Seat 1: SB ($2 in chips)
Seat 2: BB ($2.04 in chips)
Seat 3: HJ ($2.85 in chips)
Seat 5: CO ($0.75 in chips)
Seat 6: BTN ($2.54 in chips)
SB: posts small blind $0.01
BB: posts big blind $0.02
*** HOLE CARDS ***
HJ: folds
CO: folds
BTN: calls $0.02
SB: raises $0.06 to $0.08
BB: folds
BTN: calls $0.06
*** FLOP *** [3d Jh Ah]
SB: bets $0.11
BTN: folds
Uncalled bet ($0.11) returned to SB
SB collected $0.17 from pot
*** SUMMARY ***
Total pot $0.18 | Rake $0.01
Board [3d Jh Ah]
Seat 1: SB (small blind) collected ($0.17)
Seat 2: BB (big blind) folded before Flop
Seat 3: HJ folded before Flop (didn't bet)
Seat 5: CO folded before Flop (didn't bet)
Seat 6: BTN (button) folded on the Flop


PokerStars Hand #238162205791:  Hold'em No Limit ($0.01/$0.02 USD) - 2022/08/23 2:24:22 ET
Table 'Achilles IV' 6-max Seat #1 is the button
Seat 1: BTN ($2.09 in chips)
Seat 2: SB ($2.02 in chips)
Seat 3: BB ($2.85 in chips)
Seat 5: HJ ($0.75 in chips)
Seat 6: CO ($2.46 in chips)
SB: posts small blind $0.01
BB: posts big blind $0.02
*** HOLE CARDS ***
HJ: folds
CO: folds
BTN: folds
SB: folds
Uncalled bet ($0.01) returned to BB
BB collected $0.02 from pot
BB: doesn't show hand
*** SUMMARY ***
Total pot $0.02 | Rake $0
Seat 1: BTN (button) folded before Flop (didn't bet)
Seat 2: SB (small blind) folded before Flop
Seat 3: BB (big blind) collected ($0.02)
Seat 5: HJ folded before Flop (didn't bet)
Seat 6: CO folded before Flop (didn't bet)


PokerStars Hand #238162206968:  Hold'em No Limit ($0.01/$0.02 USD) - 2022/08/23 2:24:33 ET
Table 'Achilles IV' 6-max Seat #2 is the button
Seat 1: CO ($2.09 in chips)
Seat 2: BTN ($2.01 in chips)
Seat 3: SB ($2.86 in chips)
Seat 5: BB ($0.75 in chips)
Seat 6: HJ ($2.46 in chips)
SB: posts small blind $0.01
BB: posts big blind $0.02
*** HOLE CARDS ***
HJ: calls $0.02
CO: folds
BTN: calls $0.02
SB: folds
BB: checks
*** FLOP *** [5c Jd Qh]
BB: checks
HJ: checks
BTN: bets $0.07
BB: folds
HJ: folds
Uncalled bet ($0.07) returned to BTN
BTN collected $0.07 from pot
kizzle72 was removed from the table for failing to post
kizzle72 leaves the table
*** SUMMARY ***
Total pot $0.07 | Rake $0
Board [5c Jd Qh]
Seat 1: CO folded before Flop (didn't bet)
Seat 2: BTN (button) collected ($0.07)
Seat 3: SB (small blind) folded before Flop
Seat 5: BB (big blind) folded on the Flop
Seat 6: HJ folded on the Flop


PokerStars Hand #238162208992:  Hold'em No Limit ($0.01/$0.02 USD) - 2022/08/23 2:24:53 ET
Table 'Achilles IV' 6-max Seat #3 is the button
Seat 1: HJ ($2.09 in chips)
Seat 2: CO ($2.06 in chips)
Seat 3: BTN ($2.85 in chips)
Seat 5: SB ($0.73 in chips)
Seat 6: BB ($2.44 in chips)
SB: posts small blind $0.01
BB: posts big blind $0.02
*** HOLE CARDS ***
HJ: folds
CO: calls $0.02
BTN: folds
SB: folds
BB: checks
*** FLOP *** [Ks 7d 8s]
BluffJobbbz joins the table at seat #4
BB: checks
CO: checks
*** TURN *** [Ks 7d 8s] [5s]
BB: checks
CO: checks
*** RIVER *** [Ks 7d 8s 5s] [Qh]
BB: bets $0.02
CO: calls $0.02
*** SHOW DOWN ***
BB: shows [6c Ad] (high card Ace)
CO: shows [Ah 6h] (high card Ace)
BB collected $0.05 from pot
CO collected $0.04 from pot
*** SUMMARY ***
Total pot $0.09 | Rake $0
Board [Ks 7d 8s 5s Qh]
Seat 1: HJ folded before Flop (didn't bet)
Seat 2: CO showed [Ah 6h] and won ($0.04) with high card Ace
Seat 3: BTN (button) folded before Flop (didn't bet)
Seat 5: SB (small blind) folded before Flop
Seat 6: BB (big blind) showed [6c Ad] and won ($0.05) with high card Ace


PokerStars Hand #238162212114:  Hold'em No Limit ($0.01/$0.02 USD) - 2022/08/23 2:25:24 ET
Table 'Achilles IV' 6-max Seat #5 is the button
Seat 2: BB ($2.06 in chips)
Seat 3: CO ($2.85 in chips)
Seat 5: BTN ($0.72 in chips)
Seat 6: SB ($2.45 in chips)
SB: posts small blind $0.01
Vlao: is sitting out
BB: posts big blind $0.02
BluffJobbbz: sits out
*** HOLE CARDS ***
CO: folds
BTN: calls $0.02
SB: calls $0.01
BB: checks
*** FLOP *** [7h Jc 3s]
SB: checks
BB: bets $0.06
BTN: calls $0.06
SB: folds
*** TURN *** [7h Jc 3s] [As]
BB: checks
BTN: checks
*** RIVER *** [7h Jc 3s As] [4s]
BB: bets $0.10
BTN: calls $0.10
*** SHOW DOWN ***
BB: shows [Tc 8c] (high card Ace)
BTN: shows [8d 8s] (a pair of Eights)
BTN collected $0.37 from pot
*** SUMMARY ***
Total pot $0.38 | Rake $0.01
Board [7h Jc 3s As 4s]
Seat 2: BB (big blind) showed [Tc 8c] and lost with high card Ace
Seat 3: CO folded before Flop (didn't bet)
Seat 5: BTN (button) showed [8d 8s] and won ($0.37) with a pair of Eights
Seat 6: SB (small blind) folded on the Flop


PokerStars Hand #238162216439:  Hold'em No Limit ($0.01/$0.02 USD) - 2022/08/23 2:26:07 ET
Table 'Achilles IV' 6-max Seat #6 is the button
Seat 2: SB ($2 in chips)
Seat 3: BB ($2.85 in chips)
Seat 5: CO ($0.91 in chips)
Seat 6: BTN ($2.43 in chips)
SB: posts small blind $0.01
BB: posts big blind $0.02
BluffJobbbz: sits out
*** HOLE CARDS ***
CO: folds
BTN: folds
SB: calls $0.01
BB: checks
*** FLOP *** [4s 8d Td]
SB: checks
BB: checks
*** TURN *** [4s 8d Td] [4d]
SB: checks
BB: checks
*** RIVER *** [4s 8d Td 4d] [6c]
SB: bets $0.04
BB: folds
Uncalled bet ($0.04) returned to SB
SB collected $0.04 from pot
*** SUMMARY ***
Total pot $0.04 | Rake $0
Board [4s 8d Td 4d 6c]
Seat 2: SB (small blind) collected ($0.04)
Seat 3: BB (big blind) folded on the River
Seat 5: CO folded before Flop (didn't bet)
Seat 6: BTN (button) folded before Flop (didn't bet)


PokerStars Hand #238162220785:  Hold'em No Limit ($0.01/$0.02 USD) - 2022/08/23 2:26:51 ET
Table 'Achilles IV' 6-max Seat #2 is the button
Seat 2: BTN ($2.02 in chips)
Seat 3: SB ($2.83 in chips)
Seat 4: BB ($2 in chips)
Seat 5: HJ ($0.91 in chips)
Seat 6: CO ($2.43 in chips)
SB: posts small blind $0.01
BB: posts big blind $0.02
*** HOLE CARDS ***
HJ: calls $0.02
CO: raises $0.04 to $0.06
BTN: folds
SB: folds
BB: folds
HJ: calls $0.04
*** FLOP *** [8d 2d 8h]
HJ: checks
CO: bets $0.07
HJ: folds
Uncalled bet ($0.07) returned to CO
CO collected $0.14 from pot
CO: doesn't show hand
*** SUMMARY ***
Total pot $0.15 | Rake $0.01
Board [8d 2d 8h]
Seat 2: BTN (button) folded before Flop (didn't bet)
Seat 3: SB (small blind) folded before Flop
Seat 4: BB (big blind) folded before Flop
Seat 5: HJ folded on the Flop
Seat 6: CO collected ($0.14)


PokerStars Hand #238162223715:  Hold'em No Limit ($0.01/$0.02 USD) - 2022/08/23 2:27:19 ET
Table 'Achilles IV' 6-max Seat #3 is the button
Seat 2: CO ($2.02 in chips)
Seat 3: BTN ($2.82 in chips)
Seat 4: SB ($2 in chips)
Seat 5: BB ($0.85 in chips)
Seat 6: HJ ($2.51 in chips)
SB: posts small blind $0.01
BB: posts big blind $0.02
*** HOLE CARDS ***
HJ: raises $0.06 to $0.08
CO: calls $0.08
BTN: folds
SB: folds
BB: folds
*** FLOP *** [4c 5s 5h]
HJ: bets $0.10
CO: calls $0.10
*** TURN *** [4c 5s 5h] [8c]
HJ: bets $0.38
CO: calls $0.38
*** RIVER *** [4c 5s 5h 8c] [Ts]
HJ: bets $1.95 and is all-in
CO: folds
Uncalled bet ($1.95) returned to HJ
HJ collected $1.11 from pot
HJ: doesn't show hand
*** SUMMARY ***
Total pot $1.15 | Rake $0.04
Board [4c 5s 5h 8c Ts]
Seat 2: CO folded on the River
Seat 3: BTN (button) folded before Flop (didn't bet)
Seat 4: SB (small blind) folded before Flop
Seat 5: BB (big blind) folded before Flop
Seat 6: HJ collected ($1.11)


PokerStars Hand #238162226833:  Hold'em No Limit ($0.01/$0.02 USD) - 2022/08/23 2:27:49 ET
Table 'Achilles IV' 6-max Seat #4 is the button
Seat 2: HJ ($2 in chips)
Seat 3: CO ($2.82 in chips)
Seat 4: BTN ($2 in chips)
Seat 5: SB ($0.83 in chips)
Seat 6: BB ($3.06 in chips)
SB: posts small blind $0.01
BB: posts big blind $0.02
*** HOLE CARDS ***
HJ: calls $0.02
CO: folds
BTN: folds
SB: folds
BB: checks
*** FLOP *** [2c Qs 4h]
BB: checks
HJ: checks
*** TURN *** [2c Qs 4h] [5c]
BB: bets $0.04
HJ: calls $0.04
*** RIVER *** [2c Qs 4h 5c] [Td]
BB: bets $0.06
HJ: calls $0.06
*** SHOW DOWN ***
BB: shows [4s 8d] (a pair of Fours)
HJ: shows [9c 5d] (a pair of Fives)
HJ collected $0.24 from pot
*** SUMMARY ***
Total pot $0.25 | Rake $0.01
Board [2c Qs 4h 5c Td]
Seat 2: HJ showed [9c 5d] and won ($0.24) with a pair of Fives
Seat 3: CO folded before Flop (didn't bet)
Seat 4: BTN (button) folded before Flop (didn't bet)
Seat 5: SB (small blind) folded before Flop
Seat 6: BB (big blind) showed [4s 8d] and lost with a pair of Fours


PokerStars Hand #238162230573:  Hold'em No Limit ($0.01/$0.02 USD) - 2022/08/23 2:28:26 ET
Table 'Achilles IV' 6-max Seat #5 is the button
Seat 2: BB ($2.12 in chips)
Seat 3: HJ ($2.82 in chips)
Seat 4: CO ($2 in chips)
Seat 5: BTN ($0.82 in chips)
Seat 6: SB ($2.94 in chips)
SB: posts small blind $0.01
BB: posts big blind $0.02
*** HOLE CARDS ***
HJ: raises $0.04 to $0.06
CO: folds
BTN: folds
SB: calls $0.05
BB: calls $0.04
*** FLOP *** [8c 9d 7c]
SB: bets $0.08
BB: calls $0.08
HJ: calls $0.08
*** TURN *** [8c 9d 7c] [8d]
SB: bets $0.20
BB: raises $0.20 to $0.40
HJ: folds
SB: calls $0.20
*** RIVER *** [8c 9d 7c 8d] [Ks]
SB: checks
BB: bets $1.18
SB: folds
Uncalled bet ($1.18) returned to BB
BB collected $1.18 from pot
*** SUMMARY ***
Total pot $1.22 | Rake $0.04
Board [8c 9d 7c 8d Ks]
Seat 2: BB (big blind) collected ($1.18)
Seat 3: HJ folded on the Turn
Seat 4: CO folded before Flop (didn't bet)
Seat 5: BTN (button) folded before Flop (didn't bet)
Seat 6: SB (small blind) folded on the River


PokerStars Hand #238162248152:  Hold'em No Limit ($0.01/$0.02 USD) - 2022/08/23 2:29:47 ET
Table 'Achilles IV' 6-max Seat #2 is the button
Seat 2: BTN ($2.74 in chips)
Seat 3: SB ($2.70 in chips)
Seat 4: BB ($2 in chips)
Seat 5: HJ ($0.82 in chips)
Seat 6: CO ($2.40 in chips)
SB: posts small blind $0.01
BB: posts big blind $0.02
Vlao: sits out
*** HOLE CARDS ***
HJ: folds
CO: folds
BTN: calls $0.02
SB: folds
BB: raises $0.08 to $0.10
BTN: folds
Uncalled bet ($0.08) returned to BB
BB collected $0.05 from pot
BB: doesn't show hand
*** SUMMARY ***
Total pot $0.05 | Rake $0
Seat 2: BTN (button) folded before Flop
Seat 3: SB (small blind) folded before Flop
Seat 4: BB (big blind) collected ($0.05)
Seat 5: HJ folded before Flop (didn't bet)
Seat 6: CO folded before Flop (didn't bet)


PokerStars Hand #238162245192:  Hold'em No Limit ($0.01/$0.02 USD) - 2022/08/23 2:29:18 ET
Table 'Achilles IV' 6-max Seat #6 is the button
Seat 2: SB ($2.76 in chips)
Seat 3: BB ($2.68 in chips)
Seat 4: HJ ($2 in chips)
Seat 5: CO ($0.82 in chips)
Seat 6: BTN ($2.40 in chips)
SB: posts small blind $0.01
BB: posts big blind $0.02
*** HOLE CARDS ***
HJ: folds
CO: folds
BTN: folds
SB: calls $0.01
BB: checks
*** FLOP *** [4h 6c Jh]
SB: checks
BB: checks
*** TURN *** [4h 6c Jh] [Js]
SB: checks
BB: bets $0.02
SB: folds
Uncalled bet ($0.02) returned to BB
BB collected $0.04 from pot
BB: doesn't show hand
*** SUMMARY ***
Total pot $0.04 | Rake $0
Board [4h 6c Jh Js]
Seat 2: SB (small blind) folded on the Turn
Seat 3: BB (big blind) collected ($0.04)
Seat 4: HJ folded before Flop (didn't bet)
Seat 5: CO folded before Flop (didn't bet)
Seat 6: BTN (button) folded before Flop (didn't bet)


PokerStars Hand #238162249916:  Hold'em No Limit ($0.01/$0.02 USD) - 2022/08/23 2:30:05 ET
Table 'Achilles IV' 6-max Seat #3 is the button
Seat 2: CO ($2.72 in chips)
Seat 3: BTN ($2.69 in chips)
Seat 4: SB ($2.03 in chips)
Seat 5: BB ($0.82 in chips)
Seat 6: HJ ($2.40 in chips)
SB: posts small blind $0.01
BB: posts big blind $0.02
Vlao: sits out
*** HOLE CARDS ***
HJ: calls $0.02
CO: calls $0.02
BTN: folds
SB: folds
BB: checks
*** FLOP *** [8h 6d Qd]
BB: checks
HJ: checks
CO: bets $0.07
BB: folds
HJ: calls $0.07
*** TURN *** [8h 6d Qd] [6s]
HJ: checks
CO: bets $0.10
HJ: calls $0.10
*** RIVER *** [8h 6d Qd 6s] [3h]
HJ: checks
CO: checks
*** SHOW DOWN ***
HJ: shows [9h 8c] (two pair, Eights and Sixes)
CO: shows [Jd Qs] (two pair, Queens and Sixes)
CO collected $0.40 from pot
*** SUMMARY ***
Total pot $0.41 | Rake $0.01
Board [8h 6d Qd 6s 3h]
Seat 2: CO showed [Jd Qs] and won ($0.40) with two pair, Queens and Sixes
Seat 3: BTN (button) folded before Flop (didn't bet)
Seat 4: SB (small blind) folded before Flop
Seat 5: BB (big blind) folded on the Flop
Seat 6: HJ showed [9h 8c] and lost with two pair, Eights and Sixes


PokerStars Hand #238162260317:  Hold'em No Limit ($0.01/$0.02 USD) - 2022/08/23 2:30:45 ET
Table 'Achilles IV' 6-max Seat #4 is the button
Seat 2: HJ ($2.93 in chips)
Seat 3: CO ($2.69 in chips)
Seat 4: BTN ($2.02 in chips)
Seat 5: SB ($0.80 in chips)
Seat 6: BB ($2.21 in chips)
SB: posts small blind $0.01
BB: posts big blind $0.02
Vlao: sits out
*** HOLE CARDS ***
HJ: calls $0.02
CO: folds
BTN: calls $0.02
SB: calls $0.01
BB: checks
*** FLOP *** [8s 4c 6d]
SB: bets $0.08
BB: folds
HJ: calls $0.08
BTN: folds
*** TURN *** [8s 4c 6d] [7h]
SB: checks
HJ: bets $0.10
SB: calls $0.10
*** RIVER *** [8s 4c 6d 7h] [3h]
SB: checks
HJ: checks
*** SHOW DOWN ***
SB: shows [Qh Qd] (a pair of Queens)
HJ: mucks hand
SB collected $0.42 from pot
*** SUMMARY ***
Total pot $0.44 | Rake $0.02
Board [8s 4c 6d 7h 3h]
Seat 2: HJ mucked
Seat 3: CO folded before Flop (didn't bet)
Seat 4: BTN (button) folded on the Flop
Seat 5: SB (small blind) showed [Qh Qd] and won ($0.42) with a pair of Queens
Seat 6: BB (big blind) folded on the Flop


PokerStars Hand #238162263983:  Hold'em No Limit ($0.01/$0.02 USD) - 2022/08/23 2:31:22 ET
Table 'Achilles IV' 6-max Seat #5 is the button
Seat 1: BB ($2.09 in chips)
Seat 2: UTG ($2.73 in chips)
Seat 3: HJ ($2.69 in chips)
Seat 4: CO ($2 in chips)
Seat 5: BTN ($1.02 in chips)
Seat 6: SB ($2.19 in chips)
SB: posts small blind $0.01
BB: posts big blind $0.02
*** HOLE CARDS ***
UTG: calls $0.02
HJ has timed out
HJ: folds
CO: folds
BTN: calls $0.02
SB: raises $0.04 to $0.06
BB: folds
UTG: calls $0.04
BTN: calls $0.04
*** FLOP *** [8d 4h 3s]
SB: bets $0.10
UTG: calls $0.10
BTN: folds
*** TURN *** [8d 4h 3s] [2c]
SB: bets $0.30
UTG: folds
Uncalled bet ($0.30) returned to SB
SB collected $0.39 from pot
SB: doesn't show hand
*** SUMMARY ***
Total pot $0.40 | Rake $0.01
Board [8d 4h 3s 2c]
Seat 1: BB (big blind) folded before Flop
Seat 2: UTG folded on the Turn
Seat 3: HJ folded before Flop (didn't bet)
Seat 4: CO folded before Flop (didn't bet)
Seat 5: BTN (button) folded on the Flop
Seat 6: SB (small blind) collected ($0.39)


PokerStars Hand #238162269733:  Hold'em No Limit ($0.01/$0.02 USD) - 2022/08/23 2:32:18 ET
Table 'Achilles IV' 6-max Seat #6 is the button
Seat 1: SB ($2.07 in chips)
Seat 2: BB ($2.57 in chips)
Seat 3: UTG ($2.69 in chips)
Seat 4: HJ ($2 in chips)
Seat 5: CO ($0.96 in chips)
Seat 6: BTN ($2.42 in chips)
SB: posts small blind $0.01
BB: posts big blind $0.02
*** HOLE CARDS ***
UTG: folds
HJ: folds
CO: calls $0.02
BTN: calls $0.02
SB: calls $0.01
BB: checks
*** FLOP *** [Jd 3c Ac]
SB: checks
BB: checks
CO: checks
BTN: checks
*** TURN *** [Jd 3c Ac] [7h]
SB: checks
BB: bets $0.04
CO: calls $0.04
BTN: calls $0.04
SB: folds
*** RIVER *** [Jd 3c Ac 7h] [4h]
BB: checks
CO: checks
BTN: checks
*** SHOW DOWN ***
BB: shows [8d 8h] (a pair of Eights)
CO: shows [Th Js] (a pair of Jacks)
BTN: mucks hand
CO collected $0.19 from pot
*** SUMMARY ***
Total pot $0.20 | Rake $0.01
Board [Jd 3c Ac 7h 4h]
Seat 1: SB (small blind) folded on the Turn
Seat 2: BB (big blind) showed [8d 8h] and lost with a pair of Eights
Seat 3: UTG folded before Flop (didn't bet)
Seat 4: HJ folded before Flop (didn't bet)
Seat 5: CO showed [Th Js] and won ($0.19) with a pair of Jacks
Seat 6: BTN (button) mucked


PokerStars Hand #238162286309:  Hold'em No Limit ($0.01/$0.02 USD) - 2022/08/23 2:33:42 ET
Table 'Achilles IV' 6-max Seat #2 is the button
Seat 1: CO ($2.05 in chips)
Seat 2: BTN ($2.50 in chips)
Seat 3: SB ($2.63 in chips)
Seat 4: BB ($2 in chips)
Seat 5: UTG ($1.16 in chips)
Seat 6: HJ ($2.36 in chips)
SB: posts small blind $0.01
BB: posts big blind $0.02
*** HOLE CARDS ***
UTG: calls $0.02
HJ: calls $0.02
CO: folds
BTN: calls $0.02
SB: folds
BB: checks
*** FLOP *** [Ks 9c Th]
BB: checks
UTG: checks
HJ: checks
BTN: bets $0.04
BB: folds
UTG: calls $0.04
HJ: folds
*** TURN *** [Ks 9c Th] [3d]
UTG: checks
BTN: checks
*** RIVER *** [Ks 9c Th 3d] [9h]
UTG: bets $0.02
BTN: calls $0.02
*** SHOW DOWN ***
UTG: shows [Ts Ad] (two pair, Tens and Nines)
BTN: mucks hand
UTG collected $0.20 from pot
*** SUMMARY ***
Total pot $0.21 | Rake $0.01
Board [Ks 9c Th 3d 9h]
Seat 1: CO folded before Flop (didn't bet)
Seat 2: BTN (button) mucked
Seat 3: SB (small blind) folded before Flop
Seat 4: BB (big blind) folded on the Flop
Seat 5: UTG showed [Ts Ad] and won ($0.20) with two pair, Tens and Nines
Seat 6: HJ folded on the Flop


PokerStars Hand #238162293139:  Hold'em No Limit ($0.01/$0.02 USD) - 2022/08/23 2:34:50 ET
Table 'Achilles IV' 6-max Seat #3 is the button
Seat 1: HJ ($2.05 in chips)
Seat 2: CO ($2.42 in chips)
Seat 3: BTN ($2.62 in chips)
Seat 4: SB ($2 in chips)
Seat 5: BB ($1.28 in chips)
Seat 6: UTG ($2.34 in chips)
SB: posts small blind $0.01
BB: posts big blind $0.02
*** HOLE CARDS ***
UTG: raises $0.04 to $0.06
HJ: folds
CO: folds
BTN: raises $0.12 to $0.18
SB: folds
BB: folds
UTG: calls $0.12
*** FLOP *** [5d Js 6c]
UTG: checks
BTN: bets $0.20
UTG: calls $0.20
*** TURN *** [5d Js 6c] [6d]
UTG: checks
BTN: checks
*** RIVER *** [5d Js 6c 6d] [6h]
UTG: bets $0.50
BTN: raises $1.74 to $2.24 and is all-in
UTG: calls $1.46 and is all-in
Uncalled bet ($0.28) returned to BTN
*** SHOW DOWN ***
BTN: shows [Kd Kc] (a full house, Sixes full of Kings)
UTG: shows [6s Ad] (four of a kind, Sixes)
UTG collected $4.55 from pot
*** SUMMARY ***
Total pot $4.71 | Rake $0.16
Board [5d Js 6c 6d 6h]
Seat 1: HJ folded before Flop (didn't bet)
Seat 2: CO folded before Flop (didn't bet)
Seat 3: BTN (button) showed [Kd Kc] and lost with a full house, Sixes full of Kings
Seat 4: SB (small blind) folded before Flop
Seat 5: BB (big blind) folded before Flop
Seat 6: UTG showed [6s Ad] and won ($4.55) with four of a kind, Sixes


PokerStars Hand #238162301635:  Hold'em No Limit ($0.01/$0.02 USD) - 2022/08/23 2:36:14 ET
Table 'Achilles IV' 6-max Seat #4 is the button
Seat 1: UTG ($2.05 in chips)
Seat 2: HJ ($2.42 in chips)
Seat 3: CO ($2 in chips)
Seat 4: BTN ($2 in chips)
Seat 5: SB ($1.26 in chips)
Seat 6: BB ($4.55 in chips)
SB: posts small blind $0.01
BB: posts big blind $0.02
*** HOLE CARDS ***
UTG: raises $0.03 to $0.05
HJ: calls $0.05
CO: folds
BTN: folds
SB: calls $0.04
BB: calls $0.03
*** FLOP *** [5c 9h Qs]
SB: checks
BB: checks
UTG: bets $0.15
HJ: folds
SB: folds
BB: folds
Uncalled bet ($0.15) returned to UTG
UTG collected $0.19 from pot
*** SUMMARY ***
Total pot $0.20 | Rake $0.01
Board [5c 9h Qs]
Seat 1: UTG collected ($0.19)
Seat 2: HJ folded on the Flop
Seat 3: CO folded before Flop (didn't bet)
Seat 4: BTN (button) folded before Flop (didn't bet)
Seat 5: SB (small blind) folded on the Flop
Seat 6: BB (big blind) folded on the Flop


PokerStars Hand #238162305449:  Hold'em No Limit ($0.01/$0.02 USD) - 2022/08/23 2:36:51 ET
Table 'Achilles IV' 6-max Seat #5 is the button
Seat 1: BB ($2.19 in chips)
Seat 2: UTG ($2.37 in chips)
Seat 3: HJ ($2 in chips)
Seat 4: CO ($2 in chips)
Seat 5: BTN ($1.21 in chips)
Seat 6: SB ($4.50 in chips)
SB: posts small blind $0.01
BB: posts big blind $0.02
*** HOLE CARDS ***
UTG: calls $0.02
HJ: folds
CO: folds
BTN: folds
SB: folds
BB: checks
*** FLOP *** [6s 8s 4s]
BB: checks
UTG: checks
*** TURN *** [6s 8s 4s] [As]
BB: checks
UTG: bets $0.05
BB: folds
Uncalled bet ($0.05) returned to UTG
UTG collected $0.05 from pot
*** SUMMARY ***
Total pot $0.05 | Rake $0
Board [6s 8s 4s As]
Seat 1: BB (big blind) folded on the Turn
Seat 2: UTG collected ($0.05)
Seat 3: HJ folded before Flop (didn't bet)
Seat 4: CO folded before Flop (didn't bet)
Seat 5: BTN (button) folded before Flop (didn't bet)
Seat 6: SB (small blind) folded before Flop


PokerStars Hand #238162308054:  Hold'em No Limit ($0.01/$0.02 USD) - 2022/08/23 2:37:16 ET
Table 'Achilles IV' 6-max Seat #6 is the button
Seat 1: SB ($2.17 in chips)
Seat 2: BB ($2.40 in chips)
Seat 3: UTG ($2 in chips)
Seat 4: HJ ($2 in chips)
Seat 5: CO ($1.21 in chips)
Seat 6: BTN ($4.49 in chips)
SB: posts small blind $0.01
BB: posts big blind $0.02
*** HOLE CARDS ***
UTG: folds
HJ: raises $0.04 to $0.06
CO: folds
BTN: calls $0.06
SB: folds
BB: folds
*** FLOP *** [8s 7c 8h]
HJ: bets $0.04
BTN: folds
Uncalled bet ($0.04) returned to HJ
HJ collected $0.14 from pot
HJ: doesn't show hand
*** SUMMARY ***
Total pot $0.15 | Rake $0.01
Board [8s 7c 8h]
Seat 1: SB (small blind) folded before Flop
Seat 2: BB (big blind) folded before Flop
Seat 3: UTG folded before Flop (didn't bet)
Seat 4: HJ collected ($0.14)
Seat 5: CO folded before Flop (didn't bet)
Seat 6: BTN (button) folded on the Flop


PokerStars Hand #238162310908:  Hold'em No Limit ($0.01/$0.02 USD) - 2022/08/23 2:37:44 ET
Table 'Achilles IV' 6-max Seat #1 is the button
Seat 1: BTN ($2.16 in chips)
Seat 2: SB ($2.38 in chips)
Seat 3: BB ($2 in chips)
Seat 4: UTG ($2.08 in chips)
Seat 5: HJ ($1.21 in chips)
Seat 6: CO ($4.43 in chips)
SB: posts small blind $0.01
BB: posts big blind $0.02
*** HOLE CARDS ***
UTG: folds
HJ: folds
CO: raises $0.04 to $0.06
BTN: folds
SB: folds
BB: folds
Uncalled bet ($0.04) returned to CO
CO collected $0.05 from pot
CO: doesn't show hand
*** SUMMARY ***
Total pot $0.05 | Rake $0
Seat 1: BTN (button) folded before Flop (didn't bet)
Seat 2: SB (small blind) folded before Flop
Seat 3: BB (big blind) folded before Flop
Seat 4: UTG folded before Flop (didn't bet)
Seat 5: HJ folded before Flop (didn't bet)
Seat 6: CO collected ($0.05)


PokerStars Hand #238162312171:  Hold'em No Limit ($0.01/$0.02 USD) - 2022/08/23 2:37:55 ET
Table 'Achilles IV' 6-max Seat #2 is the button
Seat 1: CO ($2.16 in chips)
Seat 2: BTN ($2.37 in chips)
Seat 3: SB ($2 in chips)
Seat 4: BB ($2.08 in chips)
Seat 5: UTG ($1.21 in chips)
Seat 6: HJ ($4.46 in chips)
SB: posts small blind $0.01
BB: posts big blind $0.02
*** HOLE CARDS ***
UTG: folds
HJ: raises $0.04 to $0.06
CO: calls $0.06
BTN: calls $0.06
SB: folds
BB: folds
*** FLOP *** [Qs 5h 3h]
HJ: checks
CO: checks
BTN: bets $0.10
HJ: folds
CO: calls $0.10
*** TURN *** [Qs 5h 3h] [2d]
CO: checks
BTN: bets $0.12
CO: calls $0.12
*** RIVER *** [Qs 5h 3h 2d] [8c]
CO: checks
BTN: checks
*** SHOW DOWN ***
CO: shows [4d 3d] (a pair of Threes)
BTN: shows [Qd Ks] (a pair of Queens)
BTN collected $0.63 from pot
*** SUMMARY ***
Total pot $0.65 | Rake $0.02
Board [Qs 5h 3h 2d 8c]
Seat 1: CO showed [4d 3d] and lost with a pair of Threes
Seat 2: BTN (button) showed [Qd Ks] and won ($0.63) with a pair of Queens
Seat 3: SB (small blind) folded before Flop
Seat 4: BB (big blind) folded before Flop
Seat 5: UTG folded before Flop (didn't bet)
Seat 6: HJ folded on the Flop


PokerStars Hand #238162318114:  Hold'em No Limit ($0.01/$0.02 USD) - 2022/08/23 2:38:53 ET
Table 'Achilles IV' 6-max Seat #3 is the button
Seat 1: HJ ($2 in chips)
Seat 2: CO ($2.72 in chips)
Seat 3: BTN ($2 in chips)
Seat 4: SB ($2.06 in chips)
Seat 5: BB ($1.21 in chips)
Seat 6: UTG ($4.40 in chips)
SB: posts small blind $0.01
BB: posts big blind $0.02
*** HOLE CARDS ***
UTG: folds
UTG leaves the table
HJ: raises $0.03 to $0.05
CO: calls $0.05
Koresh153 joins the table at seat #6
BTN: folds
SB: folds
BB: calls $0.03
*** FLOP *** [Tc Qh 7h]
BB: checks
HJ: bets $0.10
CO: calls $0.10
BB: folds
*** TURN *** [Tc Qh 7h] [5s]
HJ: bets $0.28
CO: folds
Uncalled bet ($0.28) returned to HJ
HJ collected $0.35 from pot
*** SUMMARY ***
Total pot $0.36 | Rake $0.01
Board [Tc Qh 7h 5s]
Seat 1: HJ collected ($0.35)
Seat 2: CO folded on the Turn
Seat 3: BTN (button) folded before Flop (didn't bet)
Seat 4: SB (small blind) folded before Flop
Seat 5: BB (big blind) folded on the Flop
Seat 6: UTG folded before Flop (didn't bet)


PokerStars Hand #238162323856:  Hold'em No Limit ($0.01/$0.02 USD) - 2022/08/23 2:39:48 ET
Table 'Achilles IV' 6-max Seat #4 is the button
Seat 1: UTG ($2.20 in chips)
Seat 2: HJ ($2.57 in chips)
Seat 3: CO ($2 in chips)
Seat 4: BTN ($2.05 in chips)
Seat 5: SB ($1.16 in chips)
Seat 6: BB ($2.01 in chips)
SB: posts small blind $0.01
BB: posts big blind $0.02
*** HOLE CARDS ***
UTG: folds
HJ: calls $0.02
CO: folds
BTN: folds
SB: folds
BB: checks
*** FLOP *** [2s 8h Qd]
BB: checks
HJ: bets $0.05
BB: folds
Uncalled bet ($0.05) returned to HJ
HJ collected $0.05 from pot
*** SUMMARY ***
Total pot $0.05 | Rake $0
Board [2s 8h Qd]
Seat 1: UTG folded before Flop (didn't bet)
Seat 2: HJ collected ($0.05)
Seat 3: CO folded before Flop (didn't bet)
Seat 4: BTN (button) folded before Flop (didn't bet)
Seat 5: SB (small blind) folded before Flop
Seat 6: BB (big blind) folded on the Flop


PokerStars Hand #238162328112:  Hold'em No Limit ($0.01/$0.02 USD) - 2022/08/23 2:40:30 ET
Table 'Achilles IV' 6-max Seat #5 is the button
Seat 1: BB ($2.20 in chips)
Seat 2: UTG ($2.60 in chips)
Seat 3: HJ ($2 in chips)
Seat 4: CO ($2.05 in chips)
Seat 5: BTN ($1.15 in chips)
Seat 6: SB ($1.99 in chips)
SB: posts small blind $0.01
BB: posts big blind $0.02
*** HOLE CARDS ***
UTG: folds
HJ: folds
CO: folds
BTN: calls $0.02
SB: folds
BB: checks
*** FLOP *** [Th 5c 7s]
BB: checks
BTN: checks
*** TURN *** [Th 5c 7s] [3h]
BB: checks
BTN: checks
*** RIVER *** [Th 5c 7s 3h] [4s]
BB: checks
BTN: checks
*** SHOW DOWN ***
BB: shows [Kh 2s] (high card King)
BTN: shows [Jd Kd] (high card King - Jack kicker)
BTN collected $0.05 from pot
*** SUMMARY ***
Total pot $0.05 | Rake $0
Board [Th 5c 7s 3h 4s]
Seat 1: BB (big blind) showed [Kh 2s] and lost with high card King
Seat 2: UTG folded before Flop (didn't bet)
Seat 3: HJ folded before Flop (didn't bet)
Seat 4: CO folded before Flop (didn't bet)
Seat 5: BTN (button) showed [Jd Kd] and won ($0.05) with high card King
Seat 6: SB (small blind) folded before Flop


PokerStars Hand #238162331020:  Hold'em No Limit ($0.01/$0.02 USD) - 2022/08/23 2:40:58 ET
Table 'Achilles IV' 6-max Seat #6 is the button
Seat 1: SB ($2.18 in chips)
Seat 2: BB ($2.60 in chips)
Seat 3: UTG ($2 in chips)
Seat 4: HJ ($2.05 in chips)
Seat 5: CO ($1.18 in chips)
Seat 6: BTN ($1.98 in chips)
SB: posts small blind $0.01
BB: posts big blind $0.02
*** HOLE CARDS ***
UTG: folds
HJ: folds
CO: folds
UTG leaves the table
BTN: folds
DobermanBY joins the table at seat #3
SB: folds
Uncalled bet ($0.01) returned to BB
BB collected $0.02 from pot
*** SUMMARY ***
Total pot $0.02 | Rake $0
Seat 1: SB (small blind) folded before Flop
Seat 2: BB (big blind) collected ($0.02)
Seat 3: UTG folded before Flop (didn't bet)
Seat 4: HJ folded before Flop (didn't bet)
Seat 5: CO folded before Flop (didn't bet)
Seat 6: BTN (button) folded before Flop (didn't bet)


PokerStars Hand #238162332264:  Hold'em No Limit ($0.01/$0.02 USD) - 2022/08/23 2:41:11 ET
Table 'Achilles IV' 6-max Seat #1 is the button
Seat 1: BTN ($2.17 in chips)
Seat 2: SB ($2.61 in chips)
Seat 3: BB ($2 in chips)
Seat 4: UTG ($2.05 in chips)
Seat 5: HJ ($1.18 in chips)
Seat 6: CO ($1.98 in chips)
SB: posts small blind $0.01
BB: posts big blind $0.02
*** HOLE CARDS ***
UTG: folds
HJ: folds
CO has timed out
CO: folds
BTN: folds
SB: calls $0.01
BB: raises $0.04 to $0.06
SB: calls $0.04
*** FLOP *** [Th Jh 4h]
SB: checks
BB: checks
*** TURN *** [Th Jh 4h] [5s]
SB: bets $0.06
BB: folds
Uncalled bet ($0.06) returned to SB
SB collected $0.12 from pot
*** SUMMARY ***
Total pot $0.12 | Rake $0
Board [Th Jh 4h 5s]
Seat 1: BTN (button) folded before Flop (didn't bet)
Seat 2: SB (small blind) collected ($0.12)
Seat 3: BB (big blind) folded on the Turn
Seat 4: UTG folded before Flop (didn't bet)
Seat 5: HJ folded before Flop (didn't bet)
Seat 6: CO folded before Flop (didn't bet)


PokerStars Hand #238162338515:  Hold'em No Limit ($0.01/$0.02 USD) - 2022/08/23 2:42:12 ET
Table 'Achilles IV' 6-max Seat #2 is the button
Seat 1: CO ($2.17 in chips)
Seat 2: BTN ($2.67 in chips)
Seat 3: SB ($2 in chips)
Seat 4: BB ($2.05 in chips)
Seat 5: UTG ($1.18 in chips)
Seat 6: HJ ($1.98 in chips)
SB: posts small blind $0.01
BB: posts big blind $0.02
*** HOLE CARDS ***
UTG: folds
HJ: folds
CO: folds
BTN: calls $0.02
SB: folds
BB: checks
*** FLOP *** [Tc Qh Th]
BB: checks
BTN: checks
*** TURN *** [Tc Qh Th] [Qd]
BB: bets $0.02
BTN: folds
Uncalled bet ($0.02) returned to BB
BB collected $0.05 from pot
BB: doesn't show hand
*** SUMMARY ***
Total pot $0.05 | Rake $0
Board [Tc Qh Th Qd]
Seat 1: CO folded before Flop (didn't bet)
Seat 2: BTN (button) folded on the Turn
Seat 3: SB (small blind) folded before Flop
Seat 4: BB (big blind) collected ($0.05)
Seat 5: UTG folded before Flop (didn't bet)
Seat 6: HJ folded before Flop (didn't bet)


PokerStars Hand #238162341546:  Hold'em No Limit ($0.01/$0.02 USD) - 2022/08/23 2:42:41 ET
Table 'Achilles IV' 6-max Seat #3 is the button
Seat 1: HJ ($2.17 in chips)
Seat 2: CO ($2.65 in chips)
Seat 3: BTN ($2 in chips)
Seat 4: SB ($2.08 in chips)
Seat 5: BB ($1.18 in chips)
Seat 6: UTG ($1.98 in chips)
SB: posts small blind $0.01
BB: posts big blind $0.02
*** HOLE CARDS ***
UTG: folds
HJ: folds
CO: calls $0.02
BTN: folds
SB: raises $0.08 to $0.10
BB: folds
CO: folds
Uncalled bet ($0.08) returned to SB
SB collected $0.06 from pot
SB: doesn't show hand
*** SUMMARY ***
Total pot $0.06 | Rake $0
Seat 1: HJ folded before Flop (didn't bet)
Seat 2: CO folded before Flop
Seat 3: BTN (button) folded before Flop (didn't bet)
Seat 4: SB (small blind) collected ($0.06)
Seat 5: BB (big blind) folded before Flop
Seat 6: UTG folded before Flop (didn't bet)


PokerStars Hand #238162344231:  Hold'em No Limit ($0.01/$0.02 USD) - 2022/08/23 2:43:07 ET
Table 'Achilles IV' 6-max Seat #4 is the button
Seat 1: UTG ($2.17 in chips)
Seat 2: HJ ($2.63 in chips)
Seat 3: CO ($2 in chips)
Seat 4: BTN ($2.12 in chips)
Seat 5: SB ($1.16 in chips)
Seat 6: BB ($1.98 in chips)
SB: posts small blind $0.01
BB: posts big blind $0.02
*** HOLE CARDS ***
UTG: folds
HJ: calls $0.02
CO: raises $0.04 to $0.06
BTN: folds
SB: folds
BB: folds
HJ: calls $0.04
*** FLOP *** [5s Kh 2h]
HJ: checks
CO: checks
*** TURN *** [5s Kh 2h] [3h]
HJ: bets $0.07
CO: calls $0.07
*** RIVER *** [5s Kh 2h 3h] [8d]
HJ: checks
CO: checks
*** SHOW DOWN ***
HJ: shows [Th Kd] (a pair of Kings)
CO: mucks hand
HJ collected $0.28 from pot
*** SUMMARY ***
Total pot $0.29 | Rake $0.01
Board [5s Kh 2h 3h 8d]
Seat 1: UTG folded before Flop (didn't bet)
Seat 2: HJ showed [Th Kd] and won ($0.28) with a pair of Kings
Seat 3: CO mucked
Seat 4: BTN (button) folded before Flop (didn't bet)
Seat 5: SB (small blind) folded before Flop
Seat 6: BB (big blind) folded before Flop


PokerStars Hand #238162347789:  Hold'em No Limit ($0.01/$0.02 USD) - 2022/08/23 2:43:42 ET
Table 'Achilles IV' 6-max Seat #5 is the button
Seat 1: BB ($2.17 in chips)
Seat 2: UTG ($2.78 in chips)
Seat 3: HJ ($2 in chips)
Seat 4: CO ($2.12 in chips)
Seat 5: BTN ($1.15 in chips)
Seat 6: SB ($1.96 in chips)
SB: posts small blind $0.01
BB: posts big blind $0.02
*** HOLE CARDS ***
UTG: calls $0.02
HJ: folds
CO: raises $0.07 to $0.09
BTN: folds
SB: folds
BB: folds
UTG: folds
Uncalled bet ($0.07) returned to CO
CO collected $0.07 from pot
CO: doesn't show hand
*** SUMMARY ***
Total pot $0.07 | Rake $0
Seat 1: BB (big blind) folded before Flop
Seat 2: UTG folded before Flop
Seat 3: HJ folded before Flop (didn't bet)
Seat 4: CO collected ($0.07)
Seat 5: BTN (button) folded before Flop (didn't bet)
Seat 6: SB (small blind) folded before Flop


PokerStars Hand #238162350392:  Hold'em No Limit ($0.01/$0.02 USD) - 2022/08/23 2:44:07 ET
Table 'Achilles IV' 6-max Seat #6 is the button
Seat 1: SB ($2.15 in chips)
Seat 2: BB ($2.76 in chips)
Seat 3: UTG ($2 in chips)
Seat 4: HJ ($2.17 in chips)
Seat 5: CO ($1.15 in chips)
Seat 6: BTN ($1.95 in chips)
SB: posts small blind $0.01
BB: posts big blind $0.02
*** HOLE CARDS ***
UTG: folds
HJ: raises $0.04 to $0.06
CO: folds
BTN: calls $0.06
SB: folds
BB: calls $0.04
*** FLOP *** [2s Tc 7d]
BB: checks
HJ: bets $0.06
BTN: folds
BB: calls $0.06
*** TURN *** [2s Tc 7d] [9d]
BB: bets $0.10
HJ: calls $0.10
*** RIVER *** [2s Tc 7d 9d] [Ah]
BB: bets $0.10
HJ: folds
Uncalled bet ($0.10) returned to BB
BB collected $0.49 from pot
*** SUMMARY ***
Total pot $0.51 | Rake $0.02
Board [2s Tc 7d 9d Ah]
Seat 1: SB (small blind) folded before Flop
Seat 2: BB (big blind) collected ($0.49)
Seat 3: UTG folded before Flop (didn't bet)
Seat 4: HJ folded on the River
Seat 5: CO folded before Flop (didn't bet)
Seat 6: BTN (button) folded on the Flop


PokerStars Hand #238162366575:  Hold'em No Limit ($0.01/$0.02 USD) - 2022/08/23 2:46:44 ET
Table 'Achilles IV' 6-max Seat #3 is the button
Seat 1: CO ($2.14 in chips)
Seat 3: BTN ($2.01 in chips)
Seat 4: SB ($2 in chips)
Seat 5: BB ($1.15 in chips)
Seat 6: HJ ($1.89 in chips)
SB: posts small blind $0.01
BB: posts big blind $0.02
*** HOLE CARDS ***
HJ: folds
CO: folds
BTN: folds
SB: folds
Uncalled bet ($0.01) returned to BB
BB collected $0.02 from pot
*** SUMMARY ***
Total pot $0.02 | Rake $0
Seat 1: CO folded before Flop (didn't bet)
Seat 3: BTN (button) folded before Flop (didn't bet)
Seat 4: SB (small blind) folded before Flop
Seat 5: BB (big blind) collected ($0.02)
Seat 6: HJ folded before Flop (didn't bet)


PokerStars Hand #238162360623:  Hold'em No Limit ($0.01/$0.02 USD) - 2022/08/23 2:45:46 ET
Table 'Achilles IV' 6-max Seat #1 is the button
Seat 1: BTN ($2.14 in chips)
Seat 2: SB ($3.03 in chips)
Seat 3: BB ($2 in chips)
Seat 4: UTG ($2 in chips)
Seat 5: HJ ($1.15 in chips)
Seat 6: CO ($1.89 in chips)
SB: posts small blind $0.01
BB: posts big blind $0.02
*** HOLE CARDS ***
UTG: folds
HJ: folds
CO: folds
BTN: folds
SB has timed out
SB: folds
Uncalled bet ($0.01) returned to BB
BB collected $0.02 from pot
BB: doesn't show hand
*** SUMMARY ***
Total pot $0.02 | Rake $0
Seat 1: BTN (button) folded before Flop (didn't bet)
Seat 2: SB (small blind) folded before Flop
Seat 3: BB (big blind) collected ($0.02)
Seat 4: UTG folded before Flop (didn't bet)
Seat 5: HJ folded before Flop (didn't bet)
Seat 6: CO folded before Flop (didn't bet)


PokerStars Hand #238162367908:  Hold'em No Limit ($0.01/$0.02 USD) - 2022/08/23 2:46:56 ET
Table 'Achilles IV' 6-max Seat #4 is the button
Seat 1: HJ ($2.14 in chips)
Seat 3: CO ($2.01 in chips)
Seat 4: BTN ($2 in chips)
Seat 5: SB ($1.16 in chips)
Seat 6: BB ($1.89 in chips)
SB: posts small blind $0.01
BB: posts big blind $0.02
*** HOLE CARDS ***
HJ: folds
CO: folds
BTN: raises $0.04 to $0.06
SB: folds
BB: folds
Uncalled bet ($0.04) returned to BTN
BTN collected $0.05 from pot
BTN: doesn't show hand
*** SUMMARY ***
Total pot $0.05 | Rake $0
Seat 1: HJ folded before Flop (didn't bet)
Seat 3: CO folded before Flop (didn't bet)
Seat 4: BTN (button) collected ($0.05)
Seat 5: SB (small blind) folded before Flop
Seat 6: BB (big blind) folded before Flop


PokerStars Hand #238162369183:  Hold'em No Limit ($0.01/$0.02 USD) - 2022/08/23 2:47:08 ET
Table 'Achilles IV' 6-max Seat #5 is the button
Seat 1: BB ($2.14 in chips)
Seat 3: HJ ($2.01 in chips)
Seat 4: CO ($2.03 in chips)
Seat 5: BTN ($1.15 in chips)
Seat 6: SB ($1.87 in chips)
SB: posts small blind $0.01
BB: posts big blind $0.02
*** HOLE CARDS ***
HJ: folds
CO: raises $0.04 to $0.06
BTN: folds
SB: calls $0.05
BB: folds
*** FLOP *** [2c 4c 8h]
SB: bets $0.09
spider568 is disconnected
CO: raises $0.19 to $0.28
SB: calls $0.19
*** TURN *** [2c 4c 8h] [Qd]
SB: checks
CO: bets $0.34
SB: folds
Uncalled bet ($0.34) returned to CO
CO collected $0.68 from pot
CO: doesn't show hand
*** SUMMARY ***
Total pot $0.70 | Rake $0.02
Board [2c 4c 8h Qd]
Seat 1: BB (big blind) folded before Flop
Seat 3: HJ folded before Flop (didn't bet)
Seat 4: CO collected ($0.68)
Seat 5: BTN (button) folded before Flop (didn't bet)
Seat 6: SB (small blind) folded on the Turn


PokerStars Hand #238162375280:  Hold'em No Limit ($0.01/$0.02 USD) - 2022/08/23 2:48:06 ET
Table 'Achilles IV' 6-max Seat #6 is the button
Seat 1: SB ($2.12 in chips)
Seat 4: BB ($2.37 in chips)
Seat 5: CO ($1.15 in chips)
Seat 6: BTN ($1.53 in chips)
SB: posts small blind $0.01
DobermanBY: is sitting out
BB: posts big blind $0.02
*** HOLE CARDS ***
CO: calls $0.02
BTN: folds
SB: folds
BB: raises $0.06 to $0.08
CO: calls $0.06
*** FLOP *** [4s 8d 6c]
BB: bets $0.04
CO: calls $0.04
*** TURN *** [4s 8d 6c] [Tc]
BB: checks
CO: bets $0.10
BB: folds
Uncalled bet ($0.10) returned to CO
CO collected $0.24 from pot
*** SUMMARY ***
Total pot $0.25 | Rake $0.01
Board [4s 8d 6c Tc]
Seat 1: SB (small blind) folded before Flop
Seat 4: BB (big blind) folded on the Turn
Seat 5: CO collected ($0.24)
Seat 6: BTN (button) folded before Flop (didn't bet)


PokerStars Hand #238162381053:  Hold'em No Limit ($0.01/$0.02 USD) - 2022/08/23 2:49:01 ET
Table 'Achilles IV' 6-max Seat #1 is the button
Seat 1: BTN ($2.11 in chips)
Seat 4: SB ($2.25 in chips)
Seat 5: BB ($1.27 in chips)
Seat 6: CO ($2 in chips)
SB: posts small blind $0.01
BB: posts big blind $0.02
*** HOLE CARDS ***
CO: folds
BTN: raises $0.03 to $0.05
SB: folds
BB: folds
Uncalled bet ($0.03) returned to BTN
CO was removed from the table for failing to post
CO leaves the table
BTN collected $0.05 from pot
*** SUMMARY ***
Total pot $0.05 | Rake $0
Seat 1: BTN (button) collected ($0.05)
Seat 4: SB (small blind) folded before Flop
Seat 5: BB (big blind) folded before Flop
Seat 6: CO folded before Flop (didn't bet)


PokerStars Hand #238162385128:  Hold'em No Limit ($0.01/$0.02 USD) - 2022/08/23 2:49:40 ET
Table 'Achilles IV' 6-max Seat #5 is the button
Seat 1: SB ($2.12 in chips)
Seat 4: BB ($2.31 in chips)
Seat 5: BTN ($1.20 in chips)
SB: posts small blind $0.01
BB: posts big blind $0.02
*** HOLE CARDS ***
BTN: folds
SB: folds
Uncalled bet ($0.01) returned to BB
BB collected $0.02 from pot
BB: doesn't show hand
*** SUMMARY ***
Total pot $0.02 | Rake $0
Seat 1: SB (small blind) folded before Flop
Seat 4: BB (big blind) collected ($0.02)
Seat 5: BTN (button) folded before Flop (didn't bet)


PokerStars Hand #238162382502:  Hold'em No Limit ($0.01/$0.02 USD) - 2022/08/23 2:49:14 ET
Table 'Achilles IV' 6-max Seat #4 is the button
Seat 1: BB ($2.14 in chips)
Seat 4: BTN ($2.24 in chips)
Seat 5: SB ($1.25 in chips)
SB: posts small blind $0.01
BB: posts big blind $0.02
*** HOLE CARDS ***
BTN: raises $0.03 to $0.05
DobermanBY leaves the table
SB: calls $0.04
BB: folds
*** FLOP *** [6s 5h 9h]
SB: checks
BTN: bets $0.08
SB: folds
Uncalled bet ($0.08) returned to BTN
BTN collected $0.12 from pot
BTN: doesn't show hand
*** SUMMARY ***
Total pot $0.12 | Rake $0
Board [6s 5h 9h]
Seat 1: BB (big blind) folded before Flop
Seat 4: BTN (button) collected ($0.12)
Seat 5: SB (small blind) folded on the Flop


PokerStars Hand #238162385862:  Hold'em No Limit ($0.01/$0.02 USD) - 2022/08/23 2:49:46 ET
Table 'Achilles IV' 6-max Seat #1 is the button
Seat 1: BTN ($2.11 in chips)
Seat 4: SB ($2.32 in chips)
Seat 5: BB ($1.20 in chips)
SB: posts small blind $0.01
BB: posts big blind $0.02
*** HOLE CARDS ***
BTN: raises $0.03 to $0.05
SB: folds
BB: folds
Uncalled bet ($0.03) returned to BTN
BTN collected $0.05 from pot
*** SUMMARY ***
Total pot $0.05 | Rake $0
Seat 1: BTN (button) collected ($0.05)
Seat 4: SB (small blind) folded before Flop
Seat 5: BB (big blind) folded before Flop


PokerStars Hand #238162387495:  Hold'em No Limit ($0.01/$0.02 USD) - 2022/08/23 2:50:02 ET
Table 'Achilles IV' 6-max Seat #4 is the button
Seat 1: BB ($2.14 in chips)
Seat 4: BTN ($2.31 in chips)
Seat 5: SB ($1.18 in chips)
SB: posts small blind $0.01
BB: posts big blind $0.02
*** HOLE CARDS ***
BTN: folds
SB: calls $0.01
BB: checks
*** FLOP *** [7h 4d 5s]
SB: checks
BB: checks
*** TURN *** [7h 4d 5s] [Qd]
SB: checks
RodriguezDB joins the table at seat #3
BB: checks
*** RIVER *** [7h 4d 5s Qd] [8c]
SB: checks
BB: checks
*** SHOW DOWN ***
SB: shows [Ah 9c] (high card Ace)
BB: mucks hand
SB collected $0.04 from pot
*** SUMMARY ***
Total pot $0.04 | Rake $0
Board [7h 4d 5s Qd 8c]
Seat 1: BB (big blind) mucked
Seat 4: BTN (button) folded before Flop (didn't bet)
Seat 5: SB (small blind) showed [Ah 9c] and won ($0.04) with high card Ace


PokerStars Hand #238162390171:  Hold'em No Limit ($0.01/$0.02 USD) - 2022/08/23 2:50:27 ET
Table 'Achilles IV' 6-max Seat #5 is the button
Seat 1: SB ($2.12 in chips)
Seat 3: BB ($2 in chips)
Seat 4: CO ($2.31 in chips)
Seat 5: BTN ($1.20 in chips)
SB: posts small blind $0.01
BB: posts big blind $0.02
*** HOLE CARDS ***
CO: raises $0.04 to $0.06
BTN: folds
SB: folds
BB: calls $0.04
*** FLOP *** [Qd Qh Js]
BB: checks
CO: bets $0.08
BB: calls $0.08
*** TURN *** [Qd Qh Js] [7d]
BB: checks
CO: bets $0.22
BB: raises $0.72 to $0.94
CO: folds
Uncalled bet ($0.72) returned to BB
BB collected $0.70 from pot
*** SUMMARY ***
Total pot $0.73 | Rake $0.03
Board [Qd Qh Js 7d]
Seat 1: SB (small blind) folded before Flop
Seat 3: BB (big blind) collected ($0.70)
Seat 4: CO folded on the Turn
Seat 5: BTN (button) folded before Flop (didn't bet)


PokerStars Hand #238162398781:  Hold'em No Limit ($0.01/$0.02 USD) - 2022/08/23 2:51:49 ET
Table 'Achilles IV' 6-max Seat #1 is the button
Seat 1: BTN ($2.11 in chips)
Seat 3: SB ($2.34 in chips)
Seat 4: BB ($2 in chips)
Seat 5: CO ($1.20 in chips)
SB: posts small blind $0.01
BB: posts big blind $0.02
*** HOLE CARDS ***
freedomcrank joins the table at seat #6
CO: folds
BTN: folds
SB: folds
Uncalled bet ($0.01) returned to BB
BB collected $0.02 from pot
BB: doesn't show hand
*** SUMMARY ***
Total pot $0.02 | Rake $0
Seat 1: BTN (button) folded before Flop (didn't bet)
Seat 3: SB (small blind) folded before Flop
Seat 4: BB (big blind) collected ($0.02)
Seat 5: CO folded before Flop (didn't bet)


PokerStars Hand #238162400137:  Hold'em No Limit ($0.01/$0.02 USD) - 2022/08/23 2:52:02 ET
Table 'Achilles IV' 6-max Seat #3 is the button
Seat 1: CO ($2.11 in chips)
Seat 3: BTN ($2.33 in chips)
Seat 4: SB ($2.01 in chips)
Seat 5: BB ($1.20 in chips)
SB: posts small blind $0.01
BB: posts big blind $0.02
freedomcrank: sits out
*** HOLE CARDS ***
CO: folds
BTN has timed out
BTN: folds
SB: raises $0.04 to $0.06
BB: calls $0.04
*** FLOP *** [Kh 9s 7s]
SB: checks
BB: checks
*** TURN *** [Kh 9s 7s] [5s]
SB: checks
BB: checks
*** RIVER *** [Kh 9s 7s 5s] [Kc]
SB: checks
BB: checks
*** SHOW DOWN ***
SB: shows [4d Ah] (a pair of Kings)
BB: shows [8d 8c] (two pair, Kings and Eights)
BB collected $0.12 from pot
*** SUMMARY ***
Total pot $0.12 | Rake $0
Board [Kh 9s 7s 5s Kc]
Seat 1: CO folded before Flop (didn't bet)
Seat 3: BTN (button) folded before Flop (didn't bet)
Seat 4: SB (small blind) showed [4d Ah] and lost with a pair of Kings
Seat 5: BB (big blind) showed [8d 8c] and won ($0.12) with two pair, Kings and Eights


PokerStars Hand #238162403572:  Hold'em No Limit ($0.01/$0.02 USD) - 2022/08/23 2:52:34 ET
Table 'Achilles IV' 6-max Seat #4 is the button
Seat 1: HJ ($2.11 in chips)
Seat 3: CO ($2.33 in chips)
Seat 4: BTN ($2 in chips)
Seat 5: SB ($1.26 in chips)
Seat 6: BB ($2 in chips)
SB: posts small blind $0.01
BB: posts big blind $0.02
*** HOLE CARDS ***
HJ: folds
CO: raises $0.04 to $0.06
BTN: folds
SB: folds
BB: folds
Uncalled bet ($0.04) returned to CO
CO collected $0.05 from pot
*** SUMMARY ***
Total pot $0.05 | Rake $0
Seat 1: HJ folded before Flop (didn't bet)
Seat 3: CO collected ($0.05)
Seat 4: BTN (button) folded before Flop (didn't bet)
Seat 5: SB (small blind) folded before Flop
Seat 6: BB (big blind) folded before Flop


PokerStars Hand #238162405782:  Hold'em No Limit ($0.01/$0.02 USD) - 2022/08/23 2:52:55 ET
Table 'Achilles IV' 6-max Seat #5 is the button
Seat 1: BB ($2.11 in chips)
Seat 3: HJ ($2.36 in chips)
Seat 4: CO ($2 in chips)
Seat 5: BTN ($1.25 in chips)
Seat 6: SB ($1.98 in chips)
SB: posts small blind $0.01
BB: posts big blind $0.02
*** HOLE CARDS ***
HJ: folds
CO: folds
BTN: folds
SB: calls $0.01
BB: raises $0.06 to $0.08
SB: folds
Uncalled bet ($0.06) returned to BB
BB collected $0.04 from pot
*** SUMMARY ***
Total pot $0.04 | Rake $0
Seat 1: BB (big blind) collected ($0.04)
Seat 3: HJ folded before Flop (didn't bet)
Seat 4: CO folded before Flop (didn't bet)
Seat 5: BTN (button) folded before Flop (didn't bet)
Seat 6: SB (small blind) folded before Flop


PokerStars Hand #238162407772:  Hold'em No Limit ($0.01/$0.02 USD) - 2022/08/23 2:53:15 ET
Table 'Achilles IV' 6-max Seat #6 is the button
Seat 1: SB ($2.13 in chips)
Seat 3: BB ($2.36 in chips)
Seat 4: HJ ($2 in chips)
Seat 5: CO ($1.25 in chips)
Seat 6: BTN ($1.96 in chips)
SB: posts small blind $0.01
BB: posts big blind $0.02
*** HOLE CARDS ***
HJ: folds
CO: folds
BTN: raises $0.04 to $0.06
SB: folds
BB: folds
Uncalled bet ($0.04) returned to BTN
BTN collected $0.05 from pot
spider568 was removed from the table for failing to post
spider568 leaves the table
BTN: doesn't show hand
*** SUMMARY ***
Total pot $0.05 | Rake $0
Seat 1: SB (small blind) folded before Flop
Seat 3: BB (big blind) folded before Flop
Seat 4: HJ folded before Flop (didn't bet)
Seat 5: CO folded before Flop (didn't bet)
Seat 6: BTN (button) collected ($0.05)


PokerStars Hand #238162409016:  Hold'em No Limit ($0.01/$0.02 USD) - 2022/08/23 2:53:26 ET
Table 'Achilles IV' 6-max Seat #1 is the button
Seat 1: BTN ($2.12 in chips)
Seat 3: SB ($2.34 in chips)
Seat 4: BB ($2 in chips)
Seat 5: HJ ($1.25 in chips)
Seat 6: CO ($1.99 in chips)
SB: posts small blind $0.01
BB: posts big blind $0.02
*** HOLE CARDS ***
HJ: calls $0.02
CO: raises $0.04 to $0.06
BTN: folds
Rutzy259 joins the table at seat #2
SB: folds
BB: folds
HJ: calls $0.04
*** FLOP *** [7s Kd 8h]
HJ: checks
CO: bets $0.04
HJ: calls $0.04
*** TURN *** [7s Kd 8h] [6s]
HJ: checks
CO: bets $0.06
HJ: folds
Uncalled bet ($0.06) returned to CO
CO collected $0.22 from pot
CO: doesn't show hand
*** SUMMARY ***
Total pot $0.23 | Rake $0.01
Board [7s Kd 8h 6s]
Seat 1: BTN (button) folded before Flop (didn't bet)
Seat 3: SB (small blind) folded before Flop
Seat 4: BB (big blind) folded before Flop
Seat 5: HJ folded on the Turn
Seat 6: CO collected ($0.22)


PokerStars Hand #238162413228:  Hold'em No Limit ($0.01/$0.02 USD) - 2022/08/23 2:54:06 ET
Table 'Achilles IV' 6-max Seat #3 is the button
Seat 1: HJ ($2.12 in chips)
Seat 2: CO ($2 in chips)
Seat 3: BTN ($2.33 in chips)
Seat 4: SB ($2 in chips)
Seat 5: BB ($1.15 in chips)
Seat 6: UTG ($2.11 in chips)
SB: posts small blind $0.01
BB: posts big blind $0.02
CO: posts big blind $0.02
*** HOLE CARDS ***
UTG: folds
HJ: folds
CO: checks
BTN: folds
SB: folds
BB: checks
*** FLOP *** [Kd 9s 6c]
BB: checks
CO: checks
*** TURN *** [Kd 9s 6c] [Ad]
BB: checks
CO: checks
*** RIVER *** [Kd 9s 6c Ad] [Kc]
BB: checks
CO: checks
*** SHOW DOWN ***
BB: shows [4c Jd] (a pair of Kings)
CO: shows [Qc 8h] (a pair of Kings - Ace+Queen kicker)
CO collected $0.05 from pot
*** SUMMARY ***
Total pot $0.05 | Rake $0
Board [Kd 9s 6c Ad Kc]
Seat 1: HJ folded before Flop (didn't bet)
Seat 2: CO showed [Qc 8h] and won ($0.05) with a pair of Kings
Seat 3: BTN (button) folded before Flop (didn't bet)
Seat 4: SB (small blind) folded before Flop
Seat 5: BB (big blind) showed [4c Jd] and lost with a pair of Kings
Seat 6: UTG folded before Flop (didn't bet)


PokerStars Hand #238162415810:  Hold'em No Limit ($0.01/$0.02 USD) - 2022/08/23 2:54:29 ET
Table 'Achilles IV' 6-max Seat #4 is the button
Seat 1: UTG ($2.12 in chips)
Seat 2: HJ ($2.03 in chips)
Seat 3: CO ($2.33 in chips)
Seat 4: BTN ($2 in chips)
Seat 5: SB ($1.13 in chips)
Seat 6: BB ($2.11 in chips)
SB: posts small blind $0.01
BB: posts big blind $0.02
*** HOLE CARDS ***
UTG: folds
HJ: calls $0.02
CO: folds
BTN: calls $0.02
SB: calls $0.01
BB: checks
*** FLOP *** [Jc 6h 2c]
SB: checks
BB: checks
HJ: checks
BTN: checks
*** TURN *** [Jc 6h 2c] [2h]
SB: bets $0.02
BB: folds
HJ: folds
BTN: calls $0.02
*** RIVER *** [Jc 6h 2c 2h] [Ah]
SB: bets $0.02
BTN: folds
Uncalled bet ($0.02) returned to SB
SB collected $0.12 from pot
*** SUMMARY ***
Total pot $0.12 | Rake $0
Board [Jc 6h 2c 2h Ah]
Seat 1: UTG folded before Flop (didn't bet)
Seat 2: HJ folded on the Turn
Seat 3: CO folded before Flop (didn't bet)
Seat 4: BTN (button) folded on the River
Seat 5: SB (small blind) collected ($0.12)
Seat 6: BB (big blind) folded on the Turn


PokerStars Hand #238162420231:  Hold'em No Limit ($0.01/$0.02 USD) - 2022/08/23 2:55:11 ET
Table 'Achilles IV' 6-max Seat #5 is the button
Seat 1: BB ($2.12 in chips)
Seat 2: UTG ($2.01 in chips)
Seat 3: HJ ($2.33 in chips)
Seat 4: CO ($2 in chips)
Seat 5: BTN ($1.21 in chips)
Seat 6: SB ($2.09 in chips)
SB: posts small blind $0.01
BB: posts big blind $0.02
*** HOLE CARDS ***
UTG: calls $0.02
HJ: raises $0.08 to $0.10
CO: folds
BTN: folds
SB: folds
BB: folds
UTG: calls $0.08
*** FLOP *** [4h Kh Ac]
UTG: checks
HJ: bets $0.07
UTG: folds
Uncalled bet ($0.07) returned to HJ
HJ collected $0.22 from pot
*** SUMMARY ***
Total pot $0.23 | Rake $0.01
Board [4h Kh Ac]
Seat 1: BB (big blind) folded before Flop
Seat 2: UTG folded on the Flop
Seat 3: HJ collected ($0.22)
Seat 4: CO folded before Flop (didn't bet)
Seat 5: BTN (button) folded before Flop (didn't bet)
Seat 6: SB (small blind) folded before Flop


PokerStars Hand #238162424298:  Hold'em No Limit ($0.01/$0.02 USD) - 2022/08/23 2:55:52 ET
Table 'Achilles IV' 6-max Seat #6 is the button
Seat 1: SB ($2.10 in chips)
Seat 2: BB ($1.91 in chips)
Seat 3: UTG ($2.45 in chips)
Seat 4: HJ ($2 in chips)
Seat 5: CO ($1.21 in chips)
Seat 6: BTN ($2.08 in chips)
SB: posts small blind $0.01
BB: posts big blind $0.02
*** HOLE CARDS ***
UTG: folds
HJ: folds
CO: folds
BTN: folds
SB: folds
Uncalled bet ($0.01) returned to BB
BB collected $0.02 from pot
*** SUMMARY ***
Total pot $0.02 | Rake $0
Seat 1: SB (small blind) folded before Flop
Seat 2: BB (big blind) collected ($0.02)
Seat 3: UTG folded before Flop (didn't bet)
Seat 4: HJ folded before Flop (didn't bet)
Seat 5: CO folded before Flop (didn't bet)
Seat 6: BTN (button) folded before Flop (didn't bet)


PokerStars Hand #238162426007:  Hold'em No Limit ($0.01/$0.02 USD) - 2022/08/23 2:56:10 ET
Table 'Achilles IV' 6-max Seat #1 is the button
Seat 1: BTN ($2.09 in chips)
Seat 2: SB ($1.92 in chips)
Seat 3: BB ($2.45 in chips)
Seat 4: UTG ($2 in chips)
Seat 5: HJ ($1.21 in chips)
Seat 6: CO ($2.08 in chips)
SB: posts small blind $0.01
BB: posts big blind $0.02
*** HOLE CARDS ***
UTG: folds
HJ: calls $0.02
CO: folds
BTN: raises $0.06 to $0.08
SB: folds
BB: raises $0.14 to $0.22
HJ: folds
BTN: folds
Uncalled bet ($0.14) returned to BB
BB collected $0.19 from pot
*** SUMMARY ***
Total pot $0.19 | Rake $0
Seat 1: BTN (button) folded before Flop
Seat 2: SB (small blind) folded before Flop
Seat 3: BB (big blind) collected ($0.19)
Seat 4: UTG folded before Flop (didn't bet)
Seat 5: HJ folded before Flop
Seat 6: CO folded before Flop (didn't bet)


PokerStars Hand #238162428896:  Hold'em No Limit ($0.01/$0.02 USD) - 2022/08/23 2:56:39 ET
Table 'Achilles IV' 6-max Seat #2 is the button
Seat 1: CO ($2.01 in chips)
Seat 2: BTN ($1.91 in chips)
Seat 3: SB ($2.56 in chips)
Seat 4: BB ($2 in chips)
Seat 5: UTG ($1.19 in chips)
Seat 6: HJ ($2.08 in chips)
SB: posts small blind $0.01
BB: posts big blind $0.02
*** HOLE CARDS ***
UTG: folds
HJ: raises $0.04 to $0.06
CO: folds
BTN: calls $0.06
SB: calls $0.05
BB: folds
*** FLOP *** [7d 4d 5d]
SB: checks
HJ: checks
BTN: checks
*** TURN *** [7d 4d 5d] [Kd]
SB: checks
HJ: bets $0.04
BTN: folds
SB: calls $0.04
*** RIVER *** [7d 4d 5d Kd] [Jh]
SB: checks
HJ: bets $0.06
SB: calls $0.06
*** SHOW DOWN ***
HJ: shows [6d Qd] (a flush, King high)
SB: mucks hand
HJ collected $0.39 from pot
*** SUMMARY ***
Total pot $0.40 | Rake $0.01
Board [7d 4d 5d Kd Jh]
Seat 1: CO folded before Flop (didn't bet)
Seat 2: BTN (button) folded on the Turn
Seat 3: SB (small blind) mucked
Seat 4: BB (big blind) folded before Flop
Seat 5: UTG folded before Flop (didn't bet)
Seat 6: HJ showed [6d Qd] and won ($0.39) with a flush, King high


PokerStars Hand #238162437121:  Hold'em No Limit ($0.01/$0.02 USD) - 2022/08/23 2:58:03 ET
Table 'Achilles IV' 6-max Seat #3 is the button
Seat 1: HJ ($2.01 in chips)
Seat 2: CO ($1.85 in chips)
Seat 3: BTN ($2.40 in chips)
Seat 4: SB ($2 in chips)
Seat 5: BB ($1.19 in chips)
Seat 6: UTG ($2.31 in chips)
SB: posts small blind $0.01
BB: posts big blind $0.02
*** HOLE CARDS ***
UTG: raises $0.04 to $0.06
HJ: folds
CO: calls $0.06
BTN: folds
SB: folds
BB: folds
*** FLOP *** [8c As 6s]
UTG: checks
CO: checks
*** TURN *** [8c As 6s] [8d]
UTG: bets $0.04
CO: folds
Uncalled bet ($0.04) returned to UTG
UTG collected $0.14 from pot
UTG: doesn't show hand
*** SUMMARY ***
Total pot $0.15 | Rake $0.01
Board [8c As 6s 8d]
Seat 1: HJ folded before Flop (didn't bet)
Seat 2: CO folded on the Turn
Seat 3: BTN (button) folded before Flop (didn't bet)
Seat 4: SB (small blind) folded before Flop
Seat 5: BB (big blind) folded before Flop
Seat 6: UTG collected ($0.14)


PokerStars Hand #238162440135:  Hold'em No Limit ($0.01/$0.02 USD) - 2022/08/23 2:58:34 ET
Table 'Achilles IV' 6-max Seat #4 is the button
Seat 1: UTG ($2.01 in chips)
Seat 2: HJ ($1.79 in chips)
Seat 3: CO ($2.40 in chips)
Seat 4: BTN ($2 in chips)
Seat 5: SB ($1.17 in chips)
Seat 6: BB ($2.39 in chips)
SB: posts small blind $0.01
BB: posts big blind $0.02
*** HOLE CARDS ***
UTG: folds
HJ: calls $0.02
CO: folds
BTN: folds
SB: folds
BB: checks
*** FLOP *** [8h 7c Ac]
BB: checks
HJ: bets $0.08
BB: folds
Uncalled bet ($0.08) returned to HJ
HJ collected $0.05 from pot
*** SUMMARY ***
Total pot $0.05 | Rake $0
Board [8h 7c Ac]
Seat 1: UTG folded before Flop (didn't bet)
Seat 2: HJ collected ($0.05)
Seat 3: CO folded before Flop (didn't bet)
Seat 4: BTN (button) folded before Flop (didn't bet)
Seat 5: SB (small blind) folded before Flop
Seat 6: BB (big blind) folded on the Flop


PokerStars Hand #238162443165:  Hold'em No Limit ($0.01/$0.02 USD) - 2022/08/23 2:59:05 ET
Table 'Achilles IV' 6-max Seat #5 is the button
Seat 1: BB ($2.01 in chips)
Seat 2: UTG ($1.82 in chips)
Seat 3: HJ ($2.40 in chips)
Seat 4: CO ($2 in chips)
Seat 5: BTN ($1.16 in chips)
Seat 6: SB ($2.37 in chips)
SB: posts small blind $0.01
BB: posts big blind $0.02
*** HOLE CARDS ***
UTG: raises $0.02 to $0.04
HJ: folds
CO: folds
BTN: folds
SB: folds
BB: calls $0.02
*** FLOP *** [2h 6d Ac]
BB: checks
UTG: bets $0.06
BB: folds
Uncalled bet ($0.06) returned to UTG
UTG collected $0.09 from pot
*** SUMMARY ***
Total pot $0.09 | Rake $0
Board [2h 6d Ac]
Seat 1: BB (big blind) folded on the Flop
Seat 2: UTG collected ($0.09)
Seat 3: HJ folded before Flop (didn't bet)
Seat 4: CO folded before Flop (didn't bet)
Seat 5: BTN (button) folded before Flop (didn't bet)
Seat 6: SB (small blind) folded before Flop


PokerStars Hand #238162445605:  Hold'em No Limit ($0.01/$0.02 USD) - 2022/08/23 2:59:30 ET
Table 'Achilles IV' 6-max Seat #6 is the button
Seat 1: SB ($2 in chips)
Seat 2: BB ($1.87 in chips)
Seat 3: UTG ($2.40 in chips)
Seat 4: HJ ($2 in chips)
Seat 5: CO ($1.16 in chips)
Seat 6: BTN ($2.36 in chips)
SB: posts small blind $0.01
BB: posts big blind $0.02
*** HOLE CARDS ***
UTG: raises $0.04 to $0.06
HJ: raises $0.12 to $0.18
CO: folds
BTN: folds
SB: folds
BB: calls $0.16
UTG: folds
*** FLOP *** [6d 8s 2h]
BB: bets $0.06
HJ: raises $0.22 to $0.28
BB: calls $0.22
*** TURN *** [6d 8s 2h] [Kc]
BB: bets $0.38
HJ: raises $1.16 to $1.54 and is all-in
BB: calls $1.03 and is all-in
Uncalled bet ($0.13) returned to HJ
*** RIVER *** [6d 8s 2h Kc] [9c]
*** SHOW DOWN ***
BB: shows [3c 4c] (high card King)
HJ: shows [Ah Ad] (a pair of Aces)
HJ collected $3.68 from pot
*** SUMMARY ***
Total pot $3.81 | Rake $0.13
Board [6d 8s 2h Kc 9c]
Seat 1: SB (small blind) folded before Flop
Seat 2: BB (big blind) showed [3c 4c] and lost with high card King
Seat 3: UTG folded before Flop
Seat 4: HJ showed [Ah Ad] and won ($3.68) with a pair of Aces
Seat 5: CO folded before Flop (didn't bet)
Seat 6: BTN (button) folded before Flop (didn't bet)


PokerStars Hand #238162453823:  Hold'em No Limit ($0.01/$0.02 USD) - 2022/08/23 3:00:54 ET
Table 'Achilles IV' 6-max Seat #1 is the button
Seat 1: BTN ($2 in chips)
Seat 3: SB ($2.34 in chips)
Seat 4: BB ($3.81 in chips)
Seat 5: HJ ($1.16 in chips)
Seat 6: CO ($2.36 in chips)
SB: posts small blind $0.01
BB: posts big blind $0.02
*** HOLE CARDS ***
HJ: calls $0.02
CO: folds
BTN: folds
SB: folds
BB: checks
*** FLOP *** [4c Qd 9d]
BB: checks
HJ: checks
*** TURN *** [4c Qd 9d] [Qc]
BB: checks
HJ: checks
*** RIVER *** [4c Qd 9d Qc] [8c]
BB: checks
HJ: checks
*** SHOW DOWN ***
BB: shows [9c Jd] (two pair, Queens and Nines)
HJ: mucks hand
BB collected $0.05 from pot
*** SUMMARY ***
Total pot $0.05 | Rake $0
Board [4c Qd 9d Qc 8c]
Seat 1: BTN (button) folded before Flop (didn't bet)
Seat 3: SB (small blind) folded before Flop
Seat 4: BB (big blind) showed [9c Jd] and won ($0.05) with two pair, Queens and Nines
Seat 5: HJ mucked
Seat 6: CO folded before Flop (didn't bet)


PokerStars Hand #238162459453:  Hold'em No Limit ($0.01/$0.02 USD) - 2022/08/23 3:01:48 ET
Table 'Achilles IV' 6-max Seat #3 is the button
Seat 1: HJ ($2 in chips)
Seat 2: CO ($2 in chips)
Seat 3: BTN ($2.33 in chips)
Seat 4: SB ($3.84 in chips)
Seat 5: BB ($1.14 in chips)
Seat 6: UTG ($2.36 in chips)
SB: posts small blind $0.01
BB: posts big blind $0.02
CO: posts small blind $0.01
*** HOLE CARDS ***
UTG has timed out
UTG: folds
HJ: folds
CO: folds
BTN: folds
SB: folds
Uncalled bet ($0.01) returned to BB
BB collected $0.03 from pot
*** SUMMARY ***
Total pot $0.03 | Rake $0
Seat 1: HJ folded before Flop (didn't bet)
Seat 2: CO folded before Flop (didn't bet)
Seat 3: BTN (button) folded before Flop (didn't bet)
Seat 4: SB (small blind) folded before Flop
Seat 5: BB (big blind) collected ($0.03)
Seat 6: UTG folded before Flop (didn't bet)


PokerStars Hand #238162462134:  Hold'em No Limit ($0.01/$0.02 USD) - 2022/08/23 3:02:14 ET
Table 'Achilles IV' 6-max Seat #4 is the button
Seat 1: UTG ($2 in chips)
Seat 2: HJ ($1.99 in chips)
Seat 3: CO ($2.33 in chips)
Seat 4: BTN ($3.83 in chips)
Seat 5: SB ($1.16 in chips)
Seat 6: BB ($2.36 in chips)
SB: posts small blind $0.01
BB: posts big blind $0.02
*** HOLE CARDS ***
UTG: folds
HJ: folds
CO: folds
BTN: raises $0.03 to $0.05
SB: folds
BB: calls $0.03
*** FLOP *** [Qs As 8d]
BB: checks
BTN: bets $0.04
BB: calls $0.04
*** TURN *** [Qs As 8d] [6s]
BB: checks
BTN: bets $0.14
BB: folds
Uncalled bet ($0.14) returned to BTN
BTN collected $0.18 from pot
BTN: doesn't show hand
*** SUMMARY ***
Total pot $0.19 | Rake $0.01
Board [Qs As 8d 6s]
Seat 1: UTG folded before Flop (didn't bet)
Seat 2: HJ folded before Flop (didn't bet)
Seat 3: CO folded before Flop (didn't bet)
Seat 4: BTN (button) collected ($0.18)
Seat 5: SB (small blind) folded before Flop
Seat 6: BB (big blind) folded on the Turn


PokerStars Hand #238162468143:  Hold'em No Limit ($0.01/$0.02 USD) - 2022/08/23 3:03:10 ET
Table 'Achilles IV' 6-max Seat #5 is the button
Seat 1: BB ($2 in chips)
Seat 2: UTG ($1.99 in chips)
Seat 3: HJ ($2.33 in chips)
Seat 4: CO ($3.92 in chips)
Seat 5: BTN ($1.15 in chips)
Seat 6: SB ($2.27 in chips)
SB: posts small blind $0.01
BB: posts big blind $0.02
*** HOLE CARDS ***
UTG: calls $0.02
HJ: folds
CO: folds
BTN: folds
SB: raises $0.04 to $0.06
BB: calls $0.04
UTG: calls $0.04
*** FLOP *** [4c Kh 5c]
SB: bets $0.04
BB: calls $0.04
UTG: folds
*** TURN *** [4c Kh 5c] [Jh]
SB: checks
BB: bets $0.20
SB: folds
Uncalled bet ($0.20) returned to BB
BB collected $0.25 from pot
*** SUMMARY ***
Total pot $0.26 | Rake $0.01
Board [4c Kh 5c Jh]
Seat 1: BB (big blind) collected ($0.25)
Seat 2: UTG folded on the Flop
Seat 3: HJ folded before Flop (didn't bet)
Seat 4: CO folded before Flop (didn't bet)
Seat 5: BTN (button) folded before Flop (didn't bet)
Seat 6: SB (small blind) folded on the Turn


PokerStars Hand #238162472242:  Hold'em No Limit ($0.01/$0.02 USD) - 2022/08/23 3:03:48 ET
Table 'Achilles IV' 6-max Seat #6 is the button
Seat 1: SB ($2.15 in chips)
Seat 2: BB ($1.93 in chips)
Seat 3: UTG ($2.33 in chips)
Seat 4: HJ ($3.92 in chips)
Seat 5: CO ($1.15 in chips)
Seat 6: BTN ($2.17 in chips)
SB: posts small blind $0.01
BB: posts big blind $0.02
*** HOLE CARDS ***
UTG: folds
HJ: folds
CO: folds
BTN: folds
SB: folds
Uncalled bet ($0.01) returned to BB
BB collected $0.02 from pot
*** SUMMARY ***
Total pot $0.02 | Rake $0
Seat 1: SB (small blind) folded before Flop
Seat 2: BB (big blind) collected ($0.02)
Seat 3: UTG folded before Flop (didn't bet)
Seat 4: HJ folded before Flop (didn't bet)
Seat 5: CO folded before Flop (didn't bet)
Seat 6: BTN (button) folded before Flop (didn't bet)


PokerStars Hand #238162473485:  Hold'em No Limit ($0.01/$0.02 USD) - 2022/08/23 3:03:59 ET
Table 'Achilles IV' 6-max Seat #1 is the button
Seat 1: BTN ($2.14 in chips)
Seat 2: SB ($1.94 in chips)
Seat 3: BB ($2.33 in chips)
Seat 4: UTG ($3.92 in chips)
Seat 5: HJ ($1.15 in chips)
Seat 6: CO ($2.17 in chips)
SB: posts small blind $0.01
BB: posts big blind $0.02
*** HOLE CARDS ***
UTG: folds
HJ: folds
CO: calls $0.02
BTN: folds
SB: folds
BB: checks
*** FLOP *** [8c Ah Jc]
BB: checks
CO: bets $0.02
BB: calls $0.02
*** TURN *** [8c Ah Jc] [2c]
BB: checks
CO: checks
*** RIVER *** [8c Ah Jc 2c] [4s]
BB: checks
CO: bets $0.04
BB: folds
Uncalled bet ($0.04) returned to CO
CO collected $0.09 from pot
CO: doesn't show hand
*** SUMMARY ***
Total pot $0.09 | Rake $0
Board [8c Ah Jc 2c 4s]
Seat 1: BTN (button) folded before Flop (didn't bet)
Seat 2: SB (small blind) folded before Flop
Seat 3: BB (big blind) folded on the River
Seat 4: UTG folded before Flop (didn't bet)
Seat 5: HJ folded before Flop (didn't bet)
Seat 6: CO collected ($0.09)


PokerStars Hand #238162481174:  Hold'em No Limit ($0.01/$0.02 USD) - 2022/08/23 3:05:11 ET
Table 'Achilles IV' 6-max Seat #2 is the button
Seat 1: CO ($2.14 in chips)
Seat 2: BTN ($1.93 in chips)
Seat 3: SB ($2.29 in chips)
Seat 4: BB ($3.92 in chips)
Seat 5: UTG ($1.15 in chips)
Seat 6: HJ ($2.22 in chips)
SB: posts small blind $0.01
BB: posts big blind $0.02
*** HOLE CARDS ***
UTG: folds
HJ: folds
CO: folds
BTN: folds
SB: folds
Uncalled bet ($0.01) returned to BB
BB collected $0.02 from pot
BB: doesn't show hand
*** SUMMARY ***
Total pot $0.02 | Rake $0
Seat 1: CO folded before Flop (didn't bet)
Seat 2: BTN (button) folded before Flop (didn't bet)
Seat 3: SB (small blind) folded before Flop
Seat 4: BB (big blind) collected ($0.02)
Seat 5: UTG folded before Flop (didn't bet)
Seat 6: HJ folded before Flop (didn't bet)


PokerStars Hand #238162486390:  Hold'em No Limit ($0.01/$0.02 USD) - 2022/08/23 3:05:59 ET
Table 'Achilles IV' 6-max Seat #4 is the button
Seat 1: UTG ($2.14 in chips)
Seat 2: HJ ($1.96 in chips)
Seat 3: CO ($2.28 in chips)
Seat 4: BTN ($3.92 in chips)
Seat 5: SB ($1.13 in chips)
Seat 6: BB ($2.22 in chips)
SB: posts small blind $0.01
BB: posts big blind $0.02
*** HOLE CARDS ***
UTG: raises $0.03 to $0.05
HJ: calls $0.05
CO: folds
BTN: folds
SB: folds
BB: calls $0.03
*** FLOP *** [Tc 7s 7d]
BB: checks
UTG: checks
HJ: checks
*** TURN *** [Tc 7s 7d] [Qs]
BB: bets $0.04
UTG: folds
HJ: folds
Uncalled bet ($0.04) returned to BB
BB collected $0.15 from pot
BB: doesn't show hand
*** SUMMARY ***
Total pot $0.16 | Rake $0.01
Board [Tc 7s 7d Qs]
Seat 1: UTG folded on the Turn
Seat 2: HJ folded on the Turn
Seat 3: CO folded before Flop (didn't bet)
Seat 4: BTN (button) folded before Flop (didn't bet)
Seat 5: SB (small blind) folded before Flop
Seat 6: BB (big blind) collected ($0.15)


PokerStars Hand #238162490580:  Hold'em No Limit ($0.01/$0.02 USD) - 2022/08/23 3:06:38 ET
Table 'Achilles IV' 6-max Seat #5 is the button
Seat 2: BB ($1.91 in chips)
Seat 3: HJ ($2.28 in chips)
Seat 4: CO ($3.92 in chips)
Seat 5: BTN ($1.12 in chips)
Seat 6: SB ($2.32 in chips)
SB: posts small blind $0.01
Vlao: is sitting out
BB: posts big blind $0.02
*** HOLE CARDS ***
HJ: folds
CO: folds
BTN: calls $0.02
SB: folds
BB: checks
*** FLOP *** [Tc Td Jd]
BB: checks
BTN: bets $0.04
BB: raises $0.04 to $0.08
BTN: calls $0.04
*** TURN *** [Tc Td Jd] [6h]
BB: checks
BTN: bets $0.06
BB: calls $0.06
*** RIVER *** [Tc Td Jd 6h] [Qh]
BB: bets $0.28
BTN: calls $0.28
*** SHOW DOWN ***
BB: shows [Kh Qd] (two pair, Queens and Tens)
BTN: shows [Ah Ts] (three of a kind, Tens)
BTN collected $0.86 from pot
*** SUMMARY ***
Total pot $0.89 | Rake $0.03
Board [Tc Td Jd 6h Qh]
Seat 2: BB (big blind) showed [Kh Qd] and lost with two pair, Queens and Tens
Seat 3: HJ folded before Flop (didn't bet)
Seat 4: CO folded before Flop (didn't bet)
Seat 5: BTN (button) showed [Ah Ts] and won ($0.86) with three of a kind, Tens
Seat 6: SB (small blind) folded before Flop


PokerStars Hand #238162495222:  Hold'em No Limit ($0.01/$0.02 USD) - 2022/08/23 3:07:22 ET
Table 'Achilles IV' 6-max Seat #6 is the button
Seat 2: SB ($1.47 in chips)
Seat 3: BB ($2.28 in chips)
Seat 4: HJ ($3.92 in chips)
Seat 5: CO ($1.54 in chips)
Seat 6: BTN ($2.31 in chips)
SB: posts small blind $0.01
BB: posts big blind $0.02
*** HOLE CARDS ***
HJ has timed out
HJ: folds
CO: calls $0.02
BTN: raises $0.04 to $0.06
SB: folds
BB: folds
CO: calls $0.04
*** FLOP *** [4s 9h 4h]
CO: checks
BTN: checks
*** TURN *** [4s 9h 4h] [Ah]
CO: bets $0.14
BTN: folds
Uncalled bet ($0.14) returned to CO
CO collected $0.14 from pot
*** SUMMARY ***
Total pot $0.15 | Rake $0.01
Board [4s 9h 4h Ah]
Seat 2: SB (small blind) folded before Flop
Seat 3: BB (big blind) folded before Flop
Seat 4: HJ folded before Flop (didn't bet)
Seat 5: CO collected ($0.14)
Seat 6: BTN (button) folded on the Turn


PokerStars Hand #238162499473:  Hold'em No Limit ($0.01/$0.02 USD) - 2022/08/23 3:08:01 ET
Table 'Achilles IV' 6-max Seat #2 is the button
Seat 2: BTN ($1.46 in chips)
Seat 3: SB ($2.26 in chips)
Seat 4: BB ($3.92 in chips)
Seat 5: HJ ($1.62 in chips)
Seat 6: CO ($2.25 in chips)
SB: posts small blind $0.01
BB: posts big blind $0.02
*** HOLE CARDS ***
HJ: folds
CO: folds
BTN: calls $0.02
SB: folds
Vlao leaves the table
BB: checks
*** FLOP *** [Qs 5c 2d]
BB: bets $0.04
NivelXcamione joins the table at seat #1
BTN: folds
Uncalled bet ($0.04) returned to BB
BB collected $0.05 from pot
BB: doesn't show hand
*** SUMMARY ***
Total pot $0.05 | Rake $0
Board [Qs 5c 2d]
Seat 2: BTN (button) folded on the Flop
Seat 3: SB (small blind) folded before Flop
Seat 4: BB (big blind) collected ($0.05)
Seat 5: HJ folded before Flop (didn't bet)
Seat 6: CO folded before Flop (didn't bet)


PokerStars Hand #238162502965:  Hold'em No Limit ($0.01/$0.02 USD) - 2022/08/23 3:08:33 ET
Table 'Achilles IV' 6-max Seat #3 is the button
Seat 2: CO ($1.44 in chips)
Seat 3: BTN ($2.25 in chips)
Seat 4: SB ($3.95 in chips)
Seat 5: BB ($1.62 in chips)
Seat 6: HJ ($2.25 in chips)
SB: posts small blind $0.01
BB: posts big blind $0.02
NivelXcamione: sits out
*** HOLE CARDS ***
HJ: folds
CO: folds
BTN: folds
SB: folds
Uncalled bet ($0.01) returned to BB
BB collected $0.02 from pot
*** SUMMARY ***
Total pot $0.02 | Rake $0
Seat 2: CO folded before Flop (didn't bet)
Seat 3: BTN (button) folded before Flop (didn't bet)
Seat 4: SB (small blind) folded before Flop
Seat 5: BB (big blind) collected ($0.02)
Seat 6: HJ folded before Flop (didn't bet)


PokerStars Hand #238162504332:  Hold'em No Limit ($0.01/$0.02 USD) - 2022/08/23 3:08:46 ET
Table 'Achilles IV' 6-max Seat #4 is the button
Seat 2: HJ ($1.44 in chips)
Seat 3: CO ($2.25 in chips)
Seat 4: BTN ($3.94 in chips)
Seat 5: SB ($1.63 in chips)
Seat 6: BB ($2.25 in chips)
SB: posts small blind $0.01
BB: posts big blind $0.02
NivelXcamione: sits out
*** HOLE CARDS ***
HJ: calls $0.02
CO: folds
BTN: folds
SB: calls $0.01
BB: checks
*** FLOP *** [Kc 5h Ks]
SB: bets $0.04
BB: folds
HJ: calls $0.04
*** TURN *** [Kc 5h Ks] [As]
SB: bets $0.06
HJ: raises $0.06 to $0.12
SB: calls $0.06
*** RIVER *** [Kc 5h Ks As] [9s]
SB: checks
HJ: bets $1.26 and is all-in
SB: folds
Uncalled bet ($1.26) returned to HJ
HJ collected $0.37 from pot
*** SUMMARY ***
Total pot $0.38 | Rake $0.01
Board [Kc 5h Ks As 9s]
Seat 2: HJ collected ($0.37)
Seat 3: CO folded before Flop (didn't bet)
Seat 4: BTN (button) folded before Flop (didn't bet)
Seat 5: SB (small blind) folded on the River
Seat 6: BB (big blind) folded on the Flop


PokerStars Hand #238162509729:  Hold'em No Limit ($0.01/$0.02 USD) - 2022/08/23 3:09:35 ET
Table 'Achilles IV' 6-max Seat #5 is the button
Seat 1: BB ($1.30 in chips)
Seat 2: UTG ($1.63 in chips)
Seat 3: HJ ($2.25 in chips)
Seat 4: CO ($3.94 in chips)
Seat 5: BTN ($1.45 in chips)
Seat 6: SB ($2.23 in chips)
SB: posts small blind $0.01
BB: posts big blind $0.02
*** HOLE CARDS ***
UTG: folds
HJ: folds
CO: folds
BTN: folds
SB: calls $0.01
BB: checks
*** FLOP *** [Td Qh 2h]
SB: bets $0.02
BB: folds
Uncalled bet ($0.02) returned to SB
SB collected $0.04 from pot
SB: doesn't show hand
*** SUMMARY ***
Total pot $0.04 | Rake $0
Board [Td Qh 2h]
Seat 1: BB (big blind) folded on the Flop
Seat 2: UTG folded before Flop (didn't bet)
Seat 3: HJ folded before Flop (didn't bet)
Seat 4: CO folded before Flop (didn't bet)
Seat 5: BTN (button) folded before Flop (didn't bet)
Seat 6: SB (small blind) collected ($0.04)


PokerStars Hand #238162513069:  Hold'em No Limit ($0.01/$0.02 USD) - 2022/08/23 3:10:07 ET
Table 'Achilles IV' 6-max Seat #6 is the button
Seat 1: SB ($1.28 in chips)
Seat 2: BB ($1.63 in chips)
Seat 3: UTG ($2.25 in chips)
Seat 4: HJ ($3.94 in chips)
Seat 5: CO ($1.45 in chips)
Seat 6: BTN ($2.25 in chips)
SB: posts small blind $0.01
BB: posts big blind $0.02
*** HOLE CARDS ***
UTG: folds
HJ: folds
CO: folds
BTN: raises $0.04 to $0.06
SB: calls $0.05
BB: calls $0.04
*** FLOP *** [9d Th Ks]
SB: checks
BB: checks
BTN: bets $0.08
SB: calls $0.08
BB: folds
*** TURN *** [9d Th Ks] [Js]
SB: checks
BTN: checks
*** RIVER *** [9d Th Ks Js] [8d]
SB: bets $0.10
BTN: calls $0.10
*** SHOW DOWN ***
SB: shows [Kh 8h] (two pair, Kings and Eights)
BTN: shows [9h Kd] (two pair, Kings and Nines)
BTN collected $0.52 from pot
*** SUMMARY ***
Total pot $0.54 | Rake $0.02
Board [9d Th Ks Js 8d]
Seat 1: SB (small blind) showed [Kh 8h] and lost with two pair, Kings and Eights
Seat 2: BB (big blind) folded on the Flop
Seat 3: UTG folded before Flop (didn't bet)
Seat 4: HJ folded before Flop (didn't bet)
Seat 5: CO folded before Flop (didn't bet)
Seat 6: BTN (button) showed [9h Kd] and won ($0.52) with two pair, Kings and Nines


PokerStars Hand #238162518282:  Hold'em No Limit ($0.01/$0.02 USD) - 2022/08/23 3:10:55 ET
Table 'Achilles IV' 6-max Seat #1 is the button
Seat 1: BTN ($1.04 in chips)
Seat 2: SB ($1.57 in chips)
Seat 3: BB ($2.25 in chips)
Seat 4: UTG ($3.94 in chips)
Seat 5: HJ ($1.45 in chips)
Seat 6: CO ($2.53 in chips)
SB: posts small blind $0.01
BB: posts big blind $0.02
*** HOLE CARDS ***
UTG: folds
HJ: folds
CO: folds
BTN: folds
SB: folds
Uncalled bet ($0.01) returned to BB
BB collected $0.02 from pot
*** SUMMARY ***
Total pot $0.02 | Rake $0
Seat 1: BTN (button) folded before Flop (didn't bet)
Seat 2: SB (small blind) folded before Flop
Seat 3: BB (big blind) collected ($0.02)
Seat 4: UTG folded before Flop (didn't bet)
Seat 5: HJ folded before Flop (didn't bet)
Seat 6: CO folded before Flop (didn't bet)


PokerStars Hand #238162519415:  Hold'em No Limit ($0.01/$0.02 USD) - 2022/08/23 3:11:06 ET
Table 'Achilles IV' 6-max Seat #2 is the button
Seat 1: CO ($1.04 in chips)
Seat 2: BTN ($1.56 in chips)
Seat 3: SB ($2.26 in chips)
Seat 4: BB ($3.94 in chips)
Seat 5: UTG ($1.45 in chips)
Seat 6: HJ ($2.53 in chips)
SB: posts small blind $0.01
BB: posts big blind $0.02
*** HOLE CARDS ***
UTG: folds
HJ: raises $0.04 to $0.06
CO: raises $0.98 to $1.04 and is all-in
BTN: folds
SB: folds
BB: folds
HJ: folds
Uncalled bet ($0.98) returned to CO
CO collected $0.15 from pot
CO: doesn't show hand
*** SUMMARY ***
Total pot $0.15 | Rake $0
Seat 1: CO collected ($0.15)
Seat 2: BTN (button) folded before Flop (didn't bet)
Seat 3: SB (small blind) folded before Flop
Seat 4: BB (big blind) folded before Flop
Seat 5: UTG folded before Flop (didn't bet)
Seat 6: HJ folded before Flop


PokerStars Hand #238162521564:  Hold'em No Limit ($0.01/$0.02 USD) - 2022/08/23 3:11:25 ET
Table 'Achilles IV' 6-max Seat #3 is the button
Seat 1: HJ ($1.13 in chips)
Seat 2: CO ($1.56 in chips)
Seat 3: BTN ($2.25 in chips)
Seat 4: SB ($3.92 in chips)
Seat 5: BB ($1.45 in chips)
Seat 6: UTG ($2.47 in chips)
SB: posts small blind $0.01
BB: posts big blind $0.02
*** HOLE CARDS ***
UTG: folds
HJ: raises $0.04 to $0.06
CO: folds
BTN: folds
SB: folds
BB: calls $0.04
*** FLOP *** [Ts 9h 4c]
BB: checks
HJ: bets $0.06
BB: calls $0.06
*** TURN *** [Ts 9h 4c] [5s]
BB: checks
HJ: checks
*** RIVER *** [Ts 9h 4c 5s] [7h]
BB: checks
HJ: checks
*** SHOW DOWN ***
BB: shows [Ac Ks] (high card Ace)
HJ: mucks hand
BB collected $0.24 from pot
*** SUMMARY ***
Total pot $0.25 | Rake $0.01
Board [Ts 9h 4c 5s 7h]
Seat 1: HJ mucked
Seat 2: CO folded before Flop (didn't bet)
Seat 3: BTN (button) folded before Flop (didn't bet)
Seat 4: SB (small blind) folded before Flop
Seat 5: BB (big blind) showed [Ac Ks] and won ($0.24) with high card Ace
Seat 6: UTG folded before Flop (didn't bet)


PokerStars Hand #238162525724:  Hold'em No Limit ($0.01/$0.02 USD) - 2022/08/23 3:12:03 ET
Table 'Achilles IV' 6-max Seat #4 is the button
Seat 1: UTG ($1.01 in chips)
Seat 2: HJ ($1.56 in chips)
Seat 3: CO ($2.25 in chips)
Seat 4: BTN ($3.91 in chips)
Seat 5: SB ($1.57 in chips)
Seat 6: BB ($2.47 in chips)
SB: posts small blind $0.01
BB: posts big blind $0.02
*** HOLE CARDS ***
UTG: folds
HJ: folds
CO: raises $0.04 to $0.06
BTN: folds
SB: folds
BB: folds
Uncalled bet ($0.04) returned to CO
CO collected $0.05 from pot
*** SUMMARY ***
Total pot $0.05 | Rake $0
Seat 1: UTG folded before Flop (didn't bet)
Seat 2: HJ folded before Flop (didn't bet)
Seat 3: CO collected ($0.05)
Seat 4: BTN (button) folded before Flop (didn't bet)
Seat 5: SB (small blind) folded before Flop
Seat 6: BB (big blind) folded before Flop


PokerStars Hand #238162528197:  Hold'em No Limit ($0.01/$0.02 USD) - 2022/08/23 3:12:25 ET
Table 'Achilles IV' 6-max Seat #5 is the button
Seat 1: BB ($1.01 in chips)
Seat 2: UTG ($1.56 in chips)
Seat 3: HJ ($2.28 in chips)
Seat 4: CO ($3.91 in chips)
Seat 5: BTN ($1.56 in chips)
Seat 6: SB ($2.45 in chips)
SB: posts small blind $0.01
BB: posts big blind $0.02
*** HOLE CARDS ***
UTG: calls $0.02
HJ: folds
CO: folds
BTN: folds
SB: calls $0.01
BB: checks
*** FLOP *** [9s 5s 6d]
SB: checks
BB: checks
UTG: checks
*** TURN *** [9s 5s 6d] [Qs]
SB: checks
BB: bets $0.06
UTG: folds
SB: folds
Uncalled bet ($0.06) returned to BB
BB collected $0.06 from pot
BB: doesn't show hand
*** SUMMARY ***
Total pot $0.06 | Rake $0
Board [9s 5s 6d Qs]
Seat 1: BB (big blind) collected ($0.06)
Seat 2: UTG folded on the Turn
Seat 3: HJ folded before Flop (didn't bet)
Seat 4: CO folded before Flop (didn't bet)
Seat 5: BTN (button) folded before Flop (didn't bet)
Seat 6: SB (small blind) folded on the Turn


PokerStars Hand #238162531925:  Hold'em No Limit ($0.01/$0.02 USD) - 2022/08/23 3:12:59 ET
Table 'Achilles IV' 6-max Seat #6 is the button
Seat 1: SB ($1.05 in chips)
Seat 2: BB ($1.54 in chips)
Seat 3: UTG ($2.28 in chips)
Seat 4: HJ ($3.91 in chips)
Seat 5: CO ($1.56 in chips)
Seat 6: BTN ($2.43 in chips)
SB: posts small blind $0.01
BB: posts big blind $0.02
*** HOLE CARDS ***
UTG: raises $0.04 to $0.06
HJ: folds
CO: calls $0.06
BTN: calls $0.06
SB: calls $0.05
BB: folds
*** FLOP *** [Tc 9s Ts]
SB: checks
UTG: checks
CO: bets $0.12
BTN: calls $0.12
SB: folds
UTG: calls $0.12
*** TURN *** [Tc 9s Ts] [5h]
UTG: checks
CO: bets $0.30
BTN: folds
UTG: folds
Uncalled bet ($0.30) returned to CO
CO collected $0.60 from pot
*** SUMMARY ***
Total pot $0.62 | Rake $0.02
Board [Tc 9s Ts 5h]
Seat 1: SB (small blind) folded on the Flop
Seat 2: BB (big blind) folded before Flop
Seat 3: UTG folded on the Turn
Seat 4: HJ folded before Flop (didn't bet)
Seat 5: CO collected ($0.60)
Seat 6: BTN (button) folded on the Turn


PokerStars Hand #238162539751:  Hold'em No Limit ($0.01/$0.02 USD) - 2022/08/23 3:14:09 ET
Table 'Achilles IV' 6-max Seat #1 is the button
Seat 1: BTN ($0.99 in chips)
Seat 2: SB ($1.52 in chips)
Seat 3: BB ($2.10 in chips)
Seat 4: UTG ($3.91 in chips)
Seat 5: HJ ($1.98 in chips)
Seat 6: CO ($2.25 in chips)
SB: posts small blind $0.01
BB: posts big blind $0.02
*** HOLE CARDS ***
UTG: folds
HJ: calls $0.02
CO: raises $0.04 to $0.06
BTN: folds
SB: folds
BB: folds
HJ: calls $0.04
*** FLOP *** [8h 8d Tc]
HJ: checks
CO: bets $0.04
HJ: folds
Uncalled bet ($0.04) returned to CO
CO collected $0.14 from pot
CO: doesn't show hand
*** SUMMARY ***
Total pot $0.15 | Rake $0.01
Board [8h 8d Tc]
Seat 1: BTN (button) folded before Flop (didn't bet)
Seat 2: SB (small blind) folded before Flop
Seat 3: BB (big blind) folded before Flop
Seat 4: UTG folded before Flop (didn't bet)
Seat 5: HJ folded on the Flop
Seat 6: CO collected ($0.14)


PokerStars Hand #238162542967:  Hold'em No Limit ($0.01/$0.02 USD) - 2022/08/23 3:14:38 ET
Table 'Achilles IV' 6-max Seat #2 is the button
Seat 1: CO ($0.99 in chips)
Seat 2: BTN ($1.51 in chips)
Seat 3: SB ($2.08 in chips)
Seat 4: BB ($3.91 in chips)
Seat 5: UTG ($1.92 in chips)
Seat 6: HJ ($2.33 in chips)
SB: posts small blind $0.01
BB: posts big blind $0.02
*** HOLE CARDS ***
UTG: folds
HJ: folds
CO: folds
BTN: folds
SB: folds
Uncalled bet ($0.01) returned to BB
BB collected $0.02 from pot
BB: doesn't show hand
*** SUMMARY ***
Total pot $0.02 | Rake $0
Seat 1: CO folded before Flop (didn't bet)
Seat 2: BTN (button) folded before Flop (didn't bet)
Seat 3: SB (small blind) folded before Flop
Seat 4: BB (big blind) collected ($0.02)
Seat 5: UTG folded before Flop (didn't bet)
Seat 6: HJ folded before Flop (didn't bet)


PokerStars Hand #238162544236:  Hold'em No Limit ($0.01/$0.02 USD) - 2022/08/23 3:14:50 ET
Table 'Achilles IV' 6-max Seat #3 is the button
Seat 1: HJ ($0.99 in chips)
Seat 2: CO ($1.51 in chips)
Seat 3: BTN ($2.07 in chips)
Seat 4: SB ($3.92 in chips)
Seat 5: BB ($1.92 in chips)
Seat 6: UTG ($2.33 in chips)
SB: posts small blind $0.01
BB: posts big blind $0.02
*** HOLE CARDS ***
UTG: folds
HJ: calls $0.02
CO: folds
BTN: raises $0.08 to $0.10
SB: folds
BB: folds
HJ: folds
Uncalled bet ($0.08) returned to BTN
BTN collected $0.07 from pot
*** SUMMARY ***
Total pot $0.07 | Rake $0
Seat 1: HJ folded before Flop
Seat 2: CO folded before Flop (didn't bet)
Seat 3: BTN (button) collected ($0.07)
Seat 4: SB (small blind) folded before Flop
Seat 5: BB (big blind) folded before Flop
Seat 6: UTG folded before Flop (didn't bet)


PokerStars Hand #238162546835:  Hold'em No Limit ($0.01/$0.02 USD) - 2022/08/23 3:15:13 ET
Table 'Achilles IV' 6-max Seat #4 is the button
Seat 1: UTG ($0.97 in chips)
Seat 2: HJ ($1.51 in chips)
Seat 3: CO ($2.12 in chips)
Seat 4: BTN ($3.91 in chips)
Seat 5: SB ($1.90 in chips)
Seat 6: BB ($2.33 in chips)
SB: posts small blind $0.01
BB: posts big blind $0.02
*** HOLE CARDS ***
UTG: folds
HJ: folds
CO: folds
BTN: raises $0.03 to $0.05
SB: folds
BB: calls $0.03
*** FLOP *** [4s 5h 6h]
BB: checks
BTN: checks
*** TURN *** [4s 5h 6h] [3s]
BB: bets $0.08
BTN: folds
Uncalled bet ($0.08) returned to BB
BB collected $0.11 from pot
BB: doesn't show hand
*** SUMMARY ***
Total pot $0.11 | Rake $0
Board [4s 5h 6h 3s]
Seat 1: UTG folded before Flop (didn't bet)
Seat 2: HJ folded before Flop (didn't bet)
Seat 3: CO folded before Flop (didn't bet)
Seat 4: BTN (button) folded on the Turn
Seat 5: SB (small blind) folded before Flop
Seat 6: BB (big blind) collected ($0.11)


PokerStars Hand #238162552270:  Hold'em No Limit ($0.01/$0.02 USD) - 2022/08/23 3:16:02 ET
Table 'Achilles IV' 6-max Seat #5 is the button
Seat 1: BB ($0.97 in chips)
Seat 2: UTG ($1.51 in chips)
Seat 3: HJ ($2.12 in chips)
Seat 4: CO ($3.86 in chips)
Seat 5: BTN ($1.89 in chips)
Seat 6: SB ($2.39 in chips)
SB: posts small blind $0.01
BB: posts big blind $0.02
*** HOLE CARDS ***
UTG: folds
HJ: folds
CO: raises $0.03 to $0.05
BTN: folds
SB: folds
BB: folds
Uncalled bet ($0.03) returned to CO
CO collected $0.05 from pot
CO: doesn't show hand
*** SUMMARY ***
Total pot $0.05 | Rake $0
Seat 1: BB (big blind) folded before Flop
Seat 2: UTG folded before Flop (didn't bet)
Seat 3: HJ folded before Flop (didn't bet)
Seat 4: CO collected ($0.05)
Seat 5: BTN (button) folded before Flop (didn't bet)
Seat 6: SB (small blind) folded before Flop


PokerStars Hand #238162554065:  Hold'em No Limit ($0.01/$0.02 USD) - 2022/08/23 3:16:18 ET
Table 'Achilles IV' 6-max Seat #1 is the button
Seat 1: BTN ($0.95 in chips)
Seat 2: SB ($1.51 in chips)
Seat 3: BB ($2.12 in chips)
Seat 4: HJ ($3.89 in chips)
Seat 5: CO ($1.89 in chips)
SB: posts small blind $0.01
BB: posts big blind $0.02
*** HOLE CARDS ***
freedomcrank leaves the table
HJ: folds
HJ leaves the table
CO: folds
BTN: folds
SB: calls $0.01
BB: checks
*** FLOP *** [5d 6h 9s]
SB: checks
BB: checks
*** TURN *** [5d 6h 9s] [3s]
SB: bets $0.08
BB: folds
Uncalled bet ($0.08) returned to SB
SB collected $0.04 from pot
*** SUMMARY ***
Total pot $0.04 | Rake $0
Board [5d 6h 9s 3s]
Seat 1: BTN (button) folded before Flop (didn't bet)
Seat 2: SB (small blind) collected ($0.04)
Seat 3: BB (big blind) folded on the Turn
Seat 4: HJ folded before Flop (didn't bet)
Seat 5: CO folded before Flop (didn't bet)


PokerStars Hand #238162558183:  Hold'em No Limit ($0.01/$0.02 USD) - 2022/08/23 3:16:54 ET
Table 'Achilles IV' 6-max Seat #2 is the button
Seat 1: CO ($0.95 in chips)
Seat 2: BTN ($1.53 in chips)
Seat 3: SB ($2.10 in chips)
Seat 5: BB ($1.89 in chips)
SB: posts small blind $0.01
BB: posts big blind $0.02
*** HOLE CARDS ***
CO: raises $0.04 to $0.06
BTN: calls $0.06
SB: folds
BB: folds
*** FLOP *** [3h Qs Jh]
CO: bets $0.07
BTN: calls $0.07
*** TURN *** [3h Qs Jh] [3s]
CO: bets $0.14
BTN: folds
Uncalled bet ($0.14) returned to CO
CO collected $0.28 from pot
CO: doesn't show hand
*** SUMMARY ***
Total pot $0.29 | Rake $0.01
Board [3h Qs Jh 3s]
Seat 1: CO collected ($0.28)
Seat 2: BTN (button) folded on the Turn
Seat 3: SB (small blind) folded before Flop
Seat 5: BB (big blind) folded before Flop


PokerStars Hand #238162561548:  Hold'em No Limit ($0.01/$0.02 USD) - 2022/08/23 3:17:25 ET
Table 'Achilles IV' 6-max Seat #3 is the button
Seat 1: BB ($1.10 in chips)
Seat 2: CO ($1.40 in chips)
Seat 3: BTN ($2.09 in chips)
Seat 5: SB ($1.87 in chips)
SB: posts small blind $0.01
BB: posts big blind $0.02
*** HOLE CARDS ***
CO: folds
BTN: raises $0.04 to $0.06
SB: folds
blektron1 joins the table at seat #6
H17FS joins the table at seat #4
BB: folds
Uncalled bet ($0.04) returned to BTN
BTN collected $0.05 from pot
*** SUMMARY ***
Total pot $0.05 | Rake $0
Seat 1: BB (big blind) folded before Flop
Seat 2: CO folded before Flop (didn't bet)
Seat 3: BTN (button) collected ($0.05)
Seat 5: SB (small blind) folded before Flop


PokerStars Hand #238162564753:  Hold'em No Limit ($0.01/$0.02 USD) - 2022/08/23 3:17:53 ET
Table 'Achilles IV' 6-max Seat #5 is the button
Seat 1: SB ($1.08 in chips)
Seat 2: BB ($1.40 in chips)
Seat 3: HJ ($2.12 in chips)
Seat 4: CO ($1.60 in chips)
Seat 5: BTN ($1.86 in chips)
SB: posts small blind $0.01
BB: posts big blind $0.02
CO: posts big blind $0.02
*** HOLE CARDS ***
HJ: folds
CO: checks
BTN: folds
SB: calls $0.01
BB: raises $0.06 to $0.08
CO: calls $0.06
SB: folds
*** FLOP *** [6h Ad 8s]
BB: checks
CO: checks
*** TURN *** [6h Ad 8s] [9h]
BB: bets $0.10
CO: calls $0.10
*** RIVER *** [6h Ad 8s 9h] [Qs]
BB: bets $0.14
CO: calls $0.14
*** SHOW DOWN ***
BB: shows [As Jd] (a pair of Aces)
CO: mucks hand
BB collected $0.64 from pot
*** SUMMARY ***
Total pot $0.66 | Rake $0.02
Board [6h Ad 8s 9h Qs]
Seat 1: SB (small blind) folded before Flop
Seat 2: BB (big blind) showed [As Jd] and won ($0.64) with a pair of Aces
Seat 3: HJ folded before Flop (didn't bet)
Seat 4: CO mucked
Seat 5: BTN (button) folded before Flop (didn't bet)


PokerStars Hand #238162570541:  Hold'em No Limit ($0.01/$0.02 USD) - 2022/08/23 3:18:45 ET
Table 'Achilles IV' 6-max Seat #1 is the button
Seat 1: BTN ($1.06 in chips)
Seat 2: SB ($1.72 in chips)
Seat 3: BB ($2.12 in chips)
Seat 4: UTG ($1.28 in chips)
Seat 5: HJ ($1.86 in chips)
Seat 6: CO ($0.80 in chips)
SB: posts small blind $0.01
BB: posts big blind $0.02
CO: posts big blind $0.02
*** HOLE CARDS ***
UTG: calls $0.02
HJ: folds
CO: checks
BTN: folds
SB: raises $0.02 to $0.04
BB: folds
UTG: calls $0.02
CO: calls $0.02
*** FLOP *** [Tc Js Jc]
SB: checks
UTG: checks
CO: checks
*** TURN *** [Tc Js Jc] [6s]
SB: bets $0.08
UTG: calls $0.08
CO: folds
*** RIVER *** [Tc Js Jc 6s] [5h]
SB: checks
UTG: bets $0.14
SB: folds
Uncalled bet ($0.14) returned to UTG
UTG collected $0.29 from pot
*** SUMMARY ***
Total pot $0.30 | Rake $0.01
Board [Tc Js Jc 6s 5h]
Seat 1: BTN (button) folded before Flop (didn't bet)
Seat 2: SB (small blind) folded on the River
Seat 3: BB (big blind) folded before Flop
Seat 4: UTG collected ($0.29)
Seat 5: HJ folded before Flop (didn't bet)
Seat 6: CO folded on the Turn


PokerStars Hand #238162576802:  Hold'em No Limit ($0.01/$0.02 USD) - 2022/08/23 3:19:40 ET
Table 'Achilles IV' 6-max Seat #2 is the button
Seat 1: CO ($1.06 in chips)
Seat 2: BTN ($1.60 in chips)
Seat 3: SB ($2.10 in chips)
Seat 4: BB ($1.45 in chips)
Seat 5: UTG ($1.86 in chips)
Seat 6: HJ ($0.76 in chips)
SB: posts small blind $0.01
BB: posts big blind $0.02
*** HOLE CARDS ***
UTG: raises $0.02 to $0.04
HJ: calls $0.04
CO: folds
BTN: calls $0.04
SB: folds
BB: calls $0.02
*** FLOP *** [Jc 2d 4d]
BB: checks
UTG: bets $0.04
HJ: folds
BTN: calls $0.04
BB: folds
*** TURN *** [Jc 2d 4d] [6s]
UTG: checks
BTN: checks
*** RIVER *** [Jc 2d 4d 6s] [Qs]
UTG: checks
BTN: bets $0.14
UTG: folds
Uncalled bet ($0.14) returned to BTN
BTN collected $0.24 from pot
*** SUMMARY ***
Total pot $0.25 | Rake $0.01
Board [Jc 2d 4d 6s Qs]
Seat 1: CO folded before Flop (didn't bet)
Seat 2: BTN (button) collected ($0.24)
Seat 3: SB (small blind) folded before Flop
Seat 4: BB (big blind) folded on the Flop
Seat 5: UTG folded on the River
Seat 6: HJ folded on the Flop


PokerStars Hand #238162581871:  Hold'em No Limit ($0.01/$0.02 USD) - 2022/08/23 3:20:24 ET
Table 'Achilles IV' 6-max Seat #3 is the button
Seat 1: HJ ($1.06 in chips)
Seat 2: CO ($1.76 in chips)
Seat 3: BTN ($2.09 in chips)
Seat 4: SB ($1.41 in chips)
Seat 5: BB ($1.78 in chips)
Seat 6: UTG ($0.72 in chips)
SB: posts small blind $0.01
BB: posts big blind $0.02
*** HOLE CARDS ***
UTG: folds
HJ: folds
CO: calls $0.02
BTN: folds
SB: folds
BB: checks
*** FLOP *** [5c 8c 3d]
BB: checks
CO: checks
*** TURN *** [5c 8c 3d] [8d]
BB: checks
CO: checks
*** RIVER *** [5c 8c 3d 8d] [4d]
BB: bets $0.02
CO: folds
Uncalled bet ($0.02) returned to BB
BB collected $0.05 from pot
BB: doesn't show hand
*** SUMMARY ***
Total pot $0.05 | Rake $0
Board [5c 8c 3d 8d 4d]
Seat 1: HJ folded before Flop (didn't bet)
Seat 2: CO folded on the River
Seat 3: BTN (button) folded before Flop (didn't bet)
Seat 4: SB (small blind) folded before Flop
Seat 5: BB (big blind) collected ($0.05)
Seat 6: UTG folded before Flop (didn't bet)


PokerStars Hand #238162585054:  Hold'em No Limit ($0.01/$0.02 USD) - 2022/08/23 3:20:53 ET
Table 'Achilles IV' 6-max Seat #4 is the button
Seat 1: UTG ($1.06 in chips)
Seat 2: HJ ($1.74 in chips)
Seat 3: CO ($2.09 in chips)
Seat 4: BTN ($1.40 in chips)
Seat 5: SB ($1.81 in chips)
Seat 6: BB ($0.72 in chips)
SB: posts small blind $0.01
BB: posts big blind $0.02
*** HOLE CARDS ***
UTG: calls $0.02
HJ: folds
CO: folds
BTN: folds
SB: folds
BB: checks
*** FLOP *** [3s Kh 5h]
BB: checks
UTG: bets $0.04
BB: folds
Uncalled bet ($0.04) returned to UTG
UTG collected $0.05 from pot
UTG: doesn't show hand
*** SUMMARY ***
Total pot $0.05 | Rake $0
Board [3s Kh 5h]
Seat 1: UTG collected ($0.05)
Seat 2: HJ folded before Flop (didn't bet)
Seat 3: CO folded before Flop (didn't bet)
Seat 4: BTN (button) folded before Flop (didn't bet)
Seat 5: SB (small blind) folded before Flop
Seat 6: BB (big blind) folded on the Flop


PokerStars Hand #238162588339:  Hold'em No Limit ($0.01/$0.02 USD) - 2022/08/23 3:21:22 ET
Table 'Achilles IV' 6-max Seat #5 is the button
Seat 1: BB ($1.09 in chips)
Seat 2: UTG ($1.74 in chips)
Seat 3: HJ ($2.09 in chips)
Seat 4: CO ($1.40 in chips)
Seat 5: BTN ($1.80 in chips)
Seat 6: SB ($0.70 in chips)
SB: posts small blind $0.01
BB: posts big blind $0.02
*** HOLE CARDS ***
UTG: calls $0.02
HJ: folds
CO: calls $0.02
BTN: calls $0.02
SB: folds
BB: checks
*** FLOP *** [6c Ts 4c]
BB: checks
UTG: bets $0.02
CO: calls $0.02
BTN: calls $0.02
BB: folds
*** TURN *** [6c Ts 4c] [Jd]
UTG: bets $0.16
CO: folds
BTN: calls $0.16
*** RIVER *** [6c Ts 4c Jd] [9d]
UTG: bets $0.34
BTN: raises $0.34 to $0.68
UTG: folds
Uncalled bet ($0.34) returned to BTN
BTN collected $1.11 from pot
*** SUMMARY ***
Total pot $1.15 | Rake $0.04
Board [6c Ts 4c Jd 9d]
Seat 1: BB (big blind) folded on the Flop
Seat 2: UTG folded on the River
Seat 3: HJ folded before Flop (didn't bet)
Seat 4: CO folded on the Turn
Seat 5: BTN (button) collected ($1.11)
Seat 6: SB (small blind) folded before Flop


PokerStars Hand #238162596996:  Hold'em No Limit ($0.01/$0.02 USD) - 2022/08/23 3:22:41 ET
Table 'Achilles IV' 6-max Seat #6 is the button
Seat 1: SB ($1.07 in chips)
Seat 2: BB ($1.20 in chips)
Seat 3: UTG ($2.09 in chips)
Seat 4: HJ ($1.36 in chips)
Seat 5: CO ($2.37 in chips)
Seat 6: BTN ($0.69 in chips)
SB: posts small blind $0.01
BB: posts big blind $0.02
*** HOLE CARDS ***
UTG: folds
HJ: folds
CO: folds
BTN: folds
SB: folds
Uncalled bet ($0.01) returned to BB
BB collected $0.02 from pot
*** SUMMARY ***
Total pot $0.02 | Rake $0
Seat 1: SB (small blind) folded before Flop
Seat 2: BB (big blind) collected ($0.02)
Seat 3: UTG folded before Flop (didn't bet)
Seat 4: HJ folded before Flop (didn't bet)
Seat 5: CO folded before Flop (didn't bet)
Seat 6: BTN (button) folded before Flop (didn't bet)


PokerStars Hand #238162599125:  Hold'em No Limit ($0.01/$0.02 USD) - 2022/08/23 3:22:59 ET
Table 'Achilles IV' 6-max Seat #1 is the button
Seat 1: BTN ($1.06 in chips)
Seat 2: SB ($1.21 in chips)
Seat 3: BB ($2.09 in chips)
Seat 4: UTG ($1.36 in chips)
Seat 5: HJ ($2.37 in chips)
Seat 6: CO ($0.69 in chips)
SB: posts small blind $0.01
BB: posts big blind $0.02
*** HOLE CARDS ***
UTG: folds
HJ: folds
CO: calls $0.02
BTN: raises $0.04 to $0.06
SB: calls $0.05
BB: folds
CO: calls $0.04
*** FLOP *** [3d 7s 3s]
SB: bets $0.06
CO: folds
BTN: calls $0.06
*** TURN *** [3d 7s 3s] [Ts]
SB: bets $0.16
BTN: folds
Uncalled bet ($0.16) returned to SB
SB collected $0.31 from pot
*** SUMMARY ***
Total pot $0.32 | Rake $0.01
Board [3d 7s 3s Ts]
Seat 1: BTN (button) folded on the Turn
Seat 2: SB (small blind) collected ($0.31)
Seat 3: BB (big blind) folded before Flop
Seat 4: UTG folded before Flop (didn't bet)
Seat 5: HJ folded before Flop (didn't bet)
Seat 6: CO folded on the Flop


PokerStars Hand #238162605816:  Hold'em No Limit ($0.01/$0.02 USD) - 2022/08/23 3:23:59 ET
Table 'Achilles IV' 6-max Seat #2 is the button
Seat 1: CO ($0.94 in chips)
Seat 2: BTN ($1.40 in chips)
Seat 3: SB ($2.07 in chips)
Seat 4: BB ($1.36 in chips)
Seat 5: UTG ($2.37 in chips)
Seat 6: HJ ($0.63 in chips)
SB: posts small blind $0.01
BB: posts big blind $0.02
*** HOLE CARDS ***
UTG: folds
HJ: folds
CO: folds
BTN: calls $0.02
SB: raises $0.04 to $0.06
BB: calls $0.04
BTN: raises $0.04 to $0.10
SB: calls $0.04
BB: calls $0.04
*** FLOP *** [Th 9d 6s]
SB: checks
BB: checks
BTN: checks
*** TURN *** [Th 9d 6s] [6c]
SB: checks
BB: bets $0.08
BTN: calls $0.08
SB: folds
*** RIVER *** [Th 9d 6s 6c] [7c]
BB: bets $0.06
BTN: calls $0.06
*** SHOW DOWN ***
BB: shows [5c 5h] (two pair, Sixes and Fives)
BTN: shows [As 7s] (two pair, Sevens and Sixes)
BTN collected $0.56 from pot
*** SUMMARY ***
Total pot $0.58 | Rake $0.02
Board [Th 9d 6s 6c 7c]
Seat 1: CO folded before Flop (didn't bet)
Seat 2: BTN (button) showed [As 7s] and won ($0.56) with two pair, Sevens and Sixes
Seat 3: SB (small blind) folded on the Turn
Seat 4: BB (big blind) showed [5c 5h] and lost with two pair, Sixes and Fives
Seat 5: UTG folded before Flop (didn't bet)
Seat 6: HJ folded before Flop (didn't bet)


PokerStars Hand #238162612415:  Hold'em No Limit ($0.01/$0.02 USD) - 2022/08/23 3:24:58 ET
Table 'Achilles IV' 6-max Seat #3 is the button
Seat 1: HJ ($0.94 in chips)
Seat 2: CO ($1.72 in chips)
Seat 3: BTN ($2 in chips)
Seat 4: SB ($1.12 in chips)
Seat 5: BB ($2.37 in chips)
Seat 6: UTG ($0.63 in chips)
SB: posts small blind $0.01
BB: posts big blind $0.02
*** HOLE CARDS ***
UTG: folds
HJ: folds
CO: calls $0.02
BTN: raises $0.02 to $0.04
SB: calls $0.03
BB: calls $0.02
CO: raises $0.02 to $0.06
BTN: calls $0.02
SB: calls $0.02
BB: calls $0.02
*** FLOP *** [Kh Ac Tc]
SB: checks
BB: checks
CO: checks
BTN: bets $0.22
SB: folds
BB: folds
CO: raises $0.34 to $0.56
BTN: raises $1.38 to $1.94 and is all-in
CO: calls $1.10 and is all-in
Uncalled bet ($0.28) returned to BTN
*** TURN *** [Kh Ac Tc] [Ts]
*** RIVER *** [Kh Ac Tc Ts] [3c]
*** SHOW DOWN ***
CO: shows [8h Jh] (a pair of Tens)
BTN: shows [Qd As] (two pair, Aces and Tens)
BTN collected $3.44 from pot
*** SUMMARY ***
Total pot $3.56 | Rake $0.12
Board [Kh Ac Tc Ts 3c]
Seat 1: HJ folded before Flop (didn't bet)
Seat 2: CO showed [8h Jh] and lost with a pair of Tens
Seat 3: BTN (button) showed [Qd As] and won ($3.44) with two pair, Aces and Tens
Seat 4: SB (small blind) folded on the Flop
Seat 5: BB (big blind) folded on the Flop
Seat 6: UTG folded before Flop (didn't bet)


PokerStars Hand #238162623599:  Hold'em No Limit ($0.01/$0.02 USD) - 2022/08/23 3:26:02 ET
Table 'Achilles IV' 6-max Seat #4 is the button
Seat 1: HJ ($0.94 in chips)
Seat 3: CO ($3.72 in chips)
Seat 4: BTN ($1.06 in chips)
Seat 5: SB ($2.31 in chips)
Seat 6: BB ($0.63 in chips)
SB: posts small blind $0.01
BB: posts big blind $0.02
*** HOLE CARDS ***
HJ: raises $0.02 to $0.04
CO: folds
Rutzy259 leaves the table
BTN: folds
SB: calls $0.03
BB: folds
*** FLOP *** [Jc Qc 7h]
SB: checks
Xtens joins the table at seat #2
HJ: checks
*** TURN *** [Jc Qc 7h] [As]
SB: checks
HJ: checks
*** RIVER *** [Jc Qc 7h As] [Th]
SB: checks
HJ: bets $0.10
SB: folds
Uncalled bet ($0.10) returned to HJ
HJ collected $0.10 from pot
HJ: doesn't show hand
*** SUMMARY ***
Total pot $0.10 | Rake $0
Board [Jc Qc 7h As Th]
Seat 1: HJ collected ($0.10)
Seat 3: CO folded before Flop (didn't bet)
Seat 4: BTN (button) folded before Flop (didn't bet)
Seat 5: SB (small blind) folded on the River
Seat 6: BB (big blind) folded before Flop


PokerStars Hand #238162628713:  Hold'em No Limit ($0.01/$0.02 USD) - 2022/08/23 3:26:48 ET
Table 'Achilles IV' 6-max Seat #5 is the button
Seat 1: BB ($1 in chips)
Seat 3: HJ ($3.72 in chips)
Seat 4: CO ($1.06 in chips)
Seat 5: BTN ($2.27 in chips)
Seat 6: SB ($0.61 in chips)
SB: posts small blind $0.01
BB: posts big blind $0.02
Xtens: sits out
*** HOLE CARDS ***
HJ: folds
CO: calls $0.02
BTN: folds
SB: calls $0.01
BB: checks
*** FLOP *** [Kh 6h Td]
SB: checks
BB: checks
CO: checks
*** TURN *** [Kh 6h Td] [Ad]
SB: bets $0.04
BB: folds
CO: calls $0.04
*** RIVER *** [Kh 6h Td Ad] [2s]
SB: bets $0.09
CO: folds
Uncalled bet ($0.09) returned to SB
SB collected $0.14 from pot
SB: doesn't show hand
*** SUMMARY ***
Total pot $0.14 | Rake $0
Board [Kh 6h Td Ad 2s]
Seat 1: BB (big blind) folded on the Turn
Seat 3: HJ folded before Flop (didn't bet)
Seat 4: CO folded on the River
Seat 5: BTN (button) folded before Flop (didn't bet)
Seat 6: SB (small blind) collected ($0.14)


PokerStars Hand #238162632869:  Hold'em No Limit ($0.01/$0.02 USD) - 2022/08/23 3:27:25 ET
Table 'Achilles IV' 6-max Seat #6 is the button
Seat 1: SB ($0.98 in chips)
Seat 2: BB ($2 in chips)
Seat 3: UTG ($3.72 in chips)
Seat 4: HJ ($1 in chips)
Seat 5: CO ($2.27 in chips)
Seat 6: BTN ($0.69 in chips)
SB: posts small blind $0.01
BB: posts big blind $0.02
*** HOLE CARDS ***
UTG: folds
HJ: folds
CO: folds
BTN: calls $0.02
SB: calls $0.01
BB: checks
*** FLOP *** [7d Ah Ts]
SB: checks
BB: checks
BTN: checks
*** TURN *** [7d Ah Ts] [Ks]
SB: checks
BB: checks
BTN: checks
*** RIVER *** [7d Ah Ts Ks] [Td]
SB: checks
BB: checks
BTN: bets $0.04
SB: folds
BB: calls $0.04
*** SHOW DOWN ***
BTN: shows [2c 2s] (two pair, Tens and Deuces)
BB: shows [8h Kd] (two pair, Kings and Tens)
BB collected $0.14 from pot
*** SUMMARY ***
Total pot $0.14 | Rake $0
Board [7d Ah Ts Ks Td]
Seat 1: SB (small blind) folded on the River
Seat 2: BB (big blind) showed [8h Kd] and won ($0.14) with two pair, Kings and Tens
Seat 3: UTG folded before Flop (didn't bet)
Seat 4: HJ folded before Flop (didn't bet)
Seat 5: CO folded before Flop (didn't bet)
Seat 6: BTN (button) showed [2c 2s] and lost with two pair, Tens and Deuces


PokerStars Hand #238162638220:  Hold'em No Limit ($0.01/$0.02 USD) - 2022/08/23 3:28:11 ET
Table 'Achilles IV' 6-max Seat #1 is the button
Seat 1: BTN ($0.96 in chips)
Seat 2: SB ($2.08 in chips)
Seat 3: BB ($3.72 in chips)
Seat 4: UTG ($1 in chips)
Seat 5: HJ ($2.27 in chips)
Seat 6: CO ($0.63 in chips)
SB: posts small blind $0.01
BB: posts big blind $0.02
*** HOLE CARDS ***
UTG: calls $0.02
HJ: folds
CO: folds
BTN: folds
SB: folds
BB: checks
*** FLOP *** [Kc 9h 6h]
BB: checks
UTG: checks
*** TURN *** [Kc 9h 6h] [Js]
BB: checks
UTG: checks
*** RIVER *** [Kc 9h 6h Js] [2c]
BB: checks
UTG: checks
*** SHOW DOWN ***
BB: shows [2d Qh] (a pair of Deuces)
UTG: mucks hand
BB collected $0.05 from pot
*** SUMMARY ***
Total pot $0.05 | Rake $0
Board [Kc 9h 6h Js 2c]
Seat 1: BTN (button) folded before Flop (didn't bet)
Seat 2: SB (small blind) folded before Flop
Seat 3: BB (big blind) showed [2d Qh] and won ($0.05) with a pair of Deuces
Seat 4: UTG mucked
Seat 5: HJ folded before Flop (didn't bet)
Seat 6: CO folded before Flop (didn't bet)


PokerStars Hand #238162643160:  Hold'em No Limit ($0.01/$0.02 USD) - 2022/08/23 3:28:54 ET
Table 'Achilles IV' 6-max Seat #2 is the button
Seat 1: CO ($0.96 in chips)
Seat 2: BTN ($2.07 in chips)
Seat 3: SB ($3.75 in chips)
Seat 4: BB ($0.98 in chips)
Seat 5: UTG ($2.27 in chips)
Seat 6: HJ ($0.63 in chips)
SB: posts small blind $0.01
BB: posts big blind $0.02
*** HOLE CARDS ***
UTG: folds
HJ: folds
CO: folds
UTG leaves the table
BTN: raises $0.03 to $0.05
Koresh153 joins the table at seat #5
SB: folds
BB: calls $0.03
*** FLOP *** [Jd 8d Jc]
BB: checks
BTN: checks
*** TURN *** [Jd 8d Jc] [2s]
BB: checks
BTN: checks
*** RIVER *** [Jd 8d Jc 2s] [6h]
BB: checks
BTN: checks
*** SHOW DOWN ***
BB: shows [9h 7s] (a pair of Jacks)
BTN: shows [Qd Ah] (a pair of Jacks - Ace kicker)
BTN collected $0.11 from pot
*** SUMMARY ***
Total pot $0.11 | Rake $0
Board [Jd 8d Jc 2s 6h]
Seat 1: CO folded before Flop (didn't bet)
Seat 2: BTN (button) showed [Qd Ah] and won ($0.11) with a pair of Jacks
Seat 3: SB (small blind) folded before Flop
Seat 4: BB (big blind) showed [9h 7s] and lost with a pair of Jacks
Seat 5: UTG folded before Flop (didn't bet)
Seat 6: HJ folded before Flop (didn't bet)


PokerStars Hand #238162651927:  Hold'em No Limit ($0.01/$0.02 USD) - 2022/08/23 3:30:10 ET
Table 'Achilles IV' 6-max Seat #3 is the button
Seat 1: HJ ($0.96 in chips)
Seat 2: CO ($2.13 in chips)
Seat 3: BTN ($3.74 in chips)
Seat 4: SB ($0.93 in chips)
Seat 5: BB ($2 in chips)
Seat 6: UTG ($0.63 in chips)
SB: posts small blind $0.01
BB: posts big blind $0.02
*** HOLE CARDS ***
UTG: folds
HJ: folds
CO: folds
BTN: folds
SB: raises $0.02 to $0.04
BB: folds
Uncalled bet ($0.02) returned to SB
SB collected $0.04 from pot
*** SUMMARY ***
Total pot $0.04 | Rake $0
Seat 1: HJ folded before Flop (didn't bet)
Seat 2: CO folded before Flop (didn't bet)
Seat 3: BTN (button) folded before Flop (didn't bet)
Seat 4: SB (small blind) collected ($0.04)
Seat 5: BB (big blind) folded before Flop
Seat 6: UTG folded before Flop (didn't bet)


PokerStars Hand #238162654009:  Hold'em No Limit ($0.01/$0.02 USD) - 2022/08/23 3:30:29 ET
Table 'Achilles IV' 6-max Seat #4 is the button
Seat 1: UTG ($0.96 in chips)
Seat 2: HJ ($2.13 in chips)
Seat 3: CO ($3.74 in chips)
Seat 4: BTN ($0.95 in chips)
Seat 5: SB ($1.98 in chips)
Seat 6: BB ($0.63 in chips)
SB: posts small blind $0.01
BB: posts big blind $0.02
*** HOLE CARDS ***
UTG: calls $0.02
HJ: folds
CO: raises $0.04 to $0.06
BTN: raises $0.04 to $0.10
SB: folds
BB: folds
UTG: folds
CO: calls $0.04
*** FLOP *** [6c 4c 9h]
CO: checks
BTN: bets $0.85 and is all-in
CO: folds
Uncalled bet ($0.85) returned to BTN
BTN collected $0.24 from pot
*** SUMMARY ***
Total pot $0.25 | Rake $0.01
Board [6c 4c 9h]
Seat 1: UTG folded before Flop
Seat 2: HJ folded before Flop (didn't bet)
Seat 3: CO folded on the Flop
Seat 4: BTN (button) collected ($0.24)
Seat 5: SB (small blind) folded before Flop
Seat 6: BB (big blind) folded before Flop


PokerStars Hand #238162659949:  Hold'em No Limit ($0.01/$0.02 USD) - 2022/08/23 3:31:20 ET
Table 'Achilles IV' 6-max Seat #5 is the button
Seat 1: BB ($0.94 in chips)
Seat 2: UTG ($2.13 in chips)
Seat 3: HJ ($3.64 in chips)
Seat 4: CO ($1.09 in chips)
Seat 5: BTN ($1.97 in chips)
Seat 6: SB ($0.61 in chips)
SB: posts small blind $0.01
BB: posts big blind $0.02
*** HOLE CARDS ***
UTG: folds
HJ: folds
CO: calls $0.02
BTN: folds
SB: folds
BB: checks
*** FLOP *** [Kc 4d 3d]
BB: checks
CO: checks
*** TURN *** [Kc 4d 3d] [Kh]
BB: checks
CO: checks
*** RIVER *** [Kc 4d 3d Kh] [7d]
BB: bets $0.04
CO: folds
Uncalled bet ($0.04) returned to BB
BB collected $0.05 from pot
BB: doesn't show hand
*** SUMMARY ***
Total pot $0.05 | Rake $0
Board [Kc 4d 3d Kh 7d]
Seat 1: BB (big blind) collected ($0.05)
Seat 2: UTG folded before Flop (didn't bet)
Seat 3: HJ folded before Flop (didn't bet)
Seat 4: CO folded on the River
Seat 5: BTN (button) folded before Flop (didn't bet)
Seat 6: SB (small blind) folded before Flop


PokerStars Hand #238162664700:  Hold'em No Limit ($0.01/$0.02 USD) - 2022/08/23 3:32:01 ET
Table 'Achilles IV' 6-max Seat #6 is the button
Seat 1: SB ($0.97 in chips)
Seat 2: BB ($2.13 in chips)
Seat 3: UTG ($3.64 in chips)
Seat 4: HJ ($1.07 in chips)
Seat 5: CO ($1.97 in chips)
Seat 6: BTN ($0.60 in chips)
SB: posts small blind $0.01
BB: posts big blind $0.02
*** HOLE CARDS ***
UTG: folds
HJ: folds
CO: folds
BTN: folds
SB: calls $0.01
BB: checks
*** FLOP *** [6d Qc Jc]
SB: checks
BB: bets $0.02
SB: folds
Uncalled bet ($0.02) returned to BB
BB collected $0.04 from pot
BB: doesn't show hand
*** SUMMARY ***
Total pot $0.04 | Rake $0
Board [6d Qc Jc]
Seat 1: SB (small blind) folded on the Flop
Seat 2: BB (big blind) collected ($0.04)
Seat 3: UTG folded before Flop (didn't bet)
Seat 4: HJ folded before Flop (didn't bet)
Seat 5: CO folded before Flop (didn't bet)
Seat 6: BTN (button) folded before Flop (didn't bet)


PokerStars Hand #238162669021:  Hold'em No Limit ($0.01/$0.02 USD) - 2022/08/23 3:32:39 ET
Table 'Achilles IV' 6-max Seat #1 is the button
Seat 1: BTN ($0.95 in chips)
Seat 2: SB ($2.15 in chips)
Seat 3: BB ($3.64 in chips)
Seat 4: UTG ($1.07 in chips)
Seat 5: HJ ($1.97 in chips)
Seat 6: CO ($0.60 in chips)
SB: posts small blind $0.01
BB: posts big blind $0.02
*** HOLE CARDS ***
UTG: calls $0.02
HJ: folds
CO: folds
BTN: calls $0.02
SB: calls $0.01
BB: checks
*** FLOP *** [6s Qs 8s]
SB: checks
BB: checks
UTG: bets $0.04
BTN: calls $0.04
SB: calls $0.04
BB: folds
*** TURN *** [6s Qs 8s] [3s]
SB: checks
UTG: bets $0.04
BTN: calls $0.04
SB: folds
*** RIVER *** [6s Qs 8s 3s] [8h]
UTG: bets $0.97 and is all-in
BTN: folds
Uncalled bet ($0.97) returned to UTG
UTG collected $0.27 from pot
*** SUMMARY ***
Total pot $0.28 | Rake $0.01
Board [6s Qs 8s 3s 8h]
Seat 1: BTN (button) folded on the River
Seat 2: SB (small blind) folded on the Turn
Seat 3: BB (big blind) folded on the Flop
Seat 4: UTG collected ($0.27)
Seat 5: HJ folded before Flop (didn't bet)
Seat 6: CO folded before Flop (didn't bet)


PokerStars Hand #238162680845:  Hold'em No Limit ($0.01/$0.02 USD) - 2022/08/23 3:34:21 ET
Table 'Achilles IV' 6-max Seat #2 is the button
Seat 1: CO ($0.85 in chips)
Seat 2: BTN ($2.09 in chips)
Seat 3: SB ($3.62 in chips)
Seat 4: BB ($1.24 in chips)
Seat 5: UTG ($1.97 in chips)
Seat 6: HJ ($0.60 in chips)
SB: posts small blind $0.01
BB: posts big blind $0.02
*** HOLE CARDS ***
UTG: folds
HJ: folds
CO: folds
BTN: raises $0.03 to $0.05
SB: folds
BB: calls $0.03
*** FLOP *** [9d 6c 6s]
BB: bets $0.02
BTN: raises $0.07 to $0.09
BB: calls $0.07
*** TURN *** [9d 6c 6s] [Qh]
BB: checks
BTN: bets $0.14
BB: calls $0.14
*** RIVER *** [9d 6c 6s Qh] [Qc]
BB: checks
BTN: checks
*** SHOW DOWN ***
BB: shows [Ad As] (two pair, Aces and Queens)
BTN: mucks hand
BB collected $0.55 from pot
*** SUMMARY ***
Total pot $0.57 | Rake $0.02
Board [9d 6c 6s Qh Qc]
Seat 1: CO folded before Flop (didn't bet)
Seat 2: BTN (button) mucked
Seat 3: SB (small blind) folded before Flop
Seat 4: BB (big blind) showed [Ad As] and won ($0.55) with two pair, Aces and Queens
Seat 5: UTG folded before Flop (didn't bet)
Seat 6: HJ folded before Flop (didn't bet)


PokerStars Hand #238162686956:  Hold'em No Limit ($0.01/$0.02 USD) - 2022/08/23 3:35:14 ET
Table 'Achilles IV' 6-max Seat #3 is the button
Seat 1: HJ ($0.85 in chips)
Seat 2: CO ($1.81 in chips)
Seat 3: BTN ($3.61 in chips)
Seat 4: SB ($1.51 in chips)
Seat 5: BB ($1.97 in chips)
Seat 6: UTG ($0.60 in chips)
SB: posts small blind $0.01
BB: posts big blind $0.02
*** HOLE CARDS ***
UTG: folds
HJ: folds
CO: folds
BTN: raises $0.04 to $0.06
SB: folds
BB: folds
Uncalled bet ($0.04) returned to BTN
BTN collected $0.05 from pot
BTN: doesn't show hand
*** SUMMARY ***
Total pot $0.05 | Rake $0
Seat 1: HJ folded before Flop (didn't bet)
Seat 2: CO folded before Flop (didn't bet)
Seat 3: BTN (button) collected ($0.05)
Seat 4: SB (small blind) folded before Flop
Seat 5: BB (big blind) folded before Flop
Seat 6: UTG folded before Flop (didn't bet)


PokerStars Hand #238162688544:  Hold'em No Limit ($0.01/$0.02 USD) - 2022/08/23 3:35:28 ET
Table 'Achilles IV' 6-max Seat #4 is the button
Seat 1: UTG ($0.85 in chips)
Seat 2: HJ ($1.81 in chips)
Seat 3: CO ($3.64 in chips)
Seat 4: BTN ($1.50 in chips)
Seat 5: SB ($1.95 in chips)
Seat 6: BB ($0.60 in chips)
SB: posts small blind $0.01
BB: posts big blind $0.02
*** HOLE CARDS ***
UTG: folds
HJ: folds
CO: folds
BTN: folds
SB: folds
Uncalled bet ($0.01) returned to BB
BB collected $0.02 from pot
BB: doesn't show hand
*** SUMMARY ***
Total pot $0.02 | Rake $0
Seat 1: UTG folded before Flop (didn't bet)
Seat 2: HJ folded before Flop (didn't bet)
Seat 3: CO folded before Flop (didn't bet)
Seat 4: BTN (button) folded before Flop (didn't bet)
Seat 5: SB (small blind) folded before Flop
Seat 6: BB (big blind) collected ($0.02)


PokerStars Hand #238162689879:  Hold'em No Limit ($0.01/$0.02 USD) - 2022/08/23 3:35:39 ET
Table 'Achilles IV' 6-max Seat #5 is the button
Seat 1: BB ($0.85 in chips)
Seat 2: UTG ($1.81 in chips)
Seat 3: HJ ($3.64 in chips)
Seat 4: CO ($1.50 in chips)
Seat 5: BTN ($1.94 in chips)
Seat 6: SB ($0.61 in chips)
SB: posts small blind $0.01
BB: posts big blind $0.02
*** HOLE CARDS ***
UTG: folds
HJ: folds
CO: folds
BTN: raises $0.04 to $0.06
SB: folds
BB: folds
Uncalled bet ($0.04) returned to BTN
SB leaves the table
BTN collected $0.05 from pot
BTN: doesn't show hand
*** SUMMARY ***
Total pot $0.05 | Rake $0
Seat 1: BB (big blind) folded before Flop
Seat 2: UTG folded before Flop (didn't bet)
Seat 3: HJ folded before Flop (didn't bet)
Seat 4: CO folded before Flop (didn't bet)
Seat 5: BTN (button) collected ($0.05)
Seat 6: SB (small blind) folded before Flop


PokerStars Hand #238162693232:  Hold'em No Limit ($0.01/$0.02 USD) - 2022/08/23 3:36:09 ET
Table 'Achilles IV' 6-max Seat #1 is the button
Seat 1: BTN ($0.83 in chips)
Seat 2: SB ($1.81 in chips)
Seat 3: BB ($3.64 in chips)
Seat 4: HJ ($1.50 in chips)
Seat 5: CO ($1.97 in chips)
SB: posts small blind $0.01
BB: posts big blind $0.02
*** HOLE CARDS ***
HJ: folds
CO: raises $0.04 to $0.06
BTN: calls $0.06
SB: folds
Siensei joins the table at seat #6
BB: calls $0.04
*** FLOP *** [Qc 7d 6s]
BB: checks
CO: bets $0.12
BTN: folds
BB: folds
Uncalled bet ($0.12) returned to CO
CO collected $0.18 from pot
CO: doesn't show hand
*** SUMMARY ***
Total pot $0.19 | Rake $0.01
Board [Qc 7d 6s]
Seat 1: BTN (button) folded on the Flop
Seat 2: SB (small blind) folded before Flop
Seat 3: BB (big blind) folded on the Flop
Seat 4: HJ folded before Flop (didn't bet)
Seat 5: CO collected ($0.18)


PokerStars Hand #238162697240:  Hold'em No Limit ($0.01/$0.02 USD) - 2022/08/23 3:36:43 ET
Table 'Achilles IV' 6-max Seat #2 is the button
Seat 1: CO ($0.77 in chips)
Seat 2: BTN ($1.80 in chips)
Seat 3: SB ($3.58 in chips)
Seat 4: BB ($1.50 in chips)
Seat 5: HJ ($2.09 in chips)
SB: posts small blind $0.01
BB: posts big blind $0.02
Siensei: sits out
*** HOLE CARDS ***
HJ: folds
CO: folds
CO leaves the table
BTN: raises $0.03 to $0.05
SB: calls $0.04
BB: calls $0.03
*** FLOP *** [8c Qh 5c]
SB: checks
BB: checks
Flix2204 joins the table at seat #1
BTN: bets $0.08
SB: folds
BB: folds
Uncalled bet ($0.08) returned to BTN
BTN collected $0.14 from pot
BTN: doesn't show hand
*** SUMMARY ***
Total pot $0.15 | Rake $0.01
Board [8c Qh 5c]
Seat 1: CO folded before Flop (didn't bet)
Seat 2: BTN (button) collected ($0.14)
Seat 3: SB (small blind) folded on the Flop
Seat 4: BB (big blind) folded on the Flop
Seat 5: HJ folded before Flop (didn't bet)


PokerStars Hand #238162702719:  Hold'em No Limit ($0.01/$0.02 USD) - 2022/08/23 3:37:31 ET
Table 'Achilles IV' 6-max Seat #3 is the button
Seat 2: CO ($1.89 in chips)
Seat 3: BTN ($3.53 in chips)
Seat 4: SB ($1.45 in chips)
Seat 5: BB ($2.09 in chips)
SB: posts small blind $0.01
BB: posts big blind $0.02
Siensei: sits out
Flix2204: sits out
*** HOLE CARDS ***
CO: folds
BTN: folds
SB: calls $0.01
BB: checks
*** FLOP *** [Qc 4s Kh]
SB: checks
BB: checks
*** TURN *** [Qc 4s Kh] [3c]
SB: checks
BB: checks
*** RIVER *** [Qc 4s Kh 3c] [Ac]
SB: bets $0.04
BB: folds
Uncalled bet ($0.04) returned to SB
SB collected $0.04 from pot
*** SUMMARY ***
Total pot $0.04 | Rake $0
Board [Qc 4s Kh 3c Ac]
Seat 2: CO folded before Flop (didn't bet)
Seat 3: BTN (button) folded before Flop (didn't bet)
Seat 4: SB (small blind) collected ($0.04)
Seat 5: BB (big blind) folded on the River


PokerStars Hand #238162707977:  Hold'em No Limit ($0.01/$0.02 USD) - 2022/08/23 3:38:17 ET
Table 'Achilles IV' 6-max Seat #4 is the button
Seat 2: HJ ($1.89 in chips)
Seat 3: CO ($3.53 in chips)
Seat 4: BTN ($1.47 in chips)
Seat 5: SB ($2.07 in chips)
Seat 6: BB ($2 in chips)
SB: posts small blind $0.01
BB: posts big blind $0.02
Flix2204: sits out
*** HOLE CARDS ***
HJ: folds
CO: folds
BTN: folds
SB: folds
Uncalled bet ($0.01) returned to BB
BB collected $0.02 from pot
BB: doesn't show hand
*** SUMMARY ***
Total pot $0.02 | Rake $0
Seat 2: HJ folded before Flop (didn't bet)
Seat 3: CO folded before Flop (didn't bet)
Seat 4: BTN (button) folded before Flop (didn't bet)
Seat 5: SB (small blind) folded before Flop
Seat 6: BB (big blind) collected ($0.02)


PokerStars Hand #238162709276:  Hold'em No Limit ($0.01/$0.02 USD) - 2022/08/23 3:38:28 ET
Table 'Achilles IV' 6-max Seat #5 is the button
Seat 1: BB ($2 in chips)
Seat 2: UTG ($1.89 in chips)
Seat 3: HJ ($3.53 in chips)
Seat 4: CO ($1.47 in chips)
Seat 5: BTN ($2.06 in chips)
Seat 6: SB ($2.01 in chips)
SB: posts small blind $0.01
BB: posts big blind $0.02
*** HOLE CARDS ***
UTG: folds
HJ: folds
CO: calls $0.02
BTN: folds
SB: calls $0.01
BB: checks
*** FLOP *** [9s 9c 6h]
SB: checks
BB: checks
CO: bets $0.02
SB: folds
BB: folds
Uncalled bet ($0.02) returned to CO
CO collected $0.06 from pot
*** SUMMARY ***
Total pot $0.06 | Rake $0
Board [9s 9c 6h]
Seat 1: BB (big blind) folded on the Flop
Seat 2: UTG folded before Flop (didn't bet)
Seat 3: HJ folded before Flop (didn't bet)
Seat 4: CO collected ($0.06)
Seat 5: BTN (button) folded before Flop (didn't bet)
Seat 6: SB (small blind) folded on the Flop


PokerStars Hand #238162714049:  Hold'em No Limit ($0.01/$0.02 USD) - 2022/08/23 3:39:11 ET
Table 'Achilles IV' 6-max Seat #6 is the button
Seat 1: SB ($2 in chips)
Seat 2: BB ($1.89 in chips)
Seat 3: UTG ($3.53 in chips)
Seat 4: HJ ($1.51 in chips)
Seat 5: CO ($2.06 in chips)
Seat 6: BTN ($2 in chips)
SB: posts small blind $0.01
BB: posts big blind $0.02
*** HOLE CARDS ***
UTG: raises $0.04 to $0.06
HJ: calls $0.06
CO: calls $0.06
BTN: folds
SB: folds
BB: folds
*** FLOP *** [9h 5c 5h]
UTG: checks
HJ: bets $0.10
CO: folds
UTG: folds
Uncalled bet ($0.10) returned to HJ
HJ collected $0.20 from pot
*** SUMMARY ***
Total pot $0.21 | Rake $0.01
Board [9h 5c 5h]
Seat 1: SB (small blind) folded before Flop
Seat 2: BB (big blind) folded before Flop
Seat 3: UTG folded on the Flop
Seat 4: HJ collected ($0.20)
Seat 5: CO folded on the Flop
Seat 6: BTN (button) folded before Flop (didn't bet)


PokerStars Hand #238162718816:  Hold'em No Limit ($0.01/$0.02 USD) - 2022/08/23 3:39:53 ET
Table 'Achilles IV' 6-max Seat #1 is the button
Seat 1: BTN ($2 in chips)
Seat 2: SB ($1.87 in chips)
Seat 3: BB ($3.47 in chips)
Seat 4: UTG ($1.65 in chips)
Seat 5: HJ ($2 in chips)
Seat 6: CO ($2 in chips)
SB: posts small blind $0.01
BB: posts big blind $0.02
*** HOLE CARDS ***
UTG: folds
HJ: folds
CO: folds
BTN: raises $0.03 to $0.05
SB: folds
BB: folds
Uncalled bet ($0.03) returned to BTN
BTN collected $0.05 from pot
BTN: doesn't show hand
*** SUMMARY ***
Total pot $0.05 | Rake $0
Seat 1: BTN (button) collected ($0.05)
Seat 2: SB (small blind) folded before Flop
Seat 3: BB (big blind) folded before Flop
Seat 4: UTG folded before Flop (didn't bet)
Seat 5: HJ folded before Flop (didn't bet)
Seat 6: CO folded before Flop (didn't bet)


PokerStars Hand #238162722062:  Hold'em No Limit ($0.01/$0.02 USD) - 2022/08/23 3:40:21 ET
Table 'Achilles IV' 6-max Seat #2 is the button
Seat 1: CO ($2.03 in chips)
Seat 2: BTN ($1.86 in chips)
Seat 3: SB ($3.45 in chips)
Seat 4: BB ($1.65 in chips)
Seat 5: UTG ($2 in chips)
Seat 6: HJ ($2 in chips)
SB: posts small blind $0.01
BB: posts big blind $0.02
*** HOLE CARDS ***
UTG: folds
HJ: folds
CO: raises $0.03 to $0.05
BTN: folds
SB: folds
BB: calls $0.03
*** FLOP *** [9s 9h Qh]
BB: checks
CO: bets $0.04
BB: calls $0.04
*** TURN *** [9s 9h Qh] [4c]
BB: checks
CO: bets $0.12
BB: folds
Uncalled bet ($0.12) returned to CO
CO collected $0.18 from pot
CO: doesn't show hand
*** SUMMARY ***
Total pot $0.19 | Rake $0.01
Board [9s 9h Qh 4c]
Seat 1: CO collected ($0.18)
Seat 2: BTN (button) folded before Flop (didn't bet)
Seat 3: SB (small blind) folded before Flop
Seat 4: BB (big blind) folded on the Turn
Seat 5: UTG folded before Flop (didn't bet)
Seat 6: HJ folded before Flop (didn't bet)


PokerStars Hand #238162729473:  Hold'em No Limit ($0.01/$0.02 USD) - 2022/08/23 3:41:25 ET
Table 'Achilles IV' 6-max Seat #3 is the button
Seat 1: HJ ($2.12 in chips)
Seat 2: CO ($1.86 in chips)
Seat 3: BTN ($3.44 in chips)
Seat 4: SB ($1.56 in chips)
Seat 5: BB ($2 in chips)
Seat 6: UTG ($2 in chips)
SB: posts small blind $0.01
BB: posts big blind $0.02
*** HOLE CARDS ***
UTG: folds
HJ: raises $0.04 to $0.06
CO: folds
BTN: calls $0.06
SB: folds
BB: folds
*** FLOP *** [Qc Qd 6d]
HJ: bets $0.05
BTN: folds
Uncalled bet ($0.05) returned to HJ
HJ collected $0.14 from pot
HJ: doesn't show hand
*** SUMMARY ***
Total pot $0.15 | Rake $0.01
Board [Qc Qd 6d]
Seat 1: HJ collected ($0.14)
Seat 2: CO folded before Flop (didn't bet)
Seat 3: BTN (button) folded on the Flop
Seat 4: SB (small blind) folded before Flop
Seat 5: BB (big blind) folded before Flop
Seat 6: UTG folded before Flop (didn't bet)


PokerStars Hand #238162733847:  Hold'em No Limit ($0.01/$0.02 USD) - 2022/08/23 3:42:02 ET
Table 'Achilles IV' 6-max Seat #4 is the button
Seat 1: BB ($2.20 in chips)
Seat 2: HJ ($1.86 in chips)
Seat 3: CO ($3.38 in chips)
Seat 4: BTN ($1.55 in chips)
Seat 5: SB ($1.98 in chips)
SB: posts small blind $0.01
Siensei: is sitting out
BB: posts big blind $0.02
*** HOLE CARDS ***
HJ: folds
CO: folds
BTN: folds
SB: raises $0.04 to $0.06
BB: raises $0.12 to $0.18
Siensei leaves the table
SB: calls $0.12
*** FLOP *** [Kc 4s 3h]
SB: checks
BB: checks
*** TURN *** [Kc 4s 3h] [4d]
SB: checks
BB: bets $0.17
SB: calls $0.17
*** RIVER *** [Kc 4s 3h 4d] [Ah]
SB: checks
BB: checks
*** SHOW DOWN ***
SB: shows [6d 6s] (two pair, Sixes and Fours)
BB: mucks hand
SB collected $0.68 from pot
*** SUMMARY ***
Total pot $0.70 | Rake $0.02
Board [Kc 4s 3h 4d Ah]
Seat 1: BB (big blind) mucked
Seat 2: HJ folded before Flop (didn't bet)
Seat 3: CO folded before Flop (didn't bet)
Seat 4: BTN (button) folded before Flop (didn't bet)
Seat 5: SB (small blind) showed [6d 6s] and won ($0.68) with two pair, Sixes and Fours


PokerStars Hand #238162739575:  Hold'em No Limit ($0.01/$0.02 USD) - 2022/08/23 3:42:50 ET
Table 'Achilles IV' 6-max Seat #5 is the button
Seat 1: SB ($2 in chips)
Seat 2: BB ($1.86 in chips)
Seat 3: HJ ($3.38 in chips)
Seat 4: CO ($1.55 in chips)
Seat 5: BTN ($2.31 in chips)
SB: posts small blind $0.01
BB: posts big blind $0.02
*** HOLE CARDS ***
HJ: folds
VK$$$215 joins the table at seat #6
CO: folds
BTN: folds
SB: folds
Uncalled bet ($0.01) returned to BB
BB collected $0.02 from pot
BB: doesn't show hand
*** SUMMARY ***
Total pot $0.02 | Rake $0
Seat 1: SB (small blind) folded before Flop
Seat 2: BB (big blind) collected ($0.02)
Seat 3: HJ folded before Flop (didn't bet)
Seat 4: CO folded before Flop (didn't bet)
Seat 5: BTN (button) folded before Flop (didn't bet)


PokerStars Hand #238162741492:  Hold'em No Limit ($0.01/$0.02 USD) - 2022/08/23 3:43:06 ET
Table 'Achilles IV' 6-max Seat #1 is the button
Seat 1: BTN ($2 in chips)
Seat 2: SB ($1.87 in chips)
Seat 3: BB ($3.38 in chips)
Seat 4: UTG ($1.55 in chips)
Seat 5: HJ ($2.31 in chips)
Seat 6: CO ($1.60 in chips)
SB: posts small blind $0.01
BB: posts big blind $0.02
CO: posts big blind $0.02
*** HOLE CARDS ***
UTG: calls $0.02
HJ: folds
CO: checks
BTN: folds
SB: calls $0.01
BB: checks
*** FLOP *** [2d Ts Jh]
SB: checks
BB: checks
UTG: bets $0.04
CO: folds
SB: folds
BB: folds
Uncalled bet ($0.04) returned to UTG
UTG collected $0.08 from pot
*** SUMMARY ***
Total pot $0.08 | Rake $0
Board [2d Ts Jh]
Seat 1: BTN (button) folded before Flop (didn't bet)
Seat 2: SB (small blind) folded on the Flop
Seat 3: BB (big blind) folded on the Flop
Seat 4: UTG collected ($0.08)
Seat 5: HJ folded before Flop (didn't bet)
Seat 6: CO folded on the Flop (didn't bet)


PokerStars Hand #238162746629:  Hold'em No Limit ($0.01/$0.02 USD) - 2022/08/23 3:43:51 ET
Table 'Achilles IV' 6-max Seat #2 is the button
Seat 1: CO ($2 in chips)
Seat 2: BTN ($1.85 in chips)
Seat 3: SB ($3.36 in chips)
Seat 4: BB ($1.61 in chips)
Seat 5: UTG ($2.31 in chips)
Seat 6: HJ ($1.58 in chips)
SB: posts small blind $0.01
BB: posts big blind $0.02
*** HOLE CARDS ***
UTG: folds
HJ: calls $0.02
CO: raises $0.06 to $0.08
BTN: folds
SB: folds
BB: folds
HJ: calls $0.06
*** FLOP *** [Ah 3d 2h]
HJ: checks
CO: checks
*** TURN *** [Ah 3d 2h] [4h]
HJ: bets $0.02
CO: raises $0.11 to $0.13
HJ: folds
Uncalled bet ($0.11) returned to CO
CO collected $0.22 from pot
CO: doesn't show hand
*** SUMMARY ***
Total pot $0.23 | Rake $0.01
Board [Ah 3d 2h 4h]
Seat 1: CO collected ($0.22)
Seat 2: BTN (button) folded before Flop (didn't bet)
Seat 3: SB (small blind) folded before Flop
Seat 4: BB (big blind) folded before Flop
Seat 5: UTG folded before Flop (didn't bet)
Seat 6: HJ folded on the Turn


PokerStars Hand #238162754204:  Hold'em No Limit ($0.01/$0.02 USD) - 2022/08/23 3:44:56 ET
Table 'Achilles IV' 6-max Seat #3 is the button
Seat 1: HJ ($2.12 in chips)
Seat 2: CO ($1.85 in chips)
Seat 3: BTN ($3.35 in chips)
Seat 4: SB ($1.59 in chips)
Seat 5: BB ($2.31 in chips)
Seat 6: UTG ($1.48 in chips)
SB: posts small blind $0.01
BB: posts big blind $0.02
*** HOLE CARDS ***
UTG: calls $0.02
HJ: folds
CO: folds
BTN: folds
SB: raises $0.02 to $0.04
BB: folds
UTG: calls $0.02
*** FLOP *** [5h Tc 6h]
SB: bets $0.05
UTG: calls $0.05
*** TURN *** [5h Tc 6h] [Ah]
SB: bets $0.04
UTG: calls $0.04
*** RIVER *** [5h Tc 6h Ah] [4s]
SB: bets $0.13
UTG: folds
Uncalled bet ($0.13) returned to SB
SB collected $0.27 from pot
*** SUMMARY ***
Total pot $0.28 | Rake $0.01
Board [5h Tc 6h Ah 4s]
Seat 1: HJ folded before Flop (didn't bet)
Seat 2: CO folded before Flop (didn't bet)
Seat 3: BTN (button) folded before Flop (didn't bet)
Seat 4: SB (small blind) collected ($0.27)
Seat 5: BB (big blind) folded before Flop
Seat 6: UTG folded on the River


PokerStars Hand #238162762291:  Hold'em No Limit ($0.01/$0.02 USD) - 2022/08/23 3:46:03 ET
Table 'Achilles IV' 6-max Seat #4 is the button
Seat 1: UTG ($2.12 in chips)
Seat 2: HJ ($1.85 in chips)
Seat 3: CO ($3.35 in chips)
Seat 4: BTN ($1.73 in chips)
Seat 5: SB ($2.29 in chips)
Seat 6: BB ($1.35 in chips)
SB: posts small blind $0.01
BB: posts big blind $0.02
*** HOLE CARDS ***
UTG: folds
HJ: folds
CO: raises $0.04 to $0.06
BTN: calls $0.06
SB: folds
BB: folds
*** FLOP *** [4d 3h Ac]
BB leaves the table
CO: checks
BTN: checks
*** TURN *** [4d 3h Ac] [Qh]
CO: checks
BTN: checks
*** RIVER *** [4d 3h Ac Qh] [Ks]
CO: checks
BTN: checks
*** SHOW DOWN ***
CO: shows [7c 7s] (a pair of Sevens)
BTN: shows [Th Kc] (a pair of Kings)
BTN collected $0.14 from pot
*** SUMMARY ***
Total pot $0.15 | Rake $0.01
Board [4d 3h Ac Qh Ks]
Seat 1: UTG folded before Flop (didn't bet)
Seat 2: HJ folded before Flop (didn't bet)
Seat 3: CO showed [7c 7s] and lost with a pair of Sevens
Seat 4: BTN (button) showed [Th Kc] and won ($0.14) with a pair of Kings
Seat 5: SB (small blind) folded before Flop
Seat 6: BB (big blind) folded before Flop


PokerStars Hand #238162767878:  Hold'em No Limit ($0.01/$0.02 USD) - 2022/08/23 3:46:52 ET
Table 'Achilles IV' 6-max Seat #5 is the button
Seat 1: SB ($2.12 in chips)
Seat 2: BB ($1.85 in chips)
Seat 3: HJ ($3.29 in chips)
Seat 4: CO ($1.81 in chips)
Seat 5: BTN ($2.28 in chips)
SB: posts small blind $0.01
BB: posts big blind $0.02
*** HOLE CARDS ***
HJ: folds
CO: folds
BTN: folds
SB: folds
Uncalled bet ($0.01) returned to BB
BB collected $0.02 from pot
BB: doesn't show hand
*** SUMMARY ***
Total pot $0.02 | Rake $0
Seat 1: SB (small blind) folded before Flop
Seat 2: BB (big blind) collected ($0.02)
Seat 3: HJ folded before Flop (didn't bet)
Seat 4: CO folded before Flop (didn't bet)
Seat 5: BTN (button) folded before Flop (didn't bet)


PokerStars Hand #238162769660:  Hold'em No Limit ($0.01/$0.02 USD) - 2022/08/23 3:47:06 ET
Table 'Achilles IV' 6-max Seat #1 is the button
Seat 1: BTN ($2.11 in chips)
Seat 2: SB ($1.86 in chips)
Seat 3: BB ($3.29 in chips)
Seat 4: HJ ($1.81 in chips)
Seat 5: CO ($2.28 in chips)
SB: posts small blind $0.01
BB: posts big blind $0.02
*** HOLE CARDS ***
HJ: calls $0.02
CO: folds
BTN: folds
SB: folds
BB: checks
*** FLOP *** [Js 5s 8s]
mermila joins the table at seat #6
BB: bets $0.06
HJ: folds
Uncalled bet ($0.06) returned to BB
BB collected $0.05 from pot
*** SUMMARY ***
Total pot $0.05 | Rake $0
Board [Js 5s 8s]
Seat 1: BTN (button) folded before Flop (didn't bet)
Seat 2: SB (small blind) folded before Flop
Seat 3: BB (big blind) collected ($0.05)
Seat 4: HJ folded on the Flop
Seat 5: CO folded before Flop (didn't bet)


PokerStars Hand #238162774106:  Hold'em No Limit ($0.01/$0.02 USD) - 2022/08/23 3:47:43 ET
Table 'Achilles IV' 6-max Seat #2 is the button
Seat 1: CO ($2.11 in chips)
Seat 2: BTN ($1.85 in chips)
Seat 3: SB ($3.32 in chips)
Seat 4: BB ($1.79 in chips)
Seat 5: UTG ($2.28 in chips)
Seat 6: HJ ($0.80 in chips)
SB: posts small blind $0.01
BB: posts big blind $0.02
HJ: posts big blind $0.02
*** HOLE CARDS ***
UTG: folds
HJ: checks
CO: folds
BTN: folds
SB: folds
BB: checks
*** FLOP *** [Jd Th 8h]
BB: checks
HJ: checks
*** TURN *** [Jd Th 8h] [Ad]
BB: checks
HJ: checks
*** RIVER *** [Jd Th 8h Ad] [Kc]
BB: bets $0.05
HJ: folds
Uncalled bet ($0.05) returned to BB
BB collected $0.05 from pot
*** SUMMARY ***
Total pot $0.05 | Rake $0
Board [Jd Th 8h Ad Kc]
Seat 1: CO folded before Flop (didn't bet)
Seat 2: BTN (button) folded before Flop (didn't bet)
Seat 3: SB (small blind) folded before Flop
Seat 4: BB (big blind) collected ($0.05)
Seat 5: UTG folded before Flop (didn't bet)
Seat 6: HJ folded on the River (didn't bet)


PokerStars Hand #238162779707:  Hold'em No Limit ($0.01/$0.02 USD) - 2022/08/23 3:48:31 ET
Table 'Achilles IV' 6-max Seat #3 is the button
Seat 1: HJ ($2.11 in chips)
Seat 2: CO ($1.85 in chips)
Seat 3: BTN ($3.31 in chips)
Seat 4: SB ($1.82 in chips)
Seat 5: BB ($2.28 in chips)
Seat 6: UTG ($0.78 in chips)
SB: posts small blind $0.01
BB: posts big blind $0.02
*** HOLE CARDS ***
UTG: folds
HJ: folds
CO: folds
BTN has timed out
BTN: folds
SB: calls $0.01
BB: checks
*** FLOP *** [4s 8c 4c]
SB: checks
UTG leaves the table
yarik7879 joins the table at seat #6
BB: checks
*** TURN *** [4s 8c 4c] [4h]
SB: checks
BB: checks
*** RIVER *** [4s 8c 4c 4h] [6d]
SB: checks
BB: checks
*** SHOW DOWN ***
SB: shows [5h Kd] (three of a kind, Fours)
BB: shows [5c 8d] (a full house, Fours full of Eights)
BB collected $0.04 from pot
*** SUMMARY ***
Total pot $0.04 | Rake $0
Board [4s 8c 4c 4h 6d]
Seat 1: HJ folded before Flop (didn't bet)
Seat 2: CO folded before Flop (didn't bet)
Seat 3: BTN (button) folded before Flop (didn't bet)
Seat 4: SB (small blind) showed [5h Kd] and lost with three of a kind, Fours
Seat 5: BB (big blind) showed [5c 8d] and won ($0.04) with a full house, Fours full of Eights
Seat 6: UTG folded before Flop (didn't bet)


PokerStars Hand #238162790012:  Hold'em No Limit ($0.01/$0.02 USD) - 2022/08/23 3:49:58 ET
Table 'Achilles IV' 6-max Seat #4 is the button
Seat 1: UTG ($2.11 in chips)
Seat 2: HJ ($1.85 in chips)
Seat 3: CO ($3.31 in chips)
Seat 4: BTN ($1.80 in chips)
Seat 5: SB ($2.30 in chips)
Seat 6: BB ($0.80 in chips)
SB: posts small blind $0.01
BB: posts big blind $0.02
*** HOLE CARDS ***
UTG: raises $0.04 to $0.06
HJ: folds
CO: folds
BTN: folds
SB: folds
BB: calls $0.04
*** FLOP *** [Th 3h 9h]
BB: checks
UTG: bets $0.04
BB: calls $0.04
*** TURN *** [Th 3h 9h] [4s]
BB: checks
UTG: bets $0.10
BB: raises $0.10 to $0.20
UTG: calls $0.10
*** RIVER *** [Th 3h 9h 4s] [6s]
BB: bets $0.29
UTG: calls $0.29
*** SHOW DOWN ***
BB: shows [9c 9d] (three of a kind, Nines)
UTG: mucks hand
BB collected $1.15 from pot
*** SUMMARY ***
Total pot $1.19 | Rake $0.04
Board [Th 3h 9h 4s 6s]
Seat 1: UTG mucked
Seat 2: HJ folded before Flop (didn't bet)
Seat 3: CO folded before Flop (didn't bet)
Seat 4: BTN (button) folded before Flop (didn't bet)
Seat 5: SB (small blind) folded before Flop
Seat 6: BB (big blind) showed [9c 9d] and won ($1.15) with three of a kind, Nines


PokerStars Hand #238162797538:  Hold'em No Limit ($0.01/$0.02 USD) - 2022/08/23 3:51:01 ET
Table 'Achilles IV' 6-max Seat #5 is the button
Seat 1: BB ($2 in chips)
Seat 2: UTG ($1.85 in chips)
Seat 3: HJ ($3.31 in chips)
Seat 4: CO ($1.80 in chips)
Seat 5: BTN ($2.29 in chips)
Seat 6: SB ($1.36 in chips)
SB: posts small blind $0.01
BB: posts big blind $0.02
*** HOLE CARDS ***
UTG: folds
HJ: raises $0.04 to $0.06
CO: folds
BTN: raises $0.16 to $0.22
SB: folds
BB: folds
HJ: folds
Uncalled bet ($0.16) returned to BTN
BTN collected $0.15 from pot
BTN: doesn't show hand
*** SUMMARY ***
Total pot $0.15 | Rake $0
Seat 1: BB (big blind) folded before Flop
Seat 2: UTG folded before Flop (didn't bet)
Seat 3: HJ folded before Flop
Seat 4: CO folded before Flop (didn't bet)
Seat 5: BTN (button) collected ($0.15)
Seat 6: SB (small blind) folded before Flop


PokerStars Hand #238162802144:  Hold'em No Limit ($0.01/$0.02 USD) - 2022/08/23 3:51:40 ET
Table 'Achilles IV' 6-max Seat #6 is the button
Seat 1: SB ($2 in chips)
Seat 2: BB ($1.85 in chips)
Seat 3: UTG ($3.25 in chips)
Seat 4: HJ ($1.80 in chips)
Seat 5: CO ($2.38 in chips)
Seat 6: BTN ($1.35 in chips)
SB: posts small blind $0.01
BB: posts big blind $0.02
*** HOLE CARDS ***
UTG: folds
HJ: raises $0.02 to $0.04
CO: folds
BTN: calls $0.04
SB: folds
BB: folds
*** FLOP *** [8c 9s Qh]
HJ: bets $0.05
BTN: folds
Uncalled bet ($0.05) returned to HJ
HJ collected $0.11 from pot
*** SUMMARY ***
Total pot $0.11 | Rake $0
Board [8c 9s Qh]
Seat 1: SB (small blind) folded before Flop
Seat 2: BB (big blind) folded before Flop
Seat 3: UTG folded before Flop (didn't bet)
Seat 4: HJ collected ($0.11)
Seat 5: CO folded before Flop (didn't bet)
Seat 6: BTN (button) folded on the Flop


PokerStars Hand #238162810582:  Hold'em No Limit ($0.01/$0.02 USD) - 2022/08/23 3:52:08 ET
Table 'Achilles IV' 6-max Seat #1 is the button
Seat 1: BTN ($2 in chips)
Seat 2: SB ($1.83 in chips)
Seat 3: BB ($3.25 in chips)
Seat 4: UTG ($1.87 in chips)
Seat 5: HJ ($2.38 in chips)
Seat 6: CO ($1.31 in chips)
SB: posts small blind $0.01
BB: posts big blind $0.02
*** HOLE CARDS ***
UTG: raises $0.02 to $0.04
HJ: folds
CO: calls $0.04
BTN: folds
SB: folds
BB: folds
*** FLOP *** [Jh 5d Qc]
UTG: bets $0.02
CO: calls $0.02
*** TURN *** [Jh 5d Qc] [6s]
UTG: bets $0.07
CO: folds
Uncalled bet ($0.07) returned to UTG
UTG collected $0.14 from pot
*** SUMMARY ***
Total pot $0.15 | Rake $0.01
Board [Jh 5d Qc 6s]
Seat 1: BTN (button) folded before Flop (didn't bet)
Seat 2: SB (small blind) folded before Flop
Seat 3: BB (big blind) folded before Flop
Seat 4: UTG collected ($0.14)
Seat 5: HJ folded before Flop (didn't bet)
Seat 6: CO folded on the Turn


PokerStars Hand #238162815241:  Hold'em No Limit ($0.01/$0.02 USD) - 2022/08/23 3:52:47 ET
Table 'Achilles IV' 6-max Seat #2 is the button
Seat 1: CO ($2 in chips)
Seat 2: BTN ($1.82 in chips)
Seat 3: SB ($3.23 in chips)
Seat 4: BB ($1.95 in chips)
Seat 5: UTG ($2.38 in chips)
Seat 6: HJ ($1.25 in chips)
SB: posts small blind $0.01
BB: posts big blind $0.02
*** HOLE CARDS ***
UTG: folds
HJ: folds
CO: raises $0.03 to $0.05
BTN: folds
SB: folds
BB: folds
Uncalled bet ($0.03) returned to CO
CO collected $0.05 from pot
CO: doesn't show hand
*** SUMMARY ***
Total pot $0.05 | Rake $0
Seat 1: CO collected ($0.05)
Seat 2: BTN (button) folded before Flop (didn't bet)
Seat 3: SB (small blind) folded before Flop
Seat 4: BB (big blind) folded before Flop
Seat 5: UTG folded before Flop (didn't bet)
Seat 6: HJ folded before Flop (didn't bet)


PokerStars Hand #238162817966:  Hold'em No Limit ($0.01/$0.02 USD) - 2022/08/23 3:53:09 ET
Table 'Achilles IV' 6-max Seat #3 is the button
Seat 1: HJ ($2.03 in chips)
Seat 2: CO ($1.82 in chips)
Seat 3: BTN ($3.22 in chips)
Seat 4: SB ($1.93 in chips)
Seat 5: BB ($2.38 in chips)
Seat 6: UTG ($1.25 in chips)
SB: posts small blind $0.01
BB: posts big blind $0.02
*** HOLE CARDS ***
UTG: folds
HJ: folds
CO has timed out
CO: folds
BTN: folds
SB: calls $0.01
BB: checks
*** FLOP *** [Th 2h 3d]
SB: checks
BB: checks
*** TURN *** [Th 2h 3d] [6c]
SB: checks
BB: checks
*** RIVER *** [Th 2h 3d 6c] [6d]
SB: checks
BB: checks
*** SHOW DOWN ***
SB: shows [Kd 7d] (a pair of Sixes)
BB: shows [2d 8h] (two pair, Sixes and Deuces)
BB collected $0.04 from pot
*** SUMMARY ***
Total pot $0.04 | Rake $0
Board [Th 2h 3d 6c 6d]
Seat 1: HJ folded before Flop (didn't bet)
Seat 2: CO folded before Flop (didn't bet)
Seat 3: BTN (button) folded before Flop (didn't bet)
Seat 4: SB (small blind) showed [Kd 7d] and lost with a pair of Sixes
Seat 5: BB (big blind) showed [2d 8h] and won ($0.04) with two pair, Sixes and Deuces
Seat 6: UTG folded before Flop (didn't bet)


PokerStars Hand #238162825418:  Hold'em No Limit ($0.01/$0.02 USD) - 2022/08/23 3:54:12 ET
Table 'Achilles IV' 6-max Seat #4 is the button
Seat 1: BB ($2.03 in chips)
Seat 2: HJ ($1.82 in chips)
Seat 3: CO ($3.22 in chips)
Seat 4: BTN ($1.91 in chips)
Seat 6: SB ($1.25 in chips)
SB: posts small blind $0.01
BB: posts big blind $0.02
*** HOLE CARDS ***
HJ: folds
CO: folds
BTN: calls $0.02
SB: folds
BB: raises $0.08 to $0.10
BTN: calls $0.08
*** FLOP *** [5c 2c 7h]
manolelps joins the table at seat #5
BB: checks
BTN: checks
*** TURN *** [5c 2c 7h] [4h]
BB: checks
BTN: checks
*** RIVER *** [5c 2c 7h 4h] [9s]
BB: checks
BTN: checks
*** SHOW DOWN ***
BB: shows [Ah Jc] (high card Ace)
BTN: shows [Qs Ad] (high card Ace - Queen kicker)
BTN collected $0.20 from pot
*** SUMMARY ***
Total pot $0.21 | Rake $0.01
Board [5c 2c 7h 4h 9s]
Seat 1: BB (big blind) showed [Ah Jc] and lost with high card Ace
Seat 2: HJ folded before Flop (didn't bet)
Seat 3: CO folded before Flop (didn't bet)
Seat 4: BTN (button) showed [Qs Ad] and won ($0.20) with high card Ace
Seat 6: SB (small blind) folded before Flop


PokerStars Hand #238162836465:  Hold'em No Limit ($0.01/$0.02 USD) - 2022/08/23 3:55:49 ET
Table 'Achilles IV' 6-max Seat #6 is the button
Seat 1: SB ($2 in chips)
Seat 2: BB ($1.82 in chips)
Seat 3: HJ ($3.22 in chips)
Seat 4: CO ($2.01 in chips)
Seat 6: BTN ($1.24 in chips)
SB: posts small blind $0.01
BB: posts big blind $0.02
manolelps: sits out
*** HOLE CARDS ***
HJ has timed out
HJ: folds
CO: folds
BTN: folds
SB: folds
Uncalled bet ($0.01) returned to BB
BB collected $0.02 from pot
BB: doesn't show hand
*** SUMMARY ***
Total pot $0.02 | Rake $0
Seat 1: SB (small blind) folded before Flop
Seat 2: BB (big blind) collected ($0.02)
Seat 3: HJ folded before Flop (didn't bet)
Seat 4: CO folded before Flop (didn't bet)
Seat 6: BTN (button) folded before Flop (didn't bet)


PokerStars Hand #238162838205:  Hold'em No Limit ($0.01/$0.02 USD) - 2022/08/23 3:56:05 ET
Table 'Achilles IV' 6-max Seat #1 is the button
Seat 1: BTN ($2 in chips)
Seat 2: SB ($1.83 in chips)
Seat 3: BB ($3.22 in chips)
Seat 4: HJ ($2.01 in chips)
Seat 6: CO ($1.24 in chips)
SB: posts small blind $0.01
BB: posts big blind $0.02
manolelps: sits out
*** HOLE CARDS ***
HJ has timed out
HJ: folds
CO: folds
BTN: folds
SB: folds
Uncalled bet ($0.01) returned to BB
BB collected $0.02 from pot
*** SUMMARY ***
Total pot $0.02 | Rake $0
Seat 1: BTN (button) folded before Flop (didn't bet)
Seat 2: SB (small blind) folded before Flop
Seat 3: BB (big blind) collected ($0.02)
Seat 4: HJ folded before Flop (didn't bet)
Seat 6: CO folded before Flop (didn't bet)


PokerStars Hand #238162840221:  Hold'em No Limit ($0.01/$0.02 USD) - 2022/08/23 3:56:23 ET
Table 'Achilles IV' 6-max Seat #2 is the button
Seat 1: CO ($2 in chips)
Seat 2: BTN ($1.82 in chips)
Seat 3: SB ($3.23 in chips)
Seat 5: BB ($2 in chips)
Seat 6: HJ ($1.24 in chips)
SB: posts small blind $0.01
BB: posts big blind $0.02
*** HOLE CARDS ***
HJ: folds
CO: folds
BTN: folds
SB: folds
Uncalled bet ($0.01) returned to BB
BB collected $0.02 from pot
*** SUMMARY ***
Total pot $0.02 | Rake $0
Seat 1: CO folded before Flop (didn't bet)
Seat 2: BTN (button) folded before Flop (didn't bet)
Seat 3: SB (small blind) folded before Flop
Seat 5: BB (big blind) collected ($0.02)
Seat 6: HJ folded before Flop (didn't bet)


PokerStars Hand #238162842804:  Hold'em No Limit ($0.01/$0.02 USD) - 2022/08/23 3:56:48 ET
Table 'Achilles IV' 6-max Seat #3 is the button
Seat 1: HJ ($2 in chips)
Seat 2: CO ($1.82 in chips)
Seat 3: BTN ($3.22 in chips)
Seat 5: SB ($2.01 in chips)
Seat 6: BB ($1.24 in chips)
SB: posts small blind $0.01
BB: posts big blind $0.02
*** HOLE CARDS ***
HJ: folds
CO: folds
BTN: raises $0.04 to $0.06
SB: folds
BB: folds
Uncalled bet ($0.04) returned to BTN
BTN collected $0.05 from pot
*** SUMMARY ***
Total pot $0.05 | Rake $0
Seat 1: HJ folded before Flop (didn't bet)
Seat 2: CO folded before Flop (didn't bet)
Seat 3: BTN (button) collected ($0.05)
Seat 5: SB (small blind) folded before Flop
Seat 6: BB (big blind) folded before Flop


PokerStars Hand #238162846513:  Hold'em No Limit ($0.01/$0.02 USD) - 2022/08/23 3:57:23 ET
Table 'Achilles IV' 6-max Seat #5 is the button
Seat 1: BB ($2 in chips)
Seat 2: UTG ($1.82 in chips)
Seat 3: HJ ($3.25 in chips)
Seat 4: CO ($2.01 in chips)
Seat 5: BTN ($2 in chips)
Seat 6: SB ($1.22 in chips)
SB: posts small blind $0.01
BB: posts big blind $0.02
CO: posts small & big blinds $0.03
*** HOLE CARDS ***
UTG: raises $0.05 to $0.07
HJ: folds
CO: calls $0.05
BTN: folds
SB: folds
BB: folds
*** FLOP *** [7d 5d Qs]
UTG: bets $0.09
CO: folds
Uncalled bet ($0.09) returned to UTG
UTG collected $0.17 from pot
UTG: doesn't show hand
*** SUMMARY ***
Total pot $0.18 | Rake $0.01
Board [7d 5d Qs]
Seat 1: BB (big blind) folded before Flop
Seat 2: UTG collected ($0.17)
Seat 3: HJ folded before Flop (didn't bet)
Seat 4: CO folded on the Flop
Seat 5: BTN (button) folded before Flop (didn't bet)
Seat 6: SB (small blind) folded before Flop


PokerStars Hand #238162852011:  Hold'em No Limit ($0.01/$0.02 USD) - 2022/08/23 3:58:14 ET
Table 'Achilles IV' 6-max Seat #6 is the button
Seat 1: SB ($2 in chips)
Seat 2: BB ($1.92 in chips)
Seat 3: UTG ($3.25 in chips)
Seat 4: HJ ($1.93 in chips)
Seat 5: CO ($2 in chips)
Seat 6: BTN ($1.21 in chips)
SB: posts small blind $0.01
BB: posts big blind $0.02
*** HOLE CARDS ***
UTG: folds
HJ: folds
CO: folds
BTN: raises $0.02 to $0.04
SB: folds
BB: calls $0.02
*** FLOP *** [Ad 7h Qh]
BB: checks
BTN: bets $0.02
BB: calls $0.02
*** TURN *** [Ad 7h Qh] [Jh]
BB: checks
BTN: bets $0.04
BB: raises $0.04 to $0.08
BTN: calls $0.04
*** RIVER *** [Ad 7h Qh Jh] [5c]
BB: bets $0.21
BTN: folds
Uncalled bet ($0.21) returned to BB
BB collected $0.28 from pot
BB: doesn't show hand
*** SUMMARY ***
Total pot $0.29 | Rake $0.01
Board [Ad 7h Qh Jh 5c]
Seat 1: SB (small blind) folded before Flop
Seat 2: BB (big blind) collected ($0.28)
Seat 3: UTG folded before Flop (didn't bet)
Seat 4: HJ folded before Flop (didn't bet)
Seat 5: CO folded before Flop (didn't bet)
Seat 6: BTN (button) folded on the River


PokerStars Hand #238162856059:  Hold'em No Limit ($0.01/$0.02 USD) - 2022/08/23 3:58:51 ET
Table 'Achilles IV' 6-max Seat #1 is the button
Seat 1: BTN ($2 in chips)
Seat 2: SB ($2.06 in chips)
Seat 3: BB ($3.25 in chips)
Seat 4: UTG ($1.93 in chips)
Seat 5: HJ ($2 in chips)
Seat 6: CO ($1.07 in chips)
SB: posts small blind $0.01
BB: posts big blind $0.02
*** HOLE CARDS ***
UTG: calls $0.02
HJ: folds
CO: folds
BTN: folds
SB: folds
BB: checks
*** FLOP *** [3h 2d 8d]
BB: checks
UTG: checks
*** TURN *** [3h 2d 8d] [Jd]
BB: checks
UTG: checks
*** RIVER *** [3h 2d 8d Jd] [Tc]
BB: checks
UTG: checks
*** SHOW DOWN ***
BB: shows [Ks 6c] (high card King)
UTG: shows [As Qh] (high card Ace)
UTG collected $0.05 from pot
*** SUMMARY ***
Total pot $0.05 | Rake $0
Board [3h 2d 8d Jd Tc]
Seat 1: BTN (button) folded before Flop (didn't bet)
Seat 2: SB (small blind) folded before Flop
Seat 3: BB (big blind) showed [Ks 6c] and lost with high card King
Seat 4: UTG showed [As Qh] and won ($0.05) with high card Ace
Seat 5: HJ folded before Flop (didn't bet)
Seat 6: CO folded before Flop (didn't bet)


PokerStars Hand #238162861137:  Hold'em No Limit ($0.01/$0.02 USD) - 2022/08/23 3:59:38 ET
Table 'Achilles IV' 6-max Seat #2 is the button
Seat 1: CO ($2 in chips)
Seat 2: BTN ($2.05 in chips)
Seat 3: SB ($3.23 in chips)
Seat 4: BB ($1.96 in chips)
Seat 5: UTG ($2 in chips)
Seat 6: HJ ($1.07 in chips)
SB: posts small blind $0.01
BB: posts big blind $0.02
*** HOLE CARDS ***
UTG: folds
HJ: folds
CO: raises $0.03 to $0.05
BTN: calls $0.05
SB: folds
BB: calls $0.03
*** FLOP *** [3c Kc 5c]
BB: checks
CO: checks
BTN: checks
*** TURN *** [3c Kc 5c] [Qh]
BB: checks
CO: bets $0.07
BTN: calls $0.07
BB: folds
*** RIVER *** [3c Kc 5c Qh] [6d]
CO: checks
BTN: bets $0.10
CO: folds
Uncalled bet ($0.10) returned to BTN
BTN collected $0.29 from pot
BTN: doesn't show hand
*** SUMMARY ***
Total pot $0.30 | Rake $0.01
Board [3c Kc 5c Qh 6d]
Seat 1: CO folded on the River
Seat 2: BTN (button) collected ($0.29)
Seat 3: SB (small blind) folded before Flop
Seat 4: BB (big blind) folded on the Turn
Seat 5: UTG folded before Flop (didn't bet)
Seat 6: HJ folded before Flop (didn't bet)


PokerStars Hand #238162874318:  Hold'em No Limit ($0.01/$0.02 USD) - 2022/08/23 4:01:33 ET
Table 'Achilles IV' 6-max Seat #3 is the button
Seat 1: HJ ($2 in chips)
Seat 2: CO ($2.22 in chips)
Seat 3: BTN ($3.22 in chips)
Seat 4: SB ($1.91 in chips)
Seat 5: BB ($2 in chips)
Seat 6: UTG ($1.07 in chips)
SB: posts small blind $0.01
BB: posts big blind $0.02
*** HOLE CARDS ***
UTG: calls $0.02
HJ: folds
CO: folds
BTN: folds
SB: calls $0.01
BB: raises $0.08 to $0.10
UTG: calls $0.08
SB: folds
*** FLOP *** [Qd Jd 3h]
BB: checks
UTG: bets $0.21
BB: folds
Uncalled bet ($0.21) returned to UTG
UTG collected $0.21 from pot
*** SUMMARY ***
Total pot $0.22 | Rake $0.01
Board [Qd Jd 3h]
Seat 1: HJ folded before Flop (didn't bet)
Seat 2: CO folded before Flop (didn't bet)
Seat 3: BTN (button) folded before Flop (didn't bet)
Seat 4: SB (small blind) folded before Flop
Seat 5: BB (big blind) folded on the Flop
Seat 6: UTG collected ($0.21)


PokerStars Hand #238162885623:  Hold'em No Limit ($0.01/$0.02 USD) - 2022/08/23 4:03:04 ET
Table 'Achilles IV' 6-max Seat #4 is the button
Seat 1: UTG ($2 in chips)
Seat 2: HJ ($2.22 in chips)
Seat 3: CO ($3.22 in chips)
Seat 4: BTN ($1.89 in chips)
Seat 5: SB ($1.90 in chips)
Seat 6: BB ($1.18 in chips)
SB: posts small blind $0.01
BB: posts big blind $0.02
*** HOLE CARDS ***
UTG: folds
HJ: folds
CO: folds
BTN: calls $0.02
SB: folds
BB: checks
*** FLOP *** [Qd Qc 4s]
BB: checks
BTN: checks
*** TURN *** [Qd Qc 4s] [Kd]
BB: checks
BTN: checks
*** RIVER *** [Qd Qc 4s Kd] [6h]
BB: checks
BTN: checks
*** SHOW DOWN ***
BB: shows [8c 9c] (a pair of Queens)
BTN: shows [Js Ts] (a pair of Queens - King+Jack kicker)
BTN collected $0.05 from pot
*** SUMMARY ***
Total pot $0.05 | Rake $0
Board [Qd Qc 4s Kd 6h]
Seat 1: UTG folded before Flop (didn't bet)
Seat 2: HJ folded before Flop (didn't bet)
Seat 3: CO folded before Flop (didn't bet)
Seat 4: BTN (button) showed [Js Ts] and won ($0.05) with a pair of Queens
Seat 5: SB (small blind) folded before Flop
Seat 6: BB (big blind) showed [8c 9c] and lost with a pair of Queens


PokerStars Hand #238162890690:  Hold'em No Limit ($0.01/$0.02 USD) - 2022/08/23 4:03:45 ET
Table 'Achilles IV' 6-max Seat #5 is the button
Seat 1: BB ($2 in chips)
Seat 2: UTG ($2.22 in chips)
Seat 3: HJ ($3.22 in chips)
Seat 4: CO ($1.92 in chips)
Seat 5: BTN ($1.89 in chips)
Seat 6: SB ($1.16 in chips)
SB: posts small blind $0.01
BB: posts big blind $0.02
*** HOLE CARDS ***
UTG: folds
HJ: folds
CO: calls $0.02
BTN: folds
SB: raises $0.08 to $0.10
BB: folds
CO: calls $0.08
*** FLOP *** [5d 5h Ah]
SB: bets $0.04
CO: folds
Uncalled bet ($0.04) returned to SB
SB collected $0.21 from pot
*** SUMMARY ***
Total pot $0.22 | Rake $0.01
Board [5d 5h Ah]
Seat 1: BB (big blind) folded before Flop
Seat 2: UTG folded before Flop (didn't bet)
Seat 3: HJ folded before Flop (didn't bet)
Seat 4: CO folded on the Flop
Seat 5: BTN (button) folded before Flop (didn't bet)
Seat 6: SB (small blind) collected ($0.21)


PokerStars Hand #238162895659:  Hold'em No Limit ($0.01/$0.02 USD) - 2022/08/23 4:04:25 ET
Table 'Achilles IV' 6-max Seat #6 is the button
Seat 1: SB ($2 in chips)
Seat 2: BB ($2.22 in chips)
Seat 3: UTG ($3.22 in chips)
Seat 4: HJ ($1.82 in chips)
Seat 5: CO ($2 in chips)
Seat 6: BTN ($1.27 in chips)
SB: posts small blind $0.01
BB: posts big blind $0.02
*** HOLE CARDS ***
UTG: folds
HJ: folds
CO: raises $0.04 to $0.06
BTN: calls $0.06
SB: folds
BB: folds
*** FLOP *** [Ks Kc 7c]
CO: checks
BTN: bets $0.04
CO: folds
Uncalled bet ($0.04) returned to BTN
BTN collected $0.14 from pot
*** SUMMARY ***
Total pot $0.15 | Rake $0.01
Board [Ks Kc 7c]
Seat 1: SB (small blind) folded before Flop
Seat 2: BB (big blind) folded before Flop
Seat 3: UTG folded before Flop (didn't bet)
Seat 4: HJ folded before Flop (didn't bet)
Seat 5: CO folded on the Flop
Seat 6: BTN (button) collected ($0.14)


PokerStars Hand #238162902371:  Hold'em No Limit ($0.01/$0.02 USD) - 2022/08/23 4:05:19 ET
Table 'Achilles IV' 6-max Seat #1 is the button
Seat 1: BTN ($2 in chips)
Seat 2: SB ($2.20 in chips)
Seat 3: BB ($3.22 in chips)
Seat 4: UTG ($1.82 in chips)
Seat 5: HJ ($1.94 in chips)
Seat 6: CO ($1.35 in chips)
SB: posts small blind $0.01
BB: posts big blind $0.02
*** HOLE CARDS ***
UTG: folds
HJ: folds
CO: folds
BTN: folds
SB: raises $0.03 to $0.05
BB: folds
Uncalled bet ($0.03) returned to SB
SB collected $0.04 from pot
SB: doesn't show hand
*** SUMMARY ***
Total pot $0.04 | Rake $0
Seat 1: BTN (button) folded before Flop (didn't bet)
Seat 2: SB (small blind) collected ($0.04)
Seat 3: BB (big blind) folded before Flop
Seat 4: UTG folded before Flop (didn't bet)
Seat 5: HJ folded before Flop (didn't bet)
Seat 6: CO folded before Flop (didn't bet)


PokerStars Hand #238162905235:  Hold'em No Limit ($0.01/$0.02 USD) - 2022/08/23 4:05:42 ET
Table 'Achilles IV' 6-max Seat #2 is the button
Seat 1: CO ($2 in chips)
Seat 2: BTN ($2.22 in chips)
Seat 3: SB ($3.20 in chips)
Seat 4: BB ($1.82 in chips)
Seat 5: UTG ($1.94 in chips)
Seat 6: HJ ($1.35 in chips)
SB: posts small blind $0.01
BB: posts big blind $0.02
*** HOLE CARDS ***
UTG: folds
HJ: folds
CO: raises $0.03 to $0.05
BTN: folds
SB: folds
BB: calls $0.03
*** FLOP *** [2d 2h Jh]
BB: checks
CO: bets $0.04
BB: calls $0.04
*** TURN *** [2d 2h Jh] [Ah]
BB: bets $0.09
CO: calls $0.09
*** RIVER *** [2d 2h Jh Ah] [3s]
BB: bets $0.06
CO: calls $0.06
*** SHOW DOWN ***
BB: shows [Tc Th] (two pair, Tens and Deuces)
CO: shows [Ts Js] (two pair, Jacks and Deuces)
CO collected $0.47 from pot
*** SUMMARY ***
Total pot $0.49 | Rake $0.02
Board [2d 2h Jh Ah 3s]
Seat 1: CO showed [Ts Js] and won ($0.47) with two pair, Jacks and Deuces
Seat 2: BTN (button) folded before Flop (didn't bet)
Seat 3: SB (small blind) folded before Flop
Seat 4: BB (big blind) showed [Tc Th] and lost with two pair, Tens and Deuces
Seat 5: UTG folded before Flop (didn't bet)
Seat 6: HJ folded before Flop (didn't bet)


PokerStars Hand #238162912564:  Hold'em No Limit ($0.01/$0.02 USD) - 2022/08/23 4:06:41 ET
Table 'Achilles IV' 6-max Seat #3 is the button
Seat 1: HJ ($2.23 in chips)
Seat 2: CO ($2.22 in chips)
Seat 3: BTN ($3.19 in chips)
Seat 4: SB ($1.58 in chips)
Seat 5: BB ($1.94 in chips)
Seat 6: UTG ($1.35 in chips)
SB: posts small blind $0.01
BB: posts big blind $0.02
*** HOLE CARDS ***
UTG: folds
HJ: folds
CO: folds
BTN: folds
SB: calls $0.01
BB: checks
*** FLOP *** [2d 5s Th]
SB: checks
BB: bets $0.04
SB: folds
Uncalled bet ($0.04) returned to BB
BB collected $0.04 from pot
*** SUMMARY ***
Total pot $0.04 | Rake $0
Board [2d 5s Th]
Seat 1: HJ folded before Flop (didn't bet)
Seat 2: CO folded before Flop (didn't bet)
Seat 3: BTN (button) folded before Flop (didn't bet)
Seat 4: SB (small blind) folded on the Flop
Seat 5: BB (big blind) collected ($0.04)
Seat 6: UTG folded before Flop (didn't bet)


PokerStars Hand #238162917237:  Hold'em No Limit ($0.01/$0.02 USD) - 2022/08/23 4:07:19 ET
Table 'Achilles IV' 6-max Seat #4 is the button
Seat 1: UTG ($2.23 in chips)
Seat 2: HJ ($2.22 in chips)
Seat 3: CO ($3.19 in chips)
Seat 4: BTN ($1.56 in chips)
Seat 5: SB ($1.96 in chips)
Seat 6: BB ($1.35 in chips)
SB: posts small blind $0.01
BB: posts big blind $0.02
*** HOLE CARDS ***
UTG: raises $0.04 to $0.06
HJ: calls $0.06
CO: folds
BTN: folds
SB: folds
BB: folds
*** FLOP *** [3c 6s 7s]
UTG: checks
HJ: bets $0.08
UTG: folds
Uncalled bet ($0.08) returned to HJ
HJ collected $0.14 from pot
HJ: doesn't show hand
*** SUMMARY ***
Total pot $0.15 | Rake $0.01
Board [3c 6s 7s]
Seat 1: UTG folded on the Flop
Seat 2: HJ collected ($0.14)
Seat 3: CO folded before Flop (didn't bet)
Seat 4: BTN (button) folded before Flop (didn't bet)
Seat 5: SB (small blind) folded before Flop
Seat 6: BB (big blind) folded before Flop


PokerStars Hand #238162921941:  Hold'em No Limit ($0.01/$0.02 USD) - 2022/08/23 4:07:57 ET
Table 'Achilles IV' 6-max Seat #5 is the button
Seat 1: BB ($2.17 in chips)
Seat 2: UTG ($2.30 in chips)
Seat 3: HJ ($3.19 in chips)
Seat 4: CO ($1.56 in chips)
Seat 5: BTN ($1.95 in chips)
Seat 6: SB ($1.33 in chips)
SB: posts small blind $0.01
BB: posts big blind $0.02
*** HOLE CARDS ***
UTG: raises $0.03 to $0.05
HJ: folds
CO: folds
BTN: folds
SB: calls $0.04
BB: folds
*** FLOP *** [5c 3d 3c]
SB: checks
UTG: bets $0.08
SB: folds
Uncalled bet ($0.08) returned to UTG
UTG collected $0.12 from pot
UTG: doesn't show hand
*** SUMMARY ***
Total pot $0.12 | Rake $0
Board [5c 3d 3c]
Seat 1: BB (big blind) folded before Flop
Seat 2: UTG collected ($0.12)
Seat 3: HJ folded before Flop (didn't bet)
Seat 4: CO folded before Flop (didn't bet)
Seat 5: BTN (button) folded before Flop (didn't bet)
Seat 6: SB (small blind) folded on the Flop


PokerStars Hand #238162925173:  Hold'em No Limit ($0.01/$0.02 USD) - 2022/08/23 4:08:23 ET
Table 'Achilles IV' 6-max Seat #6 is the button
Seat 1: SB ($2.15 in chips)
Seat 2: BB ($2.37 in chips)
Seat 3: UTG ($3.19 in chips)
Seat 4: HJ ($1.56 in chips)
Seat 5: CO ($1.95 in chips)
Seat 6: BTN ($1.28 in chips)
SB: posts small blind $0.01
BB: posts big blind $0.02
*** HOLE CARDS ***
UTG: folds
HJ: folds
CO: folds
BTN: folds
SB: folds
Uncalled bet ($0.01) returned to BB
BB collected $0.02 from pot
BB: doesn't show hand
*** SUMMARY ***
Total pot $0.02 | Rake $0
Seat 1: SB (small blind) folded before Flop
Seat 2: BB (big blind) collected ($0.02)
Seat 3: UTG folded before Flop (didn't bet)
Seat 4: HJ folded before Flop (didn't bet)
Seat 5: CO folded before Flop (didn't bet)
Seat 6: BTN (button) folded before Flop (didn't bet)


PokerStars Hand #238162926267:  Hold'em No Limit ($0.01/$0.02 USD) - 2022/08/23 4:08:32 ET
Table 'Achilles IV' 6-max Seat #1 is the button
Seat 1: BTN ($2.14 in chips)
Seat 2: SB ($2.38 in chips)
Seat 3: BB ($3.19 in chips)
Seat 4: UTG ($1.56 in chips)
Seat 5: HJ ($1.95 in chips)
Seat 6: CO ($1.28 in chips)
SB: posts small blind $0.01
BB: posts big blind $0.02
*** HOLE CARDS ***
UTG: folds
HJ: folds
CO: raises $0.05 to $0.07
BTN: folds
SB: folds
BB: calls $0.05
*** FLOP *** [5d 4h Ah]
BB: checks
CO: bets $0.14
BB: folds
Uncalled bet ($0.14) returned to CO
CO collected $0.14 from pot
*** SUMMARY ***
Total pot $0.15 | Rake $0.01
Board [5d 4h Ah]
Seat 1: BTN (button) folded before Flop (didn't bet)
Seat 2: SB (small blind) folded before Flop
Seat 3: BB (big blind) folded on the Flop
Seat 4: UTG folded before Flop (didn't bet)
Seat 5: HJ folded before Flop (didn't bet)
Seat 6: CO collected ($0.14)


PokerStars Hand #238162930659:  Hold'em No Limit ($0.01/$0.02 USD) - 2022/08/23 4:09:07 ET
Table 'Achilles IV' 6-max Seat #2 is the button
Seat 1: CO ($2.14 in chips)
Seat 2: BTN ($2.37 in chips)
Seat 3: SB ($3.12 in chips)
Seat 4: BB ($1.56 in chips)
Seat 5: UTG ($1.95 in chips)
Seat 6: HJ ($1.35 in chips)
SB: posts small blind $0.01
BB: posts big blind $0.02
*** HOLE CARDS ***
UTG: folds
HJ: raises $0.07 to $0.09
CO: calls $0.09
BTN: folds
SB: folds
BB: calls $0.07
*** FLOP *** [Td 8h Jd]
BB: checks
HJ: bets $0.04
CO: calls $0.04
BB: calls $0.04
*** TURN *** [Td 8h Jd] [9d]
BB: checks
HJ: bets $0.06
UTG was removed from the table for failing to post
UTG leaves the table
CO: calls $0.06
BB: calls $0.06
*** RIVER *** [Td 8h Jd 9d] [Ad]
BB: checks
HJ: checks
CO: checks
*** SHOW DOWN ***
BB: shows [6h Qh] (a straight, Eight to Queen)
HJ: mucks hand
CO: mucks hand
BB collected $0.56 from pot
*** SUMMARY ***
Total pot $0.58 | Rake $0.02
Board [Td 8h Jd 9d Ad]
Seat 1: CO mucked
Seat 2: BTN (button) folded before Flop (didn't bet)
Seat 3: SB (small blind) folded before Flop
Seat 4: BB (big blind) showed [6h Qh] and won ($0.56) with a straight, Eight to Queen
Seat 5: UTG folded before Flop (didn't bet)
Seat 6: HJ mucked


PokerStars Hand #238162939906:  Hold'em No Limit ($0.01/$0.02 USD) - 2022/08/23 4:10:20 ET
Table 'Achilles IV' 6-max Seat #3 is the button
Seat 1: HJ ($2 in chips)
Seat 2: CO ($2.37 in chips)
Seat 3: BTN ($3.11 in chips)
Seat 4: SB ($1.93 in chips)
Seat 6: BB ($1.16 in chips)
SB: posts small blind $0.01
BB: posts big blind $0.02
*** HOLE CARDS ***
HJ: raises $0.04 to $0.06
CO: folds
BTN: folds
SB: folds
BB: calls $0.04
*** FLOP *** [6s 8c Td]
BTN leaves the table
BB: checks
HJ: bets $0.09
BB: folds
Uncalled bet ($0.09) returned to HJ
HJ collected $0.13 from pot
HJ: doesn't show hand
*** SUMMARY ***
Total pot $0.13 | Rake $0
Board [6s 8c Td]
Seat 1: HJ collected ($0.13)
Seat 2: CO folded before Flop (didn't bet)
Seat 3: BTN (button) folded before Flop (didn't bet)
Seat 4: SB (small blind) folded before Flop
Seat 6: BB (big blind) folded on the Flop


PokerStars Hand #238162944005:  Hold'em No Limit ($0.01/$0.02 USD) - 2022/08/23 4:10:53 ET
Table 'Achilles IV' 6-max Seat #4 is the button
Seat 2: BB ($2.37 in chips)
Seat 4: BTN ($1.92 in chips)
Seat 6: SB ($1.10 in chips)
SB: posts small blind $0.01
BB: posts big blind $0.02
*** HOLE CARDS ***
Fedorenko26 joins the table at seat #3
BTN: folds
SB: raises $0.04 to $0.06
BTN leaves the table
BB: folds
Uncalled bet ($0.04) returned to SB
SB collected $0.04 from pot
*** SUMMARY ***
Total pot $0.04 | Rake $0
Seat 2: BB (big blind) folded before Flop
Seat 4: BTN (button) folded before Flop (didn't bet)
Seat 6: SB (small blind) collected ($0.04)


PokerStars Hand #238162945157:  Hold'em No Limit ($0.01/$0.02 USD) - 2022/08/23 4:11:02 ET
Table 'Achilles IV' 6-max Seat #6 is the button
Seat 2: SB ($2.35 in chips)
Seat 3: BB ($2 in chips)
Seat 6: BTN ($1.12 in chips)
SB: posts small blind $0.01
BB: posts big blind $0.02
*** HOLE CARDS ***
BTN: folds
SB: folds
Uncalled bet ($0.01) returned to BB
BB collected $0.02 from pot
*** SUMMARY ***
Total pot $0.02 | Rake $0
Seat 2: SB (small blind) folded before Flop
Seat 3: BB (big blind) collected ($0.02)
Seat 6: BTN (button) folded before Flop (didn't bet)


PokerStars Hand #238162950505:  Hold'em No Limit ($0.01/$0.02 USD) - 2022/08/23 4:11:44 ET
Table 'Achilles IV' 6-max Seat #3 is the button
Seat 2: BB ($2.34 in chips)
Seat 3: BTN ($2 in chips)
Seat 6: SB ($1.18 in chips)
SB: posts small blind $0.01
BB: posts big blind $0.02
*** HOLE CARDS ***
BTN: folds
SB: folds
Uncalled bet ($0.01) returned to BB
BB collected $0.02 from pot
BB: doesn't show hand
*** SUMMARY ***
Total pot $0.02 | Rake $0
Seat 2: BB (big blind) collected ($0.02)
Seat 3: BTN (button) folded before Flop (didn't bet)
Seat 6: SB (small blind) folded before Flop


PokerStars Hand #238162946767:  Hold'em No Limit ($0.01/$0.02 USD) - 2022/08/23 4:11:15 ET
Table 'Achilles IV' 6-max Seat #2 is the button
Seat 2: BTN ($2.34 in chips)
Seat 3: SB ($2.01 in chips)
Seat 6: BB ($1.12 in chips)
SB: posts small blind $0.01
BB: posts big blind $0.02
*** HOLE CARDS ***
BTN has timed out
BTN: folds
SB: calls $0.01
BB: raises $0.04 to $0.06
SB: calls $0.04
*** FLOP *** [6s 3h Qd]
SB: checks
BB: bets $0.12
SB: folds
Uncalled bet ($0.12) returned to BB
BB collected $0.12 from pot
*** SUMMARY ***
Total pot $0.12 | Rake $0
Board [6s 3h Qd]
Seat 2: BTN (button) folded before Flop (didn't bet)
Seat 3: SB (small blind) folded on the Flop
Seat 6: BB (big blind) collected ($0.12)


PokerStars Hand #238162951221:  Hold'em No Limit ($0.01/$0.02 USD) - 2022/08/23 4:11:50 ET
Table 'Achilles IV' 6-max Seat #6 is the button
Seat 2: SB ($2.35 in chips)
Seat 3: BB ($2 in chips)
Seat 6: BTN ($1.17 in chips)
SB: posts small blind $0.01
BB: posts big blind $0.02
*** HOLE CARDS ***
BTN: folds
SB: raises $0.03 to $0.05
BB: calls $0.03
*** FLOP *** [9d Th Qh]
SB: checks
BB: checks
*** TURN *** [9d Th Qh] [Ac]
SB: checks
BB: checks
*** RIVER *** [9d Th Qh Ac] [Qs]
SB: checks
BB: checks
*** SHOW DOWN ***
SB: shows [8d 8h] (two pair, Queens and Eights)
BB: mucks hand
SB collected $0.10 from pot
*** SUMMARY ***
Total pot $0.10 | Rake $0
Board [9d Th Qh Ac Qs]
Seat 2: SB (small blind) showed [8d 8h] and won ($0.10) with two pair, Queens and Eights
Seat 3: BB (big blind) mucked
Seat 6: BTN (button) folded before Flop (didn't bet)


PokerStars Hand #238162959520:  Hold'em No Limit ($0.01/$0.02 USD) - 2022/08/23 4:12:55 ET
Table 'Achilles IV' 6-max Seat #3 is the button
Seat 1: BB ($2.07 in chips)
Seat 2: CO ($2.40 in chips)
Seat 3: BTN ($2 in chips)
Seat 6: SB ($1.18 in chips)
SB: posts small blind $0.01
BB: posts big blind $0.02
*** HOLE CARDS ***
CO: folds
BTN: folds
SB: folds
Uncalled bet ($0.01) returned to BB
BB collected $0.02 from pot
BB: doesn't show hand
*** SUMMARY ***
Total pot $0.02 | Rake $0
Seat 1: BB (big blind) collected ($0.02)
Seat 2: CO folded before Flop (didn't bet)
Seat 3: BTN (button) folded before Flop (didn't bet)
Seat 6: SB (small blind) folded before Flop


PokerStars Hand #238162958257:  Hold'em No Limit ($0.01/$0.02 USD) - 2022/08/23 4:12:45 ET
Table 'Achilles IV' 6-max Seat #2 is the button
Seat 2: BTN ($2.40 in chips)
Seat 3: SB ($2 in chips)
Seat 6: BB ($1.17 in chips)
SB: posts small blind $0.01
BB: posts big blind $0.02
*** HOLE CARDS ***
BTN: folds
SB: folds
Uncalled bet ($0.01) returned to BB
BB collected $0.02 from pot
*** SUMMARY ***
Total pot $0.02 | Rake $0
Seat 2: BTN (button) folded before Flop (didn't bet)
Seat 3: SB (small blind) folded before Flop
Seat 6: BB (big blind) collected ($0.02)


PokerStars Hand #238162960698:  Hold'em No Limit ($0.01/$0.02 USD) - 2022/08/23 4:13:04 ET
Table 'Achilles IV' 6-max Seat #6 is the button
Seat 1: SB ($2.08 in chips)
Seat 2: BB ($2.40 in chips)
Seat 3: CO ($2 in chips)
Seat 6: BTN ($1.17 in chips)
SB: posts small blind $0.01
BB: posts big blind $0.02
*** HOLE CARDS ***
hoholas22 joins the table at seat #5
CO: folds
BTN: folds
SB: raises $0.04 to $0.06
BB: folds
Uncalled bet ($0.04) returned to SB
SB collected $0.04 from pot
SB: doesn't show hand
*** SUMMARY ***
Total pot $0.04 | Rake $0
Seat 1: SB (small blind) collected ($0.04)
Seat 2: BB (big blind) folded before Flop
Seat 3: CO folded before Flop (didn't bet)
Seat 6: BTN (button) folded before Flop (didn't bet)


PokerStars Hand #238162962679:  Hold'em No Limit ($0.01/$0.02 USD) - 2022/08/23 4:13:20 ET
Table 'Achilles IV' 6-max Seat #1 is the button
Seat 1: BTN ($2.10 in chips)
Seat 2: SB ($2.38 in chips)
Seat 3: BB ($2 in chips)
Seat 6: CO ($1.17 in chips)
SB: posts small blind $0.01
BB: posts big blind $0.02
hoholas22: sits out
*** HOLE CARDS ***
yuyu767 joins the table at seat #4
CO: calls $0.02
BTN: folds
SB: calls $0.01
BB: checks
*** FLOP *** [Kh 4h 3c]
SB: checks
BB: checks
CO: checks
*** TURN *** [Kh 4h 3c] [8c]
SB: checks
BB: bets $0.03
CO: folds
SB: folds
Uncalled bet ($0.03) returned to BB
BB collected $0.06 from pot
*** SUMMARY ***
Total pot $0.06 | Rake $0
Board [Kh 4h 3c 8c]
Seat 1: BTN (button) folded before Flop (didn't bet)
Seat 2: SB (small blind) folded on the Turn
Seat 3: BB (big blind) collected ($0.06)
Seat 6: CO folded on the Turn


PokerStars Hand #238162970944:  Hold'em No Limit ($0.01/$0.02 USD) - 2022/08/23 4:14:24 ET
Table 'Achilles IV' 6-max Seat #2 is the button
Seat 1: CO ($2.10 in chips)
Seat 2: BTN ($2.36 in chips)
Seat 3: SB ($2.04 in chips)
Seat 4: BB ($1.60 in chips)
Seat 6: HJ ($1.15 in chips)
SB: posts small blind $0.01
BB: posts big blind $0.02
hoholas22: sits out
*** HOLE CARDS ***
HJ: raises $0.02 to $0.04
CO: folds
BTN: folds
SB: folds
BB: calls $0.02
*** FLOP *** [Ac 5c 5h]
BB: checks
HJ: bets $0.04
BB: calls $0.04
*** TURN *** [Ac 5c 5h] [Kd]
BB: checks
HJ: bets $0.06
BB: calls $0.06
*** RIVER *** [Ac 5c 5h Kd] [Qc]
BB: checks
HJ: checks
*** SHOW DOWN ***
BB: shows [9c Ah] (two pair, Aces and Fives)
HJ: mucks hand
BB collected $0.28 from pot
*** SUMMARY ***
Total pot $0.29 | Rake $0.01
Board [Ac 5c 5h Kd Qc]
Seat 1: CO folded before Flop (didn't bet)
Seat 2: BTN (button) folded before Flop (didn't bet)
Seat 3: SB (small blind) folded before Flop
Seat 4: BB (big blind) showed [9c Ah] and won ($0.28) with two pair, Aces and Fives
Seat 6: HJ mucked


PokerStars Hand #238162975176:  Hold'em No Limit ($0.01/$0.02 USD) - 2022/08/23 4:14:57 ET
Table 'Achilles IV' 6-max Seat #3 is the button
Seat 1: HJ ($2.10 in chips)
Seat 2: CO ($2.36 in chips)
Seat 3: BTN ($2.03 in chips)
Seat 4: SB ($1.74 in chips)
Seat 5: BB ($2 in chips)
Seat 6: UTG ($1.01 in chips)
SB: posts small blind $0.01
BB: posts big blind $0.02
*** HOLE CARDS ***
UTG: raises $0.07 to $0.09
HJ: folds
CO: folds
BTN: folds
SB: folds
BB: folds
Uncalled bet ($0.07) returned to UTG
UTG collected $0.05 from pot
*** SUMMARY ***
Total pot $0.05 | Rake $0
Seat 1: HJ folded before Flop (didn't bet)
Seat 2: CO folded before Flop (didn't bet)
Seat 3: BTN (button) folded before Flop (didn't bet)
Seat 4: SB (small blind) folded before Flop
Seat 5: BB (big blind) folded before Flop
Seat 6: UTG collected ($0.05)


PokerStars Hand #238162982282:  Hold'em No Limit ($0.01/$0.02 USD) - 2022/08/23 4:15:23 ET
Table 'Achilles IV' 6-max Seat #4 is the button
Seat 1: UTG ($2.10 in chips)
Seat 2: HJ ($2.36 in chips)
Seat 3: CO ($2.03 in chips)
Seat 4: BTN ($1.73 in chips)
Seat 5: SB ($1.98 in chips)
Seat 6: BB ($1.04 in chips)
SB: posts small blind $0.01
BB: posts big blind $0.02
*** HOLE CARDS ***
UTG: folds
HJ: raises $0.03 to $0.05
CO: raises $0.13 to $0.18
BTN: folds
SB: folds
BB: folds
HJ: calls $0.13
*** FLOP *** [Jh Ad 4s]
HJ: checks
CO: checks
*** TURN *** [Jh Ad 4s] [7c]
HJ: checks
CO: checks
*** RIVER *** [Jh Ad 4s 7c] [4h]
HJ: bets $0.29
CO: folds
Uncalled bet ($0.29) returned to HJ
HJ collected $0.38 from pot
HJ: doesn't show hand
*** SUMMARY ***
Total pot $0.39 | Rake $0.01
Board [Jh Ad 4s 7c 4h]
Seat 1: UTG folded before Flop (didn't bet)
Seat 2: HJ collected ($0.38)
Seat 3: CO folded on the River
Seat 4: BTN (button) folded before Flop (didn't bet)
Seat 5: SB (small blind) folded before Flop
Seat 6: BB (big blind) folded before Flop


PokerStars Hand #238162990167:  Hold'em No Limit ($0.01/$0.02 USD) - 2022/08/23 4:16:25 ET
Table 'Achilles IV' 6-max Seat #5 is the button
Seat 1: BB ($2.10 in chips)
Seat 2: UTG ($2.56 in chips)
Seat 3: HJ ($2 in chips)
Seat 4: CO ($1.73 in chips)
Seat 5: BTN ($1.97 in chips)
Seat 6: SB ($1.02 in chips)
SB: posts small blind $0.01
BB: posts big blind $0.02
*** HOLE CARDS ***
UTG: folds
HJ: raises $0.04 to $0.06
CO: folds
BTN: folds
SB: folds
BB: raises $0.18 to $0.24
HJ: folds
Uncalled bet ($0.18) returned to BB
BB collected $0.13 from pot
BB: doesn't show hand
*** SUMMARY ***
Total pot $0.13 | Rake $0
Seat 1: BB (big blind) collected ($0.13)
Seat 2: UTG folded before Flop (didn't bet)
Seat 3: HJ folded before Flop
Seat 4: CO folded before Flop (didn't bet)
Seat 5: BTN (button) folded before Flop (didn't bet)
Seat 6: SB (small blind) folded before Flop


PokerStars Hand #238162993016:  Hold'em No Limit ($0.01/$0.02 USD) - 2022/08/23 4:16:47 ET
Table 'Achilles IV' 6-max Seat #6 is the button
Seat 1: SB ($2.17 in chips)
Seat 2: BB ($2.56 in chips)
Seat 3: UTG ($2 in chips)
Seat 4: HJ ($1.73 in chips)
Seat 5: CO ($1.97 in chips)
Seat 6: BTN ($1.01 in chips)
SB: posts small blind $0.01
BB: posts big blind $0.02
*** HOLE CARDS ***
UTG: folds
HJ: folds
CO: folds
BTN: folds
SB: raises $0.04 to $0.06
BB: folds
Uncalled bet ($0.04) returned to SB
SB collected $0.04 from pot
SB: doesn't show hand
*** SUMMARY ***
Total pot $0.04 | Rake $0
Seat 1: SB (small blind) collected ($0.04)
Seat 2: BB (big blind) folded before Flop
Seat 3: UTG folded before Flop (didn't bet)
Seat 4: HJ folded before Flop (didn't bet)
Seat 5: CO folded before Flop (didn't bet)
Seat 6: BTN (button) folded before Flop (didn't bet)


PokerStars Hand #238162994516:  Hold'em No Limit ($0.01/$0.02 USD) - 2022/08/23 4:16:59 ET
Table 'Achilles IV' 6-max Seat #1 is the button
Seat 1: BTN ($2.19 in chips)
Seat 2: SB ($2.54 in chips)
Seat 3: BB ($2 in chips)
Seat 4: UTG ($1.73 in chips)
Seat 5: HJ ($1.97 in chips)
Seat 6: CO ($1.01 in chips)
SB: posts small blind $0.01
BB: posts big blind $0.02
*** HOLE CARDS ***
UTG: folds
HJ: folds
CO: folds
BTN: folds
SB: folds
Uncalled bet ($0.01) returned to BB
BB collected $0.02 from pot
*** SUMMARY ***
Total pot $0.02 | Rake $0
Seat 1: BTN (button) folded before Flop (didn't bet)
Seat 2: SB (small blind) folded before Flop
Seat 3: BB (big blind) collected ($0.02)
Seat 4: UTG folded before Flop (didn't bet)
Seat 5: HJ folded before Flop (didn't bet)
Seat 6: CO folded before Flop (didn't bet)


PokerStars Hand #238162996113:  Hold'em No Limit ($0.01/$0.02 USD) - 2022/08/23 4:17:11 ET
Table 'Achilles IV' 6-max Seat #2 is the button
Seat 1: CO ($2.19 in chips)
Seat 2: BTN ($2.53 in chips)
Seat 3: SB ($2.01 in chips)
Seat 4: BB ($1.73 in chips)
Seat 5: UTG ($1.97 in chips)
Seat 6: HJ ($1.01 in chips)
SB: posts small blind $0.01
BB: posts big blind $0.02
*** HOLE CARDS ***
UTG: folds
HJ: raises $0.05 to $0.07
CO: folds
BTN: folds
SB: folds
BB: folds
Uncalled bet ($0.05) returned to HJ
HJ collected $0.05 from pot
*** SUMMARY ***
Total pot $0.05 | Rake $0
Seat 1: CO folded before Flop (didn't bet)
Seat 2: BTN (button) folded before Flop (didn't bet)
Seat 3: SB (small blind) folded before Flop
Seat 4: BB (big blind) folded before Flop
Seat 5: UTG folded before Flop (didn't bet)
Seat 6: HJ collected ($0.05)


PokerStars Hand #238163006181:  Hold'em No Limit ($0.01/$0.02 USD) - 2022/08/23 4:18:28 ET
Table 'Achilles IV' 6-max Seat #4 is the button
Seat 2: BB ($2.53 in chips)
Seat 3: CO ($2 in chips)
Seat 4: BTN ($2.70 in chips)
Seat 5: SB ($1.95 in chips)
SB: posts small blind $0.01
BB: posts big blind $0.02
*** HOLE CARDS ***
CO: folds
BTN: folds
SB: folds
Uncalled bet ($0.01) returned to BB
BB collected $0.02 from pot
BB: doesn't show hand
*** SUMMARY ***
Total pot $0.02 | Rake $0
Seat 2: BB (big blind) collected ($0.02)
Seat 3: CO folded before Flop (didn't bet)
Seat 4: BTN (button) folded before Flop (didn't bet)
Seat 5: SB (small blind) folded before Flop


PokerStars Hand #238162997608:  Hold'em No Limit ($0.01/$0.02 USD) - 2022/08/23 4:17:22 ET
Table 'Achilles IV' 6-max Seat #3 is the button
Seat 1: HJ ($2.19 in chips)
Seat 2: CO ($2.53 in chips)
Seat 3: BTN ($2 in chips)
Seat 4: SB ($1.71 in chips)
Seat 5: BB ($1.97 in chips)
Seat 6: UTG ($1.04 in chips)
SB: posts small blind $0.01
BB: posts big blind $0.02
*** HOLE CARDS ***
UTG: calls $0.02
HJ has timed out
HJ: folds
CO: folds
BTN: folds
SB: raises $0.04 to $0.06
BB: folds
UTG: calls $0.04
*** FLOP *** [Th 6c Js]
SB: checks
UTG: checks
*** TURN *** [Th 6c Js] [Kd]
SB: checks
UTG: checks
*** RIVER *** [Th 6c Js Kd] [7h]
SB: bets $0.07
UTG: raises $0.14 to $0.21
SB: raises $0.53 to $0.74
UTG: raises $0.24 to $0.98 and is all-in
SB: calls $0.24
*** SHOW DOWN ***
UTG: shows [8c 9d] (a straight, Seven to Jack)
SB: shows [As Qs] (a straight, Ten to Ace)
SB collected $2.03 from pot
*** SUMMARY ***
Total pot $2.10 | Rake $0.07
Board [Th 6c Js Kd 7h]
Seat 1: HJ folded before Flop (didn't bet)
Seat 2: CO folded before Flop (didn't bet)
Seat 3: BTN (button) folded before Flop (didn't bet)
Seat 4: SB (small blind) showed [As Qs] and won ($2.03) with a straight, Ten to Ace
Seat 5: BB (big blind) folded before Flop
Seat 6: UTG showed [8c 9d] and lost with a straight, Seven to Jack


PokerStars Hand #238163007291:  Hold'em No Limit ($0.01/$0.02 USD) - 2022/08/23 4:18:37 ET
Table 'Achilles IV' 6-max Seat #5 is the button
Seat 2: SB ($2.54 in chips)
Seat 3: BB ($2 in chips)
Seat 4: CO ($2.70 in chips)
Seat 5: BTN ($1.94 in chips)
SB: posts small blind $0.01
BB: posts big blind $0.02
*** HOLE CARDS ***
yarik7879 leaves the table
CO: folds
BTN: raises $0.04 to $0.06
SB: calls $0.05
BB: folds
*** FLOP *** [Ks Kd 7d]
SB: checks
BTN: checks
*** TURN *** [Ks Kd 7d] [3s]
SB: checks
BTN: bets $0.07
SB: folds
Uncalled bet ($0.07) returned to BTN
BTN collected $0.14 from pot
*** SUMMARY ***
Total pot $0.14 | Rake $0
Board [Ks Kd 7d 3s]
Seat 2: SB (small blind) folded on the Turn
Seat 3: BB (big blind) folded before Flop
Seat 4: CO folded before Flop (didn't bet)
Seat 5: BTN (button) collected ($0.14)


PokerStars Hand #238163011686:  Hold'em No Limit ($0.01/$0.02 USD) - 2022/08/23 4:19:12 ET
Table 'Achilles IV' 6-max Seat #2 is the button
Seat 2: BTN ($2.48 in chips)
Seat 3: SB ($2 in chips)
Seat 4: BB ($2.70 in chips)
Seat 5: CO ($2.02 in chips)
SB: posts small blind $0.01
BB: posts big blind $0.02
*** HOLE CARDS ***
CO: raises $0.04 to $0.06
BTN: folds
SB: folds
BB: calls $0.04
*** FLOP *** [6s Td 9h]
BB: checks
CO: bets $0.06
BB: calls $0.06
*** TURN *** [6s Td 9h] [Jd]
BB: checks
CO: bets $0.12
BB: raises $0.12 to $0.24
CO: calls $0.12
*** RIVER *** [6s Td 9h Jd] [6h]
BB: checks
CO: bets $0.22
BB: calls $0.22
*** SHOW DOWN ***
CO: shows [Jh Ac] (two pair, Jacks and Sixes)
BB: shows [Js As] (two pair, Jacks and Sixes)
BB collected $0.57 from pot
CO collected $0.56 from pot
*** SUMMARY ***
Total pot $1.17 | Rake $0.04
Board [6s Td 9h Jd 6h]
Seat 2: BTN (button) folded before Flop (didn't bet)
Seat 3: SB (small blind) folded before Flop
Seat 4: BB (big blind) showed [Js As] and won ($0.57) with two pair, Jacks and Sixes
Seat 5: CO showed [Jh Ac] and won ($0.56) with two pair, Jacks and Sixes


PokerStars Hand #238163028399:  Hold'em No Limit ($0.01/$0.02 USD) - 2022/08/23 4:21:23 ET
Table 'Achilles IV' 6-max Seat #4 is the button
Seat 2: HJ ($2.49 in chips)
Seat 3: CO ($2.01 in chips)
Seat 4: BTN ($2.68 in chips)
Seat 5: SB ($1.98 in chips)
Seat 6: BB ($2 in chips)
SB: posts small blind $0.01
BB: posts big blind $0.02
Flix2204: sits out
*** HOLE CARDS ***
HJ: folds
CO: folds
BTN: folds
SB: folds
Uncalled bet ($0.01) returned to BB
BB collected $0.02 from pot
*** SUMMARY ***
Total pot $0.02 | Rake $0
Seat 2: HJ folded before Flop (didn't bet)
Seat 3: CO folded before Flop (didn't bet)
Seat 4: BTN (button) folded before Flop (didn't bet)
Seat 5: SB (small blind) folded before Flop
Seat 6: BB (big blind) collected ($0.02)


PokerStars Hand #238163020361:  Hold'em No Limit ($0.01/$0.02 USD) - 2022/08/23 4:20:20 ET
Table 'Achilles IV' 6-max Seat #3 is the button
Seat 2: CO ($2.48 in chips)
Seat 3: BTN ($2 in chips)
Seat 4: SB ($2.69 in chips)
Seat 5: BB ($2 in chips)
SB: posts small blind $0.01
BB: posts big blind $0.02
*** HOLE CARDS ***
UncleArb1612 joins the table at seat #6
CO: raises $0.03 to $0.05
BTN: raises $0.13 to $0.18
SB: folds
BB: folds
CO: calls $0.13
*** FLOP *** [5s 5h 4h]
CO: checks
BTN: checks
*** TURN *** [5s 5h 4h] [9d]
CO: checks
BTN: checks
*** RIVER *** [5s 5h 4h 9d] [3c]
CO: checks
BTN: checks
*** SHOW DOWN ***
CO: shows [Ah Jh] (a pair of Fives)
BTN: shows [Jd Ad] (a pair of Fives)
CO collected $0.19 from pot
BTN collected $0.19 from pot
*** SUMMARY ***
Total pot $0.39 | Rake $0.01
Board [5s 5h 4h 9d 3c]
Seat 2: CO showed [Ah Jh] and won ($0.19) with a pair of Fives
Seat 3: BTN (button) showed [Jd Ad] and won ($0.19) with a pair of Fives
Seat 4: SB (small blind) folded before Flop
Seat 5: BB (big blind) folded before Flop


PokerStars Hand #238163029675:  Hold'em No Limit ($0.01/$0.02 USD) - 2022/08/23 4:21:33 ET
Table 'Achilles IV' 6-max Seat #5 is the button
Seat 1: BB ($2.19 in chips)
Seat 2: UTG ($2.49 in chips)
Seat 3: HJ ($2.01 in chips)
Seat 4: CO ($2.68 in chips)
Seat 5: BTN ($1.97 in chips)
Seat 6: SB ($2.01 in chips)
SB: posts small blind $0.01
BB: posts big blind $0.02
*** HOLE CARDS ***
UTG: folds
HJ: folds
CO: folds
BTN: raises $0.04 to $0.06
SB: folds
BB: folds
Uncalled bet ($0.04) returned to BTN
BTN collected $0.05 from pot
*** SUMMARY ***
Total pot $0.05 | Rake $0
Seat 1: BB (big blind) folded before Flop
Seat 2: UTG folded before Flop (didn't bet)
Seat 3: HJ folded before Flop (didn't bet)
Seat 4: CO folded before Flop (didn't bet)
Seat 5: BTN (button) collected ($0.05)
Seat 6: SB (small blind) folded before Flop


PokerStars Hand #238163032729:  Hold'em No Limit ($0.01/$0.02 USD) - 2022/08/23 4:21:57 ET
Table 'Achilles IV' 6-max Seat #6 is the button
Seat 1: SB ($2.17 in chips)
Seat 2: BB ($2.49 in chips)
Seat 3: UTG ($2.01 in chips)
Seat 4: HJ ($2.68 in chips)
Seat 5: CO ($2 in chips)
Seat 6: BTN ($2 in chips)
SB: posts small blind $0.01
BB: posts big blind $0.02
*** HOLE CARDS ***
UTG: folds
HJ: raises $0.02 to $0.04
CO: folds
BTN: folds
SB: folds
BB: calls $0.02
*** FLOP *** [7h 7d 9h]
BB: checks
HJ: bets $0.06
BB: calls $0.06
*** TURN *** [7h 7d 9h] [6h]
BB: checks
HJ: checks
*** RIVER *** [7h 7d 9h 6h] [As]
BB: checks
HJ: checks
*** SHOW DOWN ***
BB: shows [Kc 9s] (two pair, Nines and Sevens)
HJ: mucks hand
BB collected $0.20 from pot
*** SUMMARY ***
Total pot $0.21 | Rake $0.01
Board [7h 7d 9h 6h As]
Seat 1: SB (small blind) folded before Flop
Seat 2: BB (big blind) showed [Kc 9s] and won ($0.20) with two pair, Nines and Sevens
Seat 3: UTG folded before Flop (didn't bet)
Seat 4: HJ mucked
Seat 5: CO folded before Flop (didn't bet)
Seat 6: BTN (button) folded before Flop (didn't bet)


PokerStars Hand #238163038690:  Hold'em No Limit ($0.01/$0.02 USD) - 2022/08/23 4:22:44 ET
Table 'Achilles IV' 6-max Seat #1 is the button
Seat 1: BTN ($2.16 in chips)
Seat 2: SB ($2.59 in chips)
Seat 3: BB ($2.01 in chips)
Seat 4: UTG ($2.58 in chips)
Seat 5: HJ ($2 in chips)
Seat 6: CO ($2 in chips)
SB: posts small blind $0.01
BB: posts big blind $0.02
*** HOLE CARDS ***
UTG: folds
HJ: folds
CO: calls $0.02
BTN: folds
SB: folds
BB: checks
*** FLOP *** [Kc 3c As]
BB: bets $0.04
CO: folds
Uncalled bet ($0.04) returned to BB
BB collected $0.05 from pot
*** SUMMARY ***
Total pot $0.05 | Rake $0
Board [Kc 3c As]
Seat 1: BTN (button) folded before Flop (didn't bet)
Seat 2: SB (small blind) folded before Flop
Seat 3: BB (big blind) collected ($0.05)
Seat 4: UTG folded before Flop (didn't bet)
Seat 5: HJ folded before Flop (didn't bet)
Seat 6: CO folded on the Flop


PokerStars Hand #238163043005:  Hold'em No Limit ($0.01/$0.02 USD) - 2022/08/23 4:23:17 ET
Table 'Achilles IV' 6-max Seat #2 is the button
Seat 1: CO ($2.16 in chips)
Seat 2: BTN ($2.58 in chips)
Seat 3: SB ($2.04 in chips)
Seat 4: BB ($2.58 in chips)
Seat 5: UTG ($2 in chips)
Seat 6: HJ ($1.98 in chips)
SB: posts small blind $0.01
BB: posts big blind $0.02
*** HOLE CARDS ***
UTG: raises $0.04 to $0.06
HJ: folds
CO: folds
BTN: folds
SB: folds
BB: calls $0.04
*** FLOP *** [3c Qc 4h]
BB: checks
UTG: bets $0.06
BB: raises $0.13 to $0.19
UTG: folds
Uncalled bet ($0.13) returned to BB
BB collected $0.24 from pot
*** SUMMARY ***
Total pot $0.25 | Rake $0.01
Board [3c Qc 4h]
Seat 1: CO folded before Flop (didn't bet)
Seat 2: BTN (button) folded before Flop (didn't bet)
Seat 3: SB (small blind) folded before Flop
Seat 4: BB (big blind) collected ($0.24)
Seat 5: UTG folded on the Flop
Seat 6: HJ folded before Flop (didn't bet)


PokerStars Hand #238163051527:  Hold'em No Limit ($0.01/$0.02 USD) - 2022/08/23 4:24:22 ET
Table 'Achilles IV' 6-max Seat #3 is the button
Seat 1: HJ ($2.16 in chips)
Seat 2: CO ($2.58 in chips)
Seat 3: BTN ($2.03 in chips)
Seat 4: SB ($2.70 in chips)
Seat 5: BB ($1.88 in chips)
Seat 6: UTG ($1.98 in chips)
SB: posts small blind $0.01
BB: posts big blind $0.02
*** HOLE CARDS ***
UTG: raises $0.02 to $0.04
HJ: folds
CO: folds
BTN: folds
SB: folds
BB: folds
Uncalled bet ($0.02) returned to UTG
UTG collected $0.05 from pot
*** SUMMARY ***
Total pot $0.05 | Rake $0
Seat 1: HJ folded before Flop (didn't bet)
Seat 2: CO folded before Flop (didn't bet)
Seat 3: BTN (button) folded before Flop (didn't bet)
Seat 4: SB (small blind) folded before Flop
Seat 5: BB (big blind) folded before Flop
Seat 6: UTG collected ($0.05)


PokerStars Hand #238163053039:  Hold'em No Limit ($0.01/$0.02 USD) - 2022/08/23 4:24:34 ET
Table 'Achilles IV' 6-max Seat #4 is the button
Seat 1: UTG ($2.16 in chips)
Seat 2: HJ ($2.58 in chips)
Seat 3: CO ($2.03 in chips)
Seat 4: BTN ($2.69 in chips)
Seat 5: SB ($1.86 in chips)
Seat 6: BB ($2.01 in chips)
SB: posts small blind $0.01
BB: posts big blind $0.02
*** HOLE CARDS ***
UTG: folds
HJ: folds
CO: folds
BTN: folds
SB: raises $0.04 to $0.06
BB: calls $0.04
*** FLOP *** [Td 8h Jd]
SB: checks
BB: bets $0.06
SB: folds
Uncalled bet ($0.06) returned to BB
BB collected $0.12 from pot
*** SUMMARY ***
Total pot $0.12 | Rake $0
Board [Td 8h Jd]
Seat 1: UTG folded before Flop (didn't bet)
Seat 2: HJ folded before Flop (didn't bet)
Seat 3: CO folded before Flop (didn't bet)
Seat 4: BTN (button) folded before Flop (didn't bet)
Seat 5: SB (small blind) folded on the Flop
Seat 6: BB (big blind) collected ($0.12)


PokerStars Hand #238163056727:  Hold'em No Limit ($0.01/$0.02 USD) - 2022/08/23 4:25:03 ET
Table 'Achilles IV' 6-max Seat #5 is the button
Seat 1: BB ($2.16 in chips)
Seat 2: UTG ($2.58 in chips)
Seat 3: HJ ($2.03 in chips)
Seat 4: CO ($2.69 in chips)
Seat 5: BTN ($1.80 in chips)
Seat 6: SB ($2.07 in chips)
SB: posts small blind $0.01
BB: posts big blind $0.02
*** HOLE CARDS ***
UTG: folds
HJ: raises $0.04 to $0.06
CO: folds
BTN: folds
SB: folds
BB: folds
Uncalled bet ($0.04) returned to HJ
HJ collected $0.05 from pot
*** SUMMARY ***
Total pot $0.05 | Rake $0
Seat 1: BB (big blind) folded before Flop
Seat 2: UTG folded before Flop (didn't bet)
Seat 3: HJ collected ($0.05)
Seat 4: CO folded before Flop (didn't bet)
Seat 5: BTN (button) folded before Flop (didn't bet)
Seat 6: SB (small blind) folded before Flop


PokerStars Hand #238163058971:  Hold'em No Limit ($0.01/$0.02 USD) - 2022/08/23 4:25:20 ET
Table 'Achilles IV' 6-max Seat #6 is the button
Seat 1: SB ($2.14 in chips)
Seat 2: BB ($2.58 in chips)
Seat 3: UTG ($2.06 in chips)
Seat 4: HJ ($2.69 in chips)
Seat 5: CO ($1.80 in chips)
Seat 6: BTN ($2.06 in chips)
SB: posts small blind $0.01
BB: posts big blind $0.02
*** HOLE CARDS ***
UTG: folds
HJ: folds
CO: folds
BTN: folds
SB: folds
Uncalled bet ($0.01) returned to BB
BB collected $0.02 from pot
BB: doesn't show hand
*** SUMMARY ***
Total pot $0.02 | Rake $0
Seat 1: SB (small blind) folded before Flop
Seat 2: BB (big blind) collected ($0.02)
Seat 3: UTG folded before Flop (didn't bet)
Seat 4: HJ folded before Flop (didn't bet)
Seat 5: CO folded before Flop (didn't bet)
Seat 6: BTN (button) folded before Flop (didn't bet)


PokerStars Hand #238163060280:  Hold'em No Limit ($0.01/$0.02 USD) - 2022/08/23 4:25:30 ET
Table 'Achilles IV' 6-max Seat #1 is the button
Seat 1: BTN ($2.13 in chips)
Seat 2: SB ($2.59 in chips)
Seat 3: BB ($2.06 in chips)
Seat 4: UTG ($2.69 in chips)
Seat 5: HJ ($1.80 in chips)
Seat 6: CO ($2.06 in chips)
SB: posts small blind $0.01
BB: posts big blind $0.02
*** HOLE CARDS ***
UTG: folds
HJ: folds
CO: calls $0.02
BTN: raises $0.06 to $0.08
SB: calls $0.07
BB: folds
CO: calls $0.06
*** FLOP *** [2c 3d Kh]
SB: checks
CO: checks
BTN: checks
*** TURN *** [2c 3d Kh] [Tc]
SB: checks
CO: bets $0.12
BTN: calls $0.12
SB: folds
*** RIVER *** [2c 3d Kh Tc] [7c]
CO: checks
BTN: bets $0.32
CO: folds
Uncalled bet ($0.32) returned to BTN
BTN collected $0.48 from pot
BTN: doesn't show hand
*** SUMMARY ***
Total pot $0.50 | Rake $0.02
Board [2c 3d Kh Tc 7c]
Seat 1: BTN (button) collected ($0.48)
Seat 2: SB (small blind) folded on the Turn
Seat 3: BB (big blind) folded before Flop
Seat 4: UTG folded before Flop (didn't bet)
Seat 5: HJ folded before Flop (didn't bet)
Seat 6: CO folded on the River


PokerStars Hand #238163069910:  Hold'em No Limit ($0.01/$0.02 USD) - 2022/08/23 4:26:46 ET
Table 'Achilles IV' 6-max Seat #2 is the button
Seat 1: CO ($2.41 in chips)
Seat 2: BTN ($2.51 in chips)
Seat 3: SB ($2.04 in chips)
Seat 4: BB ($2.69 in chips)
Seat 5: UTG ($1.80 in chips)
Seat 6: HJ ($1.86 in chips)
SB: posts small blind $0.01
BB: posts big blind $0.02
*** HOLE CARDS ***
UTG: folds
HJ: folds
CO: folds
BTN: raises $0.03 to $0.05
HJ leaves the table
SB: folds
BB: folds
Uncalled bet ($0.03) returned to BTN
BTN collected $0.05 from pot
BTN: doesn't show hand
*** SUMMARY ***
Total pot $0.05 | Rake $0
Seat 1: CO folded before Flop (didn't bet)
Seat 2: BTN (button) collected ($0.05)
Seat 3: SB (small blind) folded before Flop
Seat 4: BB (big blind) folded before Flop
Seat 5: UTG folded before Flop (didn't bet)
Seat 6: HJ folded before Flop (didn't bet)


PokerStars Hand #238163072187:  Hold'em No Limit ($0.01/$0.02 USD) - 2022/08/23 4:27:04 ET
Table 'Achilles IV' 6-max Seat #3 is the button
Seat 1: HJ ($2.41 in chips)
Seat 2: CO ($2.54 in chips)
Seat 3: BTN ($2.03 in chips)
Seat 4: SB ($2.67 in chips)
Seat 5: BB ($1.80 in chips)
SB: posts small blind $0.01
BB: posts big blind $0.02
*** HOLE CARDS ***
Daklien_Poke joins the table at seat #6
HJ: folds
CO: folds
BTN: raises $0.03 to $0.05
SB: folds
BB: folds
Uncalled bet ($0.03) returned to BTN
BTN collected $0.05 from pot
*** SUMMARY ***
Total pot $0.05 | Rake $0
Seat 1: HJ folded before Flop (didn't bet)
Seat 2: CO folded before Flop (didn't bet)
Seat 3: BTN (button) collected ($0.05)
Seat 4: SB (small blind) folded before Flop
Seat 5: BB (big blind) folded before Flop


PokerStars Hand #238163080106:  Hold'em No Limit ($0.01/$0.02 USD) - 2022/08/23 4:27:19 ET
Table 'Achilles IV' 6-max Seat #4 is the button
Seat 1: UTG ($2.41 in chips)
Seat 2: HJ ($2.54 in chips)
Seat 3: CO ($2.06 in chips)
Seat 4: BTN ($2.66 in chips)
Seat 5: SB ($1.78 in chips)
Seat 6: BB ($2 in chips)
SB: posts small blind $0.01
BB: posts big blind $0.02
*** HOLE CARDS ***
UTG: folds
HJ: folds
CO: raises $0.04 to $0.06
BTN: calls $0.06
SB: folds
BB: calls $0.04
*** FLOP *** [9d Td Ac]
BB: checks
CO: bets $0.14
BTN: folds
BB: folds
Uncalled bet ($0.14) returned to CO
CO collected $0.18 from pot
*** SUMMARY ***
Total pot $0.19 | Rake $0.01
Board [9d Td Ac]
Seat 1: UTG folded before Flop (didn't bet)
Seat 2: HJ folded before Flop (didn't bet)
Seat 3: CO collected ($0.18)
Seat 4: BTN (button) folded on the Flop
Seat 5: SB (small blind) folded before Flop
Seat 6: BB (big blind) folded on the Flop


PokerStars Hand #238163084096:  Hold'em No Limit ($0.01/$0.02 USD) - 2022/08/23 4:27:50 ET
Table 'Achilles IV' 6-max Seat #5 is the button
Seat 1: BB ($2.41 in chips)
Seat 2: UTG ($2.54 in chips)
Seat 3: HJ ($2.18 in chips)
Seat 4: CO ($2.60 in chips)
Seat 5: BTN ($1.77 in chips)
Seat 6: SB ($1.94 in chips)
SB: posts small blind $0.01
BB: posts big blind $0.02
*** HOLE CARDS ***
UTG: folds
HJ: raises $0.04 to $0.06
CO: folds
BTN: folds
SB: calls $0.05
BB: folds
*** FLOP *** [Ad Qc 4h]
SB: checks
HJ: bets $0.07
SB: calls $0.07
*** TURN *** [Ad Qc 4h] [Jd]
SB: checks
HJ: checks
*** RIVER *** [Ad Qc 4h Jd] [5h]
SB: checks
HJ: checks
*** SHOW DOWN ***
SB: shows [9c 9d] (a pair of Nines)
HJ: mucks hand
SB collected $0.27 from pot
*** SUMMARY ***
Total pot $0.28 | Rake $0.01
Board [Ad Qc 4h Jd 5h]
Seat 1: BB (big blind) folded before Flop
Seat 2: UTG folded before Flop (didn't bet)
Seat 3: HJ mucked
Seat 4: CO folded before Flop (didn't bet)
Seat 5: BTN (button) folded before Flop (didn't bet)
Seat 6: SB (small blind) showed [9c 9d] and won ($0.27) with a pair of Nines


PokerStars Hand #238163089631:  Hold'em No Limit ($0.01/$0.02 USD) - 2022/08/23 4:28:33 ET
Table 'Achilles IV' 6-max Seat #6 is the button
Seat 1: SB ($2.39 in chips)
Seat 2: BB ($2.54 in chips)
Seat 3: UTG ($2.05 in chips)
Seat 4: HJ ($2.60 in chips)
Seat 5: CO ($1.77 in chips)
Seat 6: BTN ($2.08 in chips)
SB: posts small blind $0.01
BB: posts big blind $0.02
*** HOLE CARDS ***
UTG: folds
HJ: raises $0.02 to $0.04
CO: folds
BTN: folds
SB: folds
BB: folds
Uncalled bet ($0.02) returned to HJ
HJ collected $0.05 from pot
*** SUMMARY ***
Total pot $0.05 | Rake $0
Seat 1: SB (small blind) folded before Flop
Seat 2: BB (big blind) folded before Flop
Seat 3: UTG folded before Flop (didn't bet)
Seat 4: HJ collected ($0.05)
Seat 5: CO folded before Flop (didn't bet)
Seat 6: BTN (button) folded before Flop (didn't bet)


PokerStars Hand #238163091778:  Hold'em No Limit ($0.01/$0.02 USD) - 2022/08/23 4:28:49 ET
Table 'Achilles IV' 6-max Seat #1 is the button
Seat 1: BTN ($2.38 in chips)
Seat 2: SB ($2.52 in chips)
Seat 3: BB ($2.05 in chips)
Seat 4: UTG ($2.63 in chips)
Seat 5: HJ ($1.77 in chips)
Seat 6: CO ($2.08 in chips)
SB: posts small blind $0.01
BB: posts big blind $0.02
*** HOLE CARDS ***
UTG: folds
HJ: folds
CO: folds
BTN: raises $0.03 to $0.05
SB: folds
BB: folds
Uncalled bet ($0.03) returned to BTN
BTN collected $0.05 from pot
BTN: doesn't show hand
*** SUMMARY ***
Total pot $0.05 | Rake $0
Seat 1: BTN (button) collected ($0.05)
Seat 2: SB (small blind) folded before Flop
Seat 3: BB (big blind) folded before Flop
Seat 4: UTG folded before Flop (didn't bet)
Seat 5: HJ folded before Flop (didn't bet)
Seat 6: CO folded before Flop (didn't bet)


PokerStars Hand #238163093101:  Hold'em No Limit ($0.01/$0.02 USD) - 2022/08/23 4:28:59 ET
Table 'Achilles IV' 6-max Seat #2 is the button
Seat 1: CO ($2.41 in chips)
Seat 2: BTN ($2.51 in chips)
Seat 3: SB ($2.03 in chips)
Seat 4: BB ($2.63 in chips)
Seat 5: UTG ($1.77 in chips)
Seat 6: HJ ($2.08 in chips)
SB: posts small blind $0.01
BB: posts big blind $0.02
*** HOLE CARDS ***
UTG: folds
HJ: folds
CO: folds
BTN: folds
SB: folds
Uncalled bet ($0.01) returned to BB
BB collected $0.02 from pot
*** SUMMARY ***
Total pot $0.02 | Rake $0
Seat 1: CO folded before Flop (didn't bet)
Seat 2: BTN (button) folded before Flop (didn't bet)
Seat 3: SB (small blind) folded before Flop
Seat 4: BB (big blind) collected ($0.02)
Seat 5: UTG folded before Flop (didn't bet)
Seat 6: HJ folded before Flop (didn't bet)


PokerStars Hand #238163095309:  Hold'em No Limit ($0.01/$0.02 USD) - 2022/08/23 4:29:16 ET
Table 'Achilles IV' 6-max Seat #3 is the button
Seat 1: HJ ($2.41 in chips)
Seat 2: CO ($2.51 in chips)
Seat 3: BTN ($2.02 in chips)
Seat 4: SB ($2.64 in chips)
Seat 5: BB ($1.77 in chips)
Seat 6: UTG ($2.08 in chips)
SB: posts small blind $0.01
BB: posts big blind $0.02
*** HOLE CARDS ***
UTG: folds
HJ: raises $0.04 to $0.06
CO: folds
BTN: folds
SB: folds
BB: folds
Uncalled bet ($0.04) returned to HJ
HJ collected $0.05 from pot
HJ: doesn't show hand
*** SUMMARY ***
Total pot $0.05 | Rake $0
Seat 1: HJ collected ($0.05)
Seat 2: CO folded before Flop (didn't bet)
Seat 3: BTN (button) folded before Flop (didn't bet)
Seat 4: SB (small blind) folded before Flop
Seat 5: BB (big blind) folded before Flop
Seat 6: UTG folded before Flop (didn't bet)


PokerStars Hand #238163097905:  Hold'em No Limit ($0.01/$0.02 USD) - 2022/08/23 4:29:36 ET
Table 'Achilles IV' 6-max Seat #4 is the button
Seat 1: UTG ($2.44 in chips)
Seat 2: HJ ($2.51 in chips)
Seat 3: CO ($2.02 in chips)
Seat 4: BTN ($2.63 in chips)
Seat 5: SB ($1.75 in chips)
Seat 6: BB ($2.08 in chips)
SB: posts small blind $0.01
BB: posts big blind $0.02
*** HOLE CARDS ***
UTG: folds
HJ: folds
CO: folds
BTN: folds
SB: folds
Uncalled bet ($0.01) returned to BB
BB collected $0.02 from pot
BB: doesn't show hand
*** SUMMARY ***
Total pot $0.02 | Rake $0
Seat 1: UTG folded before Flop (didn't bet)
Seat 2: HJ folded before Flop (didn't bet)
Seat 3: CO folded before Flop (didn't bet)
Seat 4: BTN (button) folded before Flop (didn't bet)
Seat 5: SB (small blind) folded before Flop
Seat 6: BB (big blind) collected ($0.02)


PokerStars Hand #238163099685:  Hold'em No Limit ($0.01/$0.02 USD) - 2022/08/23 4:29:49 ET
Table 'Achilles IV' 6-max Seat #5 is the button
Seat 1: BB ($2.44 in chips)
Seat 2: UTG ($2.51 in chips)
Seat 3: HJ ($2.02 in chips)
Seat 4: CO ($2.63 in chips)
Seat 5: BTN ($1.74 in chips)
Seat 6: SB ($2.09 in chips)
SB: posts small blind $0.01
BB: posts big blind $0.02
*** HOLE CARDS ***
UTG: folds
HJ: raises $0.04 to $0.06
CO: folds
BTN: folds
SB: raises $0.16 to $0.22
BB: folds
HJ: folds
Uncalled bet ($0.16) returned to SB
SB collected $0.14 from pot
SB: doesn't show hand
*** SUMMARY ***
Total pot $0.14 | Rake $0
Seat 1: BB (big blind) folded before Flop
Seat 2: UTG folded before Flop (didn't bet)
Seat 3: HJ folded before Flop
Seat 4: CO folded before Flop (didn't bet)
Seat 5: BTN (button) folded before Flop (didn't bet)
Seat 6: SB (small blind) collected ($0.14)


PokerStars Hand #238163103959:  Hold'em No Limit ($0.01/$0.02 USD) - 2022/08/23 4:30:22 ET
Table 'Achilles IV' 6-max Seat #6 is the button
Seat 1: SB ($2.42 in chips)
Seat 2: BB ($2.51 in chips)
Seat 3: UTG ($2 in chips)
Seat 4: HJ ($2.63 in chips)
Seat 5: CO ($1.74 in chips)
Seat 6: BTN ($2.17 in chips)
SB: posts small blind $0.01
BB: posts big blind $0.02
*** HOLE CARDS ***
UTG: folds
HJ: folds
CO: folds
BTN: folds
SB: folds
Uncalled bet ($0.01) returned to BB
BB collected $0.02 from pot
BB: doesn't show hand
*** SUMMARY ***
Total pot $0.02 | Rake $0
Seat 1: SB (small blind) folded before Flop
Seat 2: BB (big blind) collected ($0.02)
Seat 3: UTG folded before Flop (didn't bet)
Seat 4: HJ folded before Flop (didn't bet)
Seat 5: CO folded before Flop (didn't bet)
Seat 6: BTN (button) folded before Flop (didn't bet)


PokerStars Hand #238163105229:  Hold'em No Limit ($0.01/$0.02 USD) - 2022/08/23 4:30:32 ET
Table 'Achilles IV' 6-max Seat #1 is the button
Seat 1: BTN ($2.41 in chips)
Seat 2: SB ($2.52 in chips)
Seat 4: BB ($2.63 in chips)
Seat 5: HJ ($1.74 in chips)
Seat 6: CO ($2.17 in chips)
SB: posts small blind $0.01
Fedorenko26: is sitting out
BB: posts big blind $0.02
*** HOLE CARDS ***
Fedorenko26 leaves the table
HJ: folds
CO: folds
BTN: raises $0.03 to $0.05
SB: folds
BB: calls $0.03
*** FLOP *** [3h Jh Qc]
Fran1809 joins the table at seat #3
BB: checks
BTN: bets $0.07
BB: calls $0.07
*** TURN *** [3h Jh Qc] [4d]
BB: checks
BTN: checks
*** RIVER *** [3h Jh Qc 4d] [6c]
BB: bets $0.14
BTN: folds
Uncalled bet ($0.14) returned to BB
BB collected $0.24 from pot
*** SUMMARY ***
Total pot $0.25 | Rake $0.01
Board [3h Jh Qc 4d 6c]
Seat 1: BTN (button) folded on the River
Seat 2: SB (small blind) folded before Flop
Seat 4: BB (big blind) collected ($0.24)
Seat 5: HJ folded before Flop (didn't bet)
Seat 6: CO folded before Flop (didn't bet)


PokerStars Hand #238163112901:  Hold'em No Limit ($0.01/$0.02 USD) - 2022/08/23 4:31:32 ET
Table 'Achilles IV' 6-max Seat #4 is the button
Seat 1: HJ ($2.29 in chips)
Seat 2: CO ($2.54 in chips)
Seat 4: BTN ($2.74 in chips)
Seat 5: SB ($1.72 in chips)
Seat 6: BB ($2.17 in chips)
SB: posts small blind $0.01
BB: posts big blind $0.02
Fran1809: sits out
*** HOLE CARDS ***
HJ: raises $0.04 to $0.06
CO: folds
BTN: folds
SB: folds
BB: folds
Uncalled bet ($0.04) returned to HJ
HJ collected $0.05 from pot
HJ: doesn't show hand
*** SUMMARY ***
Total pot $0.05 | Rake $0
Seat 1: HJ collected ($0.05)
Seat 2: CO folded before Flop (didn't bet)
Seat 4: BTN (button) folded before Flop (didn't bet)
Seat 5: SB (small blind) folded before Flop
Seat 6: BB (big blind) folded before Flop


PokerStars Hand #238163111494:  Hold'em No Limit ($0.01/$0.02 USD) - 2022/08/23 4:31:21 ET
Table 'Achilles IV' 6-max Seat #2 is the button
Seat 1: CO ($2.29 in chips)
Seat 2: BTN ($2.51 in chips)
Seat 4: SB ($2.75 in chips)
Seat 5: BB ($1.74 in chips)
Seat 6: HJ ($2.17 in chips)
SB: posts small blind $0.01
BB: posts big blind $0.02
*** HOLE CARDS ***
HJ: folds
CO: folds
BTN: raises $0.03 to $0.05
SB: folds
BB: folds
Uncalled bet ($0.03) returned to BTN
BTN collected $0.05 from pot
BTN: doesn't show hand
*** SUMMARY ***
Total pot $0.05 | Rake $0
Seat 1: CO folded before Flop (didn't bet)
Seat 2: BTN (button) collected ($0.05)
Seat 4: SB (small blind) folded before Flop
Seat 5: BB (big blind) folded before Flop
Seat 6: HJ folded before Flop (didn't bet)


PokerStars Hand #238163114219:  Hold'em No Limit ($0.01/$0.02 USD) - 2022/08/23 4:31:43 ET
Table 'Achilles IV' 6-max Seat #5 is the button
Seat 1: BB ($2.32 in chips)
Seat 2: HJ ($2.54 in chips)
Seat 4: CO ($2.74 in chips)
Seat 5: BTN ($1.71 in chips)
Seat 6: SB ($2.15 in chips)
SB: posts small blind $0.01
BB: posts big blind $0.02
Fran1809: sits out
*** HOLE CARDS ***
HJ: folds
CO: folds
BTN: folds
SB: folds
Uncalled bet ($0.01) returned to BB
BB collected $0.02 from pot
BB: doesn't show hand
*** SUMMARY ***
Total pot $0.02 | Rake $0
Seat 1: BB (big blind) collected ($0.02)
Seat 2: HJ folded before Flop (didn't bet)
Seat 4: CO folded before Flop (didn't bet)
Seat 5: BTN (button) folded before Flop (didn't bet)
Seat 6: SB (small blind) folded before Flop


PokerStars Hand #238163115667:  Hold'em No Limit ($0.01/$0.02 USD) - 2022/08/23 4:31:54 ET
Table 'Achilles IV' 6-max Seat #6 is the button
Seat 1: SB ($2.33 in chips)
Seat 2: BB ($2.54 in chips)
Seat 4: HJ ($2.74 in chips)
Seat 5: CO ($1.71 in chips)
Seat 6: BTN ($2.14 in chips)
SB: posts small blind $0.01
BB: posts big blind $0.02
Fran1809: sits out
*** HOLE CARDS ***
HJ: folds
CO: raises $0.04 to $0.06
BTN: folds
SB: folds
BB: folds
Uncalled bet ($0.04) returned to CO
CO collected $0.05 from pot
*** SUMMARY ***
Total pot $0.05 | Rake $0
Seat 1: SB (small blind) folded before Flop
Seat 2: BB (big blind) folded before Flop
Seat 4: HJ folded before Flop (didn't bet)
Seat 5: CO collected ($0.05)
Seat 6: BTN (button) folded before Flop (didn't bet)


PokerStars Hand #238163117732:  Hold'em No Limit ($0.01/$0.02 USD) - 2022/08/23 4:32:10 ET
Table 'Achilles IV' 6-max Seat #1 is the button
Seat 1: BTN ($2.32 in chips)
Seat 2: SB ($2.52 in chips)
Seat 3: BB ($1.60 in chips)
Seat 4: UTG ($2.74 in chips)
Seat 5: HJ ($1.74 in chips)
Seat 6: CO ($2.14 in chips)
SB: posts small blind $0.01
BB: posts big blind $0.02
*** HOLE CARDS ***
UTG: folds
HJ: folds
CO: folds
BTN: folds
SB: folds
Uncalled bet ($0.01) returned to BB
BB collected $0.02 from pot
*** SUMMARY ***
Total pot $0.02 | Rake $0
Seat 1: BTN (button) folded before Flop (didn't bet)
Seat 2: SB (small blind) folded before Flop
Seat 3: BB (big blind) collected ($0.02)
Seat 4: UTG folded before Flop (didn't bet)
Seat 5: HJ folded before Flop (didn't bet)
Seat 6: CO folded before Flop (didn't bet)


PokerStars Hand #238163121509:  Hold'em No Limit ($0.01/$0.02 USD) - 2022/08/23 4:32:40 ET
Table 'Achilles IV' 6-max Seat #2 is the button
Seat 1: CO ($2.32 in chips)
Seat 2: BTN ($2.51 in chips)
Seat 3: SB ($1.61 in chips)
Seat 4: BB ($2.74 in chips)
Seat 5: UTG ($1.74 in chips)
Seat 6: HJ ($2.14 in chips)
SB: posts small blind $0.01
BB: posts big blind $0.02
*** HOLE CARDS ***
UTG: raises $0.04 to $0.06
HJ: folds
CO: calls $0.06
BTN: folds
SB: folds
BB: raises $0.14 to $0.20
UTG: folds
CO: calls $0.14
*** FLOP *** [Jc 5s Kh]
BB: bets $0.22
CO: calls $0.22
*** TURN *** [Jc 5s Kh] [Th]
BB: bets $0.88
CO: folds
Uncalled bet ($0.88) returned to BB
BB collected $0.88 from pot
*** SUMMARY ***
Total pot $0.91 | Rake $0.03
Board [Jc 5s Kh Th]
Seat 1: CO folded on the Turn
Seat 2: BTN (button) folded before Flop (didn't bet)
Seat 3: SB (small blind) folded before Flop
Seat 4: BB (big blind) collected ($0.88)
Seat 5: UTG folded before Flop
Seat 6: HJ folded before Flop (didn't bet)


PokerStars Hand #238163132062:  Hold'em No Limit ($0.01/$0.02 USD) - 2022/08/23 4:34:03 ET
Table 'Achilles IV' 6-max Seat #3 is the button
Seat 1: HJ ($2 in chips)
Seat 2: CO ($2.51 in chips)
Seat 3: BTN ($1.60 in chips)
Seat 4: SB ($3.20 in chips)
Seat 5: BB ($1.68 in chips)
Seat 6: UTG ($2.14 in chips)
SB: posts small blind $0.01
BB: posts big blind $0.02
*** HOLE CARDS ***
UTG: folds
HJ: folds
CO: folds
BTN: calls $0.02
SB: folds
BB: checks
*** FLOP *** [8h Jc 7h]
BB: checks
BTN: checks
*** TURN *** [8h Jc 7h] [2d]
BB: checks
BTN: checks
*** RIVER *** [8h Jc 7h 2d] [8c]
BB: checks
BTN: bets $0.05
BB: folds
Uncalled bet ($0.05) returned to BTN
BTN collected $0.05 from pot
*** SUMMARY ***
Total pot $0.05 | Rake $0
Board [8h Jc 7h 2d 8c]
Seat 1: HJ folded before Flop (didn't bet)
Seat 2: CO folded before Flop (didn't bet)
Seat 3: BTN (button) collected ($0.05)
Seat 4: SB (small blind) folded before Flop
Seat 5: BB (big blind) folded on the River
Seat 6: UTG folded before Flop (didn't bet)


PokerStars Hand #238163136110:  Hold'em No Limit ($0.01/$0.02 USD) - 2022/08/23 4:34:35 ET
Table 'Achilles IV' 6-max Seat #4 is the button
Seat 1: UTG ($2 in chips)
Seat 2: HJ ($2.51 in chips)
Seat 3: CO ($1.63 in chips)
Seat 4: BTN ($3.19 in chips)
Seat 5: SB ($1.66 in chips)
Seat 6: BB ($2.14 in chips)
SB: posts small blind $0.01
BB: posts big blind $0.02
*** HOLE CARDS ***
UTG: folds
HJ: folds
CO: calls $0.02
BTN: folds
SB: calls $0.01
BB: checks
*** FLOP *** [3d Jh 9h]
SB: checks
BB: checks
CO: checks
*** TURN *** [3d Jh 9h] [2c]
SB: checks
BB: bets $0.05
CO: folds
SB: folds
Uncalled bet ($0.05) returned to BB
BB collected $0.06 from pot
BB: doesn't show hand
*** SUMMARY ***
Total pot $0.06 | Rake $0
Board [3d Jh 9h 2c]
Seat 1: UTG folded before Flop (didn't bet)
Seat 2: HJ folded before Flop (didn't bet)
Seat 3: CO folded on the Turn
Seat 4: BTN (button) folded before Flop (didn't bet)
Seat 5: SB (small blind) folded on the Turn
Seat 6: BB (big blind) collected ($0.06)


PokerStars Hand #238163140419:  Hold'em No Limit ($0.01/$0.02 USD) - 2022/08/23 4:35:08 ET
Table 'Achilles IV' 6-max Seat #5 is the button
Seat 1: BB ($2 in chips)
Seat 2: UTG ($2.51 in chips)
Seat 3: HJ ($1.61 in chips)
Seat 4: CO ($3.19 in chips)
Seat 5: BTN ($1.64 in chips)
Seat 6: SB ($2.18 in chips)
SB: posts small blind $0.01
BB: posts big blind $0.02
*** HOLE CARDS ***
UTG: folds
HJ: folds
CO: calls $0.02
BTN: raises $0.04 to $0.06
SB: folds
BB: calls $0.04
CO: calls $0.04
*** FLOP *** [5d Qs 8h]
BB: checks
CO: checks
BTN: bets $0.09
BB: calls $0.09
CO: folds
*** TURN *** [5d Qs 8h] [7c]
BB: checks
BTN: bets $0.18
BB: calls $0.18
*** RIVER *** [5d Qs 8h 7c] [3c]
BB: checks
BTN: bets $0.25
BB: calls $0.25
*** SHOW DOWN ***
BTN: shows [Ah Ad] (a pair of Aces)
BB: mucks hand
BTN collected $1.19 from pot
*** SUMMARY ***
Total pot $1.23 | Rake $0.04
Board [5d Qs 8h 7c 3c]
Seat 1: BB (big blind) mucked
Seat 2: UTG folded before Flop (didn't bet)
Seat 3: HJ folded before Flop (didn't bet)
Seat 4: CO folded on the Flop
Seat 5: BTN (button) showed [Ah Ad] and won ($1.19) with a pair of Aces
Seat 6: SB (small blind) folded before Flop


PokerStars Hand #238163151383:  Hold'em No Limit ($0.01/$0.02 USD) - 2022/08/23 4:36:33 ET
Table 'Achilles IV' 6-max Seat #6 is the button
Seat 1: SB ($2 in chips)
Seat 2: BB ($2.51 in chips)
Seat 3: UTG ($1.61 in chips)
Seat 4: HJ ($3.13 in chips)
Seat 5: CO ($2.25 in chips)
Seat 6: BTN ($2.17 in chips)
SB: posts small blind $0.01
BB: posts big blind $0.02
*** HOLE CARDS ***
UTG: calls $0.02
HJ: folds
CO: folds
BTN: folds
SB: folds
BB: checks
*** FLOP *** [3s 9s 2h]
BB: checks
SB leaves the table
UTG: checks
*** TURN *** [3s 9s 2h] [5h]
BB: checks
UTG: bets $0.05
hilarjo joins the table at seat #1
BB: folds
Uncalled bet ($0.05) returned to UTG
UTG collected $0.05 from pot
*** SUMMARY ***
Total pot $0.05 | Rake $0
Board [3s 9s 2h 5h]
Seat 1: SB (small blind) folded before Flop
Seat 2: BB (big blind) folded on the Turn
Seat 3: UTG collected ($0.05)
Seat 4: HJ folded before Flop (didn't bet)
Seat 5: CO folded before Flop (didn't bet)
Seat 6: BTN (button) folded before Flop (didn't bet)


PokerStars Hand #238163157482:  Hold'em No Limit ($0.01/$0.02 USD) - 2022/08/23 4:37:21 ET
Table 'Achilles IV' 6-max Seat #2 is the button
Seat 2: BTN ($2.49 in chips)
Seat 3: SB ($1.64 in chips)
Seat 4: BB ($3.13 in chips)
Seat 5: HJ ($2.25 in chips)
Seat 6: CO ($2.17 in chips)
SB: posts small blind $0.01
BB: posts big blind $0.02
hilarjo: sits out
*** HOLE CARDS ***
HJ: raises $0.04 to $0.06
CO: folds
BTN: folds
SB: calls $0.05
BB: folds
*** FLOP *** [9c 5d Jh]
SB: checks
HJ: bets $0.07
SB: folds
Uncalled bet ($0.07) returned to HJ
HJ collected $0.14 from pot
*** SUMMARY ***
Total pot $0.14 | Rake $0
Board [9c 5d Jh]
Seat 2: BTN (button) folded before Flop (didn't bet)
Seat 3: SB (small blind) folded on the Flop
Seat 4: BB (big blind) folded before Flop
Seat 5: HJ collected ($0.14)
Seat 6: CO folded before Flop (didn't bet)


PokerStars Hand #238163162221:  Hold'em No Limit ($0.01/$0.02 USD) - 2022/08/23 4:37:57 ET
Table 'Achilles IV' 6-max Seat #4 is the button
Seat 2: HJ ($2.52 in chips)
Seat 3: CO ($1.58 in chips)
Seat 4: BTN ($3.10 in chips)
Seat 5: SB ($2.31 in chips)
Seat 6: BB ($2.17 in chips)
SB: posts small blind $0.01
BB: posts big blind $0.02
hilarjo: sits out
*** HOLE CARDS ***
HJ: raises $0.03 to $0.05
CO: folds
BTN: folds
SB: folds
BB: folds
Uncalled bet ($0.03) returned to HJ
HJ collected $0.05 from pot
HJ: doesn't show hand
*** SUMMARY ***
Total pot $0.05 | Rake $0
Seat 2: HJ collected ($0.05)
Seat 3: CO folded before Flop (didn't bet)
Seat 4: BTN (button) folded before Flop (didn't bet)
Seat 5: SB (small blind) folded before Flop
Seat 6: BB (big blind) folded before Flop


PokerStars Hand #238163160959:  Hold'em No Limit ($0.01/$0.02 USD) - 2022/08/23 4:37:47 ET
Table 'Achilles IV' 6-max Seat #3 is the button
Seat 2: CO ($2.49 in chips)
Seat 3: BTN ($1.58 in chips)
Seat 4: SB ($3.11 in chips)
Seat 5: BB ($2.33 in chips)
Seat 6: HJ ($2.17 in chips)
SB: posts small blind $0.01
BB: posts big blind $0.02
hilarjo: sits out
*** HOLE CARDS ***
HJ: folds
CO: raises $0.03 to $0.05
BTN: folds
SB: folds
BB: folds
Uncalled bet ($0.03) returned to CO
CO collected $0.05 from pot
CO: doesn't show hand
*** SUMMARY ***
Total pot $0.05 | Rake $0
Seat 2: CO collected ($0.05)
Seat 3: BTN (button) folded before Flop (didn't bet)
Seat 4: SB (small blind) folded before Flop
Seat 5: BB (big blind) folded before Flop
Seat 6: HJ folded before Flop (didn't bet)


PokerStars Hand #238163163544:  Hold'em No Limit ($0.01/$0.02 USD) - 2022/08/23 4:38:07 ET
Table 'Achilles IV' 6-max Seat #5 is the button
Seat 1: BB ($2 in chips)
Seat 2: UTG ($2.55 in chips)
Seat 3: HJ ($1.58 in chips)
Seat 4: CO ($3.10 in chips)
Seat 5: BTN ($2.30 in chips)
Seat 6: SB ($2.15 in chips)
SB: posts small blind $0.01
BB: posts big blind $0.02
*** HOLE CARDS ***
UTG: folds
HJ: calls $0.02
CO: folds
BTN: raises $0.06 to $0.08
SB: folds
BB: folds
HJ: calls $0.06
*** FLOP *** [8h 4h Qd]
HJ: checks
BTN: bets $0.09
HJ: folds
Uncalled bet ($0.09) returned to BTN
BTN collected $0.18 from pot
*** SUMMARY ***
Total pot $0.19 | Rake $0.01
Board [8h 4h Qd]
Seat 1: BB (big blind) folded before Flop
Seat 2: UTG folded before Flop (didn't bet)
Seat 3: HJ folded on the Flop
Seat 4: CO folded before Flop (didn't bet)
Seat 5: BTN (button) collected ($0.18)
Seat 6: SB (small blind) folded before Flop


PokerStars Hand #238163168052:  Hold'em No Limit ($0.01/$0.02 USD) - 2022/08/23 4:38:42 ET
Table 'Achilles IV' 6-max Seat #6 is the button
Seat 1: SB ($2 in chips)
Seat 2: BB ($2.55 in chips)
Seat 3: UTG ($1.50 in chips)
Seat 4: HJ ($3.10 in chips)
Seat 5: CO ($2.40 in chips)
Seat 6: BTN ($2.14 in chips)
SB: posts small blind $0.01
BB: posts big blind $0.02
*** HOLE CARDS ***
UTG: folds
HJ: folds
CO: folds
BTN: folds
SB: raises $0.04 to $0.06
BB: folds
Uncalled bet ($0.04) returned to SB
SB collected $0.04 from pot
SB: doesn't show hand
*** SUMMARY ***
Total pot $0.04 | Rake $0
Seat 1: SB (small blind) collected ($0.04)
Seat 2: BB (big blind) folded before Flop
Seat 3: UTG folded before Flop (didn't bet)
Seat 4: HJ folded before Flop (didn't bet)
Seat 5: CO folded before Flop (didn't bet)
Seat 6: BTN (button) folded before Flop (didn't bet)


PokerStars Hand #238163169525:  Hold'em No Limit ($0.01/$0.02 USD) - 2022/08/23 4:38:53 ET
Table 'Achilles IV' 6-max Seat #1 is the button
Seat 1: BTN ($2.02 in chips)
Seat 2: SB ($2.53 in chips)
Seat 3: BB ($1.50 in chips)
Seat 4: UTG ($3.10 in chips)
Seat 5: HJ ($2.40 in chips)
Seat 6: CO ($2.14 in chips)
SB: posts small blind $0.01
BB: posts big blind $0.02
*** HOLE CARDS ***
UTG: raises $0.02 to $0.04
HJ: folds
CO: folds
BTN: folds
SB: folds
BB: calls $0.02
*** FLOP *** [Qc Qs 4h]
BB: checks
UTG: bets $0.04
BB: calls $0.04
*** TURN *** [Qc Qs 4h] [Qd]
BB: checks
UTG: bets $0.08
BB: calls $0.08
*** RIVER *** [Qc Qs 4h Qd] [Ac]
BB: checks
UTG: checks
*** SHOW DOWN ***
BB: shows [Jc Js] (a full house, Queens full of Jacks)
UTG: mucks hand
BB collected $0.32 from pot
*** SUMMARY ***
Total pot $0.33 | Rake $0.01
Board [Qc Qs 4h Qd Ac]
Seat 1: BTN (button) folded before Flop (didn't bet)
Seat 2: SB (small blind) folded before Flop
Seat 3: BB (big blind) showed [Jc Js] and won ($0.32) with a full house, Queens full of Jacks
Seat 4: UTG mucked
Seat 5: HJ folded before Flop (didn't bet)
Seat 6: CO folded before Flop (didn't bet)


PokerStars Hand #238163176566:  Hold'em No Limit ($0.01/$0.02 USD) - 2022/08/23 4:39:48 ET
Table 'Achilles IV' 6-max Seat #2 is the button
Seat 1: CO ($2.02 in chips)
Seat 2: BTN ($2.52 in chips)
Seat 3: SB ($1.66 in chips)
Seat 4: BB ($2.94 in chips)
Seat 5: UTG ($2.40 in chips)
Seat 6: HJ ($2.14 in chips)
SB: posts small blind $0.01
BB: posts big blind $0.02
*** HOLE CARDS ***
UTG: folds
HJ: raises $0.03 to $0.05
CO: folds
BTN: folds
SB: calls $0.04
BB: folds
*** FLOP *** [Qc 8d Td]
SB: checks
HJ: bets $0.05
SB: calls $0.05
*** TURN *** [Qc 8d Td] [3d]
SB: checks
HJ: bets $0.09
SB: calls $0.09
*** RIVER *** [Qc 8d Td 3d] [Js]
SB: bets $0.19
HJ: folds
Uncalled bet ($0.19) returned to SB
SB collected $0.39 from pot
*** SUMMARY ***
Total pot $0.40 | Rake $0.01
Board [Qc 8d Td 3d Js]
Seat 1: CO folded before Flop (didn't bet)
Seat 2: BTN (button) folded before Flop (didn't bet)
Seat 3: SB (small blind) collected ($0.39)
Seat 4: BB (big blind) folded before Flop
Seat 5: UTG folded before Flop (didn't bet)
Seat 6: HJ folded on the River


PokerStars Hand #238163187171:  Hold'em No Limit ($0.01/$0.02 USD) - 2022/08/23 4:41:08 ET
Table 'Achilles IV' 6-max Seat #3 is the button
Seat 1: HJ ($2.02 in chips)
Seat 2: CO ($2.52 in chips)
Seat 3: BTN ($1.86 in chips)
Seat 4: SB ($2.92 in chips)
Seat 5: BB ($2.40 in chips)
Seat 6: UTG ($1.95 in chips)
SB: posts small blind $0.01
BB: posts big blind $0.02
*** HOLE CARDS ***
UTG: raises $0.03 to $0.05
HJ: folds
CO: folds
BTN: folds
SB: folds
BB: folds
Uncalled bet ($0.03) returned to UTG
UTG collected $0.05 from pot
UTG: doesn't show hand
*** SUMMARY ***
Total pot $0.05 | Rake $0
Seat 1: HJ folded before Flop (didn't bet)
Seat 2: CO folded before Flop (didn't bet)
Seat 3: BTN (button) folded before Flop (didn't bet)
Seat 4: SB (small blind) folded before Flop
Seat 5: BB (big blind) folded before Flop
Seat 6: UTG collected ($0.05)


PokerStars Hand #238163189135:  Hold'em No Limit ($0.01/$0.02 USD) - 2022/08/23 4:41:22 ET
Table 'Achilles IV' 6-max Seat #4 is the button
Seat 1: UTG ($2.02 in chips)
Seat 2: HJ ($2.52 in chips)
Seat 3: CO ($1.86 in chips)
Seat 4: BTN ($2.91 in chips)
Seat 5: SB ($2.38 in chips)
Seat 6: BB ($1.98 in chips)
SB: posts small blind $0.01
BB: posts big blind $0.02
*** HOLE CARDS ***
UTG: folds
HJ: folds
CO: calls $0.02
BTN: folds
SB: calls $0.01
BB: checks
*** FLOP *** [6h Qh 3d]
SB: checks
BB: checks
CO: checks
*** TURN *** [6h Qh 3d] [5h]
SB: checks
BB: bets $0.05
CO: folds
SB: folds
Uncalled bet ($0.05) returned to BB
BB collected $0.06 from pot
BB: doesn't show hand
*** SUMMARY ***
Total pot $0.06 | Rake $0
Board [6h Qh 3d 5h]
Seat 1: UTG folded before Flop (didn't bet)
Seat 2: HJ folded before Flop (didn't bet)
Seat 3: CO folded on the Turn
Seat 4: BTN (button) folded before Flop (didn't bet)
Seat 5: SB (small blind) folded on the Turn
Seat 6: BB (big blind) collected ($0.06)


PokerStars Hand #238163194552:  Hold'em No Limit ($0.01/$0.02 USD) - 2022/08/23 4:42:03 ET
Table 'Achilles IV' 6-max Seat #5 is the button
Seat 1: BB ($2.02 in chips)
Seat 2: UTG ($2.52 in chips)
Seat 3: HJ ($1.84 in chips)
Seat 4: CO ($2.91 in chips)
Seat 5: BTN ($2.36 in chips)
Seat 6: SB ($2.02 in chips)
SB: posts small blind $0.01
BB: posts big blind $0.02
*** HOLE CARDS ***
UTG: folds
HJ: calls $0.02
CO: folds
BTN: folds
SB: folds
BB: checks
*** FLOP *** [Jc Kd Qs]
BB: checks
HJ: bets $0.02
BB: calls $0.02
*** TURN *** [Jc Kd Qs] [9d]
BB: checks
HJ: checks
*** RIVER *** [Jc Kd Qs 9d] [6h]
BB: checks
HJ: checks
*** SHOW DOWN ***
BB: shows [Qh 8d] (a pair of Queens)
HJ: shows [Qc 4s] (a pair of Queens)
BB collected $0.05 from pot
HJ collected $0.04 from pot
*** SUMMARY ***
Total pot $0.09 | Rake $0
Board [Jc Kd Qs 9d 6h]
Seat 1: BB (big blind) showed [Qh 8d] and won ($0.05) with a pair of Queens
Seat 2: UTG folded before Flop (didn't bet)
Seat 3: HJ showed [Qc 4s] and won ($0.04) with a pair of Queens
Seat 4: CO folded before Flop (didn't bet)
Seat 5: BTN (button) folded before Flop (didn't bet)
Seat 6: SB (small blind) folded before Flop


PokerStars Hand #238163198789:  Hold'em No Limit ($0.01/$0.02 USD) - 2022/08/23 4:42:35 ET
Table 'Achilles IV' 6-max Seat #6 is the button
Seat 1: SB ($2.03 in chips)
Seat 2: BB ($2.52 in chips)
Seat 3: UTG ($1.84 in chips)
Seat 4: HJ ($2.91 in chips)
Seat 5: CO ($2.36 in chips)
Seat 6: BTN ($2.01 in chips)
SB: posts small blind $0.01
BB: posts big blind $0.02
*** HOLE CARDS ***
UTG: calls $0.02
HJ: folds
CO: folds
BTN: folds
SB: calls $0.01
BB: raises $0.06 to $0.08
UTG: folds
SB: folds
Uncalled bet ($0.06) returned to BB
BB collected $0.06 from pot
BB: doesn't show hand
*** SUMMARY ***
Total pot $0.06 | Rake $0
Seat 1: SB (small blind) folded before Flop
Seat 2: BB (big blind) collected ($0.06)
Seat 3: UTG folded before Flop
Seat 4: HJ folded before Flop (didn't bet)
Seat 5: CO folded before Flop (didn't bet)
Seat 6: BTN (button) folded before Flop (didn't bet)


PokerStars Hand #238163202784:  Hold'em No Limit ($0.01/$0.02 USD) - 2022/08/23 4:43:05 ET
Table 'Achilles IV' 6-max Seat #1 is the button
Seat 1: BTN ($2.01 in chips)
Seat 2: SB ($2.56 in chips)
Seat 3: BB ($1.82 in chips)
Seat 4: UTG ($2.91 in chips)
Seat 5: HJ ($2.36 in chips)
Seat 6: CO ($2.01 in chips)
SB: posts small blind $0.01
BB: posts big blind $0.02
*** HOLE CARDS ***
UTG: raises $0.04 to $0.06
HJ: folds
CO: folds
BTN: folds
SB: folds
BB: calls $0.04
*** FLOP *** [5h Qh 4s]
BB: checks
UTG: bets $0.06
BB: folds
Uncalled bet ($0.06) returned to UTG
UTG collected $0.13 from pot
*** SUMMARY ***
Total pot $0.13 | Rake $0
Board [5h Qh 4s]
Seat 1: BTN (button) folded before Flop (didn't bet)
Seat 2: SB (small blind) folded before Flop
Seat 3: BB (big blind) folded on the Flop
Seat 4: UTG collected ($0.13)
Seat 5: HJ folded before Flop (didn't bet)
Seat 6: CO folded before Flop (didn't bet)


PokerStars Hand #238163207165:  Hold'em No Limit ($0.01/$0.02 USD) - 2022/08/23 4:43:38 ET
Table 'Achilles IV' 6-max Seat #2 is the button
Seat 1: CO ($2.01 in chips)
Seat 2: BTN ($2.55 in chips)
Seat 3: SB ($1.76 in chips)
Seat 4: BB ($2.98 in chips)
Seat 5: UTG ($2.36 in chips)
Seat 6: HJ ($2.01 in chips)
SB: posts small blind $0.01
BB: posts big blind $0.02
*** HOLE CARDS ***
UTG: folds
HJ: folds
CO: raises $0.04 to $0.06
BTN: calls $0.06
SB: folds
BB: calls $0.04
*** FLOP *** [8s Tc Kc]
BB: checks
CO: checks
BTN: checks
*** TURN *** [8s Tc Kc] [6c]
BB: bets $0.07
CO: folds
BTN: folds
Uncalled bet ($0.07) returned to BB
BB collected $0.18 from pot
*** SUMMARY ***
Total pot $0.19 | Rake $0.01
Board [8s Tc Kc 6c]
Seat 1: CO folded on the Turn
Seat 2: BTN (button) folded on the Turn
Seat 3: SB (small blind) folded before Flop
Seat 4: BB (big blind) collected ($0.18)
Seat 5: UTG folded before Flop (didn't bet)
Seat 6: HJ folded before Flop (didn't bet)


PokerStars Hand #238163213657:  Hold'em No Limit ($0.01/$0.02 USD) - 2022/08/23 4:44:26 ET
Table 'Achilles IV' 6-max Seat #3 is the button
Seat 1: HJ ($2 in chips)
Seat 2: CO ($2.49 in chips)
Seat 3: BTN ($1.75 in chips)
Seat 4: SB ($3.10 in chips)
Seat 5: BB ($2.36 in chips)
Seat 6: UTG ($2.01 in chips)
SB: posts small blind $0.01
BB: posts big blind $0.02
*** HOLE CARDS ***
UTG: folds
HJ: folds
CO: folds
BTN: folds
SB: folds
Uncalled bet ($0.01) returned to BB
BB collected $0.02 from pot
*** SUMMARY ***
Total pot $0.02 | Rake $0
Seat 1: HJ folded before Flop (didn't bet)
Seat 2: CO folded before Flop (didn't bet)
Seat 3: BTN (button) folded before Flop (didn't bet)
Seat 4: SB (small blind) folded before Flop
Seat 5: BB (big blind) collected ($0.02)
Seat 6: UTG folded before Flop (didn't bet)


PokerStars Hand #238163214681:  Hold'em No Limit ($0.01/$0.02 USD) - 2022/08/23 4:44:34 ET
Table 'Achilles IV' 6-max Seat #4 is the button
Seat 1: UTG ($2 in chips)
Seat 2: HJ ($2.49 in chips)
Seat 3: CO ($1.75 in chips)
Seat 4: BTN ($3.09 in chips)
Seat 5: SB ($2.37 in chips)
Seat 6: BB ($2.01 in chips)
SB: posts small blind $0.01
BB: posts big blind $0.02
*** HOLE CARDS ***
UTG: folds
HJ: folds
CO: folds
BTN: folds
SB: folds
Uncalled bet ($0.01) returned to BB
BB collected $0.02 from pot
BB: doesn't show hand
*** SUMMARY ***
Total pot $0.02 | Rake $0
Seat 1: UTG folded before Flop (didn't bet)
Seat 2: HJ folded before Flop (didn't bet)
Seat 3: CO folded before Flop (didn't bet)
Seat 4: BTN (button) folded before Flop (didn't bet)
Seat 5: SB (small blind) folded before Flop
Seat 6: BB (big blind) collected ($0.02)


PokerStars Hand #238163218022:  Hold'em No Limit ($0.01/$0.02 USD) - 2022/08/23 4:44:58 ET
Table 'Achilles IV' 6-max Seat #5 is the button
Seat 1: BB ($2 in chips)
Seat 2: UTG ($2.49 in chips)
Seat 3: HJ ($1.75 in chips)
Seat 4: CO ($3.09 in chips)
Seat 5: BTN ($2.36 in chips)
Seat 6: SB ($2.02 in chips)
SB: posts small blind $0.01
BB: posts big blind $0.02
*** HOLE CARDS ***
UTG: folds
HJ: calls $0.02
CO: folds
BTN: folds
SB: folds
BB: checks
*** FLOP *** [3c Qs 4d]
BB: checks
HJ: bets $0.02
BB: calls $0.02
*** TURN *** [3c Qs 4d] [Jd]
BB: checks
HJ: bets $0.09
BB: folds
Uncalled bet ($0.09) returned to HJ
HJ collected $0.09 from pot
*** SUMMARY ***
Total pot $0.09 | Rake $0
Board [3c Qs 4d Jd]
Seat 1: BB (big blind) folded on the Turn
Seat 2: UTG folded before Flop (didn't bet)
Seat 3: HJ collected ($0.09)
Seat 4: CO folded before Flop (didn't bet)
Seat 5: BTN (button) folded before Flop (didn't bet)
Seat 6: SB (small blind) folded before Flop


PokerStars Hand #238163223050:  Hold'em No Limit ($0.01/$0.02 USD) - 2022/08/23 4:45:36 ET
Table 'Achilles IV' 6-max Seat #6 is the button
Seat 1: SB ($2 in chips)
Seat 2: BB ($2.49 in chips)
Seat 3: UTG ($1.80 in chips)
Seat 4: HJ ($3.09 in chips)
Seat 5: CO ($2.36 in chips)
Seat 6: BTN ($2.01 in chips)
SB: posts small blind $0.01
BB: posts big blind $0.02
*** HOLE CARDS ***
UTG: calls $0.02
HJ: raises $0.02 to $0.04
CO: folds
BTN: folds
SB: folds
BB: folds
UTG: calls $0.02
*** FLOP *** [Qs Ad 3s]
UTG: checks
HJ: bets $0.05
UTG: calls $0.05
*** TURN *** [Qs Ad 3s] [7c]
UTG: checks
HJ: checks
*** RIVER *** [Qs Ad 3s 7c] [9d]
UTG: bets $0.20
HJ: calls $0.20
*** SHOW DOWN ***
UTG: shows [6s 5s] (high card Ace)
HJ: shows [Jd Qh] (a pair of Queens)
HJ collected $0.59 from pot
*** SUMMARY ***
Total pot $0.61 | Rake $0.02
Board [Qs Ad 3s 7c 9d]
Seat 1: SB (small blind) folded before Flop
Seat 2: BB (big blind) folded before Flop
Seat 3: UTG showed [6s 5s] and lost with high card Ace
Seat 4: HJ showed [Jd Qh] and won ($0.59) with a pair of Queens
Seat 5: CO folded before Flop (didn't bet)
Seat 6: BTN (button) folded before Flop (didn't bet)


PokerStars Hand #238163232370:  Hold'em No Limit ($0.01/$0.02 USD) - 2022/08/23 4:46:44 ET
Table 'Achilles IV' 6-max Seat #1 is the button
Seat 1: BTN ($2 in chips)
Seat 2: SB ($2.47 in chips)
Seat 3: BB ($1.51 in chips)
Seat 4: UTG ($3.39 in chips)
Seat 5: HJ ($2.36 in chips)
Seat 6: CO ($2.01 in chips)
SB: posts small blind $0.01
BB: posts big blind $0.02
*** HOLE CARDS ***
UTG: folds
HJ: folds
CO: folds
BTN: folds
SB: raises $0.03 to $0.05
BB: calls $0.03
*** FLOP *** [2c 8h 4d]
SB: bets $0.03
BB: calls $0.03
*** TURN *** [2c 8h 4d] [9d]
SB: checks
BB: bets $0.15
SB: folds
Uncalled bet ($0.15) returned to BB
BB collected $0.15 from pot
*** SUMMARY ***
Total pot $0.16 | Rake $0.01
Board [2c 8h 4d 9d]
Seat 1: BTN (button) folded before Flop (didn't bet)
Seat 2: SB (small blind) folded on the Turn
Seat 3: BB (big blind) collected ($0.15)
Seat 4: UTG folded before Flop (didn't bet)
Seat 5: HJ folded before Flop (didn't bet)
Seat 6: CO folded before Flop (didn't bet)


PokerStars Hand #238163236203:  Hold'em No Limit ($0.01/$0.02 USD) - 2022/08/23 4:47:12 ET
Table 'Achilles IV' 6-max Seat #2 is the button
Seat 1: CO ($2 in chips)
Seat 2: BTN ($2.39 in chips)
Seat 3: SB ($1.58 in chips)
Seat 4: BB ($3.39 in chips)
Seat 5: UTG ($2.36 in chips)
Seat 6: HJ ($2.01 in chips)
SB: posts small blind $0.01
BB: posts big blind $0.02
*** HOLE CARDS ***
UTG: folds
HJ: folds
CO: folds
BTN: folds
SB: raises $0.02 to $0.04
BB: calls $0.02
*** FLOP *** [2c Qh 9h]
SB: bets $0.08
BB: folds
Uncalled bet ($0.08) returned to SB
SB collected $0.08 from pot
*** SUMMARY ***
Total pot $0.08 | Rake $0
Board [2c Qh 9h]
Seat 1: CO folded before Flop (didn't bet)
Seat 2: BTN (button) folded before Flop (didn't bet)
Seat 3: SB (small blind) collected ($0.08)
Seat 4: BB (big blind) folded on the Flop
Seat 5: UTG folded before Flop (didn't bet)
Seat 6: HJ folded before Flop (didn't bet)


PokerStars Hand #238163240172:  Hold'em No Limit ($0.01/$0.02 USD) - 2022/08/23 4:47:41 ET
Table 'Achilles IV' 6-max Seat #3 is the button
Seat 1: HJ ($2 in chips)
Seat 2: CO ($2.39 in chips)
Seat 3: BTN ($1.62 in chips)
Seat 4: SB ($3.35 in chips)
Seat 5: BB ($2.36 in chips)
Seat 6: UTG ($2.01 in chips)
SB: posts small blind $0.01
BB: posts big blind $0.02
*** HOLE CARDS ***
UTG: folds
HJ: folds
CO: folds
BTN: raises $0.02 to $0.04
SB: folds
BB: folds
Uncalled bet ($0.02) returned to BTN
BTN collected $0.05 from pot
*** SUMMARY ***
Total pot $0.05 | Rake $0
Seat 1: HJ folded before Flop (didn't bet)
Seat 2: CO folded before Flop (didn't bet)
Seat 3: BTN (button) collected ($0.05)
Seat 4: SB (small blind) folded before Flop
Seat 5: BB (big blind) folded before Flop
Seat 6: UTG folded before Flop (didn't bet)


PokerStars Hand #238163242016:  Hold'em No Limit ($0.01/$0.02 USD) - 2022/08/23 4:47:54 ET
Table 'Achilles IV' 6-max Seat #4 is the button
Seat 1: UTG ($2 in chips)
Seat 2: HJ ($2.39 in chips)
Seat 3: CO ($1.65 in chips)
Seat 4: BTN ($3.34 in chips)
Seat 5: SB ($2.34 in chips)
Seat 6: BB ($2.01 in chips)
SB: posts small blind $0.01
BB: posts big blind $0.02
*** HOLE CARDS ***
UTG: folds
HJ: raises $0.03 to $0.05
CO: folds
BTN: folds
SB: folds
BB: folds
Uncalled bet ($0.03) returned to HJ
HJ collected $0.05 from pot
HJ: doesn't show hand
*** SUMMARY ***
Total pot $0.05 | Rake $0
Seat 1: UTG folded before Flop (didn't bet)
Seat 2: HJ collected ($0.05)
Seat 3: CO folded before Flop (didn't bet)
Seat 4: BTN (button) folded before Flop (didn't bet)
Seat 5: SB (small blind) folded before Flop
Seat 6: BB (big blind) folded before Flop


PokerStars Hand #238163243571:  Hold'em No Limit ($0.01/$0.02 USD) - 2022/08/23 4:48:06 ET
Table 'Achilles IV' 6-max Seat #5 is the button
Seat 1: BB ($2 in chips)
Seat 2: UTG ($2.42 in chips)
Seat 3: HJ ($1.65 in chips)
Seat 4: CO ($3.34 in chips)
Seat 5: BTN ($2.33 in chips)
Seat 6: SB ($1.99 in chips)
SB: posts small blind $0.01
BB: posts big blind $0.02
*** HOLE CARDS ***
UTG: folds
HJ: calls $0.02
CO: folds
BTN: calls $0.02
SB: folds
BB: checks
*** FLOP *** [4s Ac Qh]
BB: checks
HJ: checks
BTN: checks
*** TURN *** [4s Ac Qh] [9c]
BB: checks
HJ: checks
BTN: checks
*** RIVER *** [4s Ac Qh 9c] [7d]
BB: checks
HJ: checks
BTN: checks
*** SHOW DOWN ***
BB: shows [3c 4c] (a pair of Fours)
HJ: mucks hand
BTN: shows [5h 5d] (a pair of Fives)
BTN collected $0.07 from pot
*** SUMMARY ***
Total pot $0.07 | Rake $0
Board [4s Ac Qh 9c 7d]
Seat 1: BB (big blind) showed [3c 4c] and lost with a pair of Fours
Seat 2: UTG folded before Flop (didn't bet)
Seat 3: HJ mucked
Seat 4: CO folded before Flop (didn't bet)
Seat 5: BTN (button) showed [5h 5d] and won ($0.07) with a pair of Fives
Seat 6: SB (small blind) folded before Flop


PokerStars Hand #238163247842:  Hold'em No Limit ($0.01/$0.02 USD) - 2022/08/23 4:48:37 ET
Table 'Achilles IV' 6-max Seat #6 is the button
Seat 1: SB ($2 in chips)
Seat 2: BB ($2.42 in chips)
Seat 3: UTG ($1.63 in chips)
Seat 4: HJ ($3.34 in chips)
Seat 5: CO ($2.38 in chips)
Seat 6: BTN ($1.98 in chips)
SB: posts small blind $0.01
BB: posts big blind $0.02
*** HOLE CARDS ***
UTG: calls $0.02
HJ: folds
CO: folds
BTN: calls $0.02
SB: raises $0.10 to $0.12
BB: folds
UTG: calls $0.10
BTN: calls $0.10
*** FLOP *** [3h 7h Jc]
SB: checks
UTG: checks
BTN: checks
*** TURN *** [3h 7h Jc] [Jh]
SB: checks
UTG: checks
BTN: bets $0.22
SB: folds
UTG: calls $0.22
*** RIVER *** [3h 7h Jc Jh] [5c]
UTG: checks
BTN: bets $0.68
UTG: calls $0.68
*** SHOW DOWN ***
BTN: shows [Ac Qd] (a pair of Jacks)
UTG: shows [Qh Kh] (a flush, King high)
UTG collected $2.10 from pot
*** SUMMARY ***
Total pot $2.18 | Rake $0.08
Board [3h 7h Jc Jh 5c]
Seat 1: SB (small blind) folded on the Turn
Seat 2: BB (big blind) folded before Flop
Seat 3: UTG showed [Qh Kh] and won ($2.10) with a flush, King high
Seat 4: HJ folded before Flop (didn't bet)
Seat 5: CO folded before Flop (didn't bet)
Seat 6: BTN (button) showed [Ac Qd] and lost with a pair of Jacks


PokerStars Hand #238163257448:  Hold'em No Limit ($0.01/$0.02 USD) - 2022/08/23 4:49:47 ET
Table 'Achilles IV' 6-max Seat #2 is the button
Seat 1: CO ($2 in chips)
Seat 2: BTN ($2.39 in chips)
Seat 3: SB ($2.72 in chips)
Seat 4: BB ($3.34 in chips)
Seat 5: UTG ($2.38 in chips)
Seat 6: HJ ($0.96 in chips)
SB: posts small blind $0.01
BB: posts big blind $0.02
*** HOLE CARDS ***
UTG: folds
HJ: folds
CO: folds
BTN: folds
SB: raises $0.04 to $0.06
BB: folds
Uncalled bet ($0.04) returned to SB
SB collected $0.04 from pot
*** SUMMARY ***
Total pot $0.04 | Rake $0
Seat 1: CO folded before Flop (didn't bet)
Seat 2: BTN (button) folded before Flop (didn't bet)
Seat 3: SB (small blind) collected ($0.04)
Seat 4: BB (big blind) folded before Flop
Seat 5: UTG folded before Flop (didn't bet)
Seat 6: HJ folded before Flop (didn't bet)


PokerStars Hand #238163255663:  Hold'em No Limit ($0.01/$0.02 USD) - 2022/08/23 4:49:34 ET
Table 'Achilles IV' 6-max Seat #1 is the button
Seat 1: BTN ($2 in chips)
Seat 2: SB ($2.40 in chips)
Seat 3: BB ($2.71 in chips)
Seat 4: UTG ($3.34 in chips)
Seat 5: HJ ($2.38 in chips)
Seat 6: CO ($0.96 in chips)
SB: posts small blind $0.01
BB: posts big blind $0.02
*** HOLE CARDS ***
UTG: folds
HJ: folds
CO: folds
BTN: folds
SB: folds
Uncalled bet ($0.01) returned to BB
BB collected $0.02 from pot
*** SUMMARY ***
Total pot $0.02 | Rake $0
Seat 1: BTN (button) folded before Flop (didn't bet)
Seat 2: SB (small blind) folded before Flop
Seat 3: BB (big blind) collected ($0.02)
Seat 4: UTG folded before Flop (didn't bet)
Seat 5: HJ folded before Flop (didn't bet)
Seat 6: CO folded before Flop (didn't bet)


PokerStars Hand #238163260012:  Hold'em No Limit ($0.01/$0.02 USD) - 2022/08/23 4:50:06 ET
Table 'Achilles IV' 6-max Seat #3 is the button
Seat 1: HJ ($2 in chips)
Seat 2: CO ($2.39 in chips)
Seat 3: BTN ($2.74 in chips)
Seat 4: SB ($3.32 in chips)
Seat 5: BB ($2.38 in chips)
Seat 6: UTG ($0.96 in chips)
SB: posts small blind $0.01
BB: posts big blind $0.02
*** HOLE CARDS ***
UTG: folds
HJ: folds
CO: folds
BTN: calls $0.02
SB: folds
BB: checks
*** FLOP *** [Ts Td 8d]
BB: checks
BTN: bets $0.05
BB: folds
Uncalled bet ($0.05) returned to BTN
BTN collected $0.05 from pot
*** SUMMARY ***
Total pot $0.05 | Rake $0
Board [Ts Td 8d]
Seat 1: HJ folded before Flop (didn't bet)
Seat 2: CO folded before Flop (didn't bet)
Seat 3: BTN (button) collected ($0.05)
Seat 4: SB (small blind) folded before Flop
Seat 5: BB (big blind) folded on the Flop
Seat 6: UTG folded before Flop (didn't bet)


PokerStars Hand #238163263267:  Hold'em No Limit ($0.01/$0.02 USD) - 2022/08/23 4:50:30 ET
Table 'Achilles IV' 6-max Seat #4 is the button
Seat 1: UTG ($2 in chips)
Seat 2: HJ ($2.39 in chips)
Seat 3: CO ($2.77 in chips)
Seat 4: BTN ($3.31 in chips)
Seat 5: SB ($2.36 in chips)
Seat 6: BB ($0.96 in chips)
SB: posts small blind $0.01
BB: posts big blind $0.02
*** HOLE CARDS ***
UTG: folds
HJ: folds
CO: calls $0.02
BTN: folds
SB: folds
BB: checks
*** FLOP *** [3c 9c Ks]
BB: checks
CO: checks
*** TURN *** [3c 9c Ks] [Js]
BB: bets $0.02
CO: calls $0.02
*** RIVER *** [3c 9c Ks Js] [Qc]
BB: checks
CO: checks
*** SHOW DOWN ***
BB: shows [7c Jd] (a pair of Jacks)
CO: mucks hand
BB collected $0.09 from pot
*** SUMMARY ***
Total pot $0.09 | Rake $0
Board [3c 9c Ks Js Qc]
Seat 1: UTG folded before Flop (didn't bet)
Seat 2: HJ folded before Flop (didn't bet)
Seat 3: CO mucked
Seat 4: BTN (button) folded before Flop (didn't bet)
Seat 5: SB (small blind) folded before Flop
Seat 6: BB (big blind) showed [7c Jd] and won ($0.09) with a pair of Jacks


PokerStars Hand #238163267600:  Hold'em No Limit ($0.01/$0.02 USD) - 2022/08/23 4:51:02 ET
Table 'Achilles IV' 6-max Seat #5 is the button
Seat 1: BB ($2 in chips)
Seat 2: UTG ($2.39 in chips)
Seat 3: HJ ($2.73 in chips)
Seat 4: CO ($3.31 in chips)
Seat 5: BTN ($2.35 in chips)
Seat 6: SB ($1.01 in chips)
SB: posts small blind $0.01
BB: posts big blind $0.02
*** HOLE CARDS ***
UTG: folds
HJ: calls $0.02
CO: folds
BTN: folds
SB: folds
BB: checks
*** FLOP *** [7c Kh 2c]
BB: checks
HJ: bets $0.05
BB: folds
Uncalled bet ($0.05) returned to HJ
HJ collected $0.05 from pot
*** SUMMARY ***
Total pot $0.05 | Rake $0
Board [7c Kh 2c]
Seat 1: BB (big blind) folded on the Flop
Seat 2: UTG folded before Flop (didn't bet)
Seat 3: HJ collected ($0.05)
Seat 4: CO folded before Flop (didn't bet)
Seat 5: BTN (button) folded before Flop (didn't bet)
Seat 6: SB (small blind) folded before Flop


PokerStars Hand #238163271414:  Hold'em No Limit ($0.01/$0.02 USD) - 2022/08/23 4:51:29 ET
Table 'Achilles IV' 6-max Seat #6 is the button
Seat 1: SB ($2 in chips)
Seat 2: BB ($2.39 in chips)
Seat 3: UTG ($2.76 in chips)
Seat 4: HJ ($3.31 in chips)
Seat 5: CO ($2.35 in chips)
Seat 6: BTN ($1 in chips)
SB: posts small blind $0.01
BB: posts big blind $0.02
*** HOLE CARDS ***
UTG: folds
HJ: folds
CO: folds
BTN: folds
SB: folds
Uncalled bet ($0.01) returned to BB
BB collected $0.02 from pot
BB: doesn't show hand
*** SUMMARY ***
Total pot $0.02 | Rake $0
Seat 1: SB (small blind) folded before Flop
Seat 2: BB (big blind) collected ($0.02)
Seat 3: UTG folded before Flop (didn't bet)
Seat 4: HJ folded before Flop (didn't bet)
Seat 5: CO folded before Flop (didn't bet)
Seat 6: BTN (button) folded before Flop (didn't bet)


PokerStars Hand #238163272515:  Hold'em No Limit ($0.01/$0.02 USD) - 2022/08/23 4:51:38 ET
Table 'Achilles IV' 6-max Seat #1 is the button
Seat 1: BTN ($2 in chips)
Seat 2: SB ($2.40 in chips)
Seat 3: BB ($2.76 in chips)
Seat 4: UTG ($3.31 in chips)
Seat 5: HJ ($2.35 in chips)
Seat 6: CO ($1 in chips)
SB: posts small blind $0.01
BB: posts big blind $0.02
*** HOLE CARDS ***
UTG: folds
HJ: folds
CO: raises $0.03 to $0.05
BTN: raises $0.13 to $0.18
SB: folds
BB: folds
CO: folds
Uncalled bet ($0.13) returned to BTN
BTN collected $0.13 from pot
BTN: doesn't show hand
*** SUMMARY ***
Total pot $0.13 | Rake $0
Seat 1: BTN (button) collected ($0.13)
Seat 2: SB (small blind) folded before Flop
Seat 3: BB (big blind) folded before Flop
Seat 4: UTG folded before Flop (didn't bet)
Seat 5: HJ folded before Flop (didn't bet)
Seat 6: CO folded before Flop


PokerStars Hand #238163275639:  Hold'em No Limit ($0.01/$0.02 USD) - 2022/08/23 4:52:01 ET
Table 'Achilles IV' 6-max Seat #2 is the button
Seat 1: CO ($2.08 in chips)
Seat 2: BTN ($2.39 in chips)
Seat 3: SB ($2.74 in chips)
Seat 4: BB ($3.31 in chips)
Seat 5: UTG ($2.35 in chips)
Seat 6: HJ ($0.95 in chips)
SB: posts small blind $0.01
BB: posts big blind $0.02
*** HOLE CARDS ***
UTG: folds
HJ: folds
CO: folds
BTN: raises $0.03 to $0.05
SB: folds
BB: raises $0.05 to $0.10
BTN: calls $0.05
*** FLOP *** [Js 2d Qh]
BB: checks
BTN: checks
*** TURN *** [Js 2d Qh] [Ad]
BB: bets $0.10
BTN: calls $0.10
*** RIVER *** [Js 2d Qh Ad] [6s]
BB: bets $0.20
BTN: calls $0.20
*** SHOW DOWN ***
BB: shows [Kd Ac] (a pair of Aces)
BTN: mucks hand
BB collected $0.78 from pot
*** SUMMARY ***
Total pot $0.81 | Rake $0.03
Board [Js 2d Qh Ad 6s]
Seat 1: CO folded before Flop (didn't bet)
Seat 2: BTN (button) mucked
Seat 3: SB (small blind) folded before Flop
Seat 4: BB (big blind) showed [Kd Ac] and won ($0.78) with a pair of Aces
Seat 5: UTG folded before Flop (didn't bet)
Seat 6: HJ folded before Flop (didn't bet)


PokerStars Hand #238163284563:  Hold'em No Limit ($0.01/$0.02 USD) - 2022/08/23 4:53:07 ET
Table 'Achilles IV' 6-max Seat #3 is the button
Seat 1: HJ ($2.08 in chips)
Seat 2: CO ($1.99 in chips)
Seat 3: BTN ($2.73 in chips)
Seat 4: SB ($3.69 in chips)
Seat 5: BB ($2.35 in chips)
Seat 6: UTG ($0.95 in chips)
SB: posts small blind $0.01
BB: posts big blind $0.02
*** HOLE CARDS ***
UTG: folds
HJ: raises $0.04 to $0.06
CO: folds
BTN: calls $0.06
SB: folds
BB: calls $0.04
*** FLOP *** [Kh Jd 7d]
BB: checks
HJ: checks
BTN: checks
*** TURN *** [Kh Jd 7d] [7h]
BB: bets $0.09
HJ: folds
BTN: calls $0.09
*** RIVER *** [Kh Jd 7d 7h] [8h]
BB: bets $0.36
BTN: folds
Uncalled bet ($0.36) returned to BB
BB collected $0.36 from pot
*** SUMMARY ***
Total pot $0.37 | Rake $0.01
Board [Kh Jd 7d 7h 8h]
Seat 1: HJ folded on the Turn
Seat 2: CO folded before Flop (didn't bet)
Seat 3: BTN (button) folded on the River
Seat 4: SB (small blind) folded before Flop
Seat 5: BB (big blind) collected ($0.36)
Seat 6: UTG folded before Flop (didn't bet)


PokerStars Hand #238163292425:  Hold'em No Limit ($0.01/$0.02 USD) - 2022/08/23 4:54:05 ET
Table 'Achilles IV' 6-max Seat #4 is the button
Seat 1: UTG ($2.02 in chips)
Seat 2: HJ ($1.99 in chips)
Seat 3: CO ($2.58 in chips)
Seat 4: BTN ($3.68 in chips)
Seat 5: SB ($2.56 in chips)
Seat 6: BB ($0.95 in chips)
SB: posts small blind $0.01
BB: posts big blind $0.02
*** HOLE CARDS ***
UTG: folds
HJ: folds
CO: calls $0.02
BTN: folds
SB: folds
BB: checks
*** FLOP *** [Qh 6c Ks]
BB: checks
CO: bets $0.02
BB: calls $0.02
*** TURN *** [Qh 6c Ks] [7h]
BB: checks
CO: bets $0.02
BB: calls $0.02
*** RIVER *** [Qh 6c Ks 7h] [Th]
BB: checks
CO: bets $0.13
BB: folds
Uncalled bet ($0.13) returned to CO
CO collected $0.13 from pot
*** SUMMARY ***
Total pot $0.13 | Rake $0
Board [Qh 6c Ks 7h Th]
Seat 1: UTG folded before Flop (didn't bet)
Seat 2: HJ folded before Flop (didn't bet)
Seat 3: CO collected ($0.13)
Seat 4: BTN (button) folded before Flop (didn't bet)
Seat 5: SB (small blind) folded before Flop
Seat 6: BB (big blind) folded on the River


PokerStars Hand #238163296512:  Hold'em No Limit ($0.01/$0.02 USD) - 2022/08/23 4:54:35 ET
Table 'Achilles IV' 6-max Seat #5 is the button
Seat 1: BB ($2.02 in chips)
Seat 2: HJ ($1.99 in chips)
Seat 4: CO ($3.68 in chips)
Seat 5: BTN ($2.55 in chips)
Seat 6: SB ($0.89 in chips)
SB: posts small blind $0.01
BB: posts big blind $0.02
*** HOLE CARDS ***
HJ: folds
Fran1809 leaves the table
CO: raises $0.02 to $0.04
BTN: folds
SB: folds
BB: calls $0.02
*** FLOP *** [3c 6d Qs]
BB: checks
CO: checks
*** TURN *** [3c 6d Qs] [2c]
BB: bets $0.07
CO: calls $0.07
*** RIVER *** [3c 6d Qs 2c] [As]
BB: checks
CO: bets $0.15
BB: folds
Uncalled bet ($0.15) returned to CO
CO collected $0.22 from pot
*** SUMMARY ***
Total pot $0.23 | Rake $0.01
Board [3c 6d Qs 2c As]
Seat 1: BB (big blind) folded on the River
Seat 2: HJ folded before Flop (didn't bet)
Seat 4: CO collected ($0.22)
Seat 5: BTN (button) folded before Flop (didn't bet)
Seat 6: SB (small blind) folded before Flop


PokerStars Hand #238163304345:  Hold'em No Limit ($0.01/$0.02 USD) - 2022/08/23 4:55:35 ET
Table 'Achilles IV' 6-max Seat #1 is the button
Seat 1: BTN ($2 in chips)
Seat 4: SB ($3.80 in chips)
Seat 5: BB ($2.55 in chips)
Seat 6: CO ($0.88 in chips)
SB: posts small blind $0.01
BB: posts big blind $0.02
*** HOLE CARDS ***
CO: folds
BTN: folds
SB: folds
Uncalled bet ($0.01) returned to BB
BB collected $0.02 from pot
*** SUMMARY ***
Total pot $0.02 | Rake $0
Seat 1: BTN (button) folded before Flop (didn't bet)
Seat 4: SB (small blind) folded before Flop
Seat 5: BB (big blind) collected ($0.02)
Seat 6: CO folded before Flop (didn't bet)


PokerStars Hand #238163303308:  Hold'em No Limit ($0.01/$0.02 USD) - 2022/08/23 4:55:26 ET
Table 'Achilles IV' 6-max Seat #6 is the button
Seat 1: SB ($2 in chips)
Seat 4: BB ($3.79 in chips)
Seat 5: CO ($2.55 in chips)
Seat 6: BTN ($0.88 in chips)
SB: posts small blind $0.01
Xtens: is sitting out
BB: posts big blind $0.02
*** HOLE CARDS ***
CO: folds
BTN: folds
Xtens leaves the table
SB: folds
Uncalled bet ($0.01) returned to BB
BB collected $0.02 from pot
*** SUMMARY ***
Total pot $0.02 | Rake $0
Seat 1: SB (small blind) folded before Flop
Seat 4: BB (big blind) collected ($0.02)
Seat 5: CO folded before Flop (didn't bet)
Seat 6: BTN (button) folded before Flop (didn't bet)


PokerStars Hand #238163305070:  Hold'em No Limit ($0.01/$0.02 USD) - 2022/08/23 4:55:41 ET
Table 'Achilles IV' 6-max Seat #4 is the button
Seat 1: CO ($2 in chips)
Seat 4: BTN ($3.79 in chips)
Seat 5: SB ($2.56 in chips)
Seat 6: BB ($0.88 in chips)
SB: posts small blind $0.01
BB: posts big blind $0.02
*** HOLE CARDS ***
CO: folds
BTN: folds
SB: folds
Uncalled bet ($0.01) returned to BB
BB collected $0.02 from pot
BB: doesn't show hand
*** SUMMARY ***
Total pot $0.02 | Rake $0
Seat 1: CO folded before Flop (didn't bet)
Seat 4: BTN (button) folded before Flop (didn't bet)
Seat 5: SB (small blind) folded before Flop
Seat 6: BB (big blind) collected ($0.02)


PokerStars Hand #238163306057:  Hold'em No Limit ($0.01/$0.02 USD) - 2022/08/23 4:55:50 ET
Table 'Achilles IV' 6-max Seat #5 is the button
Seat 1: BB ($2 in chips)
Seat 4: CO ($3.79 in chips)
Seat 5: BTN ($2.55 in chips)
Seat 6: SB ($0.89 in chips)
SB: posts small blind $0.01
BB: posts big blind $0.02
*** HOLE CARDS ***
CO: raises $0.02 to $0.04
BTN: folds
SB: folds
BB: folds
Uncalled bet ($0.02) returned to CO
CO collected $0.05 from pot
*** SUMMARY ***
Total pot $0.05 | Rake $0
Seat 1: BB (big blind) folded before Flop
Seat 4: CO collected ($0.05)
Seat 5: BTN (button) folded before Flop (didn't bet)
Seat 6: SB (small blind) folded before Flop


PokerStars Hand #238163309780:  Hold'em No Limit ($0.01/$0.02 USD) - 2022/08/23 4:56:21 ET
Table 'Achilles IV' 6-max Seat #1 is the button
Seat 1: BTN ($2 in chips)
Seat 4: SB ($3.80 in chips)
Seat 5: BB ($2.55 in chips)
Seat 6: CO ($0.91 in chips)
SB: posts small blind $0.01
BB: posts big blind $0.02
*** HOLE CARDS ***
CO: raises $0.03 to $0.05
BTN: folds
SB: folds
BB: folds
Uncalled bet ($0.03) returned to CO
CO collected $0.05 from pot
CO: doesn't show hand
*** SUMMARY ***
Total pot $0.05 | Rake $0
Seat 1: BTN (button) folded before Flop (didn't bet)
Seat 4: SB (small blind) folded before Flop
Seat 5: BB (big blind) folded before Flop
Seat 6: CO collected ($0.05)


PokerStars Hand #238163308434:  Hold'em No Limit ($0.01/$0.02 USD) - 2022/08/23 4:56:09 ET
Table 'Achilles IV' 6-max Seat #6 is the button
Seat 1: SB ($2 in chips)
Seat 4: BB ($3.82 in chips)
Seat 5: CO ($2.55 in chips)
Seat 6: BTN ($0.88 in chips)
SB: posts small blind $0.01
BB: posts big blind $0.02
*** HOLE CARDS ***
CO: folds
BTN: raises $0.03 to $0.05
SB: folds
BB: folds
Uncalled bet ($0.03) returned to BTN
BTN collected $0.05 from pot
BTN: doesn't show hand
*** SUMMARY ***
Total pot $0.05 | Rake $0
Seat 1: SB (small blind) folded before Flop
Seat 4: BB (big blind) folded before Flop
Seat 5: CO folded before Flop (didn't bet)
Seat 6: BTN (button) collected ($0.05)


PokerStars Hand #238163311288:  Hold'em No Limit ($0.01/$0.02 USD) - 2022/08/23 4:56:33 ET
Table 'Achilles IV' 6-max Seat #4 is the button
Seat 1: CO ($2 in chips)
Seat 4: BTN ($3.79 in chips)
Seat 5: SB ($2.53 in chips)
Seat 6: BB ($0.94 in chips)
SB: posts small blind $0.01
BB: posts big blind $0.02
*** HOLE CARDS ***
CO: folds
BTN: folds
SB: folds
Uncalled bet ($0.01) returned to BB
BB collected $0.02 from pot
BB: doesn't show hand
*** SUMMARY ***
Total pot $0.02 | Rake $0
Seat 1: CO folded before Flop (didn't bet)
Seat 4: BTN (button) folded before Flop (didn't bet)
Seat 5: SB (small blind) folded before Flop
Seat 6: BB (big blind) collected ($0.02)


PokerStars Hand #238163312608:  Hold'em No Limit ($0.01/$0.02 USD) - 2022/08/23 4:56:44 ET
Table 'Achilles IV' 6-max Seat #5 is the button
Seat 1: BB ($2 in chips)
Seat 4: CO ($3.79 in chips)
Seat 5: BTN ($2.52 in chips)
Seat 6: SB ($0.95 in chips)
SB: posts small blind $0.01
BB: posts big blind $0.02
*** HOLE CARDS ***
CO: folds
CO leaves the table
BTN: folds
SB: calls $0.01
BB: checks
*** FLOP *** [9s Jh 9c]
SB: bets $0.02
BB: folds
Uncalled bet ($0.02) returned to SB
SB collected $0.04 from pot
SB: doesn't show hand
*** SUMMARY ***
Total pot $0.04 | Rake $0
Board [9s Jh 9c]
Seat 1: BB (big blind) folded on the Flop
Seat 4: CO folded before Flop (didn't bet)
Seat 5: BTN (button) folded before Flop (didn't bet)
Seat 6: SB (small blind) collected ($0.04)


PokerStars Hand #238163315658:  Hold'em No Limit ($0.01/$0.02 USD) - 2022/08/23 4:57:10 ET
Table 'Achilles IV' 6-max Seat #6 is the button
Seat 1: SB ($2 in chips)
Seat 5: BB ($2.52 in chips)
Seat 6: BTN ($0.97 in chips)
SB: posts small blind $0.01
BB: posts big blind $0.02
*** HOLE CARDS ***
BTN: raises $0.03 to $0.05
SB: folds
BB: folds
Uncalled bet ($0.03) returned to BTN
BTN collected $0.05 from pot
BTN: doesn't show hand
*** SUMMARY ***
Total pot $0.05 | Rake $0
Seat 1: SB (small blind) folded before Flop
Seat 5: BB (big blind) folded before Flop
Seat 6: BTN (button) collected ($0.05)


PokerStars Hand #238163316632:  Hold'em No Limit ($0.01/$0.02 USD) - 2022/08/23 4:57:18 ET
Table 'Achilles IV' 6-max Seat #1 is the button
Seat 1: BTN ($2 in chips)
Seat 5: SB ($2.50 in chips)
Seat 6: BB ($1 in chips)
SB: posts small blind $0.01
BB: posts big blind $0.02
*** HOLE CARDS ***
BTN: folds
SB: folds
Uncalled bet ($0.01) returned to BB
BB collected $0.02 from pot
BB: doesn't show hand
*** SUMMARY ***
Total pot $0.02 | Rake $0
Seat 1: BTN (button) folded before Flop (didn't bet)
Seat 5: SB (small blind) folded before Flop
Seat 6: BB (big blind) collected ($0.02)


