PokerStars Hand #238170258293:  Hold'em No Limit ($0.01/$0.02 USD) - 2022/08/23 13:16:14 ET
Table 'Equinox IV' 6-max Seat #3 is the button
Seat 1: VIKTORIYA12382 ($0.80 in chips)
Seat 3: Vikont69 ($2 in chips)
Seat 4: oceter ($2 in chips)
oceter: posts small blind $0.01
VIKTORIYA12382: posts big blind $0.02
*** HOLE CARDS ***
Vikont69: folds
oceter: raises $0.03 to $0.05
VIKTORIYA12382: calls $0.03
*** FLOP *** [4c Ks 7s]
oceter: checks
VIKTORIYA12382: bets $0.10
oceter: calls $0.10
*** TURN *** [4c Ks 7s] [Ah]
oceter: checks
VIKTORIYA12382: bets $0.29
oceter: folds
Uncalled bet ($0.29) returned to VIKTORIYA12382
VIKTORIYA12382 collected $0.29 from pot
*** SUMMARY ***
Total pot $0.30 | Rake $0.01
Board [4c Ks 7s Ah]
Seat 1: VIKTORIYA12382 (big blind) collected ($0.29)
Seat 3: Vikont69 (button) folded before Flop (didn't bet)
Seat 4: oceter (small blind) folded on the Turn


PokerStars Hand #238170265767:  Hold'em No Limit ($0.01/$0.02 USD) - 2022/08/23 13:16:37 ET
Table 'Equinox IV' 6-max Seat #4 is the button
Seat 1: VIKTORIYA12382 ($0.94 in chips)
Seat 3: Vikont69 ($2 in chips)
Seat 4: oceter ($2 in chips)
VIKTORIYA12382: posts small blind $0.01
Vikont69: posts big blind $0.02
*** HOLE CARDS ***
oceter: folds
VIKTORIYA12382: calls $0.01
Vikont69: checks
*** FLOP *** [3h 2s 5s]
VIKTORIYA12382: bets $0.04
Vikont69: calls $0.04
*** TURN *** [3h 2s 5s] [2h]
LAMUS_PL joins the table at seat #5
VIKTORIYA12382: checks
Vikont69: checks
*** RIVER *** [3h 2s 5s 2h] [4h]
Leonel cz joins the table at seat #6
VIKTORIYA12382: bets $0.02
Vikont69: calls $0.02
*** SHOW DOWN ***
VIKTORIYA12382: shows [8h Qd] (a pair of Deuces)
Vikont69: shows [Tc 4d] (two pair, Fours and Deuces)
Vikont69 collected $0.15 from pot
*** SUMMARY ***
Total pot $0.16 | Rake $0.01
Board [3h 2s 5s 2h 4h]
Seat 1: VIKTORIYA12382 (small blind) showed [8h Qd] and lost with a pair of Deuces
Seat 3: Vikont69 (big blind) showed [Tc 4d] and won ($0.15) with two pair, Fours and Deuces
Seat 4: oceter (button) folded before Flop (didn't bet)


PokerStars Hand #238170272209:  Hold'em No Limit ($0.01/$0.02 USD) - 2022/08/23 13:16:58 ET
Table 'Equinox IV' 6-max Seat #1 is the button
Seat 1: VIKTORIYA12382 ($0.86 in chips)
Seat 3: Vikont69 ($2.07 in chips)
Seat 4: oceter ($2 in chips)
Vikont69: posts small blind $0.01
elchicosinombre joins the table at seat #2
oceter: posts big blind $0.02
LAMUS_PL: sits out
Leonel cz: sits out
*** HOLE CARDS ***
VIKTORIYA12382: raises $0.02 to $0.04
Vikont69: calls $0.03
oceter: raises $0.16 to $0.20
VIKTORIYA12382: folds
Vikont69: folds
Uncalled bet ($0.16) returned to oceter
oceter collected $0.12 from pot
oceter: doesn't show hand
*** SUMMARY ***
Total pot $0.12 | Rake $0
Seat 1: VIKTORIYA12382 (button) folded before Flop
Seat 3: Vikont69 (small blind) folded before Flop
Seat 4: oceter (big blind) collected ($0.12)


PokerStars Hand #238170277275:  Hold'em No Limit ($0.01/$0.02 USD) - 2022/08/23 13:17:14 ET
Table 'Equinox IV' 6-max Seat #3 is the button
Seat 1: VIKTORIYA12382 ($0.82 in chips)
Seat 3: Vikont69 ($2.03 in chips)
Seat 4: oceter ($2.08 in chips)
Seat 5: LAMUS_PL ($2 in chips)
oceter: posts small blind $0.01
LAMUS_PL: posts big blind $0.02
Leonel cz: sits out
elchicosinombre: sits out
*** HOLE CARDS ***
VIKTORIYA12382: folds
Vikont69: raises $0.06 to $0.08
oceter: folds
LAMUS_PL: calls $0.06
*** FLOP *** [6s 4c Kd]
LAMUS_PL: checks
Vikont69: bets $0.10
LAMUS_PL: calls $0.10
*** TURN *** [6s 4c Kd] [5c]
LAMUS_PL: bets $0.35
Vikont69: calls $0.35
*** RIVER *** [6s 4c Kd 5c] [3c]
LAMUS_PL: bets $0.02
Vikont69: calls $0.02
*** SHOW DOWN ***
LAMUS_PL: shows [8h 7d] (a straight, Four to Eight)
Vikont69: mucks hand
LAMUS_PL collected $1.06 from pot
*** SUMMARY ***
Total pot $1.11 | Rake $0.05
Board [6s 4c Kd 5c 3c]
Seat 1: VIKTORIYA12382 folded before Flop (didn't bet)
Seat 3: Vikont69 (button) mucked
Seat 4: oceter (small blind) folded before Flop
Seat 5: LAMUS_PL (big blind) showed [8h 7d] and won ($1.06) with a straight, Four to Eight


PokerStars Hand #238170302011:  Hold'em No Limit ($0.01/$0.02 USD) - 2022/08/23 13:18:01 ET
Table 'Equinox IV' 6-max Seat #4 is the button
Seat 1: VIKTORIYA12382 ($0.82 in chips)
Seat 3: Vikont69 ($1.48 in chips)
Seat 4: oceter ($2.07 in chips)
Seat 5: LAMUS_PL ($2.51 in chips)
Seat 6: Leonel cz ($2 in chips)
LAMUS_PL: posts small blind $0.01
Leonel cz: posts big blind $0.02
elchicosinombre: sits out
*** HOLE CARDS ***
VIKTORIYA12382: calls $0.02
Vikont69: folds
oceter: folds
LAMUS_PL: folds
Leonel cz: checks
*** FLOP *** [6h Th 8c]
Leonel cz: checks
VIKTORIYA12382: checks
*** TURN *** [6h Th 8c] [As]
Leonel cz: checks
VIKTORIYA12382: checks
*** RIVER *** [6h Th 8c As] [2s]
Leonel cz: checks
VIKTORIYA12382: checks
*** SHOW DOWN ***
Leonel cz: shows [Ks 9c] (high card Ace)
VIKTORIYA12382: mucks hand
Leonel cz collected $0.05 from pot
*** SUMMARY ***
Total pot $0.05 | Rake $0
Board [6h Th 8c As 2s]
Seat 1: VIKTORIYA12382 mucked
Seat 3: Vikont69 folded before Flop (didn't bet)
Seat 4: oceter (button) folded before Flop (didn't bet)
Seat 5: LAMUS_PL (small blind) folded before Flop
Seat 6: Leonel cz (big blind) showed [Ks 9c] and won ($0.05) with high card Ace


PokerStars Hand #238170313139:  Hold'em No Limit ($0.01/$0.02 USD) - 2022/08/23 13:18:35 ET
Table 'Equinox IV' 6-max Seat #5 is the button
Seat 1: VIKTORIYA12382 ($0.80 in chips)
Seat 3: Vikont69 ($1.48 in chips)
Seat 4: oceter ($2.07 in chips)
Seat 5: LAMUS_PL ($2.50 in chips)
Seat 6: Leonel cz ($2.03 in chips)
Leonel cz: posts small blind $0.01
VIKTORIYA12382: posts big blind $0.02
elchicosinombre: sits out
*** HOLE CARDS ***
Vikont69: raises $0.04 to $0.06
oceter: folds
LAMUS_PL: folds
Leonel cz: folds
VIKTORIYA12382: folds
Uncalled bet ($0.04) returned to Vikont69
Vikont69 collected $0.05 from pot
*** SUMMARY ***
Total pot $0.05 | Rake $0
Seat 1: VIKTORIYA12382 (big blind) folded before Flop
Seat 3: Vikont69 collected ($0.05)
Seat 4: oceter folded before Flop (didn't bet)
Seat 5: LAMUS_PL (button) folded before Flop (didn't bet)
Seat 6: Leonel cz (small blind) folded before Flop


PokerStars Hand #238170317256:  Hold'em No Limit ($0.01/$0.02 USD) - 2022/08/23 13:18:48 ET
Table 'Equinox IV' 6-max Seat #6 is the button
Seat 1: VIKTORIYA12382 ($0.78 in chips)
Seat 2: elchicosinombre ($1.60 in chips)
Seat 3: Vikont69 ($1.51 in chips)
Seat 4: oceter ($2.07 in chips)
Seat 5: LAMUS_PL ($2.50 in chips)
Seat 6: Leonel cz ($2.02 in chips)
VIKTORIYA12382: posts small blind $0.01
elchicosinombre: posts big blind $0.02
*** HOLE CARDS ***
Vikont69: raises $0.04 to $0.06
oceter: folds
LAMUS_PL: folds
Leonel cz: folds
VIKTORIYA12382: calls $0.05
elchicosinombre: calls $0.04
*** FLOP *** [Kd Ac Qd]
VIKTORIYA12382: checks
elchicosinombre: bets $0.02
Vikont69: calls $0.02
VIKTORIYA12382: calls $0.02
*** TURN *** [Kd Ac Qd] [5h]
VIKTORIYA12382: bets $0.06
elchicosinombre: calls $0.06
Vikont69: folds
*** RIVER *** [Kd Ac Qd 5h] [Jc]
VIKTORIYA12382: bets $0.06
elchicosinombre: calls $0.06
*** SHOW DOWN ***
VIKTORIYA12382: shows [6h Qh] (a pair of Queens)
elchicosinombre: shows [Ad 2s] (a pair of Aces)
elchicosinombre collected $0.46 from pot
*** SUMMARY ***
Total pot $0.48 | Rake $0.02
Board [Kd Ac Qd 5h Jc]
Seat 1: VIKTORIYA12382 (small blind) showed [6h Qh] and lost with a pair of Queens
Seat 2: elchicosinombre (big blind) showed [Ad 2s] and won ($0.46) with a pair of Aces
Seat 3: Vikont69 folded on the Turn
Seat 4: oceter folded before Flop (didn't bet)
Seat 5: LAMUS_PL folded before Flop (didn't bet)
Seat 6: Leonel cz (button) folded before Flop (didn't bet)


PokerStars Hand #238170329011:  Hold'em No Limit ($0.01/$0.02 USD) - 2022/08/23 13:19:24 ET
Table 'Equinox IV' 6-max Seat #1 is the button
Seat 1: VIKTORIYA12382 ($0.58 in chips)
Seat 2: elchicosinombre ($1.86 in chips)
Seat 3: Vikont69 ($1.43 in chips)
Seat 4: oceter ($2.07 in chips)
Seat 5: LAMUS_PL ($2.50 in chips)
Seat 6: Leonel cz ($2.02 in chips)
elchicosinombre: posts small blind $0.01
Vikont69: posts big blind $0.02
*** HOLE CARDS ***
oceter: folds
LAMUS_PL: folds
Leonel cz: folds
VIKTORIYA12382: folds
elchicosinombre: folds
Uncalled bet ($0.01) returned to Vikont69
Vikont69 collected $0.02 from pot
*** SUMMARY ***
Total pot $0.02 | Rake $0
Seat 1: VIKTORIYA12382 (button) folded before Flop (didn't bet)
Seat 2: elchicosinombre (small blind) folded before Flop
Seat 3: Vikont69 (big blind) collected ($0.02)
Seat 4: oceter folded before Flop (didn't bet)
Seat 5: LAMUS_PL folded before Flop (didn't bet)
Seat 6: Leonel cz folded before Flop (didn't bet)


PokerStars Hand #238170332836:  Hold'em No Limit ($0.01/$0.02 USD) - 2022/08/23 13:19:36 ET
Table 'Equinox IV' 6-max Seat #2 is the button
Seat 1: VIKTORIYA12382 ($0.58 in chips)
Seat 2: elchicosinombre ($1.85 in chips)
Seat 3: Vikont69 ($1.44 in chips)
Seat 4: oceter ($2.07 in chips)
Seat 5: LAMUS_PL ($2.50 in chips)
Seat 6: Leonel cz ($2.02 in chips)
Vikont69: posts small blind $0.01
oceter: posts big blind $0.02
*** HOLE CARDS ***
LAMUS_PL: folds
Leonel cz: raises $0.03 to $0.05
VIKTORIYA12382: calls $0.05
elchicosinombre: folds
Vikont69: calls $0.04
oceter: folds
*** FLOP *** [Qd 6s 5c]
Vikont69: checks
Leonel cz: bets $0.08
VIKTORIYA12382: calls $0.08
Vikont69: folds
*** TURN *** [Qd 6s 5c] [Jc]
Leonel cz: bets $0.16
VIKTORIYA12382: folds
Uncalled bet ($0.16) returned to Leonel cz
Leonel cz collected $0.32 from pot
*** SUMMARY ***
Total pot $0.33 | Rake $0.01
Board [Qd 6s 5c Jc]
Seat 1: VIKTORIYA12382 folded on the Turn
Seat 2: elchicosinombre (button) folded before Flop (didn't bet)
Seat 3: Vikont69 (small blind) folded on the Flop
Seat 4: oceter (big blind) folded before Flop
Seat 5: LAMUS_PL folded before Flop (didn't bet)
Seat 6: Leonel cz collected ($0.32)


PokerStars Hand #238170343134:  Hold'em No Limit ($0.01/$0.02 USD) - 2022/08/23 13:20:08 ET
Table 'Equinox IV' 6-max Seat #3 is the button
Seat 1: VIKTORIYA12382 ($0.45 in chips)
Seat 2: elchicosinombre ($1.85 in chips)
Seat 3: Vikont69 ($1.39 in chips)
Seat 4: oceter ($2.05 in chips)
Seat 5: LAMUS_PL ($2.50 in chips)
Seat 6: Leonel cz ($2.21 in chips)
oceter: posts small blind $0.01
LAMUS_PL: posts big blind $0.02
*** HOLE CARDS ***
Leonel cz: folds
VIKTORIYA12382: folds
elchicosinombre: raises $0.04 to $0.06
Vikont69: folds
oceter: folds
LAMUS_PL: folds
Uncalled bet ($0.04) returned to elchicosinombre
elchicosinombre collected $0.05 from pot
*** SUMMARY ***
Total pot $0.05 | Rake $0
Seat 1: VIKTORIYA12382 folded before Flop (didn't bet)
Seat 2: elchicosinombre collected ($0.05)
Seat 3: Vikont69 (button) folded before Flop (didn't bet)
Seat 4: oceter (small blind) folded before Flop
Seat 5: LAMUS_PL (big blind) folded before Flop
Seat 6: Leonel cz folded before Flop (didn't bet)


PokerStars Hand #238170349994:  Hold'em No Limit ($0.01/$0.02 USD) - 2022/08/23 13:20:30 ET
Table 'Equinox IV' 6-max Seat #4 is the button
Seat 1: VIKTORIYA12382 ($0.45 in chips)
Seat 2: elchicosinombre ($1.88 in chips)
Seat 3: Vikont69 ($1.39 in chips)
Seat 4: oceter ($2.04 in chips)
Seat 5: LAMUS_PL ($2.48 in chips)
Seat 6: Leonel cz ($2.21 in chips)
LAMUS_PL: posts small blind $0.01
Leonel cz: posts big blind $0.02
*** HOLE CARDS ***
VIKTORIYA12382: calls $0.02
elchicosinombre: folds
Vikont69: folds
oceter: folds
LAMUS_PL: folds
Leonel cz: checks
*** FLOP *** [Qd 7s Js]
Leonel cz: checks
VIKTORIYA12382: checks
*** TURN *** [Qd 7s Js] [8s]
Leonel cz: checks
VIKTORIYA12382: checks
*** RIVER *** [Qd 7s Js 8s] [4s]
Leonel cz: checks
VIKTORIYA12382: checks
*** SHOW DOWN ***
Leonel cz: shows [7d Kh] (a pair of Sevens)
VIKTORIYA12382: mucks hand
Leonel cz collected $0.05 from pot
*** SUMMARY ***
Total pot $0.05 | Rake $0
Board [Qd 7s Js 8s 4s]
Seat 1: VIKTORIYA12382 mucked
Seat 2: elchicosinombre folded before Flop (didn't bet)
Seat 3: Vikont69 folded before Flop (didn't bet)
Seat 4: oceter (button) folded before Flop (didn't bet)
Seat 5: LAMUS_PL (small blind) folded before Flop
Seat 6: Leonel cz (big blind) showed [7d Kh] and won ($0.05) with a pair of Sevens


PokerStars Hand #238170360028:  Hold'em No Limit ($0.01/$0.02 USD) - 2022/08/23 13:21:01 ET
Table 'Equinox IV' 6-max Seat #5 is the button
Seat 1: VIKTORIYA12382 ($0.43 in chips)
Seat 2: elchicosinombre ($1.88 in chips)
Seat 3: Vikont69 ($1.39 in chips)
Seat 4: oceter ($2.04 in chips)
Seat 5: LAMUS_PL ($2.47 in chips)
Seat 6: Leonel cz ($2.24 in chips)
Leonel cz: posts small blind $0.01
VIKTORIYA12382: posts big blind $0.02
*** HOLE CARDS ***
elchicosinombre: raises $0.02 to $0.04
Vikont69: calls $0.04
oceter: folds
LAMUS_PL: folds
Leonel cz: folds
VIKTORIYA12382: calls $0.02
*** FLOP *** [Qh Jc Th]
VIKTORIYA12382: bets $0.13
elchicosinombre: folds
Vikont69: calls $0.13
*** TURN *** [Qh Jc Th] [8c]
VIKTORIYA12382: bets $0.02
Vikont69: calls $0.02
*** RIVER *** [Qh Jc Th 8c] [5d]
VIKTORIYA12382: bets $0.02
Vikont69: calls $0.02
*** SHOW DOWN ***
VIKTORIYA12382: shows [7c Kd] (high card King)
Vikont69: shows [7s Ks] (high card King)
VIKTORIYA12382 collected $0.23 from pot
Vikont69 collected $0.22 from pot
*** SUMMARY ***
Total pot $0.47 | Rake $0.02
Board [Qh Jc Th 8c 5d]
Seat 1: VIKTORIYA12382 (big blind) showed [7c Kd] and won ($0.23) with high card King
Seat 2: elchicosinombre folded on the Flop
Seat 3: Vikont69 showed [7s Ks] and won ($0.22) with high card King
Seat 4: oceter folded before Flop (didn't bet)
Seat 5: LAMUS_PL (button) folded before Flop (didn't bet)
Seat 6: Leonel cz (small blind) folded before Flop


PokerStars Hand #238170371132:  Hold'em No Limit ($0.01/$0.02 USD) - 2022/08/23 13:21:35 ET
Table 'Equinox IV' 6-max Seat #1 is the button
Seat 1: VIKTORIYA12382 ($0.45 in chips)
Seat 2: elchicosinombre ($1.84 in chips)
Seat 3: Vikont69 ($1.40 in chips)
Seat 4: oceter ($2.04 in chips)
Seat 5: LAMUS_PL ($2.47 in chips)
elchicosinombre: posts small blind $0.01
Vikont69: posts big blind $0.02
*** HOLE CARDS ***
oceter: folds
LAMUS_PL: folds
VIKTORIYA12382: folds
elchicosinombre: calls $0.01
Vikont69: checks
*** FLOP *** [5d Kc 7h]
elchicosinombre: checks
Vikont69: bets $0.02
elchicosinombre: folds
Uncalled bet ($0.02) returned to Vikont69
Vikont69 collected $0.04 from pot
*** SUMMARY ***
Total pot $0.04 | Rake $0
Board [5d Kc 7h]
Seat 1: VIKTORIYA12382 (button) folded before Flop (didn't bet)
Seat 2: elchicosinombre (small blind) folded on the Flop
Seat 3: Vikont69 (big blind) collected ($0.04)
Seat 4: oceter folded before Flop (didn't bet)
Seat 5: LAMUS_PL folded before Flop (didn't bet)


PokerStars Hand #238170381870:  Hold'em No Limit ($0.01/$0.02 USD) - 2022/08/23 13:22:09 ET
Table 'Equinox IV' 6-max Seat #2 is the button
Seat 1: VIKTORIYA12382 ($0.45 in chips)
Seat 2: elchicosinombre ($1.82 in chips)
Seat 3: Vikont69 ($1.42 in chips)
Seat 4: oceter ($2.04 in chips)
Seat 5: LAMUS_PL ($2.47 in chips)
Vikont69: posts small blind $0.01
oceter: posts big blind $0.02
*** HOLE CARDS ***
LAMUS_PL: folds
VIKTORIYA12382: folds
elchicosinombre: calls $0.02
Vikont69: raises $0.02 to $0.04
oceter: calls $0.02
elchicosinombre: calls $0.02
*** FLOP *** [8c Ad 6c]
Vikont69: bets $0.06
oceter: calls $0.06
elchicosinombre: folds
*** TURN *** [8c Ad 6c] [4h]
Vikont69: bets $0.12
oceter: calls $0.12
*** RIVER *** [8c Ad 6c 4h] [As]
Vikont69: bets $0.23
oceter: calls $0.23
*** SHOW DOWN ***
Vikont69: shows [9d Ah] (three of a kind, Aces)
oceter: shows [Ac Tc] (three of a kind, Aces - Ten kicker)
oceter collected $0.91 from pot
*** SUMMARY ***
Total pot $0.94 | Rake $0.03
Board [8c Ad 6c 4h As]
Seat 1: VIKTORIYA12382 folded before Flop (didn't bet)
Seat 2: elchicosinombre (button) folded on the Flop
Seat 3: Vikont69 (small blind) showed [9d Ah] and lost with three of a kind, Aces
Seat 4: oceter (big blind) showed [Ac Tc] and won ($0.91) with three of a kind, Aces
Seat 5: LAMUS_PL folded before Flop (didn't bet)


PokerStars Hand #238170402126:  Hold'em No Limit ($0.01/$0.02 USD) - 2022/08/23 13:23:12 ET
Table 'Equinox IV' 6-max Seat #3 is the button
Seat 1: VIKTORIYA12382 ($0.45 in chips)
Seat 2: elchicosinombre ($1.78 in chips)
Seat 3: Vikont69 ($0.97 in chips)
Seat 4: oceter ($2.50 in chips)
Seat 5: LAMUS_PL ($2.47 in chips)
Seat 6: Leonel cz ($2.23 in chips)
oceter: posts small blind $0.01
LAMUS_PL: posts big blind $0.02
*** HOLE CARDS ***
Leonel cz: folds
VIKTORIYA12382: folds
elchicosinombre: folds
Vikont69: raises $0.02 to $0.04
oceter: folds
LAMUS_PL: calls $0.02
*** FLOP *** [8h Ah 9h]
LAMUS_PL: checks
Vikont69: bets $0.02
LAMUS_PL: raises $0.09 to $0.11
Vikont69: folds
Uncalled bet ($0.09) returned to LAMUS_PL
LAMUS_PL collected $0.13 from pot
LAMUS_PL: doesn't show hand
*** SUMMARY ***
Total pot $0.13 | Rake $0
Board [8h Ah 9h]
Seat 1: VIKTORIYA12382 folded before Flop (didn't bet)
Seat 2: elchicosinombre folded before Flop (didn't bet)
Seat 3: Vikont69 (button) folded on the Flop
Seat 4: oceter (small blind) folded before Flop
Seat 5: LAMUS_PL (big blind) collected ($0.13)
Seat 6: Leonel cz folded before Flop (didn't bet)


PokerStars Hand #238170414181:  Hold'em No Limit ($0.01/$0.02 USD) - 2022/08/23 13:23:49 ET
Table 'Equinox IV' 6-max Seat #4 is the button
Seat 1: VIKTORIYA12382 ($0.45 in chips)
Seat 2: elchicosinombre ($1.78 in chips)
Seat 3: Vikont69 ($0.91 in chips)
Seat 4: oceter ($2.49 in chips)
Seat 5: LAMUS_PL ($2.54 in chips)
Seat 6: Leonel cz ($2.23 in chips)
LAMUS_PL: posts small blind $0.01
Leonel cz: posts big blind $0.02
*** HOLE CARDS ***
VIKTORIYA12382: calls $0.02
elchicosinombre: raises $0.02 to $0.04
Vikont69: folds
Vikont69 leaves the table
oceter: folds
ShrimpMania joins the table at seat #3
LAMUS_PL: folds
Leonel cz: folds
VIKTORIYA12382: calls $0.02
*** FLOP *** [2h 8s 7d]
VIKTORIYA12382: checks
elchicosinombre: checks
*** TURN *** [2h 8s 7d] [Ts]
VIKTORIYA12382: bets $0.02
elchicosinombre: calls $0.02
*** RIVER *** [2h 8s 7d Ts] [Kd]
VIKTORIYA12382: checks
elchicosinombre: checks
*** SHOW DOWN ***
VIKTORIYA12382: shows [4h 6d] (high card King)
elchicosinombre: shows [Jd 8d] (a pair of Eights)
elchicosinombre collected $0.14 from pot
*** SUMMARY ***
Total pot $0.15 | Rake $0.01
Board [2h 8s 7d Ts Kd]
Seat 1: VIKTORIYA12382 showed [4h 6d] and lost with high card King
Seat 2: elchicosinombre showed [Jd 8d] and won ($0.14) with a pair of Eights
Seat 3: Vikont69 folded before Flop (didn't bet)
Seat 4: oceter (button) folded before Flop (didn't bet)
Seat 5: LAMUS_PL (small blind) folded before Flop
Seat 6: Leonel cz (big blind) folded before Flop


PokerStars Hand #238170429372:  Hold'em No Limit ($0.01/$0.02 USD) - 2022/08/23 13:24:36 ET
Table 'Equinox IV' 6-max Seat #5 is the button
Seat 1: VIKTORIYA12382 ($0.39 in chips)
Seat 2: elchicosinombre ($1.86 in chips)
Seat 4: oceter ($2.49 in chips)
Seat 5: LAMUS_PL ($2.53 in chips)
Seat 6: Leonel cz ($2.21 in chips)
Leonel cz: posts small blind $0.01
VIKTORIYA12382: posts big blind $0.02
ShrimpMania: sits out
*** HOLE CARDS ***
elchicosinombre: folds
oceter: folds
LAMUS_PL: folds
Leonel cz: folds
Uncalled bet ($0.01) returned to VIKTORIYA12382
VIKTORIYA12382 collected $0.02 from pot
*** SUMMARY ***
Total pot $0.02 | Rake $0
Seat 1: VIKTORIYA12382 (big blind) collected ($0.02)
Seat 2: elchicosinombre folded before Flop (didn't bet)
Seat 4: oceter folded before Flop (didn't bet)
Seat 5: LAMUS_PL (button) folded before Flop (didn't bet)
Seat 6: Leonel cz (small blind) folded before Flop


PokerStars Hand #238170433836:  Hold'em No Limit ($0.01/$0.02 USD) - 2022/08/23 13:24:50 ET
Table 'Equinox IV' 6-max Seat #6 is the button
Seat 1: VIKTORIYA12382 ($0.40 in chips)
Seat 2: elchicosinombre ($1.86 in chips)
Seat 4: oceter ($2.49 in chips)
Seat 5: LAMUS_PL ($2.53 in chips)
Seat 6: Leonel cz ($2.20 in chips)
VIKTORIYA12382: posts small blind $0.01
elchicosinombre: posts big blind $0.02
ShrimpMania: sits out
*** HOLE CARDS ***
oceter: folds
LAMUS_PL: raises $0.03 to $0.05
Leonel cz: folds
VIKTORIYA12382: folds
elchicosinombre: folds
Uncalled bet ($0.03) returned to LAMUS_PL
LAMUS_PL collected $0.05 from pot
LAMUS_PL: doesn't show hand
*** SUMMARY ***
Total pot $0.05 | Rake $0
Seat 1: VIKTORIYA12382 (small blind) folded before Flop
Seat 2: elchicosinombre (big blind) folded before Flop
Seat 4: oceter folded before Flop (didn't bet)
Seat 5: LAMUS_PL collected ($0.05)
Seat 6: Leonel cz (button) folded before Flop (didn't bet)


PokerStars Hand #238170437753:  Hold'em No Limit ($0.01/$0.02 USD) - 2022/08/23 13:25:02 ET
Table 'Equinox IV' 6-max Seat #1 is the button
Seat 1: VIKTORIYA12382 ($0.39 in chips)
Seat 2: elchicosinombre ($1.84 in chips)
Seat 3: ShrimpMania ($2 in chips)
Seat 4: oceter ($2.49 in chips)
Seat 5: LAMUS_PL ($2.56 in chips)
Seat 6: Leonel cz ($2.20 in chips)
elchicosinombre: posts small blind $0.01
ShrimpMania: posts big blind $0.02
*** HOLE CARDS ***
oceter: folds
LAMUS_PL: folds
Leonel cz: folds
VIKTORIYA12382: calls $0.02
elchicosinombre: folds
ShrimpMania: checks
*** FLOP *** [Jd 7h 9h]
ShrimpMania: checks
VIKTORIYA12382: checks
*** TURN *** [Jd 7h 9h] [6c]
ShrimpMania: checks
VIKTORIYA12382: checks
*** RIVER *** [Jd 7h 9h 6c] [9s]
ShrimpMania: checks
VIKTORIYA12382: checks
*** SHOW DOWN ***
ShrimpMania: shows [6h Qd] (two pair, Nines and Sixes)
VIKTORIYA12382: mucks hand
ShrimpMania collected $0.05 from pot
*** SUMMARY ***
Total pot $0.05 | Rake $0
Board [Jd 7h 9h 6c 9s]
Seat 1: VIKTORIYA12382 (button) mucked
Seat 2: elchicosinombre (small blind) folded before Flop
Seat 3: ShrimpMania (big blind) showed [6h Qd] and won ($0.05) with two pair, Nines and Sixes
Seat 4: oceter folded before Flop (didn't bet)
Seat 5: LAMUS_PL folded before Flop (didn't bet)
Seat 6: Leonel cz folded before Flop (didn't bet)


PokerStars Hand #238170446813:  Hold'em No Limit ($0.01/$0.02 USD) - 2022/08/23 13:25:31 ET
Table 'Equinox IV' 6-max Seat #2 is the button
Seat 1: VIKTORIYA12382 ($0.37 in chips)
Seat 2: elchicosinombre ($1.83 in chips)
Seat 3: ShrimpMania ($2.03 in chips)
Seat 4: oceter ($2.49 in chips)
Seat 5: LAMUS_PL ($2.56 in chips)
Seat 6: Leonel cz ($2.20 in chips)
ShrimpMania: posts small blind $0.01
oceter: posts big blind $0.02
*** HOLE CARDS ***
LAMUS_PL: raises $0.04 to $0.06
Leonel cz: calls $0.06
VIKTORIYA12382: calls $0.06
elchicosinombre: raises $0.04 to $0.10
ShrimpMania: folds
oceter: folds
LAMUS_PL: calls $0.04
Leonel cz: calls $0.04
VIKTORIYA12382: calls $0.04
*** FLOP *** [3c 9d Qh]
LAMUS_PL: checks
Leonel cz: bets $0.10
VIKTORIYA12382: folds
elchicosinombre: calls $0.10
LAMUS_PL: folds
*** TURN *** [3c 9d Qh] [Js]
Leonel cz: checks
elchicosinombre: checks
*** RIVER *** [3c 9d Qh Js] [9c]
Leonel cz: checks
elchicosinombre: bets $0.30
Leonel cz: folds
Uncalled bet ($0.30) returned to elchicosinombre
elchicosinombre collected $0.61 from pot
*** SUMMARY ***
Total pot $0.63 | Rake $0.02
Board [3c 9d Qh Js 9c]
Seat 1: VIKTORIYA12382 folded on the Flop
Seat 2: elchicosinombre (button) collected ($0.61)
Seat 3: ShrimpMania (small blind) folded before Flop
Seat 4: oceter (big blind) folded before Flop
Seat 5: LAMUS_PL folded on the Flop
Seat 6: Leonel cz folded on the River


PokerStars Hand #238170472061:  Hold'em No Limit ($0.01/$0.02 USD) - 2022/08/23 13:26:49 ET
Table 'Equinox IV' 6-max Seat #3 is the button
Seat 1: VIKTORIYA12382 ($0.27 in chips)
Seat 2: elchicosinombre ($2.24 in chips)
Seat 3: ShrimpMania ($2.02 in chips)
Seat 4: oceter ($2.47 in chips)
Seat 5: LAMUS_PL ($2.46 in chips)
Seat 6: Leonel cz ($2 in chips)
oceter: posts small blind $0.01
LAMUS_PL: posts big blind $0.02
*** HOLE CARDS ***
Leonel cz: folds
VIKTORIYA12382: folds
elchicosinombre: folds
ShrimpMania: folds
oceter: folds
Uncalled bet ($0.01) returned to LAMUS_PL
LAMUS_PL collected $0.02 from pot
LAMUS_PL: doesn't show hand
*** SUMMARY ***
Total pot $0.02 | Rake $0
Seat 1: VIKTORIYA12382 folded before Flop (didn't bet)
Seat 2: elchicosinombre folded before Flop (didn't bet)
Seat 3: ShrimpMania (button) folded before Flop (didn't bet)
Seat 4: oceter (small blind) folded before Flop
Seat 5: LAMUS_PL (big blind) collected ($0.02)
Seat 6: Leonel cz folded before Flop (didn't bet)


PokerStars Hand #238170475804:  Hold'em No Limit ($0.01/$0.02 USD) - 2022/08/23 13:27:01 ET
Table 'Equinox IV' 6-max Seat #4 is the button
Seat 1: VIKTORIYA12382 ($0.27 in chips)
Seat 2: elchicosinombre ($2.24 in chips)
Seat 3: ShrimpMania ($2.02 in chips)
Seat 4: oceter ($2.46 in chips)
Seat 5: LAMUS_PL ($2.47 in chips)
Seat 6: Leonel cz ($2 in chips)
LAMUS_PL: posts small blind $0.01
Leonel cz: posts big blind $0.02
*** HOLE CARDS ***
VIKTORIYA12382: folds
elchicosinombre: raises $0.04 to $0.06
ShrimpMania: folds
oceter: folds
LAMUS_PL: folds
Leonel cz: folds
Uncalled bet ($0.04) returned to elchicosinombre
elchicosinombre collected $0.05 from pot
*** SUMMARY ***
Total pot $0.05 | Rake $0
Seat 1: VIKTORIYA12382 folded before Flop (didn't bet)
Seat 2: elchicosinombre collected ($0.05)
Seat 3: ShrimpMania folded before Flop (didn't bet)
Seat 4: oceter (button) folded before Flop (didn't bet)
Seat 5: LAMUS_PL (small blind) folded before Flop
Seat 6: Leonel cz (big blind) folded before Flop


PokerStars Hand #238170481298:  Hold'em No Limit ($0.01/$0.02 USD) - 2022/08/23 13:27:18 ET
Table 'Equinox IV' 6-max Seat #5 is the button
Seat 1: VIKTORIYA12382 ($0.27 in chips)
Seat 2: elchicosinombre ($2.27 in chips)
Seat 3: ShrimpMania ($2.02 in chips)
Seat 4: oceter ($2.46 in chips)
Seat 5: LAMUS_PL ($2.46 in chips)
Seat 6: Leonel cz ($2 in chips)
Leonel cz: posts small blind $0.01
VIKTORIYA12382: posts big blind $0.02
*** HOLE CARDS ***
elchicosinombre: folds
ShrimpMania: folds
oceter: folds
LAMUS_PL: raises $0.02 to $0.04
Leonel cz: raises $0.16 to $0.20
VIKTORIYA12382: raises $0.07 to $0.27 and is all-in
LAMUS_PL: folds
Leonel cz: calls $0.07
*** FLOP *** [6s 7d 2h]
*** TURN *** [6s 7d 2h] [Ad]
*** RIVER *** [6s 7d 2h Ad] [2s]
*** SHOW DOWN ***
Leonel cz: shows [Ks Qs] (a pair of Deuces)
VIKTORIYA12382: shows [Qd Th] (a pair of Deuces - lower kicker)
Leonel cz collected $0.56 from pot
*** SUMMARY ***
Total pot $0.58 | Rake $0.02
Board [6s 7d 2h Ad 2s]
Seat 1: VIKTORIYA12382 (big blind) showed [Qd Th] and lost with a pair of Deuces
Seat 2: elchicosinombre folded before Flop (didn't bet)
Seat 3: ShrimpMania folded before Flop (didn't bet)
Seat 4: oceter folded before Flop (didn't bet)
Seat 5: LAMUS_PL (button) folded before Flop
Seat 6: Leonel cz (small blind) showed [Ks Qs] and won ($0.56) with a pair of Deuces


PokerStars Hand #238170492629:  Hold'em No Limit ($0.01/$0.02 USD) - 2022/08/23 13:27:53 ET
Table 'Equinox IV' 6-max Seat #6 is the button
Seat 2: elchicosinombre ($2.27 in chips)
Seat 3: ShrimpMania ($2.02 in chips)
Seat 4: oceter ($2.46 in chips)
Seat 5: LAMUS_PL ($2.42 in chips)
Seat 6: Leonel cz ($2.29 in chips)
VIKTORIYA12382 leaves the table
elchicosinombre: posts small blind $0.01
ShrimpMania: posts big blind $0.02
*** HOLE CARDS ***
oceter: folds
joeeic13 joins the table at seat #1
LAMUS_PL: folds
Leonel cz: folds
elchicosinombre: raises $0.04 to $0.06
ShrimpMania: folds
Uncalled bet ($0.04) returned to elchicosinombre
elchicosinombre collected $0.04 from pot
*** SUMMARY ***
Total pot $0.04 | Rake $0
Seat 2: elchicosinombre (small blind) collected ($0.04)
Seat 3: ShrimpMania (big blind) folded before Flop
Seat 4: oceter folded before Flop (didn't bet)
Seat 5: LAMUS_PL folded before Flop (didn't bet)
Seat 6: Leonel cz (button) folded before Flop (didn't bet)


PokerStars Hand #238170501775:  Hold'em No Limit ($0.01/$0.02 USD) - 2022/08/23 13:28:22 ET
Table 'Equinox IV' 6-max Seat #2 is the button
Seat 1: joeeic13 ($0.80 in chips)
Seat 2: elchicosinombre ($2.29 in chips)
Seat 3: ShrimpMania ($2 in chips)
Seat 5: LAMUS_PL ($2.42 in chips)
Seat 6: Leonel cz ($2.29 in chips)
ShrimpMania: posts small blind $0.01
oceter: is sitting out
LAMUS_PL: posts big blind $0.02
joeeic13: posts big blind $0.02
*** HOLE CARDS ***
oceter leaves the table
Leonel cz: folds
munyó joins the table at seat #4
joeeic13: checks
elchicosinombre: raises $0.08 to $0.10
ShrimpMania: folds
LAMUS_PL: folds
joeeic13: calls $0.08
*** FLOP *** [5h Kd Qs]
joeeic13: checks
elchicosinombre: bets $0.15
joeeic13: folds
Uncalled bet ($0.15) returned to elchicosinombre
elchicosinombre collected $0.22 from pot
*** SUMMARY ***
Total pot $0.23 | Rake $0.01
Board [5h Kd Qs]
Seat 1: joeeic13 folded on the Flop
Seat 2: elchicosinombre (button) collected ($0.22)
Seat 3: ShrimpMania (small blind) folded before Flop
Seat 5: LAMUS_PL (big blind) folded before Flop
Seat 6: Leonel cz folded before Flop (didn't bet)


PokerStars Hand #238170514784:  Hold'em No Limit ($0.01/$0.02 USD) - 2022/08/23 13:29:02 ET
Table 'Equinox IV' 6-max Seat #3 is the button
Seat 1: joeeic13 ($0.70 in chips)
Seat 2: elchicosinombre ($2.41 in chips)
Seat 3: ShrimpMania ($2 in chips)
Seat 5: LAMUS_PL ($2.40 in chips)
Seat 6: Leonel cz ($2.29 in chips)
LAMUS_PL: posts small blind $0.01
Leonel cz: posts big blind $0.02
*** HOLE CARDS ***
joeeic13: calls $0.02
elchicosinombre: calls $0.02
ShrimpMania: folds
LAMUS_PL: folds
Leonel cz: checks
*** FLOP *** [6d 5c 6h]
Leonel cz: checks
joeeic13: checks
elchicosinombre: checks
*** TURN *** [6d 5c 6h] [4c]
Leonel cz: checks
joeeic13: checks
elchicosinombre: checks
*** RIVER *** [6d 5c 6h 4c] [Kd]
Leonel cz: checks
joeeic13: bets $0.02
elchicosinombre: raises $0.05 to $0.07
Leonel cz: folds
joeeic13: folds
Uncalled bet ($0.05) returned to elchicosinombre
elchicosinombre collected $0.11 from pot
*** SUMMARY ***
Total pot $0.11 | Rake $0
Board [6d 5c 6h 4c Kd]
Seat 1: joeeic13 folded on the River
Seat 2: elchicosinombre collected ($0.11)
Seat 3: ShrimpMania (button) folded before Flop (didn't bet)
Seat 5: LAMUS_PL (small blind) folded before Flop
Seat 6: Leonel cz (big blind) folded on the River


PokerStars Hand #238170531675:  Hold'em No Limit ($0.01/$0.02 USD) - 2022/08/23 13:29:55 ET
Table 'Equinox IV' 6-max Seat #5 is the button
Seat 1: joeeic13 ($0.66 in chips)
Seat 2: elchicosinombre ($2.48 in chips)
Seat 3: ShrimpMania ($2 in chips)
Seat 4: munyó ($1.60 in chips)
Seat 5: LAMUS_PL ($2.39 in chips)
Seat 6: Leonel cz ($2.27 in chips)
Leonel cz: posts small blind $0.01
joeeic13: posts big blind $0.02
munyó: posts big blind $0.02
*** HOLE CARDS ***
elchicosinombre: folds
ShrimpMania: folds
munyó: checks
LAMUS_PL: raises $0.06 to $0.08
Leonel cz: folds
joeeic13: calls $0.06
munyó: folds
*** FLOP *** [3s 6d 4d]
joeeic13: bets $0.02
LAMUS_PL: calls $0.02
*** TURN *** [3s 6d 4d] [Jc]
joeeic13: bets $0.02
LAMUS_PL: calls $0.02
*** RIVER *** [3s 6d 4d Jc] [Qs]
joeeic13: bets $0.08
LAMUS_PL: folds
Uncalled bet ($0.08) returned to joeeic13
joeeic13 collected $0.26 from pot
*** SUMMARY ***
Total pot $0.27 | Rake $0.01
Board [3s 6d 4d Jc Qs]
Seat 1: joeeic13 (big blind) collected ($0.26)
Seat 2: elchicosinombre folded before Flop (didn't bet)
Seat 3: ShrimpMania folded before Flop (didn't bet)
Seat 4: munyó folded before Flop (didn't bet)
Seat 5: LAMUS_PL (button) folded on the River
Seat 6: Leonel cz (small blind) folded before Flop


PokerStars Hand #238170545268:  Hold'em No Limit ($0.01/$0.02 USD) - 2022/08/23 13:30:36 ET
Table 'Equinox IV' 6-max Seat #6 is the button
Seat 1: joeeic13 ($0.80 in chips)
Seat 2: elchicosinombre ($2.48 in chips)
Seat 3: ShrimpMania ($2 in chips)
Seat 4: munyó ($1.58 in chips)
Seat 5: LAMUS_PL ($2.27 in chips)
Seat 6: Leonel cz ($2.26 in chips)
joeeic13: posts small blind $0.01
elchicosinombre: posts big blind $0.02
*** HOLE CARDS ***
ShrimpMania: raises $0.04 to $0.06
munyó: folds
LAMUS_PL: folds
Leonel cz: folds
joeeic13: calls $0.05
elchicosinombre: calls $0.04
*** FLOP *** [8d Ad Kd]
joeeic13: bets $0.02
elchicosinombre: folds
ShrimpMania: raises $0.12 to $0.14
joeeic13: calls $0.12
*** TURN *** [8d Ad Kd] [Td]
joeeic13: bets $0.02
ShrimpMania: folds
Uncalled bet ($0.02) returned to joeeic13
joeeic13 collected $0.44 from pot
*** SUMMARY ***
Total pot $0.46 | Rake $0.02
Board [8d Ad Kd Td]
Seat 1: joeeic13 (small blind) collected ($0.44)
Seat 2: elchicosinombre (big blind) folded on the Flop
Seat 3: ShrimpMania folded on the Turn
Seat 4: munyó folded before Flop (didn't bet)
Seat 5: LAMUS_PL folded before Flop (didn't bet)
Seat 6: Leonel cz (button) folded before Flop (didn't bet)


PokerStars Hand #238170559565:  Hold'em No Limit ($0.01/$0.02 USD) - 2022/08/23 13:31:19 ET
Table 'Equinox IV' 6-max Seat #1 is the button
Seat 1: joeeic13 ($1.04 in chips)
Seat 2: elchicosinombre ($2.42 in chips)
Seat 3: ShrimpMania ($2 in chips)
Seat 4: munyó ($1.58 in chips)
Seat 5: LAMUS_PL ($2.27 in chips)
Seat 6: Leonel cz ($2.26 in chips)
elchicosinombre: posts small blind $0.01
ShrimpMania: posts big blind $0.02
*** HOLE CARDS ***
munyó: calls $0.02
LAMUS_PL: raises $0.06 to $0.08
Leonel cz: folds
joeeic13: calls $0.08
elchicosinombre: folds
ShrimpMania: folds
munyó: folds
*** FLOP *** [Ac 7d 3c]
LAMUS_PL: bets $0.13
joeeic13: folds
Uncalled bet ($0.13) returned to LAMUS_PL
LAMUS_PL collected $0.20 from pot
LAMUS_PL: doesn't show hand
*** SUMMARY ***
Total pot $0.21 | Rake $0.01
Board [Ac 7d 3c]
Seat 1: joeeic13 (button) folded on the Flop
Seat 2: elchicosinombre (small blind) folded before Flop
Seat 3: ShrimpMania (big blind) folded before Flop
Seat 4: munyó folded before Flop
Seat 5: LAMUS_PL collected ($0.20)
Seat 6: Leonel cz folded before Flop (didn't bet)


PokerStars Hand #238170575082:  Hold'em No Limit ($0.01/$0.02 USD) - 2022/08/23 13:32:05 ET
Table 'Equinox IV' 6-max Seat #2 is the button
Seat 1: joeeic13 ($0.96 in chips)
Seat 2: elchicosinombre ($2.41 in chips)
Seat 3: ShrimpMania ($2 in chips)
Seat 4: munyó ($1.56 in chips)
Seat 5: LAMUS_PL ($2.39 in chips)
Seat 6: Leonel cz ($2.26 in chips)
ShrimpMania: posts small blind $0.01
munyó: posts big blind $0.02
*** HOLE CARDS ***
LAMUS_PL: folds
Leonel cz: folds
joeeic13: folds
elchicosinombre: calls $0.02
ShrimpMania: folds
munyó: checks
*** FLOP *** [As 5h Qs]
munyó: checks
elchicosinombre: bets $0.02
munyó: folds
Uncalled bet ($0.02) returned to elchicosinombre
elchicosinombre collected $0.05 from pot
*** SUMMARY ***
Total pot $0.05 | Rake $0
Board [As 5h Qs]
Seat 1: joeeic13 folded before Flop (didn't bet)
Seat 2: elchicosinombre (button) collected ($0.05)
Seat 3: ShrimpMania (small blind) folded before Flop
Seat 4: munyó (big blind) folded on the Flop
Seat 5: LAMUS_PL folded before Flop (didn't bet)
Seat 6: Leonel cz folded before Flop (didn't bet)


PokerStars Hand #238170581230:  Hold'em No Limit ($0.01/$0.02 USD) - 2022/08/23 13:32:24 ET
Table 'Equinox IV' 6-max Seat #3 is the button
Seat 1: joeeic13 ($0.96 in chips)
Seat 2: elchicosinombre ($2.44 in chips)
Seat 3: ShrimpMania ($2 in chips)
Seat 4: munyó ($1.54 in chips)
Seat 5: LAMUS_PL ($2.39 in chips)
Seat 6: Leonel cz ($2.26 in chips)
munyó: posts small blind $0.01
LAMUS_PL: posts big blind $0.02
*** HOLE CARDS ***
Leonel cz: folds
joeeic13: folds
elchicosinombre: folds
ShrimpMania: folds
munyó: calls $0.01
LAMUS_PL: checks
*** FLOP *** [Qd 6c Td]
munyó: checks
LAMUS_PL: checks
*** TURN *** [Qd 6c Td] [Ts]
munyó: checks
LAMUS_PL: bets $0.02
munyó: folds
Uncalled bet ($0.02) returned to LAMUS_PL
LAMUS_PL collected $0.04 from pot
LAMUS_PL: doesn't show hand
*** SUMMARY ***
Total pot $0.04 | Rake $0
Board [Qd 6c Td Ts]
Seat 1: joeeic13 folded before Flop (didn't bet)
Seat 2: elchicosinombre folded before Flop (didn't bet)
Seat 3: ShrimpMania (button) folded before Flop (didn't bet)
Seat 4: munyó (small blind) folded on the Turn
Seat 5: LAMUS_PL (big blind) collected ($0.04)
Seat 6: Leonel cz folded before Flop (didn't bet)


PokerStars Hand #238170591988:  Hold'em No Limit ($0.01/$0.02 USD) - 2022/08/23 13:32:56 ET
Table 'Equinox IV' 6-max Seat #4 is the button
Seat 1: joeeic13 ($0.96 in chips)
Seat 2: elchicosinombre ($2.44 in chips)
Seat 3: ShrimpMania ($2 in chips)
Seat 4: munyó ($1.52 in chips)
Seat 5: LAMUS_PL ($2.41 in chips)
Seat 6: Leonel cz ($2.26 in chips)
LAMUS_PL: posts small blind $0.01
Leonel cz: posts big blind $0.02
*** HOLE CARDS ***
joeeic13: folds
elchicosinombre: raises $0.02 to $0.04
ShrimpMania: folds
munyó: folds
LAMUS_PL: folds
Leonel cz: folds
Uncalled bet ($0.02) returned to elchicosinombre
elchicosinombre collected $0.05 from pot
*** SUMMARY ***
Total pot $0.05 | Rake $0
Seat 1: joeeic13 folded before Flop (didn't bet)
Seat 2: elchicosinombre collected ($0.05)
Seat 3: ShrimpMania folded before Flop (didn't bet)
Seat 4: munyó (button) folded before Flop (didn't bet)
Seat 5: LAMUS_PL (small blind) folded before Flop
Seat 6: Leonel cz (big blind) folded before Flop


PokerStars Hand #238170597165:  Hold'em No Limit ($0.01/$0.02 USD) - 2022/08/23 13:33:11 ET
Table 'Equinox IV' 6-max Seat #5 is the button
Seat 1: joeeic13 ($0.96 in chips)
Seat 2: elchicosinombre ($2.47 in chips)
Seat 3: ShrimpMania ($2 in chips)
Seat 4: munyó ($1.52 in chips)
Seat 5: LAMUS_PL ($2.40 in chips)
Seat 6: Leonel cz ($2.24 in chips)
Leonel cz: posts small blind $0.01
joeeic13: posts big blind $0.02
*** HOLE CARDS ***
elchicosinombre: calls $0.02
ShrimpMania: folds
munyó: calls $0.02
LAMUS_PL: folds
Leonel cz: raises $0.10 to $0.12
joeeic13: folds
elchicosinombre: folds
munyó: folds
Uncalled bet ($0.10) returned to Leonel cz
Leonel cz collected $0.08 from pot
Leonel cz: doesn't show hand
*** SUMMARY ***
Total pot $0.08 | Rake $0
Seat 1: joeeic13 (big blind) folded before Flop
Seat 2: elchicosinombre folded before Flop
Seat 3: ShrimpMania folded before Flop (didn't bet)
Seat 4: munyó folded before Flop
Seat 5: LAMUS_PL (button) folded before Flop (didn't bet)
Seat 6: Leonel cz (small blind) collected ($0.08)


PokerStars Hand #238170605887:  Hold'em No Limit ($0.01/$0.02 USD) - 2022/08/23 13:33:37 ET
Table 'Equinox IV' 6-max Seat #6 is the button
Seat 1: joeeic13 ($0.94 in chips)
Seat 2: elchicosinombre ($2.45 in chips)
Seat 3: ShrimpMania ($2 in chips)
Seat 4: munyó ($1.50 in chips)
Seat 5: LAMUS_PL ($2.40 in chips)
Seat 6: Leonel cz ($2.30 in chips)
joeeic13: posts small blind $0.01
elchicosinombre: posts big blind $0.02
*** HOLE CARDS ***
ShrimpMania: folds
munyó: folds
LAMUS_PL: raises $0.03 to $0.05
Leonel cz: folds
joeeic13: calls $0.04
elchicosinombre: folds
*** FLOP *** [Ah 8c Qh]
joeeic13: checks
LAMUS_PL: bets $0.08
joeeic13: folds
Uncalled bet ($0.08) returned to LAMUS_PL
LAMUS_PL collected $0.12 from pot
LAMUS_PL: doesn't show hand
*** SUMMARY ***
Total pot $0.12 | Rake $0
Board [Ah 8c Qh]
Seat 1: joeeic13 (small blind) folded on the Flop
Seat 2: elchicosinombre (big blind) folded before Flop
Seat 3: ShrimpMania folded before Flop (didn't bet)
Seat 4: munyó folded before Flop (didn't bet)
Seat 5: LAMUS_PL collected ($0.12)
Seat 6: Leonel cz (button) folded before Flop (didn't bet)


PokerStars Hand #238170614739:  Hold'em No Limit ($0.01/$0.02 USD) - 2022/08/23 13:34:03 ET
Table 'Equinox IV' 6-max Seat #1 is the button
Seat 1: joeeic13 ($0.89 in chips)
Seat 2: elchicosinombre ($2.43 in chips)
Seat 3: ShrimpMania ($2 in chips)
Seat 4: munyó ($1.50 in chips)
Seat 5: LAMUS_PL ($2.47 in chips)
Seat 6: Leonel cz ($2.30 in chips)
elchicosinombre: posts small blind $0.01
ShrimpMania: posts big blind $0.02
*** HOLE CARDS ***
munyó: folds
LAMUS_PL: raises $0.04 to $0.06
Leonel cz: folds
joeeic13: calls $0.06
elchicosinombre: folds
ShrimpMania: folds
*** FLOP *** [4c Qc 7c]
LAMUS_PL: bets $0.09
joeeic13: folds
Uncalled bet ($0.09) returned to LAMUS_PL
LAMUS_PL collected $0.14 from pot
LAMUS_PL: doesn't show hand
*** SUMMARY ***
Total pot $0.15 | Rake $0.01
Board [4c Qc 7c]
Seat 1: joeeic13 (button) folded on the Flop
Seat 2: elchicosinombre (small blind) folded before Flop
Seat 3: ShrimpMania (big blind) folded before Flop
Seat 4: munyó folded before Flop (didn't bet)
Seat 5: LAMUS_PL collected ($0.14)
Seat 6: Leonel cz folded before Flop (didn't bet)


PokerStars Hand #238170624417:  Hold'em No Limit ($0.01/$0.02 USD) - 2022/08/23 13:34:31 ET
Table 'Equinox IV' 6-max Seat #2 is the button
Seat 1: joeeic13 ($0.83 in chips)
Seat 2: elchicosinombre ($2.42 in chips)
Seat 3: ShrimpMania ($2 in chips)
Seat 4: munyó ($1.50 in chips)
Seat 5: LAMUS_PL ($2.55 in chips)
Seat 6: Leonel cz ($2.30 in chips)
ShrimpMania: posts small blind $0.01
munyó: posts big blind $0.02
*** HOLE CARDS ***
LAMUS_PL: folds
Leonel cz: folds
joeeic13: calls $0.02
elchicosinombre: folds
ShrimpMania: calls $0.01
munyó: raises $0.04 to $0.06
joeeic13: calls $0.04
ShrimpMania: folds
*** FLOP *** [7h 6c 9h]
munyó: bets $0.07
joeeic13: calls $0.07
*** TURN *** [7h 6c 9h] [4h]
munyó: checks
joeeic13: checks
*** RIVER *** [7h 6c 9h 4h] [Kh]
munyó: checks
joeeic13: checks
*** SHOW DOWN ***
munyó: shows [Ad Jd] (high card Ace)
joeeic13: shows [Ac Qh] (a flush, King high)
joeeic13 collected $0.27 from pot
*** SUMMARY ***
Total pot $0.28 | Rake $0.01
Board [7h 6c 9h 4h Kh]
Seat 1: joeeic13 showed [Ac Qh] and won ($0.27) with a flush, King high
Seat 2: elchicosinombre (button) folded before Flop (didn't bet)
Seat 3: ShrimpMania (small blind) folded before Flop
Seat 4: munyó (big blind) showed [Ad Jd] and lost with high card Ace
Seat 5: LAMUS_PL folded before Flop (didn't bet)
Seat 6: Leonel cz folded before Flop (didn't bet)


PokerStars Hand #238170640886:  Hold'em No Limit ($0.01/$0.02 USD) - 2022/08/23 13:35:20 ET
Table 'Equinox IV' 6-max Seat #3 is the button
Seat 1: joeeic13 ($0.97 in chips)
Seat 2: elchicosinombre ($2.42 in chips)
Seat 3: ShrimpMania ($2 in chips)
Seat 4: munyó ($1.37 in chips)
Seat 5: LAMUS_PL ($2.55 in chips)
Seat 6: Leonel cz ($2.30 in chips)
munyó: posts small blind $0.01
LAMUS_PL: posts big blind $0.02
*** HOLE CARDS ***
Leonel cz: folds
joeeic13: folds
elchicosinombre: folds
ShrimpMania: raises $0.03 to $0.05
munyó: calls $0.04
LAMUS_PL: folds
*** FLOP *** [5d Ad Qh]
munyó: checks
ShrimpMania: checks
*** TURN *** [5d Ad Qh] [8h]
munyó: checks
ShrimpMania: checks
*** RIVER *** [5d Ad Qh 8h] [6d]
munyó: checks
ShrimpMania: checks
*** SHOW DOWN ***
munyó: shows [Kc Jh] (high card Ace)
ShrimpMania: shows [9c 8c] (a pair of Eights)
ShrimpMania collected $0.12 from pot
*** SUMMARY ***
Total pot $0.12 | Rake $0
Board [5d Ad Qh 8h 6d]
Seat 1: joeeic13 folded before Flop (didn't bet)
Seat 2: elchicosinombre folded before Flop (didn't bet)
Seat 3: ShrimpMania (button) showed [9c 8c] and won ($0.12) with a pair of Eights
Seat 4: munyó (small blind) showed [Kc Jh] and lost with high card Ace
Seat 5: LAMUS_PL (big blind) folded before Flop
Seat 6: Leonel cz folded before Flop (didn't bet)


PokerStars Hand #238170655931:  Hold'em No Limit ($0.01/$0.02 USD) - 2022/08/23 13:36:04 ET
Table 'Equinox IV' 6-max Seat #4 is the button
Seat 1: joeeic13 ($0.97 in chips)
Seat 2: elchicosinombre ($2.42 in chips)
Seat 3: ShrimpMania ($2.07 in chips)
Seat 4: munyó ($1.32 in chips)
Seat 5: LAMUS_PL ($2.53 in chips)
Seat 6: Leonel cz ($2.30 in chips)
LAMUS_PL: posts small blind $0.01
Leonel cz: posts big blind $0.02
*** HOLE CARDS ***
joeeic13: folds
elchicosinombre: folds
ShrimpMania: folds
munyó: folds
LAMUS_PL: folds
Uncalled bet ($0.01) returned to Leonel cz
Leonel cz collected $0.02 from pot
Leonel cz: doesn't show hand
*** SUMMARY ***
Total pot $0.02 | Rake $0
Seat 1: joeeic13 folded before Flop (didn't bet)
Seat 2: elchicosinombre folded before Flop (didn't bet)
Seat 3: ShrimpMania folded before Flop (didn't bet)
Seat 4: munyó (button) folded before Flop (didn't bet)
Seat 5: LAMUS_PL (small blind) folded before Flop
Seat 6: Leonel cz (big blind) collected ($0.02)


PokerStars Hand #238170664340:  Hold'em No Limit ($0.01/$0.02 USD) - 2022/08/23 13:36:29 ET
Table 'Equinox IV' 6-max Seat #5 is the button
Seat 1: joeeic13 ($0.97 in chips)
Seat 2: elchicosinombre ($2.42 in chips)
Seat 3: ShrimpMania ($2.07 in chips)
Seat 4: munyó ($1.32 in chips)
Seat 5: LAMUS_PL ($2.52 in chips)
Seat 6: Leonel cz ($2.31 in chips)
Leonel cz: posts small blind $0.01
joeeic13: posts big blind $0.02
*** HOLE CARDS ***
elchicosinombre: calls $0.02
ShrimpMania: folds
munyó: calls $0.02
LAMUS_PL: folds
Leonel cz: folds
joeeic13: checks
*** FLOP *** [9s 6s 3c]
joeeic13: bets $0.02
elchicosinombre: calls $0.02
munyó: calls $0.02
*** TURN *** [9s 6s 3c] [Qh]
joeeic13: checks
elchicosinombre: checks
munyó: checks
*** RIVER *** [9s 6s 3c Qh] [Qd]
joeeic13: bets $0.02
elchicosinombre: calls $0.02
munyó: folds
*** SHOW DOWN ***
joeeic13: shows [2s 2c] (two pair, Queens and Deuces)
elchicosinombre: shows [Js 9d] (two pair, Queens and Nines)
elchicosinombre collected $0.16 from pot
*** SUMMARY ***
Total pot $0.17 | Rake $0.01
Board [9s 6s 3c Qh Qd]
Seat 1: joeeic13 (big blind) showed [2s 2c] and lost with two pair, Queens and Deuces
Seat 2: elchicosinombre showed [Js 9d] and won ($0.16) with two pair, Queens and Nines
Seat 3: ShrimpMania folded before Flop (didn't bet)
Seat 4: munyó folded on the River
Seat 5: LAMUS_PL (button) folded before Flop (didn't bet)
Seat 6: Leonel cz (small blind) folded before Flop


PokerStars Hand #238170684478:  Hold'em No Limit ($0.01/$0.02 USD) - 2022/08/23 13:37:28 ET
Table 'Equinox IV' 6-max Seat #6 is the button
Seat 1: joeeic13 ($0.91 in chips)
Seat 2: elchicosinombre ($2.52 in chips)
Seat 3: ShrimpMania ($2.07 in chips)
Seat 4: munyó ($1.28 in chips)
Seat 5: LAMUS_PL ($2.52 in chips)
Seat 6: Leonel cz ($2.30 in chips)
joeeic13: posts small blind $0.01
elchicosinombre: posts big blind $0.02
*** HOLE CARDS ***
ShrimpMania: folds
munyó: folds
LAMUS_PL: raises $0.03 to $0.05
Leonel cz: calls $0.05
joeeic13: raises $0.35 to $0.40
elchicosinombre: folds
LAMUS_PL: folds
Leonel cz: folds
Uncalled bet ($0.35) returned to joeeic13
joeeic13 collected $0.17 from pot
*** SUMMARY ***
Total pot $0.17 | Rake $0
Seat 1: joeeic13 (small blind) collected ($0.17)
Seat 2: elchicosinombre (big blind) folded before Flop
Seat 3: ShrimpMania folded before Flop (didn't bet)
Seat 4: munyó folded before Flop (didn't bet)
Seat 5: LAMUS_PL folded before Flop
Seat 6: Leonel cz (button) folded before Flop


PokerStars Hand #238170697329:  Hold'em No Limit ($0.01/$0.02 USD) - 2022/08/23 13:38:06 ET
Table 'Equinox IV' 6-max Seat #1 is the button
Seat 1: joeeic13 ($1.03 in chips)
Seat 2: elchicosinombre ($2.50 in chips)
Seat 3: ShrimpMania ($2.07 in chips)
Seat 4: munyó ($1.28 in chips)
Seat 5: LAMUS_PL ($2.47 in chips)
Seat 6: Leonel cz ($2.25 in chips)
elchicosinombre: posts small blind $0.01
ShrimpMania: posts big blind $0.02
*** HOLE CARDS ***
munyó: calls $0.02
LAMUS_PL: folds
Leonel cz: folds
joeeic13: folds
elchicosinombre: raises $0.02 to $0.04
ShrimpMania: calls $0.02
munyó: calls $0.02
*** FLOP *** [9s 4s 5s]
elchicosinombre: checks
ShrimpMania: bets $0.08
munyó: calls $0.08
elchicosinombre: folds
*** TURN *** [9s 4s 5s] [6s]
ShrimpMania: checks
munyó: checks
*** RIVER *** [9s 4s 5s 6s] [Ts]
ShrimpMania: checks
munyó: checks
*** SHOW DOWN ***
ShrimpMania: shows [9c Ac] (a flush, Ten high)
munyó: shows [4c 4h] (a flush, Ten high)
ShrimpMania collected $0.14 from pot
munyó collected $0.13 from pot
*** SUMMARY ***
Total pot $0.28 | Rake $0.01
Board [9s 4s 5s 6s Ts]
Seat 1: joeeic13 (button) folded before Flop (didn't bet)
Seat 2: elchicosinombre (small blind) folded on the Flop
Seat 3: ShrimpMania (big blind) showed [9c Ac] and won ($0.14) with a flush, Ten high
Seat 4: munyó showed [4c 4h] and won ($0.13) with a flush, Ten high
Seat 5: LAMUS_PL folded before Flop (didn't bet)
Seat 6: Leonel cz folded before Flop (didn't bet)


PokerStars Hand #238170708734:  Hold'em No Limit ($0.01/$0.02 USD) - 2022/08/23 13:38:40 ET
Table 'Equinox IV' 6-max Seat #2 is the button
Seat 1: joeeic13 ($1.03 in chips)
Seat 2: elchicosinombre ($2.46 in chips)
Seat 3: ShrimpMania ($2.09 in chips)
Seat 4: munyó ($1.29 in chips)
Seat 5: LAMUS_PL ($2.47 in chips)
Seat 6: Leonel cz ($2.25 in chips)
ShrimpMania: posts small blind $0.01
munyó: posts big blind $0.02
*** HOLE CARDS ***
LAMUS_PL: raises $0.04 to $0.06
Leonel cz: folds
joeeic13: folds
elchicosinombre: folds
ShrimpMania: folds
munyó: calls $0.04
*** FLOP *** [Th Kh Jc]
munyó: checks
LAMUS_PL: checks
*** TURN *** [Th Kh Jc] [2d]
munyó: bets $0.13
LAMUS_PL: folds
Uncalled bet ($0.13) returned to munyó
munyó collected $0.13 from pot
munyó: doesn't show hand
*** SUMMARY ***
Total pot $0.13 | Rake $0
Board [Th Kh Jc 2d]
Seat 1: joeeic13 folded before Flop (didn't bet)
Seat 2: elchicosinombre (button) folded before Flop (didn't bet)
Seat 3: ShrimpMania (small blind) folded before Flop
Seat 4: munyó (big blind) collected ($0.13)
Seat 5: LAMUS_PL folded on the Turn
Seat 6: Leonel cz folded before Flop (didn't bet)


PokerStars Hand #238170718066:  Hold'em No Limit ($0.01/$0.02 USD) - 2022/08/23 13:39:08 ET
Table 'Equinox IV' 6-max Seat #3 is the button
Seat 1: joeeic13 ($1.03 in chips)
Seat 2: elchicosinombre ($2.46 in chips)
Seat 3: ShrimpMania ($2.08 in chips)
Seat 4: munyó ($1.36 in chips)
Seat 5: LAMUS_PL ($2.41 in chips)
Seat 6: Leonel cz ($2.25 in chips)
munyó: posts small blind $0.01
LAMUS_PL: posts big blind $0.02
*** HOLE CARDS ***
Leonel cz: folds
joeeic13: folds
elchicosinombre: raises $0.02 to $0.04
ShrimpMania: folds
munyó: calls $0.03
LAMUS_PL: calls $0.02
*** FLOP *** [3c 7d Ac]
munyó: checks
LAMUS_PL: checks
elchicosinombre: bets $0.05
munyó: folds
LAMUS_PL: folds
Uncalled bet ($0.05) returned to elchicosinombre
elchicosinombre collected $0.12 from pot
*** SUMMARY ***
Total pot $0.12 | Rake $0
Board [3c 7d Ac]
Seat 1: joeeic13 folded before Flop (didn't bet)
Seat 2: elchicosinombre collected ($0.12)
Seat 3: ShrimpMania (button) folded before Flop (didn't bet)
Seat 4: munyó (small blind) folded on the Flop
Seat 5: LAMUS_PL (big blind) folded on the Flop
Seat 6: Leonel cz folded before Flop (didn't bet)


PokerStars Hand #238170728605:  Hold'em No Limit ($0.01/$0.02 USD) - 2022/08/23 13:39:39 ET
Table 'Equinox IV' 6-max Seat #4 is the button
Seat 1: joeeic13 ($1.03 in chips)
Seat 2: elchicosinombre ($2.54 in chips)
Seat 3: ShrimpMania ($2.08 in chips)
Seat 4: munyó ($1.32 in chips)
Seat 5: LAMUS_PL ($2.37 in chips)
Seat 6: Leonel cz ($2.25 in chips)
LAMUS_PL: posts small blind $0.01
Leonel cz: posts big blind $0.02
*** HOLE CARDS ***
joeeic13: calls $0.02
elchicosinombre: calls $0.02
ShrimpMania: folds
munyó: folds
LAMUS_PL: raises $0.08 to $0.10
Leonel cz: folds
joeeic13: folds
elchicosinombre: calls $0.08
*** FLOP *** [8c Td 6h]
LAMUS_PL: checks
elchicosinombre: checks
*** TURN *** [8c Td 6h] [Tc]
LAMUS_PL: bets $0.10
elchicosinombre: calls $0.10
*** RIVER *** [8c Td 6h Tc] [4s]
LAMUS_PL: checks
elchicosinombre: checks
*** SHOW DOWN ***
LAMUS_PL: shows [7h 7d] (two pair, Tens and Sevens)
elchicosinombre: shows [9h 8d] (two pair, Tens and Eights)
elchicosinombre collected $0.42 from pot
*** SUMMARY ***
Total pot $0.44 | Rake $0.02
Board [8c Td 6h Tc 4s]
Seat 1: joeeic13 folded before Flop
Seat 2: elchicosinombre showed [9h 8d] and won ($0.42) with two pair, Tens and Eights
Seat 3: ShrimpMania folded before Flop (didn't bet)
Seat 4: munyó (button) folded before Flop (didn't bet)
Seat 5: LAMUS_PL (small blind) showed [7h 7d] and lost with two pair, Tens and Sevens
Seat 6: Leonel cz (big blind) folded before Flop


PokerStars Hand #238170748279:  Hold'em No Limit ($0.01/$0.02 USD) - 2022/08/23 13:40:38 ET
Table 'Equinox IV' 6-max Seat #5 is the button
Seat 1: joeeic13 ($1.01 in chips)
Seat 2: elchicosinombre ($2.76 in chips)
Seat 3: ShrimpMania ($2.08 in chips)
Seat 4: munyó ($1.32 in chips)
Seat 5: LAMUS_PL ($2.17 in chips)
Seat 6: Leonel cz ($2.23 in chips)
Leonel cz: posts small blind $0.01
joeeic13: posts big blind $0.02
*** HOLE CARDS ***
elchicosinombre: calls $0.02
ShrimpMania: folds
munyó: calls $0.02
LAMUS_PL: raises $0.08 to $0.10
Leonel cz: folds
joeeic13: folds
elchicosinombre: calls $0.08
munyó: folds
*** FLOP *** [7h 4c 2c]
elchicosinombre: checks
LAMUS_PL: bets $0.16
elchicosinombre: folds
Uncalled bet ($0.16) returned to LAMUS_PL
LAMUS_PL collected $0.24 from pot
LAMUS_PL: doesn't show hand
*** SUMMARY ***
Total pot $0.25 | Rake $0.01
Board [7h 4c 2c]
Seat 1: joeeic13 (big blind) folded before Flop
Seat 2: elchicosinombre folded on the Flop
Seat 3: ShrimpMania folded before Flop (didn't bet)
Seat 4: munyó folded before Flop
Seat 5: LAMUS_PL (button) collected ($0.24)
Seat 6: Leonel cz (small blind) folded before Flop


PokerStars Hand #238170761920:  Hold'em No Limit ($0.01/$0.02 USD) - 2022/08/23 13:41:19 ET
Table 'Equinox IV' 6-max Seat #6 is the button
Seat 1: joeeic13 ($0.99 in chips)
Seat 2: elchicosinombre ($2.66 in chips)
Seat 3: ShrimpMania ($2.08 in chips)
Seat 4: munyó ($1.30 in chips)
Seat 5: LAMUS_PL ($2.31 in chips)
Seat 6: Leonel cz ($2.22 in chips)
joeeic13: posts small blind $0.01
elchicosinombre: posts big blind $0.02
*** HOLE CARDS ***
ShrimpMania: raises $0.04 to $0.06
munyó: folds
LAMUS_PL: calls $0.06
Leonel cz: folds
joeeic13: folds
elchicosinombre: calls $0.04
*** FLOP *** [4h 9h 6s]
elchicosinombre: bets $0.09
ShrimpMania: folds
LAMUS_PL: raises $0.12 to $0.21
elchicosinombre: calls $0.12
*** TURN *** [4h 9h 6s] [7s]
elchicosinombre: checks
LAMUS_PL: checks
*** RIVER *** [4h 9h 6s 7s] [4d]
elchicosinombre: bets $0.29
LAMUS_PL: folds
Uncalled bet ($0.29) returned to elchicosinombre
elchicosinombre collected $0.59 from pot
*** SUMMARY ***
Total pot $0.61 | Rake $0.02
Board [4h 9h 6s 7s 4d]
Seat 1: joeeic13 (small blind) folded before Flop
Seat 2: elchicosinombre (big blind) collected ($0.59)
Seat 3: ShrimpMania folded on the Flop
Seat 4: munyó folded before Flop (didn't bet)
Seat 5: LAMUS_PL folded on the River
Seat 6: Leonel cz (button) folded before Flop (didn't bet)


PokerStars Hand #238170781852:  Hold'em No Limit ($0.01/$0.02 USD) - 2022/08/23 13:42:18 ET
Table 'Equinox IV' 6-max Seat #1 is the button
Seat 1: joeeic13 ($0.98 in chips)
Seat 2: elchicosinombre ($2.98 in chips)
Seat 3: ShrimpMania ($2.02 in chips)
Seat 4: munyó ($1.30 in chips)
Seat 5: LAMUS_PL ($2.04 in chips)
Seat 6: Leonel cz ($2.22 in chips)
elchicosinombre: posts small blind $0.01
ShrimpMania: posts big blind $0.02
*** HOLE CARDS ***
munyó: calls $0.02
LAMUS_PL: folds
Leonel cz: folds
joeeic13: folds
elchicosinombre: folds
ShrimpMania: checks
*** FLOP *** [Ac Jh Td]
ShrimpMania: checks
munyó: bets $0.04
ShrimpMania: folds
Uncalled bet ($0.04) returned to munyó
munyó collected $0.05 from pot
munyó: doesn't show hand
*** SUMMARY ***
Total pot $0.05 | Rake $0
Board [Ac Jh Td]
Seat 1: joeeic13 (button) folded before Flop (didn't bet)
Seat 2: elchicosinombre (small blind) folded before Flop
Seat 3: ShrimpMania (big blind) folded on the Flop
Seat 4: munyó collected ($0.05)
Seat 5: LAMUS_PL folded before Flop (didn't bet)
Seat 6: Leonel cz folded before Flop (didn't bet)


PokerStars Hand #238170794113:  Hold'em No Limit ($0.01/$0.02 USD) - 2022/08/23 13:42:54 ET
Table 'Equinox IV' 6-max Seat #2 is the button
Seat 1: joeeic13 ($0.98 in chips)
Seat 2: elchicosinombre ($2.97 in chips)
Seat 3: ShrimpMania ($2 in chips)
Seat 4: munyó ($1.33 in chips)
Seat 5: LAMUS_PL ($2.04 in chips)
Seat 6: Leonel cz ($2.22 in chips)
ShrimpMania: posts small blind $0.01
munyó: posts big blind $0.02
*** HOLE CARDS ***
LAMUS_PL: raises $0.04 to $0.06
Leonel cz: folds
joeeic13: calls $0.06
elchicosinombre: calls $0.06
ShrimpMania: calls $0.05
munyó: folds
*** FLOP *** [2s Jc 5h]
ShrimpMania: checks
LAMUS_PL: bets $0.17
joeeic13: folds
elchicosinombre: folds
ShrimpMania: folds
Uncalled bet ($0.17) returned to LAMUS_PL
LAMUS_PL collected $0.25 from pot
LAMUS_PL: doesn't show hand
*** SUMMARY ***
Total pot $0.26 | Rake $0.01
Board [2s Jc 5h]
Seat 1: joeeic13 folded on the Flop
Seat 2: elchicosinombre (button) folded on the Flop
Seat 3: ShrimpMania (small blind) folded on the Flop
Seat 4: munyó (big blind) folded before Flop
Seat 5: LAMUS_PL collected ($0.25)
Seat 6: Leonel cz folded before Flop (didn't bet)


PokerStars Hand #238170812281:  Hold'em No Limit ($0.01/$0.02 USD) - 2022/08/23 13:43:48 ET
Table 'Equinox IV' 6-max Seat #3 is the button
Seat 1: joeeic13 ($0.92 in chips)
Seat 2: elchicosinombre ($2.91 in chips)
Seat 3: ShrimpMania ($2 in chips)
Seat 4: munyó ($1.31 in chips)
Seat 5: LAMUS_PL ($2.23 in chips)
Seat 6: Leonel cz ($2.22 in chips)
munyó: posts small blind $0.01
LAMUS_PL: posts big blind $0.02
*** HOLE CARDS ***
Leonel cz: folds
joeeic13: calls $0.02
elchicosinombre: calls $0.02
ShrimpMania: folds
munyó: calls $0.01
LAMUS_PL: checks
*** FLOP *** [9h 6d 8d]
munyó: checks
LAMUS_PL: bets $0.05
joeeic13: folds
elchicosinombre: calls $0.05
munyó: folds
*** TURN *** [9h 6d 8d] [Jd]
LAMUS_PL: checks
elchicosinombre: bets $0.08
LAMUS_PL: folds
Uncalled bet ($0.08) returned to elchicosinombre
elchicosinombre collected $0.17 from pot
*** SUMMARY ***
Total pot $0.18 | Rake $0.01
Board [9h 6d 8d Jd]
Seat 1: joeeic13 folded on the Flop
Seat 2: elchicosinombre collected ($0.17)
Seat 3: ShrimpMania (button) folded before Flop (didn't bet)
Seat 4: munyó (small blind) folded on the Flop
Seat 5: LAMUS_PL (big blind) folded on the Turn
Seat 6: Leonel cz folded before Flop (didn't bet)


PokerStars Hand #238170830251:  Hold'em No Limit ($0.01/$0.02 USD) - 2022/08/23 13:44:42 ET
Table 'Equinox IV' 6-max Seat #4 is the button
Seat 1: joeeic13 ($0.90 in chips)
Seat 2: elchicosinombre ($3.01 in chips)
Seat 3: ShrimpMania ($2 in chips)
Seat 4: munyó ($1.29 in chips)
Seat 5: LAMUS_PL ($2.16 in chips)
Seat 6: Leonel cz ($2.22 in chips)
LAMUS_PL: posts small blind $0.01
Leonel cz: posts big blind $0.02
*** HOLE CARDS ***
joeeic13: folds
elchicosinombre: calls $0.02
ShrimpMania: folds
munyó: folds
LAMUS_PL: folds
Leonel cz: checks
*** FLOP *** [8c Kd 6h]
Leonel cz: checks
elchicosinombre: bets $0.02
Leonel cz: calls $0.02
*** TURN *** [8c Kd 6h] [Ac]
Leonel cz: checks
elchicosinombre: bets $0.04
Leonel cz: folds
Uncalled bet ($0.04) returned to elchicosinombre
elchicosinombre collected $0.09 from pot
*** SUMMARY ***
Total pot $0.09 | Rake $0
Board [8c Kd 6h Ac]
Seat 1: joeeic13 folded before Flop (didn't bet)
Seat 2: elchicosinombre collected ($0.09)
Seat 3: ShrimpMania folded before Flop (didn't bet)
Seat 4: munyó (button) folded before Flop (didn't bet)
Seat 5: LAMUS_PL (small blind) folded before Flop
Seat 6: Leonel cz (big blind) folded on the Turn


PokerStars Hand #238170843922:  Hold'em No Limit ($0.01/$0.02 USD) - 2022/08/23 13:45:22 ET
Table 'Equinox IV' 6-max Seat #5 is the button
Seat 1: joeeic13 ($0.90 in chips)
Seat 2: elchicosinombre ($3.06 in chips)
Seat 3: ShrimpMania ($2 in chips)
Seat 4: munyó ($1.29 in chips)
Seat 5: LAMUS_PL ($2.15 in chips)
Seat 6: Leonel cz ($2.18 in chips)
Leonel cz: posts small blind $0.01
joeeic13: posts big blind $0.02
*** HOLE CARDS ***
elchicosinombre: folds
ShrimpMania: folds
munyó: calls $0.02
LAMUS_PL: raises $0.06 to $0.08
Leonel cz: folds
joeeic13: folds
munyó: folds
Uncalled bet ($0.06) returned to LAMUS_PL
LAMUS_PL collected $0.07 from pot
LAMUS_PL: doesn't show hand
*** SUMMARY ***
Total pot $0.07 | Rake $0
Seat 1: joeeic13 (big blind) folded before Flop
Seat 2: elchicosinombre folded before Flop (didn't bet)
Seat 3: ShrimpMania folded before Flop (didn't bet)
Seat 4: munyó folded before Flop
Seat 5: LAMUS_PL (button) collected ($0.07)
Seat 6: Leonel cz (small blind) folded before Flop


PokerStars Hand #238170854085:  Hold'em No Limit ($0.01/$0.02 USD) - 2022/08/23 13:45:53 ET
Table 'Equinox IV' 6-max Seat #6 is the button
Seat 1: joeeic13 ($0.88 in chips)
Seat 2: elchicosinombre ($3.06 in chips)
Seat 3: ShrimpMania ($2 in chips)
Seat 4: munyó ($1.27 in chips)
Seat 5: LAMUS_PL ($2.20 in chips)
Seat 6: Leonel cz ($2.17 in chips)
joeeic13: posts small blind $0.01
elchicosinombre: posts big blind $0.02
*** HOLE CARDS ***
ShrimpMania: folds
munyó: folds
LAMUS_PL: folds
Leonel cz: folds
joeeic13: calls $0.01
munyó leaves the table
elchicosinombre: checks
*** FLOP *** [6c 4s 6d]
joeeic13: checks
elchicosinombre: checks
*** TURN *** [6c 4s 6d] [Ts]
den S187 joins the table at seat #4
joeeic13: bets $0.02
elchicosinombre: folds
Uncalled bet ($0.02) returned to joeeic13
joeeic13 collected $0.04 from pot
*** SUMMARY ***
Total pot $0.04 | Rake $0
Board [6c 4s 6d Ts]
Seat 1: joeeic13 (small blind) collected ($0.04)
Seat 2: elchicosinombre (big blind) folded on the Turn
Seat 3: ShrimpMania folded before Flop (didn't bet)
Seat 4: munyó folded before Flop (didn't bet)
Seat 5: LAMUS_PL folded before Flop (didn't bet)
Seat 6: Leonel cz (button) folded before Flop (didn't bet)


PokerStars Hand #238170872772:  Hold'em No Limit ($0.01/$0.02 USD) - 2022/08/23 13:46:49 ET
Table 'Equinox IV' 6-max Seat #1 is the button
Seat 1: joeeic13 ($0.90 in chips)
Seat 2: elchicosinombre ($3.04 in chips)
Seat 4: den S187 ($2 in chips)
Seat 5: LAMUS_PL ($2.20 in chips)
Seat 6: Leonel cz ($2.17 in chips)
elchicosinombre: posts small blind $0.01
ShrimpMania: is sitting out
ShrimpMania leaves the table
den S187: posts big blind $0.02
*** HOLE CARDS ***
LAMUS_PL: folds
Leonel cz: folds
joeeic13: calls $0.02
elchicosinombre: raises $0.02 to $0.04
den S187: folds
joeeic13: calls $0.02
*** FLOP *** [2s Jd 7c]
andrada_alex200 joins the table at seat #3
elchicosinombre: checks
joeeic13: checks
*** TURN *** [2s Jd 7c] [3d]
elchicosinombre: checks
joeeic13: checks
*** RIVER *** [2s Jd 7c 3d] [Th]
elchicosinombre: checks
joeeic13: checks
*** SHOW DOWN ***
elchicosinombre: shows [Qc Kh] (high card King)
joeeic13: shows [8c Ah] (high card Ace)
joeeic13 collected $0.10 from pot
*** SUMMARY ***
Total pot $0.10 | Rake $0
Board [2s Jd 7c 3d Th]
Seat 1: joeeic13 (button) showed [8c Ah] and won ($0.10) with high card Ace
Seat 2: elchicosinombre (small blind) showed [Qc Kh] and lost with high card King
Seat 4: den S187 (big blind) folded before Flop
Seat 5: LAMUS_PL folded before Flop (didn't bet)
Seat 6: Leonel cz folded before Flop (didn't bet)


PokerStars Hand #238170884174:  Hold'em No Limit ($0.01/$0.02 USD) - 2022/08/23 13:47:23 ET
Table 'Equinox IV' 6-max Seat #2 is the button
Seat 1: joeeic13 ($0.96 in chips)
Seat 2: elchicosinombre ($3 in chips)
Seat 4: den S187 ($2 in chips)
Seat 5: LAMUS_PL ($2.20 in chips)
Seat 6: Leonel cz ($2.17 in chips)
den S187: posts small blind $0.01
LAMUS_PL: posts big blind $0.02
*** HOLE CARDS ***
Leonel cz: folds
joeeic13: folds
elchicosinombre: folds
den S187: folds
Uncalled bet ($0.01) returned to LAMUS_PL
LAMUS_PL collected $0.02 from pot
LAMUS_PL: doesn't show hand
*** SUMMARY ***
Total pot $0.02 | Rake $0
Seat 1: joeeic13 folded before Flop (didn't bet)
Seat 2: elchicosinombre (button) folded before Flop (didn't bet)
Seat 4: den S187 (small blind) folded before Flop
Seat 5: LAMUS_PL (big blind) collected ($0.02)
Seat 6: Leonel cz folded before Flop (didn't bet)


PokerStars Hand #238170888016:  Hold'em No Limit ($0.01/$0.02 USD) - 2022/08/23 13:47:34 ET
Table 'Equinox IV' 6-max Seat #4 is the button
Seat 1: joeeic13 ($0.96 in chips)
Seat 2: elchicosinombre ($3 in chips)
Seat 3: andrada_alex200 ($0.88 in chips)
Seat 4: den S187 ($2 in chips)
Seat 5: LAMUS_PL ($2.21 in chips)
Seat 6: Leonel cz ($2.17 in chips)
LAMUS_PL: posts small blind $0.01
Leonel cz: posts big blind $0.02
andrada_alex200: posts big blind $0.02
*** HOLE CARDS ***
joeeic13: folds
elchicosinombre: folds
andrada_alex200: checks
den S187: folds
LAMUS_PL: folds
Leonel cz: checks
*** FLOP *** [Jh 8h Qc]
Leonel cz: checks
andrada_alex200: checks
*** TURN *** [Jh 8h Qc] [6d]
Leonel cz: checks
andrada_alex200: checks
*** RIVER *** [Jh 8h Qc 6d] [Ts]
Leonel cz: checks
andrada_alex200: checks
*** SHOW DOWN ***
Leonel cz: shows [3h 3d] (a pair of Threes)
andrada_alex200: mucks hand
Leonel cz collected $0.05 from pot
*** SUMMARY ***
Total pot $0.05 | Rake $0
Board [Jh 8h Qc 6d Ts]
Seat 1: joeeic13 folded before Flop (didn't bet)
Seat 2: elchicosinombre folded before Flop (didn't bet)
Seat 3: andrada_alex200 mucked
Seat 4: den S187 (button) folded before Flop (didn't bet)
Seat 5: LAMUS_PL (small blind) folded before Flop
Seat 6: Leonel cz (big blind) showed [3h 3d] and won ($0.05) with a pair of Threes


PokerStars Hand #238170897385:  Hold'em No Limit ($0.01/$0.02 USD) - 2022/08/23 13:48:03 ET
Table 'Equinox IV' 6-max Seat #5 is the button
Seat 1: joeeic13 ($0.96 in chips)
Seat 2: elchicosinombre ($3 in chips)
Seat 3: andrada_alex200 ($0.86 in chips)
Seat 4: den S187 ($2 in chips)
Seat 5: LAMUS_PL ($2.20 in chips)
Seat 6: Leonel cz ($2.20 in chips)
Leonel cz: posts small blind $0.01
joeeic13: posts big blind $0.02
*** HOLE CARDS ***
elchicosinombre: folds
andrada_alex200: calls $0.02
den S187: folds
LAMUS_PL: raises $0.06 to $0.08
Leonel cz: folds
joeeic13: calls $0.06
andrada_alex200: calls $0.06
*** FLOP *** [6d Td Qd]
joeeic13: checks
andrada_alex200: checks
LAMUS_PL: checks
*** TURN *** [6d Td Qd] [Kc]
joeeic13: bets $0.02
andrada_alex200: calls $0.02
LAMUS_PL: folds
*** RIVER *** [6d Td Qd Kc] [5h]
joeeic13: checks
andrada_alex200: bets $0.28
joeeic13: folds
Uncalled bet ($0.28) returned to andrada_alex200
andrada_alex200 collected $0.28 from pot
*** SUMMARY ***
Total pot $0.29 | Rake $0.01
Board [6d Td Qd Kc 5h]
Seat 1: joeeic13 (big blind) folded on the River
Seat 2: elchicosinombre folded before Flop (didn't bet)
Seat 3: andrada_alex200 collected ($0.28)
Seat 4: den S187 folded before Flop (didn't bet)
Seat 5: LAMUS_PL (button) folded on the Turn
Seat 6: Leonel cz (small blind) folded before Flop


PokerStars Hand #238170910505:  Hold'em No Limit ($0.01/$0.02 USD) - 2022/08/23 13:48:42 ET
Table 'Equinox IV' 6-max Seat #6 is the button
Seat 1: joeeic13 ($0.86 in chips)
Seat 2: elchicosinombre ($3 in chips)
Seat 3: andrada_alex200 ($1.04 in chips)
Seat 4: den S187 ($2 in chips)
Seat 5: LAMUS_PL ($2.12 in chips)
Seat 6: Leonel cz ($2.19 in chips)
joeeic13: posts small blind $0.01
elchicosinombre: posts big blind $0.02
*** HOLE CARDS ***
andrada_alex200: calls $0.02
den S187: folds
LAMUS_PL: folds
Leonel cz: folds
joeeic13: folds
elchicosinombre: checks
*** FLOP *** [Th 3s 7c]
joeeic13 leaves the table
elchicosinombre: bets $0.02
andrada_alex200: calls $0.02
*** TURN *** [Th 3s 7c] [Ah]
elchicosinombre: checks
andrada_alex200: checks
*** RIVER *** [Th 3s 7c Ah] [Qd]
elchicosinombre: checks
andrada_alex200: checks
*** SHOW DOWN ***
elchicosinombre: shows [Qs 8h] (a pair of Queens)
andrada_alex200: mucks hand
elchicosinombre collected $0.09 from pot
bungle63 joins the table at seat #1
*** SUMMARY ***
Total pot $0.09 | Rake $0
Board [Th 3s 7c Ah Qd]
Seat 1: joeeic13 (small blind) folded before Flop
Seat 2: elchicosinombre (big blind) showed [Qs 8h] and won ($0.09) with a pair of Queens
Seat 3: andrada_alex200 mucked
Seat 4: den S187 folded before Flop (didn't bet)
Seat 5: LAMUS_PL folded before Flop (didn't bet)
Seat 6: Leonel cz (button) folded before Flop (didn't bet)


PokerStars Hand #238170923047:  Hold'em No Limit ($0.01/$0.02 USD) - 2022/08/23 13:49:20 ET
Table 'Equinox IV' 6-max Seat #2 is the button
Seat 2: elchicosinombre ($3.05 in chips)
Seat 3: andrada_alex200 ($1 in chips)
Seat 4: den S187 ($2 in chips)
Seat 5: LAMUS_PL ($2.12 in chips)
Seat 6: Leonel cz ($2.19 in chips)
andrada_alex200: posts small blind $0.01
den S187: posts big blind $0.02
bungle63 is connected
bungle63: sits out
*** HOLE CARDS ***
LAMUS_PL: folds
Leonel cz: folds
elchicosinombre: raises $0.02 to $0.04
andrada_alex200: calls $0.03
den S187: calls $0.02
*** FLOP *** [Kd 7s 5d]
andrada_alex200: checks
den S187: checks
elchicosinombre: checks
*** TURN *** [Kd 7s 5d] [6h]
andrada_alex200: checks
den S187: bets $0.06
elchicosinombre: folds
andrada_alex200: folds
Uncalled bet ($0.06) returned to den S187
den S187 collected $0.12 from pot
den S187: doesn't show hand
*** SUMMARY ***
Total pot $0.12 | Rake $0
Board [Kd 7s 5d 6h]
Seat 2: elchicosinombre (button) folded on the Turn
Seat 3: andrada_alex200 (small blind) folded on the Turn
Seat 4: den S187 (big blind) collected ($0.12)
Seat 5: LAMUS_PL folded before Flop (didn't bet)
Seat 6: Leonel cz folded before Flop (didn't bet)


PokerStars Hand #238170934913:  Hold'em No Limit ($0.01/$0.02 USD) - 2022/08/23 13:49:56 ET
Table 'Equinox IV' 6-max Seat #3 is the button
Seat 1: bungle63 ($0.80 in chips)
Seat 2: elchicosinombre ($3.01 in chips)
Seat 3: andrada_alex200 ($0.96 in chips)
Seat 4: den S187 ($2.08 in chips)
Seat 5: LAMUS_PL ($2.12 in chips)
Seat 6: Leonel cz ($2.19 in chips)
den S187: posts small blind $0.01
LAMUS_PL: posts big blind $0.02
bungle63: posts big blind $0.02
*** HOLE CARDS ***
Leonel cz: folds
bungle63: checks
elchicosinombre: raises $0.02 to $0.04
andrada_alex200: calls $0.04
den S187: folds
LAMUS_PL: calls $0.02
bungle63: folds
*** FLOP *** [6d Td Kh]
LAMUS_PL: checks
elchicosinombre: checks
andrada_alex200: bets $0.07
LAMUS_PL: calls $0.07
elchicosinombre: calls $0.07
*** TURN *** [6d Td Kh] [Ah]
LAMUS_PL: bets $0.32
elchicosinombre: folds
andrada_alex200: folds
Uncalled bet ($0.32) returned to LAMUS_PL
LAMUS_PL collected $0.35 from pot
LAMUS_PL: doesn't show hand
*** SUMMARY ***
Total pot $0.36 | Rake $0.01
Board [6d Td Kh Ah]
Seat 1: bungle63 folded before Flop (didn't bet)
Seat 2: elchicosinombre folded on the Turn
Seat 3: andrada_alex200 (button) folded on the Turn
Seat 4: den S187 (small blind) folded before Flop
Seat 5: LAMUS_PL (big blind) collected ($0.35)
Seat 6: Leonel cz folded before Flop (didn't bet)


PokerStars Hand #238170955980:  Hold'em No Limit ($0.01/$0.02 USD) - 2022/08/23 13:51:00 ET
Table 'Equinox IV' 6-max Seat #4 is the button
Seat 1: bungle63 ($0.78 in chips)
Seat 2: elchicosinombre ($2.90 in chips)
Seat 3: andrada_alex200 ($0.85 in chips)
Seat 4: den S187 ($2.07 in chips)
Seat 5: LAMUS_PL ($2.36 in chips)
Seat 6: Leonel cz ($2.19 in chips)
LAMUS_PL: posts small blind $0.01
Leonel cz: posts big blind $0.02
*** HOLE CARDS ***
bungle63: folds
elchicosinombre: raises $0.02 to $0.04
andrada_alex200: calls $0.04
den S187: folds
LAMUS_PL: raises $0.15 to $0.19
Leonel cz: calls $0.17
elchicosinombre: calls $0.15
andrada_alex200: calls $0.15
*** FLOP *** [4s 9s 8c]
LAMUS_PL: bets $0.48
Leonel cz: folds
elchicosinombre: folds
andrada_alex200: folds
Uncalled bet ($0.48) returned to LAMUS_PL
LAMUS_PL collected $0.72 from pot
LAMUS_PL: doesn't show hand
*** SUMMARY ***
Total pot $0.76 | Rake $0.04
Board [4s 9s 8c]
Seat 1: bungle63 folded before Flop (didn't bet)
Seat 2: elchicosinombre folded on the Flop
Seat 3: andrada_alex200 folded on the Flop
Seat 4: den S187 (button) folded before Flop (didn't bet)
Seat 5: LAMUS_PL (small blind) collected ($0.72)
Seat 6: Leonel cz (big blind) folded on the Flop


PokerStars Hand #238170973546:  Hold'em No Limit ($0.01/$0.02 USD) - 2022/08/23 13:51:53 ET
Table 'Equinox IV' 6-max Seat #5 is the button
Seat 1: bungle63 ($0.78 in chips)
Seat 2: elchicosinombre ($2.71 in chips)
Seat 3: andrada_alex200 ($0.66 in chips)
Seat 4: den S187 ($2.07 in chips)
Seat 5: LAMUS_PL ($2.89 in chips)
Seat 6: Leonel cz ($2 in chips)
Leonel cz: posts small blind $0.01
bungle63: posts big blind $0.02
*** HOLE CARDS ***
elchicosinombre: folds
andrada_alex200: calls $0.02
den S187: folds
LAMUS_PL: raises $0.06 to $0.08
Leonel cz: folds
bungle63: raises $0.12 to $0.20
andrada_alex200: calls $0.18
LAMUS_PL: folds
*** FLOP *** [7s 7c As]
bungle63: checks
andrada_alex200: bets $0.46 and is all-in
bungle63: calls $0.46
*** TURN *** [7s 7c As] [6h]
*** RIVER *** [7s 7c As 6h] [Jh]
*** SHOW DOWN ***
bungle63: shows [Ad Qs] (two pair, Aces and Sevens)
andrada_alex200: shows [9d Ts] (a pair of Sevens)
bungle63 cashed out the hand for $1.30 | Cash Out Fee $0.01
*** SUMMARY ***
Total pot $1.41 | Rake $0.05
Board [7s 7c As 6h Jh]
Seat 1: bungle63 (big blind) showed [Ad Qs] and won ($1.36) with two pair, Aces and Sevens (pot not awarded as player cashed out)
Seat 2: elchicosinombre folded before Flop (didn't bet)
Seat 3: andrada_alex200 showed [9d Ts] and lost with a pair of Sevens
Seat 4: den S187 folded before Flop (didn't bet)
Seat 5: LAMUS_PL (button) folded before Flop
Seat 6: Leonel cz (small blind) folded before Flop


PokerStars Hand #238171002692:  Hold'em No Limit ($0.01/$0.02 USD) - 2022/08/23 13:53:23 ET
Table 'Equinox IV' 6-max Seat #1 is the button
Seat 1: bungle63 ($1.38 in chips)
Seat 2: elchicosinombre ($2.75 in chips)
Seat 3: AxCent8 ($0.80 in chips)
Seat 4: den S187 ($2.07 in chips)
Seat 5: LAMUS_PL ($2.81 in chips)
Seat 6: Leonel cz ($2 in chips)
elchicosinombre: posts small blind $0.01
AxCent8: posts big blind $0.02
*** HOLE CARDS ***
den S187: folds
LAMUS_PL: folds
Leonel cz: folds
bungle63: folds
elchicosinombre: folds
Uncalled bet ($0.01) returned to AxCent8
AxCent8 collected $0.02 from pot
*** SUMMARY ***
Total pot $0.02 | Rake $0
Seat 1: bungle63 (button) folded before Flop (didn't bet)
Seat 2: elchicosinombre (small blind) folded before Flop
Seat 3: AxCent8 (big blind) collected ($0.02)
Seat 4: den S187 folded before Flop (didn't bet)
Seat 5: LAMUS_PL folded before Flop (didn't bet)
Seat 6: Leonel cz folded before Flop (didn't bet)


PokerStars Hand #238170987012:  Hold'em No Limit ($0.01/$0.02 USD) - 2022/08/23 13:52:35 ET
Table 'Equinox IV' 6-max Seat #6 is the button
Seat 1: bungle63 ($1.42 in chips)
Seat 2: elchicosinombre ($2.71 in chips)
Seat 4: den S187 ($2.07 in chips)
Seat 5: LAMUS_PL ($2.81 in chips)
Seat 6: Leonel cz ($2 in chips)
bungle63: posts small blind $0.01
elchicosinombre: posts big blind $0.02
*** HOLE CARDS ***
den S187: folds
LAMUS_PL: folds
andrada_alex200 leaves the table
Leonel cz: folds
bungle63: calls $0.01
elchicosinombre: checks
*** FLOP *** [8s 8h 5s]
bungle63: checks
AxCent8 joins the table at seat #3
elchicosinombre: checks
*** TURN *** [8s 8h 5s] [5c]
bungle63: checks
elchicosinombre: checks
*** RIVER *** [8s 8h 5s 5c] [Ks]
bungle63: bets $0.02
elchicosinombre: calls $0.02
*** SHOW DOWN ***
bungle63: shows [Td 2c] (two pair, Eights and Fives)
elchicosinombre: shows [Ac 4d] (two pair, Eights and Fives - Ace kicker)
elchicosinombre collected $0.08 from pot
*** SUMMARY ***
Total pot $0.08 | Rake $0
Board [8s 8h 5s 5c Ks]
Seat 1: bungle63 (small blind) showed [Td 2c] and lost with two pair, Eights and Fives
Seat 2: elchicosinombre (big blind) showed [Ac 4d] and won ($0.08) with two pair, Eights and Fives
Seat 4: den S187 folded before Flop (didn't bet)
Seat 5: LAMUS_PL folded before Flop (didn't bet)
Seat 6: Leonel cz (button) folded before Flop (didn't bet)


PokerStars Hand #238171005517:  Hold'em No Limit ($0.01/$0.02 USD) - 2022/08/23 13:53:31 ET
Table 'Equinox IV' 6-max Seat #2 is the button
Seat 1: bungle63 ($1.38 in chips)
Seat 2: elchicosinombre ($2.74 in chips)
Seat 3: AxCent8 ($0.81 in chips)
Seat 4: den S187 ($2.07 in chips)
Seat 5: LAMUS_PL ($2.81 in chips)
Seat 6: Leonel cz ($2 in chips)
AxCent8: posts small blind $0.01
den S187: posts big blind $0.02
*** HOLE CARDS ***
LAMUS_PL: folds
Leonel cz: folds
bungle63: folds
elchicosinombre: calls $0.02
AxCent8: folds
den S187: checks
*** FLOP *** [9c Ac 8h]
den S187: checks
elchicosinombre: bets $0.03
den S187: calls $0.03
*** TURN *** [9c Ac 8h] [8d]
den S187: checks
elchicosinombre: checks
*** RIVER *** [9c Ac 8h 8d] [Ks]
den S187: checks
elchicosinombre: bets $2.69 and is all-in
den S187: folds
Uncalled bet ($2.69) returned to elchicosinombre
elchicosinombre collected $0.11 from pot
*** SUMMARY ***
Total pot $0.11 | Rake $0
Board [9c Ac 8h 8d Ks]
Seat 1: bungle63 folded before Flop (didn't bet)
Seat 2: elchicosinombre (button) collected ($0.11)
Seat 3: AxCent8 (small blind) folded before Flop
Seat 4: den S187 (big blind) folded on the River
Seat 5: LAMUS_PL folded before Flop (didn't bet)
Seat 6: Leonel cz folded before Flop (didn't bet)


PokerStars Hand #238171019803:  Hold'em No Limit ($0.01/$0.02 USD) - 2022/08/23 13:54:15 ET
Table 'Equinox IV' 6-max Seat #3 is the button
Seat 1: bungle63 ($1.38 in chips)
Seat 2: elchicosinombre ($2.80 in chips)
Seat 3: AxCent8 ($0.80 in chips)
Seat 4: den S187 ($2.02 in chips)
Seat 5: LAMUS_PL ($2.81 in chips)
Seat 6: Leonel cz ($2 in chips)
den S187: posts small blind $0.01
LAMUS_PL: posts big blind $0.02
*** HOLE CARDS ***
Leonel cz: raises $0.03 to $0.05
bungle63: folds
elchicosinombre: folds
AxCent8: folds
den S187: folds
LAMUS_PL: folds
Uncalled bet ($0.03) returned to Leonel cz
Leonel cz collected $0.05 from pot
Leonel cz: doesn't show hand
*** SUMMARY ***
Total pot $0.05 | Rake $0
Seat 1: bungle63 folded before Flop (didn't bet)
Seat 2: elchicosinombre folded before Flop (didn't bet)
Seat 3: AxCent8 (button) folded before Flop (didn't bet)
Seat 4: den S187 (small blind) folded before Flop
Seat 5: LAMUS_PL (big blind) folded before Flop
Seat 6: Leonel cz collected ($0.05)


PokerStars Hand #238171023785:  Hold'em No Limit ($0.01/$0.02 USD) - 2022/08/23 13:54:27 ET
Table 'Equinox IV' 6-max Seat #4 is the button
Seat 1: bungle63 ($1.38 in chips)
Seat 2: elchicosinombre ($2.80 in chips)
Seat 3: AxCent8 ($0.80 in chips)
Seat 4: den S187 ($2.01 in chips)
Seat 5: LAMUS_PL ($2.79 in chips)
Seat 6: Leonel cz ($2.03 in chips)
LAMUS_PL: posts small blind $0.01
Leonel cz: posts big blind $0.02
*** HOLE CARDS ***
bungle63: calls $0.02
elchicosinombre: folds
AxCent8: folds
den S187: raises $0.03 to $0.05
LAMUS_PL: folds
Leonel cz: folds
bungle63: calls $0.03
*** FLOP *** [4d Kc 8h]
bungle63: checks
den S187: checks
*** TURN *** [4d Kc 8h] [Ac]
bungle63: checks
den S187: bets $0.07
bungle63: calls $0.07
*** RIVER *** [4d Kc 8h Ac] [Qc]
bungle63: checks
den S187: checks
*** SHOW DOWN ***
bungle63: shows [Ah 7s] (a pair of Aces)
den S187: mucks hand
bungle63 collected $0.26 from pot
*** SUMMARY ***
Total pot $0.27 | Rake $0.01
Board [4d Kc 8h Ac Qc]
Seat 1: bungle63 showed [Ah 7s] and won ($0.26) with a pair of Aces
Seat 2: elchicosinombre folded before Flop (didn't bet)
Seat 3: AxCent8 folded before Flop (didn't bet)
Seat 4: den S187 (button) mucked
Seat 5: LAMUS_PL (small blind) folded before Flop
Seat 6: Leonel cz (big blind) folded before Flop


PokerStars Hand #238171040340:  Hold'em No Limit ($0.01/$0.02 USD) - 2022/08/23 13:55:18 ET
Table 'Equinox IV' 6-max Seat #5 is the button
Seat 1: bungle63 ($1.52 in chips)
Seat 2: elchicosinombre ($2.80 in chips)
Seat 3: AxCent8 ($0.80 in chips)
Seat 4: den S187 ($2 in chips)
Seat 5: LAMUS_PL ($2.78 in chips)
Seat 6: Leonel cz ($2.01 in chips)
Leonel cz: posts small blind $0.01
bungle63: posts big blind $0.02
*** HOLE CARDS ***
elchicosinombre: folds
AxCent8: folds
den S187: raises $0.03 to $0.05
LAMUS_PL: folds
Leonel cz: folds
bungle63: calls $0.03
*** FLOP *** [8c 7c 8d]
bungle63: checks
den S187: checks
*** TURN *** [8c 7c 8d] [5c]
bungle63: bets $0.02
den S187: folds
Uncalled bet ($0.02) returned to bungle63
bungle63 collected $0.11 from pot
bungle63: doesn't show hand
*** SUMMARY ***
Total pot $0.11 | Rake $0
Board [8c 7c 8d 5c]
Seat 1: bungle63 (big blind) collected ($0.11)
Seat 2: elchicosinombre folded before Flop (didn't bet)
Seat 3: AxCent8 folded before Flop (didn't bet)
Seat 4: den S187 folded on the Turn
Seat 5: LAMUS_PL (button) folded before Flop (didn't bet)
Seat 6: Leonel cz (small blind) folded before Flop


PokerStars Hand #238171047652:  Hold'em No Limit ($0.01/$0.02 USD) - 2022/08/23 13:55:47 ET
Table 'Equinox IV' 6-max Seat #6 is the button
Seat 1: bungle63 ($1.58 in chips)
Seat 2: elchicosinombre ($2.80 in chips)
Seat 3: AxCent8 ($0.80 in chips)
Seat 4: den S187 ($2 in chips)
Seat 5: LAMUS_PL ($2.78 in chips)
Seat 6: Leonel cz ($2 in chips)
bungle63: posts small blind $0.01
elchicosinombre: posts big blind $0.02
*** HOLE CARDS ***
AxCent8: folds
den S187: folds
LAMUS_PL: raises $0.03 to $0.05
Leonel cz: folds
bungle63: calls $0.04
elchicosinombre: folds
*** FLOP *** [Qc 3s Qd]
bungle63: checks
LAMUS_PL: bets $0.08
bungle63: calls $0.08
*** TURN *** [Qc 3s Qd] [7c]
bungle63: checks
LAMUS_PL: checks
*** RIVER *** [Qc 3s Qd 7c] [9c]
bungle63: checks
LAMUS_PL: checks
*** SHOW DOWN ***
bungle63: shows [Kh Jc] (a pair of Queens)
LAMUS_PL: shows [7s 6c] (two pair, Queens and Sevens)
LAMUS_PL collected $0.27 from pot
*** SUMMARY ***
Total pot $0.28 | Rake $0.01
Board [Qc 3s Qd 7c 9c]
Seat 1: bungle63 (small blind) showed [Kh Jc] and lost with a pair of Queens
Seat 2: elchicosinombre (big blind) folded before Flop
Seat 3: AxCent8 folded before Flop (didn't bet)
Seat 4: den S187 folded before Flop (didn't bet)
Seat 5: LAMUS_PL showed [7s 6c] and won ($0.27) with two pair, Queens and Sevens
Seat 6: Leonel cz (button) folded before Flop (didn't bet)


PokerStars Hand #238171055788:  Hold'em No Limit ($0.01/$0.02 USD) - 2022/08/23 13:56:20 ET
Table 'Equinox IV' 6-max Seat #1 is the button
Seat 1: bungle63 ($1.45 in chips)
Seat 2: elchicosinombre ($2.78 in chips)
Seat 3: AxCent8 ($0.80 in chips)
Seat 4: den S187 ($2 in chips)
Seat 5: LAMUS_PL ($2.92 in chips)
Seat 6: Leonel cz ($2 in chips)
elchicosinombre: posts small blind $0.01
AxCent8: posts big blind $0.02
*** HOLE CARDS ***
den S187: folds
LAMUS_PL: folds
Leonel cz: folds
bungle63: folds
elchicosinombre: folds
Uncalled bet ($0.01) returned to AxCent8
bungle63 leaves the table
AxCent8 collected $0.02 from pot
*** SUMMARY ***
Total pot $0.02 | Rake $0
Seat 1: bungle63 (button) folded before Flop (didn't bet)
Seat 2: elchicosinombre (small blind) folded before Flop
Seat 3: AxCent8 (big blind) collected ($0.02)
Seat 4: den S187 folded before Flop (didn't bet)
Seat 5: LAMUS_PL folded before Flop (didn't bet)
Seat 6: Leonel cz folded before Flop (didn't bet)


PokerStars Hand #238171058827:  Hold'em No Limit ($0.01/$0.02 USD) - 2022/08/23 13:56:32 ET
Table 'Equinox IV' 6-max Seat #2 is the button
Seat 2: elchicosinombre ($2.77 in chips)
Seat 3: AxCent8 ($0.81 in chips)
Seat 5: LAMUS_PL ($2.92 in chips)
Seat 6: Leonel cz ($2 in chips)
AxCent8: posts small blind $0.01
den S187: is sitting out
LAMUS_PL: posts big blind $0.02
*** HOLE CARDS ***
Leonel cz: folds
elchicosinombre: calls $0.02
den S187 leaves the table
AxCent8: folds
LAMUS_PL: checks
*** FLOP *** [Ac 5s Qh]
SidneyCrosby8 joins the table at seat #4
Emag fo Dog joins the table at seat #1
LAMUS_PL: checks
elchicosinombre: checks
*** TURN *** [Ac 5s Qh] [Kd]
LAMUS_PL: bets $0.03
elchicosinombre: calls $0.03
*** RIVER *** [Ac 5s Qh Kd] [8c]
LAMUS_PL: bets $0.07
elchicosinombre: folds
Uncalled bet ($0.07) returned to LAMUS_PL
LAMUS_PL collected $0.11 from pot
LAMUS_PL: doesn't show hand
*** SUMMARY ***
Total pot $0.11 | Rake $0
Board [Ac 5s Qh Kd 8c]
Seat 2: elchicosinombre (button) folded on the River
Seat 3: AxCent8 (small blind) folded before Flop
Seat 5: LAMUS_PL (big blind) collected ($0.11)
Seat 6: Leonel cz folded before Flop (didn't bet)


PokerStars Hand #238171066696:  Hold'em No Limit ($0.01/$0.02 USD) - 2022/08/23 13:57:04 ET
Table 'Equinox IV' 6-max Seat #3 is the button
Seat 2: elchicosinombre ($2.72 in chips)
Seat 3: AxCent8 ($0.80 in chips)
Seat 5: LAMUS_PL ($2.98 in chips)
Seat 6: Leonel cz ($2 in chips)
LAMUS_PL: posts small blind $0.01
Leonel cz: posts big blind $0.02
Emag fo Dog: sits out
*** HOLE CARDS ***
elchicosinombre: calls $0.02
AxCent8: folds
LAMUS_PL: folds
Leonel cz: checks
*** FLOP *** [5s Ah 7c]
Leonel cz: checks
elchicosinombre: checks
*** TURN *** [5s Ah 7c] [8d]
Leonel cz: checks
elchicosinombre: checks
*** RIVER *** [5s Ah 7c 8d] [2c]
Leonel cz: checks
elchicosinombre: checks
*** SHOW DOWN ***
Leonel cz: shows [Jh Ts] (high card Ace)
elchicosinombre: shows [Qs 8s] (a pair of Eights)
elchicosinombre collected $0.05 from pot
*** SUMMARY ***
Total pot $0.05 | Rake $0
Board [5s Ah 7c 8d 2c]
Seat 2: elchicosinombre showed [Qs 8s] and won ($0.05) with a pair of Eights
Seat 3: AxCent8 (button) folded before Flop (didn't bet)
Seat 5: LAMUS_PL (small blind) folded before Flop
Seat 6: Leonel cz (big blind) showed [Jh Ts] and lost with high card Ace


PokerStars Hand #238171083626:  Hold'em No Limit ($0.01/$0.02 USD) - 2022/08/23 13:57:36 ET
Table 'Equinox IV' 6-max Seat #5 is the button
Seat 1: Emag fo Dog ($1.68 in chips)
Seat 2: elchicosinombre ($2.75 in chips)
Seat 3: AxCent8 ($0.80 in chips)
Seat 5: LAMUS_PL ($2.97 in chips)
Seat 6: Leonel cz ($2 in chips)
Leonel cz: posts small blind $0.01
Emag fo Dog: posts big blind $0.02
SidneyCrosby8: sits out
*** HOLE CARDS ***
elchicosinombre: folds
AxCent8: folds
LAMUS_PL: folds
Leonel cz: folds
Uncalled bet ($0.01) returned to Emag fo Dog
Emag fo Dog collected $0.02 from pot
Emag fo Dog: doesn't show hand
*** SUMMARY ***
Total pot $0.02 | Rake $0
Seat 1: Emag fo Dog (big blind) collected ($0.02)
Seat 2: elchicosinombre folded before Flop (didn't bet)
Seat 3: AxCent8 folded before Flop (didn't bet)
Seat 5: LAMUS_PL (button) folded before Flop (didn't bet)
Seat 6: Leonel cz (small blind) folded before Flop


PokerStars Hand #238171086436:  Hold'em No Limit ($0.01/$0.02 USD) - 2022/08/23 13:57:47 ET
Table 'Equinox IV' 6-max Seat #6 is the button
Seat 1: Emag fo Dog ($1.69 in chips)
Seat 2: elchicosinombre ($2.75 in chips)
Seat 3: AxCent8 ($0.80 in chips)
Seat 5: LAMUS_PL ($2.97 in chips)
Seat 6: Leonel cz ($2 in chips)
Emag fo Dog: posts small blind $0.01
elchicosinombre: posts big blind $0.02
SidneyCrosby8: sits out
*** HOLE CARDS ***
AxCent8: folds
LAMUS_PL: raises $0.03 to $0.05
Leonel cz: folds
Emag fo Dog: folds
elchicosinombre: folds
Uncalled bet ($0.03) returned to LAMUS_PL
LAMUS_PL collected $0.05 from pot
LAMUS_PL: doesn't show hand
*** SUMMARY ***
Total pot $0.05 | Rake $0
Seat 1: Emag fo Dog (small blind) folded before Flop
Seat 2: elchicosinombre (big blind) folded before Flop
Seat 3: AxCent8 folded before Flop (didn't bet)
Seat 5: LAMUS_PL collected ($0.05)
Seat 6: Leonel cz (button) folded before Flop (didn't bet)


PokerStars Hand #238171089471:  Hold'em No Limit ($0.01/$0.02 USD) - 2022/08/23 13:57:59 ET
Table 'Equinox IV' 6-max Seat #1 is the button
Seat 1: Emag fo Dog ($1.68 in chips)
Seat 2: elchicosinombre ($2.73 in chips)
Seat 3: AxCent8 ($0.80 in chips)
Seat 6: Leonel cz ($2 in chips)
elchicosinombre: posts small blind $0.01
AxCent8: posts big blind $0.02
SidneyCrosby8: sits out
*** HOLE CARDS ***
Leonel cz: folds
Emag fo Dog: raises $0.03 to $0.05
elchicosinombre: calls $0.04
AxCent8: calls $0.03
*** FLOP *** [5c 2h Qh]
elchicosinombre: checks
AxCent8: checks
Emag fo Dog: bets $0.02
elchicosinombre: calls $0.02
AxCent8: folds
*** TURN *** [5c 2h Qh] [4s]
elchicosinombre: checks
Emag fo Dog: bets $0.02
elchicosinombre: folds
Uncalled bet ($0.02) returned to Emag fo Dog
Emag fo Dog collected $0.18 from pot
Emag fo Dog: doesn't show hand
*** SUMMARY ***
Total pot $0.19 | Rake $0.01
Board [5c 2h Qh 4s]
Seat 1: Emag fo Dog (button) collected ($0.18)
Seat 2: elchicosinombre (small blind) folded on the Turn
Seat 3: AxCent8 (big blind) folded on the Flop
Seat 6: Leonel cz folded before Flop (didn't bet)


PokerStars Hand #238171101904:  Hold'em No Limit ($0.01/$0.02 USD) - 2022/08/23 13:58:48 ET
Table 'Equinox IV' 6-max Seat #2 is the button
Seat 1: Emag fo Dog ($1.79 in chips)
Seat 2: elchicosinombre ($2.66 in chips)
Seat 3: AxCent8 ($0.75 in chips)
Seat 4: SidneyCrosby8 ($2 in chips)
Seat 6: Leonel cz ($2 in chips)
AxCent8: posts small blind $0.01
SidneyCrosby8: posts big blind $0.02
*** HOLE CARDS ***
Leonel cz: folds
Emag fo Dog: folds
elchicosinombre: folds
AxCent8: folds
Uncalled bet ($0.01) returned to SidneyCrosby8
SidneyCrosby8 collected $0.02 from pot
SidneyCrosby8: doesn't show hand
*** SUMMARY ***
Total pot $0.02 | Rake $0
Seat 1: Emag fo Dog folded before Flop (didn't bet)
Seat 2: elchicosinombre (button) folded before Flop (didn't bet)
Seat 3: AxCent8 (small blind) folded before Flop
Seat 4: SidneyCrosby8 (big blind) collected ($0.02)
Seat 6: Leonel cz folded before Flop (didn't bet)


PokerStars Hand #238171105357:  Hold'em No Limit ($0.01/$0.02 USD) - 2022/08/23 13:59:02 ET
Table 'Equinox IV' 6-max Seat #3 is the button
Seat 1: Emag fo Dog ($1.79 in chips)
Seat 2: elchicosinombre ($2.66 in chips)
Seat 3: AxCent8 ($0.74 in chips)
Seat 4: SidneyCrosby8 ($2.01 in chips)
Seat 6: Leonel cz ($2 in chips)
SidneyCrosby8: posts small blind $0.01
Leonel cz: posts big blind $0.02
*** HOLE CARDS ***
Emag fo Dog: folds
elchicosinombre: folds
AxCent8: folds
SidneyCrosby8: folds
Uncalled bet ($0.01) returned to Leonel cz
Leonel cz collected $0.02 from pot
Leonel cz: doesn't show hand
*** SUMMARY ***
Total pot $0.02 | Rake $0
Seat 1: Emag fo Dog folded before Flop (didn't bet)
Seat 2: elchicosinombre folded before Flop (didn't bet)
Seat 3: AxCent8 (button) folded before Flop (didn't bet)
Seat 4: SidneyCrosby8 (small blind) folded before Flop
Seat 6: Leonel cz (big blind) collected ($0.02)


PokerStars Hand #238171108178:  Hold'em No Limit ($0.01/$0.02 USD) - 2022/08/23 13:59:14 ET
Table 'Equinox IV' 6-max Seat #4 is the button
Seat 1: Emag fo Dog ($1.79 in chips)
Seat 2: elchicosinombre ($2.66 in chips)
Seat 3: AxCent8 ($0.74 in chips)
Seat 4: SidneyCrosby8 ($2 in chips)
Seat 6: Leonel cz ($2.01 in chips)
Leonel cz: posts small blind $0.01
Emag fo Dog: posts big blind $0.02
*** HOLE CARDS ***
elchicosinombre: folds
AxCent8: calls $0.02
SidneyCrosby8: folds
Leonel cz: folds
Emag fo Dog: checks
*** FLOP *** [6h 6c 7h]
Emag fo Dog: bets $0.02
AxCent8: folds
Uncalled bet ($0.02) returned to Emag fo Dog
Emag fo Dog collected $0.05 from pot
Emag fo Dog: doesn't show hand
*** SUMMARY ***
Total pot $0.05 | Rake $0
Board [6h 6c 7h]
Seat 1: Emag fo Dog (big blind) collected ($0.05)
Seat 2: elchicosinombre folded before Flop (didn't bet)
Seat 3: AxCent8 folded on the Flop
Seat 4: SidneyCrosby8 (button) folded before Flop (didn't bet)
Seat 6: Leonel cz (small blind) folded before Flop


PokerStars Hand #238171114465:  Hold'em No Limit ($0.01/$0.02 USD) - 2022/08/23 13:59:39 ET
Table 'Equinox IV' 6-max Seat #6 is the button
Seat 1: Emag fo Dog ($1.82 in chips)
Seat 2: elchicosinombre ($2.66 in chips)
Seat 3: AxCent8 ($0.72 in chips)
Seat 4: SidneyCrosby8 ($2 in chips)
Seat 6: Leonel cz ($2 in chips)
Emag fo Dog: posts small blind $0.01
elchicosinombre: posts big blind $0.02
*** HOLE CARDS ***
AxCent8: folds
SidneyCrosby8: folds
Leonel cz: raises $0.03 to $0.05
Emag fo Dog: folds
elchicosinombre: calls $0.03
*** FLOP *** [9h Kh Kd]
elchicosinombre: bets $0.05
Leonel cz: calls $0.05
*** TURN *** [9h Kh Kd] [6s]
elchicosinombre: checks
Leonel cz: bets $0.10
elchicosinombre: calls $0.10
*** RIVER *** [9h Kh Kd 6s] [2s]
elchicosinombre: checks
Leonel cz: checks
*** SHOW DOWN ***
elchicosinombre: shows [8h 9d] (two pair, Kings and Nines)
Leonel cz: mucks hand
elchicosinombre collected $0.40 from pot
*** SUMMARY ***
Total pot $0.41 | Rake $0.01
Board [9h Kh Kd 6s 2s]
Seat 1: Emag fo Dog (small blind) folded before Flop
Seat 2: elchicosinombre (big blind) showed [8h 9d] and won ($0.40) with two pair, Kings and Nines
Seat 3: AxCent8 folded before Flop (didn't bet)
Seat 4: SidneyCrosby8 folded before Flop (didn't bet)
Seat 6: Leonel cz (button) mucked


PokerStars Hand #238171125703:  Hold'em No Limit ($0.01/$0.02 USD) - 2022/08/23 14:00:23 ET
Table 'Equinox IV' 6-max Seat #1 is the button
Seat 1: Emag fo Dog ($1.81 in chips)
Seat 2: elchicosinombre ($2.86 in chips)
Seat 3: AxCent8 ($0.72 in chips)
Seat 4: SidneyCrosby8 ($2 in chips)
Seat 6: Leonel cz ($2 in chips)
elchicosinombre: posts small blind $0.01
AxCent8: posts big blind $0.02
*** HOLE CARDS ***
SidneyCrosby8: folds
Leonel cz: folds
Emag fo Dog: folds
elchicosinombre: folds
Uncalled bet ($0.01) returned to AxCent8
AxCent8 collected $0.02 from pot
*** SUMMARY ***
Total pot $0.02 | Rake $0
Seat 1: Emag fo Dog (button) folded before Flop (didn't bet)
Seat 2: elchicosinombre (small blind) folded before Flop
Seat 3: AxCent8 (big blind) collected ($0.02)
Seat 4: SidneyCrosby8 folded before Flop (didn't bet)
Seat 6: Leonel cz folded before Flop (didn't bet)


PokerStars Hand #238171127279:  Hold'em No Limit ($0.01/$0.02 USD) - 2022/08/23 14:00:29 ET
Table 'Equinox IV' 6-max Seat #2 is the button
Seat 1: Emag fo Dog ($1.81 in chips)
Seat 2: elchicosinombre ($2.85 in chips)
Seat 3: AxCent8 ($0.73 in chips)
Seat 4: SidneyCrosby8 ($2 in chips)
Seat 6: Leonel cz ($2 in chips)
AxCent8: posts small blind $0.01
SidneyCrosby8: posts big blind $0.02
*** HOLE CARDS ***
Leonel cz: folds
Emag fo Dog: folds
elchicosinombre: folds
AxCent8: folds
Uncalled bet ($0.01) returned to SidneyCrosby8
SidneyCrosby8 collected $0.02 from pot
SidneyCrosby8: doesn't show hand
*** SUMMARY ***
Total pot $0.02 | Rake $0
Seat 1: Emag fo Dog folded before Flop (didn't bet)
Seat 2: elchicosinombre (button) folded before Flop (didn't bet)
Seat 3: AxCent8 (small blind) folded before Flop
Seat 4: SidneyCrosby8 (big blind) collected ($0.02)
Seat 6: Leonel cz folded before Flop (didn't bet)


PokerStars Hand #238171129424:  Hold'em No Limit ($0.01/$0.02 USD) - 2022/08/23 14:00:37 ET
Table 'Equinox IV' 6-max Seat #3 is the button
Seat 1: Emag fo Dog ($1.81 in chips)
Seat 2: elchicosinombre ($2.85 in chips)
Seat 3: AxCent8 ($0.72 in chips)
Seat 4: SidneyCrosby8 ($2.01 in chips)
Seat 6: Leonel cz ($2 in chips)
SidneyCrosby8: posts small blind $0.01
Leonel cz: posts big blind $0.02
*** HOLE CARDS ***
Emag fo Dog: raises $0.04 to $0.06
elchicosinombre: calls $0.06
AxCent8: folds
SidneyCrosby8: folds
Leonel cz: folds
*** FLOP *** [Qd 5d Ts]
Emag fo Dog: bets $0.02
elchicosinombre: calls $0.02
*** TURN *** [Qd 5d Ts] [Ad]
Emag fo Dog: bets $0.02
elchicosinombre: raises $0.08 to $0.10
Emag fo Dog: calls $0.08
*** RIVER *** [Qd 5d Ts Ad] [Jd]
Emag fo Dog: bets $0.02
elchicosinombre: raises $2.65 to $2.67 and is all-in
Emag fo Dog: folds
Uncalled bet ($2.65) returned to elchicosinombre
elchicosinombre collected $0.41 from pot
*** SUMMARY ***
Total pot $0.43 | Rake $0.02
Board [Qd 5d Ts Ad Jd]
Seat 1: Emag fo Dog folded on the River
Seat 2: elchicosinombre collected ($0.41)
Seat 3: AxCent8 (button) folded before Flop (didn't bet)
Seat 4: SidneyCrosby8 (small blind) folded before Flop
Seat 6: Leonel cz (big blind) folded before Flop


PokerStars Hand #238171146457:  Hold'em No Limit ($0.01/$0.02 USD) - 2022/08/23 14:01:35 ET
Table 'Equinox IV' 6-max Seat #4 is the button
Seat 1: Emag fo Dog ($1.68 in chips)
Seat 2: elchicosinombre ($3.06 in chips)
Seat 3: AxCent8 ($0.72 in chips)
Seat 4: SidneyCrosby8 ($2 in chips)
Seat 6: Leonel cz ($2 in chips)
Leonel cz: posts small blind $0.01
Emag fo Dog: posts big blind $0.02
*** HOLE CARDS ***
elchicosinombre: folds
AxCent8: folds
SidneyCrosby8: folds
Leonel cz: folds
Uncalled bet ($0.01) returned to Emag fo Dog
Emag fo Dog collected $0.02 from pot
Emag fo Dog: doesn't show hand
*** SUMMARY ***
Total pot $0.02 | Rake $0
Seat 1: Emag fo Dog (big blind) collected ($0.02)
Seat 2: elchicosinombre folded before Flop (didn't bet)
Seat 3: AxCent8 folded before Flop (didn't bet)
Seat 4: SidneyCrosby8 (button) folded before Flop (didn't bet)
Seat 6: Leonel cz (small blind) folded before Flop


PokerStars Hand #238171149905:  Hold'em No Limit ($0.01/$0.02 USD) - 2022/08/23 14:01:45 ET
Table 'Equinox IV' 6-max Seat #6 is the button
Seat 1: Emag fo Dog ($1.69 in chips)
Seat 2: elchicosinombre ($3.06 in chips)
Seat 3: AxCent8 ($0.72 in chips)
Seat 4: SidneyCrosby8 ($2 in chips)
Seat 6: Leonel cz ($2 in chips)
Emag fo Dog: posts small blind $0.01
elchicosinombre: posts big blind $0.02
*** HOLE CARDS ***
AxCent8: calls $0.02
SidneyCrosby8: folds
Leonel cz: folds
Emag fo Dog: calls $0.01
elchicosinombre: checks
*** FLOP *** [2h 6h 4s]
Emag fo Dog: bets $0.02
elchicosinombre: calls $0.02
AxCent8: raises $0.04 to $0.06
Emag fo Dog: calls $0.04
elchicosinombre: calls $0.04
*** TURN *** [2h 6h 4s] [Qh]
Emag fo Dog: bets $0.02
elchicosinombre: folds
AxCent8: calls $0.02
*** RIVER *** [2h 6h 4s Qh] [2d]
Emag fo Dog: bets $0.02
AxCent8: calls $0.02
*** SHOW DOWN ***
Emag fo Dog: shows [4d 7d] (two pair, Fours and Deuces)
AxCent8: shows [6d 6c] (a full house, Sixes full of Deuces)
AxCent8 collected $0.31 from pot
*** SUMMARY ***
Total pot $0.32 | Rake $0.01
Board [2h 6h 4s Qh 2d]
Seat 1: Emag fo Dog (small blind) showed [4d 7d] and lost with two pair, Fours and Deuces
Seat 2: elchicosinombre (big blind) folded on the Turn
Seat 3: AxCent8 showed [6d 6c] and won ($0.31) with a full house, Sixes full of Deuces
Seat 4: SidneyCrosby8 folded before Flop (didn't bet)
Seat 6: Leonel cz (button) folded before Flop (didn't bet)


PokerStars Hand #238171179832:  Hold'em No Limit ($0.01/$0.02 USD) - 2022/08/23 14:03:16 ET
Table 'Equinox IV' 6-max Seat #1 is the button
Seat 1: Emag fo Dog ($1.68 in chips)
Seat 2: elchicosinombre ($2.98 in chips)
Seat 3: AxCent8 ($0.91 in chips)
Seat 6: Leonel cz ($2 in chips)
elchicosinombre: posts small blind $0.01
AxCent8: posts big blind $0.02
LAMUS_PL: sits out
*** HOLE CARDS ***
Leonel cz: raises $0.03 to $0.05
Emag fo Dog: folds
elchicosinombre: calls $0.04
AxCent8: folds
*** FLOP *** [3s Kh 8c]
elchicosinombre: bets $0.02
Leonel cz: raises $0.08 to $0.10
elchicosinombre: calls $0.08
*** TURN *** [3s Kh 8c] [2d]
elchicosinombre: checks
Leonel cz: bets $0.10
elchicosinombre: calls $0.10
*** RIVER *** [3s Kh 8c 2d] [7h]
elchicosinombre: checks
Leonel cz: checks
*** SHOW DOWN ***
elchicosinombre: shows [Ks 6d] (a pair of Kings)
Leonel cz: mucks hand
elchicosinombre collected $0.50 from pot
*** SUMMARY ***
Total pot $0.52 | Rake $0.02
Board [3s Kh 8c 2d 7h]
Seat 1: Emag fo Dog (button) folded before Flop (didn't bet)
Seat 2: elchicosinombre (small blind) showed [Ks 6d] and won ($0.50) with a pair of Kings
Seat 3: AxCent8 (big blind) folded before Flop
Seat 6: Leonel cz mucked


PokerStars Hand #238171192425:  Hold'em No Limit ($0.01/$0.02 USD) - 2022/08/23 14:03:54 ET
Table 'Equinox IV' 6-max Seat #2 is the button
Seat 1: Emag fo Dog ($1.68 in chips)
Seat 2: elchicosinombre ($3.23 in chips)
Seat 3: AxCent8 ($0.89 in chips)
Seat 5: LAMUS_PL ($3 in chips)
Seat 6: Leonel cz ($2 in chips)
AxCent8: posts small blind $0.01
LAMUS_PL: posts big blind $0.02
*** HOLE CARDS ***
Leonel cz: folds
Emag fo Dog: raises $0.03 to $0.05
elchicosinombre: folds
AxCent8: calls $0.04
LAMUS_PL: folds
*** FLOP *** [Ah 7s Th]
AxCent8: checks
Emag fo Dog: bets $0.02
AxCent8: folds
Uncalled bet ($0.02) returned to Emag fo Dog
Emag fo Dog collected $0.12 from pot
Emag fo Dog: doesn't show hand
*** SUMMARY ***
Total pot $0.12 | Rake $0
Board [Ah 7s Th]
Seat 1: Emag fo Dog collected ($0.12)
Seat 2: elchicosinombre (button) folded before Flop (didn't bet)
Seat 3: AxCent8 (small blind) folded on the Flop
Seat 5: LAMUS_PL (big blind) folded before Flop
Seat 6: Leonel cz folded before Flop (didn't bet)


PokerStars Hand #238171219970:  Hold'em No Limit ($0.01/$0.02 USD) - 2022/08/23 14:04:50 ET
Table 'Equinox IV' 6-max Seat #3 is the button
Seat 1: Emag fo Dog ($1.75 in chips)
Seat 2: elchicosinombre ($3.23 in chips)
Seat 3: AxCent8 ($0.84 in chips)
Seat 5: LAMUS_PL ($2.98 in chips)
Seat 6: Leonel cz ($2 in chips)
LAMUS_PL: posts small blind $0.01
Leonel cz: posts big blind $0.02
*** HOLE CARDS ***
Emag fo Dog: raises $0.04 to $0.06
elchicosinombre: folds
AxCent8: folds
LAMUS_PL: folds
Leonel cz: folds
Uncalled bet ($0.04) returned to Emag fo Dog
Emag fo Dog collected $0.05 from pot
Emag fo Dog: doesn't show hand
*** SUMMARY ***
Total pot $0.05 | Rake $0
Seat 1: Emag fo Dog collected ($0.05)
Seat 2: elchicosinombre folded before Flop (didn't bet)
Seat 3: AxCent8 (button) folded before Flop (didn't bet)
Seat 5: LAMUS_PL (small blind) folded before Flop
Seat 6: Leonel cz (big blind) folded before Flop


PokerStars Hand #238171223073:  Hold'em No Limit ($0.01/$0.02 USD) - 2022/08/23 14:04:59 ET
Table 'Equinox IV' 6-max Seat #5 is the button
Seat 1: Emag fo Dog ($1.78 in chips)
Seat 2: elchicosinombre ($3.23 in chips)
Seat 3: AxCent8 ($0.84 in chips)
Seat 4: SidneyCrosby8 ($2 in chips)
Seat 5: LAMUS_PL ($2.97 in chips)
Seat 6: Leonel cz ($2 in chips)
Leonel cz: posts small blind $0.01
Emag fo Dog: posts big blind $0.02
SidneyCrosby8: posts small & big blinds $0.03
*** HOLE CARDS ***
elchicosinombre: calls $0.02
AxCent8: folds
SidneyCrosby8: checks
LAMUS_PL: folds
Leonel cz: raises $0.10 to $0.12
Emag fo Dog: calls $0.10
elchicosinombre: folds
SidneyCrosby8: folds
*** FLOP *** [9h 9s 4d]
Leonel cz: bets $0.14
Emag fo Dog: calls $0.14
*** TURN *** [9h 9s 4d] [5h]
Leonel cz: bets $0.36
Emag fo Dog: calls $0.36
*** RIVER *** [9h 9s 4d 5h] [Qh]
Leonel cz: checks
Emag fo Dog: checks
*** SHOW DOWN ***
Leonel cz: shows [Ac Td] (a pair of Nines)
Emag fo Dog: shows [8h 8d] (two pair, Nines and Eights)
Emag fo Dog collected $1.24 from pot
*** SUMMARY ***
Total pot $1.29 | Rake $0.05
Board [9h 9s 4d 5h Qh]
Seat 1: Emag fo Dog (big blind) showed [8h 8d] and won ($1.24) with two pair, Nines and Eights
Seat 2: elchicosinombre folded before Flop
Seat 3: AxCent8 folded before Flop (didn't bet)
Seat 4: SidneyCrosby8 folded before Flop (didn't bet)
Seat 5: LAMUS_PL (button) folded before Flop (didn't bet)
Seat 6: Leonel cz (small blind) showed [Ac Td] and lost with a pair of Nines


PokerStars Hand #238171242533:  Hold'em No Limit ($0.01/$0.02 USD) - 2022/08/23 14:05:55 ET
Table 'Equinox IV' 6-max Seat #6 is the button
Seat 1: Emag fo Dog ($2.40 in chips)
Seat 2: elchicosinombre ($3.21 in chips)
Seat 3: AxCent8 ($0.84 in chips)
Seat 4: SidneyCrosby8 ($2 in chips)
Seat 5: LAMUS_PL ($2.97 in chips)
Seat 6: Leonel cz ($2 in chips)
Emag fo Dog: posts small blind $0.01
elchicosinombre: posts big blind $0.02
*** HOLE CARDS ***
AxCent8: folds
SidneyCrosby8: folds
LAMUS_PL: raises $0.03 to $0.05
Leonel cz: folds
Emag fo Dog: calls $0.04
elchicosinombre: calls $0.03
*** FLOP *** [As 6d Kc]
Emag fo Dog: bets $0.02
elchicosinombre: folds
LAMUS_PL: folds
Uncalled bet ($0.02) returned to Emag fo Dog
Emag fo Dog collected $0.14 from pot
Emag fo Dog: doesn't show hand
*** SUMMARY ***
Total pot $0.15 | Rake $0.01
Board [As 6d Kc]
Seat 1: Emag fo Dog (small blind) collected ($0.14)
Seat 2: elchicosinombre (big blind) folded on the Flop
Seat 3: AxCent8 folded before Flop (didn't bet)
Seat 4: SidneyCrosby8 folded before Flop (didn't bet)
Seat 5: LAMUS_PL folded on the Flop
Seat 6: Leonel cz (button) folded before Flop (didn't bet)


PokerStars Hand #238171253340:  Hold'em No Limit ($0.01/$0.02 USD) - 2022/08/23 14:06:27 ET
Table 'Equinox IV' 6-max Seat #1 is the button
Seat 1: Emag fo Dog ($2.49 in chips)
Seat 2: elchicosinombre ($3.16 in chips)
Seat 3: AxCent8 ($0.84 in chips)
Seat 4: SidneyCrosby8 ($2 in chips)
Seat 5: LAMUS_PL ($2.92 in chips)
Seat 6: Leonel cz ($2 in chips)
elchicosinombre: posts small blind $0.01
AxCent8: posts big blind $0.02
*** HOLE CARDS ***
SidneyCrosby8: folds
LAMUS_PL: raises $0.04 to $0.06
Leonel cz: folds
Emag fo Dog: folds
elchicosinombre: folds
AxCent8: folds
Uncalled bet ($0.04) returned to LAMUS_PL
LAMUS_PL collected $0.05 from pot
LAMUS_PL: doesn't show hand
*** SUMMARY ***
Total pot $0.05 | Rake $0
Seat 1: Emag fo Dog (button) folded before Flop (didn't bet)
Seat 2: elchicosinombre (small blind) folded before Flop
Seat 3: AxCent8 (big blind) folded before Flop
Seat 4: SidneyCrosby8 folded before Flop (didn't bet)
Seat 5: LAMUS_PL collected ($0.05)
Seat 6: Leonel cz folded before Flop (didn't bet)


PokerStars Hand #238171257324:  Hold'em No Limit ($0.01/$0.02 USD) - 2022/08/23 14:06:39 ET
Table 'Equinox IV' 6-max Seat #2 is the button
Seat 1: Emag fo Dog ($2.49 in chips)
Seat 2: elchicosinombre ($3.15 in chips)
Seat 3: AxCent8 ($0.82 in chips)
Seat 4: SidneyCrosby8 ($2 in chips)
Seat 5: LAMUS_PL ($2.95 in chips)
Seat 6: Leonel cz ($2 in chips)
AxCent8: posts small blind $0.01
SidneyCrosby8: posts big blind $0.02
*** HOLE CARDS ***
LAMUS_PL: folds
Leonel cz: raises $0.03 to $0.05
Emag fo Dog: folds
elchicosinombre: folds
elchicosinombre leaves the table
AxCent8: folds
SidneyCrosby8: calls $0.03
*** FLOP *** [Tc 9c Jd]
SidneyCrosby8: checks
Leonel cz: bets $0.05
SidneyCrosby8: folds
Uncalled bet ($0.05) returned to Leonel cz
Leonel cz collected $0.11 from pot
Leonel cz: doesn't show hand
*** SUMMARY ***
Total pot $0.11 | Rake $0
Board [Tc 9c Jd]
Seat 1: Emag fo Dog folded before Flop (didn't bet)
Seat 2: elchicosinombre (button) folded before Flop (didn't bet)
Seat 3: AxCent8 (small blind) folded before Flop
Seat 4: SidneyCrosby8 (big blind) folded on the Flop
Seat 5: LAMUS_PL folded before Flop (didn't bet)
Seat 6: Leonel cz collected ($0.11)


PokerStars Hand #238171268472:  Hold'em No Limit ($0.01/$0.02 USD) - 2022/08/23 14:07:11 ET
Table 'Equinox IV' 6-max Seat #3 is the button
Seat 1: Emag fo Dog ($2.49 in chips)
Seat 3: AxCent8 ($0.81 in chips)
Seat 4: SidneyCrosby8 ($2 in chips)
Seat 5: LAMUS_PL ($2.95 in chips)
Seat 6: Leonel cz ($2.06 in chips)
SidneyCrosby8: posts small blind $0.01
LAMUS_PL: posts big blind $0.02
*** HOLE CARDS ***
Leonel cz: folds
Emag fo Dog: raises $0.03 to $0.05
AxCent8: folds
SidneyCrosby8: folds
LAMUS_PL: calls $0.03
*** FLOP *** [Kh 4h 9s]
LAMUS_PL: checks
Earco joins the table at seat #2
Emag fo Dog: bets $0.02
LAMUS_PL: calls $0.02
*** TURN *** [Kh 4h 9s] [Ah]
LAMUS_PL: bets $0.06
Emag fo Dog: calls $0.06
*** RIVER *** [Kh 4h 9s Ah] [Ac]
LAMUS_PL: checks
Emag fo Dog: bets $0.17
LAMUS_PL: folds
Uncalled bet ($0.17) returned to Emag fo Dog
Emag fo Dog collected $0.26 from pot
Emag fo Dog: doesn't show hand
*** SUMMARY ***
Total pot $0.27 | Rake $0.01
Board [Kh 4h 9s Ah Ac]
Seat 1: Emag fo Dog collected ($0.26)
Seat 3: AxCent8 (button) folded before Flop (didn't bet)
Seat 4: SidneyCrosby8 (small blind) folded before Flop
Seat 5: LAMUS_PL (big blind) folded on the River
Seat 6: Leonel cz folded before Flop (didn't bet)


PokerStars Hand #238171285211:  Hold'em No Limit ($0.01/$0.02 USD) - 2022/08/23 14:08:00 ET
Table 'Equinox IV' 6-max Seat #4 is the button
Seat 1: Emag fo Dog ($2.62 in chips)
Seat 3: AxCent8 ($0.81 in chips)
Seat 4: SidneyCrosby8 ($2 in chips)
Seat 5: LAMUS_PL ($2.82 in chips)
Seat 6: Leonel cz ($2.06 in chips)
LAMUS_PL: posts small blind $0.01
Leonel cz: posts big blind $0.02
Earco: sits out
*** HOLE CARDS ***
Emag fo Dog: raises $0.04 to $0.06
AxCent8: folds
SidneyCrosby8: calls $0.06
LAMUS_PL: folds
Leonel cz: folds
*** FLOP *** [6s 8h 9h]
Emag fo Dog: bets $0.02
SidneyCrosby8: raises $0.08 to $0.10
Emag fo Dog: calls $0.08
*** TURN *** [6s 8h 9h] [Kc]
Emag fo Dog: bets $0.02
SidneyCrosby8: raises $0.26 to $0.28
Emag fo Dog: folds
Uncalled bet ($0.26) returned to SidneyCrosby8
SidneyCrosby8 collected $0.38 from pot
SidneyCrosby8: doesn't show hand
*** SUMMARY ***
Total pot $0.39 | Rake $0.01
Board [6s 8h 9h Kc]
Seat 1: Emag fo Dog folded on the Turn
Seat 3: AxCent8 folded before Flop (didn't bet)
Seat 4: SidneyCrosby8 (button) collected ($0.38)
Seat 5: LAMUS_PL (small blind) folded before Flop
Seat 6: Leonel cz (big blind) folded before Flop


PokerStars Hand #238171300488:  Hold'em No Limit ($0.01/$0.02 USD) - 2022/08/23 14:08:45 ET
Table 'Equinox IV' 6-max Seat #5 is the button
Seat 1: Emag fo Dog ($2.44 in chips)
Seat 3: AxCent8 ($0.81 in chips)
Seat 4: SidneyCrosby8 ($2.20 in chips)
Seat 5: LAMUS_PL ($2.81 in chips)
Seat 6: Leonel cz ($2.04 in chips)
Leonel cz: posts small blind $0.01
Emag fo Dog: posts big blind $0.02
Earco: sits out
*** HOLE CARDS ***
AxCent8: folds
SidneyCrosby8: folds
LAMUS_PL: raises $0.02 to $0.04
Leonel cz: folds
Emag fo Dog: calls $0.02
*** FLOP *** [Qs 5c Ts]
Emag fo Dog: bets $0.02
LAMUS_PL: raises $0.09 to $0.11
Emag fo Dog: calls $0.09
*** TURN *** [Qs 5c Ts] [Kc]
Emag fo Dog: bets $0.02
LAMUS_PL: raises $0.27 to $0.29
Emag fo Dog: folds
Uncalled bet ($0.27) returned to LAMUS_PL
LAMUS_PL collected $0.34 from pot
LAMUS_PL: doesn't show hand
*** SUMMARY ***
Total pot $0.35 | Rake $0.01
Board [Qs 5c Ts Kc]
Seat 1: Emag fo Dog (big blind) folded on the Turn
Seat 3: AxCent8 folded before Flop (didn't bet)
Seat 4: SidneyCrosby8 folded before Flop (didn't bet)
Seat 5: LAMUS_PL (button) collected ($0.34)
Seat 6: Leonel cz (small blind) folded before Flop


PokerStars Hand #238171317386:  Hold'em No Limit ($0.01/$0.02 USD) - 2022/08/23 14:09:35 ET
Table 'Equinox IV' 6-max Seat #6 is the button
Seat 1: Emag fo Dog ($2.27 in chips)
Seat 2: Earco ($2 in chips)
Seat 3: AxCent8 ($0.81 in chips)
Seat 4: SidneyCrosby8 ($2.20 in chips)
Seat 5: LAMUS_PL ($2.98 in chips)
Seat 6: Leonel cz ($2.03 in chips)
Emag fo Dog: posts small blind $0.01
Earco: posts big blind $0.02
*** HOLE CARDS ***
AxCent8: calls $0.02
SidneyCrosby8: raises $0.08 to $0.10
LAMUS_PL: calls $0.10
Leonel cz: folds
Emag fo Dog: folds
Earco: folds
AxCent8: folds
*** FLOP *** [8h 9s 4d]
SidneyCrosby8: checks
LAMUS_PL: checks
*** TURN *** [8h 9s 4d] [Jh]
SidneyCrosby8: checks
LAMUS_PL: bets $0.11
SidneyCrosby8: folds
Uncalled bet ($0.11) returned to LAMUS_PL
LAMUS_PL collected $0.24 from pot
LAMUS_PL: doesn't show hand
*** SUMMARY ***
Total pot $0.25 | Rake $0.01
Board [8h 9s 4d Jh]
Seat 1: Emag fo Dog (small blind) folded before Flop
Seat 2: Earco (big blind) folded before Flop
Seat 3: AxCent8 folded before Flop
Seat 4: SidneyCrosby8 folded on the Turn
Seat 5: LAMUS_PL collected ($0.24)
Seat 6: Leonel cz (button) folded before Flop (didn't bet)


PokerStars Hand #238171329159:  Hold'em No Limit ($0.01/$0.02 USD) - 2022/08/23 14:10:09 ET
Table 'Equinox IV' 6-max Seat #1 is the button
Seat 1: Emag fo Dog ($2.26 in chips)
Seat 2: Earco ($1.98 in chips)
Seat 3: AxCent8 ($0.79 in chips)
Seat 4: SidneyCrosby8 ($2.10 in chips)
Seat 5: LAMUS_PL ($3.12 in chips)
Seat 6: Leonel cz ($2.03 in chips)
Earco: posts small blind $0.01
AxCent8: posts big blind $0.02
*** HOLE CARDS ***
SidneyCrosby8: folds
LAMUS_PL: raises $0.04 to $0.06
Leonel cz: calls $0.06
Emag fo Dog: calls $0.06
Earco: folds
AxCent8: folds
*** FLOP *** [5s 9d Qc]
LAMUS_PL: checks
Leonel cz: bets $0.10
Emag fo Dog: folds
LAMUS_PL: folds
Uncalled bet ($0.10) returned to Leonel cz
Leonel cz collected $0.20 from pot
Leonel cz: doesn't show hand
*** SUMMARY ***
Total pot $0.21 | Rake $0.01
Board [5s 9d Qc]
Seat 1: Emag fo Dog (button) folded on the Flop
Seat 2: Earco (small blind) folded before Flop
Seat 3: AxCent8 (big blind) folded before Flop
Seat 4: SidneyCrosby8 folded before Flop (didn't bet)
Seat 5: LAMUS_PL folded on the Flop
Seat 6: Leonel cz collected ($0.20)


PokerStars Hand #238171344172:  Hold'em No Limit ($0.01/$0.02 USD) - 2022/08/23 14:10:53 ET
Table 'Equinox IV' 6-max Seat #2 is the button
Seat 1: Emag fo Dog ($2.20 in chips)
Seat 2: Earco ($1.97 in chips)
Seat 3: AxCent8 ($0.77 in chips)
Seat 4: SidneyCrosby8 ($2.10 in chips)
Seat 5: LAMUS_PL ($3.06 in chips)
Seat 6: Leonel cz ($2.17 in chips)
AxCent8: posts small blind $0.01
SidneyCrosby8: posts big blind $0.02
*** HOLE CARDS ***
LAMUS_PL: raises $0.04 to $0.06
Leonel cz: folds
Emag fo Dog: folds
Earco: folds
AxCent8: folds
SidneyCrosby8: calls $0.04
*** FLOP *** [6h 3h Ac]
SidneyCrosby8: checks
LAMUS_PL: bets $0.09
SidneyCrosby8: folds
Uncalled bet ($0.09) returned to LAMUS_PL
LAMUS_PL collected $0.13 from pot
LAMUS_PL: doesn't show hand
*** SUMMARY ***
Total pot $0.13 | Rake $0
Board [6h 3h Ac]
Seat 1: Emag fo Dog folded before Flop (didn't bet)
Seat 2: Earco (button) folded before Flop (didn't bet)
Seat 3: AxCent8 (small blind) folded before Flop
Seat 4: SidneyCrosby8 (big blind) folded on the Flop
Seat 5: LAMUS_PL collected ($0.13)
Seat 6: Leonel cz folded before Flop (didn't bet)


PokerStars Hand #238171354262:  Hold'em No Limit ($0.01/$0.02 USD) - 2022/08/23 14:11:22 ET
Table 'Equinox IV' 6-max Seat #3 is the button
Seat 1: Emag fo Dog ($2.20 in chips)
Seat 2: Earco ($1.97 in chips)
Seat 3: AxCent8 ($0.76 in chips)
Seat 4: SidneyCrosby8 ($2.04 in chips)
Seat 5: LAMUS_PL ($3.13 in chips)
Seat 6: Leonel cz ($2.17 in chips)
SidneyCrosby8: posts small blind $0.01
LAMUS_PL: posts big blind $0.02
*** HOLE CARDS ***
Leonel cz: folds
Emag fo Dog: raises $0.04 to $0.06
Earco: folds
AxCent8: folds
SidneyCrosby8: folds
Leonel cz leaves the table
LAMUS_PL: calls $0.04
*** FLOP *** [7s 9h 9s]
LAMUS_PL: checks
Laserkart3 joins the table at seat #6
Emag fo Dog: bets $0.02
LAMUS_PL: raises $0.11 to $0.13
Emag fo Dog: folds
Uncalled bet ($0.11) returned to LAMUS_PL
LAMUS_PL collected $0.16 from pot
LAMUS_PL: doesn't show hand
*** SUMMARY ***
Total pot $0.17 | Rake $0.01
Board [7s 9h 9s]
Seat 1: Emag fo Dog folded on the Flop
Seat 2: Earco folded before Flop (didn't bet)
Seat 3: AxCent8 (button) folded before Flop (didn't bet)
Seat 4: SidneyCrosby8 (small blind) folded before Flop
Seat 5: LAMUS_PL (big blind) collected ($0.16)
Seat 6: Leonel cz folded before Flop (didn't bet)


PokerStars Hand #238171366124:  Hold'em No Limit ($0.01/$0.02 USD) - 2022/08/23 14:11:56 ET
Table 'Equinox IV' 6-max Seat #4 is the button
Seat 1: Emag fo Dog ($2.12 in chips)
Seat 2: Earco ($1.97 in chips)
Seat 3: AxCent8 ($0.76 in chips)
Seat 4: SidneyCrosby8 ($2.03 in chips)
Seat 5: LAMUS_PL ($3.21 in chips)
Seat 6: Laserkart3 ($1.60 in chips)
LAMUS_PL: posts small blind $0.01
Laserkart3: posts big blind $0.02
*** HOLE CARDS ***
Emag fo Dog: folds
Earco: folds
AxCent8: calls $0.02
SidneyCrosby8: folds
LAMUS_PL: raises $0.06 to $0.08
Laserkart3: folds
AxCent8: calls $0.06
*** FLOP *** [Kh Ks 7c]
LAMUS_PL: checks
AxCent8: bets $0.68 and is all-in
LAMUS_PL: calls $0.68
*** TURN *** [Kh Ks 7c] [9c]
*** RIVER *** [Kh Ks 7c 9c] [5d]
*** SHOW DOWN ***
LAMUS_PL: shows [Qd Qh] (two pair, Kings and Queens)
AxCent8: shows [Tc Jc] (a pair of Kings)
LAMUS_PL collected $1.48 from pot
*** SUMMARY ***
Total pot $1.54 | Rake $0.06
Board [Kh Ks 7c 9c 5d]
Seat 1: Emag fo Dog folded before Flop (didn't bet)
Seat 2: Earco folded before Flop (didn't bet)
Seat 3: AxCent8 showed [Tc Jc] and lost with a pair of Kings
Seat 4: SidneyCrosby8 (button) folded before Flop (didn't bet)
Seat 5: LAMUS_PL (small blind) showed [Qd Qh] and won ($1.48) with two pair, Kings and Queens
Seat 6: Laserkart3 (big blind) folded before Flop


PokerStars Hand #238171381972:  Hold'em No Limit ($0.01/$0.02 USD) - 2022/08/23 14:12:43 ET
Table 'Equinox IV' 6-max Seat #5 is the button
Seat 1: Emag fo Dog ($2.12 in chips)
Seat 2: Earco ($1.97 in chips)
Seat 4: SidneyCrosby8 ($2.03 in chips)
Seat 5: LAMUS_PL ($3.93 in chips)
Seat 6: Laserkart3 ($1.58 in chips)
Laserkart3: posts small blind $0.01
Emag fo Dog: posts big blind $0.02
*** HOLE CARDS ***
Earco: folds
SidneyCrosby8: raises $0.04 to $0.06
LAMUS_PL: calls $0.06
Laserkart3: folds
Emag fo Dog: folds
*** FLOP *** [5s Kd 5d]
SidneyCrosby8: checks
LAMUS_PL: checks
*** TURN *** [5s Kd 5d] [7s]
SidneyCrosby8: bets $0.11
LAMUS_PL: folds
Uncalled bet ($0.11) returned to SidneyCrosby8
SidneyCrosby8 collected $0.14 from pot
SidneyCrosby8: doesn't show hand
*** SUMMARY ***
Total pot $0.15 | Rake $0.01
Board [5s Kd 5d 7s]
Seat 1: Emag fo Dog (big blind) folded before Flop
Seat 2: Earco folded before Flop (didn't bet)
Seat 4: SidneyCrosby8 collected ($0.14)
Seat 5: LAMUS_PL (button) folded on the Turn
Seat 6: Laserkart3 (small blind) folded before Flop


PokerStars Hand #238171390165:  Hold'em No Limit ($0.01/$0.02 USD) - 2022/08/23 14:13:06 ET
Table 'Equinox IV' 6-max Seat #6 is the button
Seat 1: Emag fo Dog ($2.10 in chips)
Seat 2: Earco ($1.97 in chips)
Seat 3: AxCent8 ($0.80 in chips)
Seat 4: SidneyCrosby8 ($2.11 in chips)
Seat 5: LAMUS_PL ($3.87 in chips)
Seat 6: Laserkart3 ($1.57 in chips)
Emag fo Dog: posts small blind $0.01
Earco: posts big blind $0.02
*** HOLE CARDS ***
AxCent8: folds
SidneyCrosby8: folds
LAMUS_PL: raises $0.03 to $0.05
AxCent8 leaves the table
Laserkart3: folds
Emag fo Dog: folds
Earco: folds
Uncalled bet ($0.03) returned to LAMUS_PL
LAMUS_PL collected $0.05 from pot
LAMUS_PL: doesn't show hand
*** SUMMARY ***
Total pot $0.05 | Rake $0
Seat 1: Emag fo Dog (small blind) folded before Flop
Seat 2: Earco (big blind) folded before Flop
Seat 3: AxCent8 folded before Flop (didn't bet)
Seat 4: SidneyCrosby8 folded before Flop (didn't bet)
Seat 5: LAMUS_PL collected ($0.05)
Seat 6: Laserkart3 (button) folded before Flop (didn't bet)


PokerStars Hand #238171395755:  Hold'em No Limit ($0.01/$0.02 USD) - 2022/08/23 14:13:23 ET
Table 'Equinox IV' 6-max Seat #1 is the button
Seat 1: Emag fo Dog ($2.09 in chips)
Seat 2: Earco ($1.95 in chips)
Seat 4: SidneyCrosby8 ($2.11 in chips)
Seat 5: LAMUS_PL ($3.90 in chips)
Seat 6: Laserkart3 ($1.57 in chips)
Earco: posts small blind $0.01
SidneyCrosby8: posts big blind $0.02
*** HOLE CARDS ***
LAMUS_PL: folds
Laserkart3: folds
Emag fo Dog: raises $0.03 to $0.05
Earco: folds
SidneyCrosby8: folds
Uncalled bet ($0.03) returned to Emag fo Dog
Emag fo Dog collected $0.05 from pot
Emag fo Dog: doesn't show hand
*** SUMMARY ***
Total pot $0.05 | Rake $0
Seat 1: Emag fo Dog (button) collected ($0.05)
Seat 2: Earco (small blind) folded before Flop
Seat 4: SidneyCrosby8 (big blind) folded before Flop
Seat 5: LAMUS_PL folded before Flop (didn't bet)
Seat 6: Laserkart3 folded before Flop (didn't bet)


PokerStars Hand #238171400068:  Hold'em No Limit ($0.01/$0.02 USD) - 2022/08/23 14:13:35 ET
Table 'Equinox IV' 6-max Seat #2 is the button
Seat 1: Emag fo Dog ($2.12 in chips)
Seat 2: Earco ($1.94 in chips)
Seat 4: SidneyCrosby8 ($2.09 in chips)
Seat 5: LAMUS_PL ($3.90 in chips)
Seat 6: Laserkart3 ($1.57 in chips)
SidneyCrosby8: posts small blind $0.01
LAMUS_PL: posts big blind $0.02
*** HOLE CARDS ***
Laserkart3: calls $0.02
Emag fo Dog: folds
Pasztor868 joins the table at seat #3
Earco: raises $0.04 to $0.06
SidneyCrosby8: folds
LAMUS_PL: folds
Laserkart3: calls $0.04
*** FLOP *** [Th 2s 6h]
Laserkart3: checks
Earco: bets $0.07
Laserkart3: calls $0.07
*** TURN *** [Th 2s 6h] [8s]
Laserkart3: checks
Earco: checks
*** RIVER *** [Th 2s 6h 8s] [Ac]
Laserkart3: checks
Earco: checks
*** SHOW DOWN ***
Laserkart3: shows [Ah 5h] (a pair of Aces)
Earco: mucks hand
Laserkart3 collected $0.28 from pot
*** SUMMARY ***
Total pot $0.29 | Rake $0.01
Board [Th 2s 6h 8s Ac]
Seat 1: Emag fo Dog folded before Flop (didn't bet)
Seat 2: Earco (button) mucked
Seat 4: SidneyCrosby8 (small blind) folded before Flop
Seat 5: LAMUS_PL (big blind) folded before Flop
Seat 6: Laserkart3 showed [Ah 5h] and won ($0.28) with a pair of Aces


PokerStars Hand #238171419474:  Hold'em No Limit ($0.01/$0.02 USD) - 2022/08/23 14:14:31 ET
Table 'Equinox IV' 6-max Seat #4 is the button
Seat 1: Emag fo Dog ($2.12 in chips)
Seat 2: Earco ($1.81 in chips)
Seat 4: SidneyCrosby8 ($2.08 in chips)
Seat 5: LAMUS_PL ($3.88 in chips)
Seat 6: Laserkart3 ($1.72 in chips)
LAMUS_PL: posts small blind $0.01
Laserkart3: posts big blind $0.02
Pasztor868: sits out
*** HOLE CARDS ***
Emag fo Dog: folds
Earco: raises $0.04 to $0.06
SidneyCrosby8: folds
LAMUS_PL: folds
Laserkart3: folds
Uncalled bet ($0.04) returned to Earco
Earco collected $0.05 from pot
Earco: doesn't show hand
*** SUMMARY ***
Total pot $0.05 | Rake $0
Seat 1: Emag fo Dog folded before Flop (didn't bet)
Seat 2: Earco collected ($0.05)
Seat 4: SidneyCrosby8 (button) folded before Flop (didn't bet)
Seat 5: LAMUS_PL (small blind) folded before Flop
Seat 6: Laserkart3 (big blind) folded before Flop


PokerStars Hand #238171423584:  Hold'em No Limit ($0.01/$0.02 USD) - 2022/08/23 14:14:43 ET
Table 'Equinox IV' 6-max Seat #5 is the button
Seat 1: Emag fo Dog ($2.12 in chips)
Seat 2: Earco ($1.84 in chips)
Seat 4: SidneyCrosby8 ($2.08 in chips)
Seat 5: LAMUS_PL ($3.87 in chips)
Seat 6: Laserkart3 ($1.70 in chips)
Laserkart3: posts small blind $0.01
Emag fo Dog: posts big blind $0.02
Pasztor868: sits out
*** HOLE CARDS ***
Earco: folds
SidneyCrosby8: folds
LAMUS_PL: raises $0.02 to $0.04
Laserkart3: calls $0.03
Emag fo Dog: calls $0.02
*** FLOP *** [Th 9d 7s]
Laserkart3: checks
Emag fo Dog: bets $0.02
LAMUS_PL: calls $0.02
Laserkart3: calls $0.02
*** TURN *** [Th 9d 7s] [6s]
Laserkart3: checks
Emag fo Dog: checks
LAMUS_PL: checks
*** RIVER *** [Th 9d 7s 6s] [5c]
Pasztor868 is disconnected
Laserkart3: checks
Emag fo Dog: checks
LAMUS_PL: checks
*** SHOW DOWN ***
Laserkart3: shows [4d Kd] (high card King)
Emag fo Dog: shows [As 2c] (high card Ace)
LAMUS_PL: shows [Jd 7c] (a pair of Sevens)
LAMUS_PL collected $0.17 from pot
*** SUMMARY ***
Total pot $0.18 | Rake $0.01
Board [Th 9d 7s 6s 5c]
Seat 1: Emag fo Dog (big blind) showed [As 2c] and lost with high card Ace
Seat 2: Earco folded before Flop (didn't bet)
Seat 4: SidneyCrosby8 folded before Flop (didn't bet)
Seat 5: LAMUS_PL (button) showed [Jd 7c] and won ($0.17) with a pair of Sevens
Seat 6: Laserkart3 (small blind) showed [4d Kd] and lost with high card King


PokerStars Hand #238171445750:  Hold'em No Limit ($0.01/$0.02 USD) - 2022/08/23 14:15:46 ET
Table 'Equinox IV' 6-max Seat #6 is the button
Seat 1: Emag fo Dog ($2.06 in chips)
Seat 2: Earco ($1.84 in chips)
Seat 4: SidneyCrosby8 ($2.08 in chips)
Seat 5: LAMUS_PL ($3.98 in chips)
Seat 6: Laserkart3 ($1.64 in chips)
Emag fo Dog: posts small blind $0.01
Earco: posts big blind $0.02
Pasztor868 has timed out while disconnected
Pasztor868: is sitting out
*** HOLE CARDS ***
SidneyCrosby8: folds
LAMUS_PL: folds
Laserkart3: folds
Emag fo Dog: raises $0.03 to $0.05
Earco: folds
Uncalled bet ($0.03) returned to Emag fo Dog
Emag fo Dog collected $0.04 from pot
Emag fo Dog: doesn't show hand
*** SUMMARY ***
Total pot $0.04 | Rake $0
Seat 1: Emag fo Dog (small blind) collected ($0.04)
Seat 2: Earco (big blind) folded before Flop
Seat 4: SidneyCrosby8 folded before Flop (didn't bet)
Seat 5: LAMUS_PL folded before Flop (didn't bet)
Seat 6: Laserkart3 (button) folded before Flop (didn't bet)


PokerStars Hand #238171453774:  Hold'em No Limit ($0.01/$0.02 USD) - 2022/08/23 14:16:09 ET
Table 'Equinox IV' 6-max Seat #1 is the button
Seat 1: Emag fo Dog ($2.08 in chips)
Seat 2: Earco ($1.82 in chips)
Seat 4: SidneyCrosby8 ($2.08 in chips)
Seat 5: LAMUS_PL ($3.98 in chips)
Seat 6: Laserkart3 ($1.64 in chips)
Earco: posts small blind $0.01
SidneyCrosby8: posts big blind $0.02
*** HOLE CARDS ***
LAMUS_PL: raises $0.04 to $0.06
Laserkart3: folds
Emag fo Dog: folds
Earco: folds
SidneyCrosby8: calls $0.04
*** FLOP *** [Ts 7d As]
SidneyCrosby8: checks
LAMUS_PL: checks
*** TURN *** [Ts 7d As] [Kh]
SidneyCrosby8: bets $0.07
LAMUS_PL: folds
Uncalled bet ($0.07) returned to SidneyCrosby8
SidneyCrosby8 collected $0.13 from pot
SidneyCrosby8: doesn't show hand
*** SUMMARY ***
Total pot $0.13 | Rake $0
Board [Ts 7d As Kh]
Seat 1: Emag fo Dog (button) folded before Flop (didn't bet)
Seat 2: Earco (small blind) folded before Flop
Seat 4: SidneyCrosby8 (big blind) collected ($0.13)
Seat 5: LAMUS_PL folded on the Turn
Seat 6: Laserkart3 folded before Flop (didn't bet)


PokerStars Hand #238171463341:  Hold'em No Limit ($0.01/$0.02 USD) - 2022/08/23 14:16:37 ET
Table 'Equinox IV' 6-max Seat #2 is the button
Seat 1: Emag fo Dog ($2.08 in chips)
Seat 2: Earco ($1.81 in chips)
Seat 4: SidneyCrosby8 ($2.15 in chips)
Seat 5: LAMUS_PL ($3.92 in chips)
Seat 6: Laserkart3 ($1.64 in chips)
SidneyCrosby8: posts small blind $0.01
LAMUS_PL: posts big blind $0.02
*** HOLE CARDS ***
Laserkart3: calls $0.02
Emag fo Dog: calls $0.02
Earco: calls $0.02
SidneyCrosby8: calls $0.01
LAMUS_PL: checks
*** FLOP *** [5h 4h 7h]
SidneyCrosby8: bets $0.02
LAMUS_PL: folds
Laserkart3: calls $0.02
Emag fo Dog: raises $2.04 to $2.06 and is all-in
Earco: folds
SidneyCrosby8: folds
Laserkart3: folds
Uncalled bet ($2.04) returned to Emag fo Dog
Emag fo Dog collected $0.15 from pot
Emag fo Dog: doesn't show hand
*** SUMMARY ***
Total pot $0.16 | Rake $0.01
Board [5h 4h 7h]
Seat 1: Emag fo Dog collected ($0.15)
Seat 2: Earco (button) folded on the Flop
Seat 4: SidneyCrosby8 (small blind) folded on the Flop
Seat 5: LAMUS_PL (big blind) folded on the Flop
Seat 6: Laserkart3 folded on the Flop


PokerStars Hand #238171479860:  Hold'em No Limit ($0.01/$0.02 USD) - 2022/08/23 14:17:24 ET
Table 'Equinox IV' 6-max Seat #4 is the button
Seat 1: Emag fo Dog ($2.19 in chips)
Seat 2: Earco ($2 in chips)
Seat 4: SidneyCrosby8 ($2.11 in chips)
Seat 5: LAMUS_PL ($3.90 in chips)
Seat 6: Laserkart3 ($1.60 in chips)
LAMUS_PL: posts small blind $0.01
Laserkart3: posts big blind $0.02
*** HOLE CARDS ***
Emag fo Dog: raises $0.04 to $0.06
Earco: folds
SidneyCrosby8: folds
LAMUS_PL: folds
Laserkart3: calls $0.04
*** FLOP *** [Qs 9d Kh]
Laserkart3: checks
Emag fo Dog: bets $0.02
Laserkart3: raises $0.02 to $0.04
Emag fo Dog: folds
Uncalled bet ($0.02) returned to Laserkart3
Laserkart3 collected $0.16 from pot
*** SUMMARY ***
Total pot $0.17 | Rake $0.01
Board [Qs 9d Kh]
Seat 1: Emag fo Dog folded on the Flop
Seat 2: Earco folded before Flop (didn't bet)
Seat 4: SidneyCrosby8 (button) folded before Flop (didn't bet)
Seat 5: LAMUS_PL (small blind) folded before Flop
Seat 6: Laserkart3 (big blind) collected ($0.16)


PokerStars Hand #238171491197:  Hold'em No Limit ($0.01/$0.02 USD) - 2022/08/23 14:17:57 ET
Table 'Equinox IV' 6-max Seat #5 is the button
Seat 1: Emag fo Dog ($2.11 in chips)
Seat 2: Earco ($2 in chips)
Seat 4: SidneyCrosby8 ($2.11 in chips)
Seat 5: LAMUS_PL ($3.89 in chips)
Seat 6: Laserkart3 ($1.68 in chips)
Laserkart3: posts small blind $0.01
Emag fo Dog: posts big blind $0.02
*** HOLE CARDS ***
Earco: folds
SidneyCrosby8: folds
LAMUS_PL: raises $0.02 to $0.04
Laserkart3: folds
Emag fo Dog: calls $0.02
*** FLOP *** [Ad Jd 3s]
Emag fo Dog: bets $0.02
LAMUS_PL: folds
Uncalled bet ($0.02) returned to Emag fo Dog
Emag fo Dog collected $0.09 from pot
Emag fo Dog: doesn't show hand
*** SUMMARY ***
Total pot $0.09 | Rake $0
Board [Ad Jd 3s]
Seat 1: Emag fo Dog (big blind) collected ($0.09)
Seat 2: Earco folded before Flop (didn't bet)
Seat 4: SidneyCrosby8 folded before Flop (didn't bet)
Seat 5: LAMUS_PL (button) folded on the Flop
Seat 6: Laserkart3 (small blind) folded before Flop


PokerStars Hand #238171499474:  Hold'em No Limit ($0.01/$0.02 USD) - 2022/08/23 14:18:21 ET
Table 'Equinox IV' 6-max Seat #6 is the button
Seat 1: Emag fo Dog ($2.16 in chips)
Seat 2: Earco ($2 in chips)
Seat 4: SidneyCrosby8 ($2.11 in chips)
Seat 5: LAMUS_PL ($3.85 in chips)
Seat 6: Laserkart3 ($1.67 in chips)
Emag fo Dog: posts small blind $0.01
Earco: posts big blind $0.02
*** HOLE CARDS ***
SidneyCrosby8: folds
LAMUS_PL: folds
Laserkart3: folds
Emag fo Dog: raises $0.03 to $0.05
Earco: calls $0.03
*** FLOP *** [Th 8s 3d]
Emag fo Dog: bets $0.02
Earco: folds
Uncalled bet ($0.02) returned to Emag fo Dog
Emag fo Dog collected $0.10 from pot
Emag fo Dog: doesn't show hand
*** SUMMARY ***
Total pot $0.10 | Rake $0
Board [Th 8s 3d]
Seat 1: Emag fo Dog (small blind) collected ($0.10)
Seat 2: Earco (big blind) folded on the Flop
Seat 4: SidneyCrosby8 folded before Flop (didn't bet)
Seat 5: LAMUS_PL folded before Flop (didn't bet)
Seat 6: Laserkart3 (button) folded before Flop (didn't bet)


PokerStars Hand #238171508011:  Hold'em No Limit ($0.01/$0.02 USD) - 2022/08/23 14:18:45 ET
Table 'Equinox IV' 6-max Seat #1 is the button
Seat 1: Emag fo Dog ($2.21 in chips)
Seat 2: Earco ($1.95 in chips)
Seat 4: SidneyCrosby8 ($2.11 in chips)
Seat 5: LAMUS_PL ($3.85 in chips)
Seat 6: Laserkart3 ($1.67 in chips)
Earco: posts small blind $0.01
SidneyCrosby8: posts big blind $0.02
*** HOLE CARDS ***
LAMUS_PL: folds
Laserkart3: folds
Emag fo Dog: raises $0.03 to $0.05
Earco: calls $0.04
SidneyCrosby8: calls $0.03
*** FLOP *** [5c 4c Kh]
Earco: checks
SidneyCrosby8: checks
Emag fo Dog: bets $0.02
Earco: folds
SidneyCrosby8: raises $0.06 to $0.08
Emag fo Dog: folds
Uncalled bet ($0.06) returned to SidneyCrosby8
SidneyCrosby8 collected $0.18 from pot
SidneyCrosby8: doesn't show hand
*** SUMMARY ***
Total pot $0.19 | Rake $0.01
Board [5c 4c Kh]
Seat 1: Emag fo Dog (button) folded on the Flop
Seat 2: Earco (small blind) folded on the Flop
Seat 4: SidneyCrosby8 (big blind) collected ($0.18)
Seat 5: LAMUS_PL folded before Flop (didn't bet)
Seat 6: Laserkart3 folded before Flop (didn't bet)


PokerStars Hand #238171520327:  Hold'em No Limit ($0.01/$0.02 USD) - 2022/08/23 14:19:21 ET
Table 'Equinox IV' 6-max Seat #2 is the button
Seat 1: Emag fo Dog ($2.14 in chips)
Seat 2: Earco ($1.90 in chips)
Seat 4: SidneyCrosby8 ($2.22 in chips)
Seat 5: LAMUS_PL ($3.85 in chips)
Seat 6: Laserkart3 ($1.67 in chips)
SidneyCrosby8: posts small blind $0.01
LAMUS_PL: posts big blind $0.02
*** HOLE CARDS ***
Laserkart3: folds
Emag fo Dog: folds
Earco: folds
SidneyCrosby8: folds
Uncalled bet ($0.01) returned to LAMUS_PL
LAMUS_PL collected $0.02 from pot
LAMUS_PL: doesn't show hand
*** SUMMARY ***
Total pot $0.02 | Rake $0
Seat 1: Emag fo Dog folded before Flop (didn't bet)
Seat 2: Earco (button) folded before Flop (didn't bet)
Seat 4: SidneyCrosby8 (small blind) folded before Flop
Seat 5: LAMUS_PL (big blind) collected ($0.02)
Seat 6: Laserkart3 folded before Flop (didn't bet)


PokerStars Hand #238171524474:  Hold'em No Limit ($0.01/$0.02 USD) - 2022/08/23 14:19:32 ET
Table 'Equinox IV' 6-max Seat #4 is the button
Seat 1: Emag fo Dog ($2.14 in chips)
Seat 2: Earco ($1.90 in chips)
Seat 4: SidneyCrosby8 ($2.21 in chips)
Seat 5: LAMUS_PL ($3.86 in chips)
LAMUS_PL: posts small blind $0.01
Laserkart3: is sitting out
Emag fo Dog: posts big blind $0.02
*** HOLE CARDS ***
Earco: raises $0.04 to $0.06
SidneyCrosby8: calls $0.06
Laserkart3 leaves the table
LAMUS_PL: folds
Emag fo Dog: folds
*** FLOP *** [6c Ks 9s]
Morales7-PRO joins the table at seat #6
Earco: bets $0.09
SidneyCrosby8: folds
Uncalled bet ($0.09) returned to Earco
Earco collected $0.14 from pot
Earco: doesn't show hand
*** SUMMARY ***
Total pot $0.15 | Rake $0.01
Board [6c Ks 9s]
Seat 1: Emag fo Dog (big blind) folded before Flop
Seat 2: Earco collected ($0.14)
Seat 4: SidneyCrosby8 (button) folded on the Flop
Seat 5: LAMUS_PL (small blind) folded before Flop


PokerStars Hand #238171532575:  Hold'em No Limit ($0.01/$0.02 USD) - 2022/08/23 14:19:56 ET
Table 'Equinox IV' 6-max Seat #5 is the button
Seat 1: Emag fo Dog ($2.12 in chips)
Seat 2: Earco ($1.98 in chips)
Seat 4: SidneyCrosby8 ($2.15 in chips)
Seat 5: LAMUS_PL ($3.85 in chips)
Emag fo Dog: posts small blind $0.01
Earco: posts big blind $0.02
*** HOLE CARDS ***
SidneyCrosby8: folds
LAMUS_PL: folds
Emag fo Dog: raises $0.03 to $0.05
Earco: folds
Uncalled bet ($0.03) returned to Emag fo Dog
Emag fo Dog collected $0.04 from pot
Emag fo Dog: doesn't show hand
*** SUMMARY ***
Total pot $0.04 | Rake $0
Seat 1: Emag fo Dog (small blind) collected ($0.04)
Seat 2: Earco (big blind) folded before Flop
Seat 4: SidneyCrosby8 folded before Flop (didn't bet)
Seat 5: LAMUS_PL (button) folded before Flop (didn't bet)


PokerStars Hand #238171536376:  Hold'em No Limit ($0.01/$0.02 USD) - 2022/08/23 14:20:06 ET
Table 'Equinox IV' 6-max Seat #1 is the button
Seat 1: Emag fo Dog ($2.14 in chips)
Seat 2: Earco ($1.96 in chips)
Seat 4: SidneyCrosby8 ($2.15 in chips)
Seat 5: LAMUS_PL ($3.85 in chips)
Earco: posts small blind $0.01
SidneyCrosby8: posts big blind $0.02
Morales7-PRO: sits out
*** HOLE CARDS ***
LAMUS_PL: raises $0.03 to $0.05
Emag fo Dog: folds
Earco: folds
SidneyCrosby8: folds
Uncalled bet ($0.03) returned to LAMUS_PL
LAMUS_PL collected $0.05 from pot
LAMUS_PL: doesn't show hand
*** SUMMARY ***
Total pot $0.05 | Rake $0
Seat 1: Emag fo Dog (button) folded before Flop (didn't bet)
Seat 2: Earco (small blind) folded before Flop
Seat 4: SidneyCrosby8 (big blind) folded before Flop
Seat 5: LAMUS_PL collected ($0.05)


PokerStars Hand #238171541578:  Hold'em No Limit ($0.01/$0.02 USD) - 2022/08/23 14:20:21 ET
Table 'Equinox IV' 6-max Seat #2 is the button
Seat 1: Emag fo Dog ($2.14 in chips)
Seat 2: Earco ($1.95 in chips)
Seat 4: SidneyCrosby8 ($2.13 in chips)
Seat 5: LAMUS_PL ($3.88 in chips)
SidneyCrosby8: posts small blind $0.01
LAMUS_PL: posts big blind $0.02
Morales7-PRO: sits out
*** HOLE CARDS ***
Emag fo Dog: raises $0.03 to $0.05
Earco: calls $0.05
SidneyCrosby8: folds
LAMUS_PL: folds
*** FLOP *** [Ks Qd Jd]
Emag fo Dog: bets $0.02
Earco: folds
Uncalled bet ($0.02) returned to Emag fo Dog
Emag fo Dog collected $0.13 from pot
Emag fo Dog: doesn't show hand
*** SUMMARY ***
Total pot $0.13 | Rake $0
Board [Ks Qd Jd]
Seat 1: Emag fo Dog collected ($0.13)
Seat 2: Earco (button) folded on the Flop
Seat 4: SidneyCrosby8 (small blind) folded before Flop
Seat 5: LAMUS_PL (big blind) folded before Flop


PokerStars Hand #238171549752:  Hold'em No Limit ($0.01/$0.02 USD) - 2022/08/23 14:20:44 ET
Table 'Equinox IV' 6-max Seat #4 is the button
Seat 1: Emag fo Dog ($2.22 in chips)
Seat 2: Earco ($1.90 in chips)
Seat 4: SidneyCrosby8 ($2.12 in chips)
Seat 5: LAMUS_PL ($3.86 in chips)
Seat 6: Morales7-PRO ($2 in chips)
LAMUS_PL: posts small blind $0.01
Morales7-PRO: posts big blind $0.02
*** HOLE CARDS ***
Emag fo Dog: folds
Earco: folds
SidneyCrosby8: raises $0.04 to $0.06
LAMUS_PL: raises $0.16 to $0.22
Morales7-PRO: folds
SidneyCrosby8: folds
Uncalled bet ($0.16) returned to LAMUS_PL
LAMUS_PL collected $0.14 from pot
LAMUS_PL: doesn't show hand
*** SUMMARY ***
Total pot $0.14 | Rake $0
Seat 1: Emag fo Dog folded before Flop (didn't bet)
Seat 2: Earco folded before Flop (didn't bet)
Seat 4: SidneyCrosby8 (button) folded before Flop
Seat 5: LAMUS_PL (small blind) collected ($0.14)
Seat 6: Morales7-PRO (big blind) folded before Flop


PokerStars Hand #238171556475:  Hold'em No Limit ($0.01/$0.02 USD) - 2022/08/23 14:21:04 ET
Table 'Equinox IV' 6-max Seat #5 is the button
Seat 1: Emag fo Dog ($2.22 in chips)
Seat 2: Earco ($1.90 in chips)
Seat 4: SidneyCrosby8 ($2.06 in chips)
Seat 5: LAMUS_PL ($3.94 in chips)
Seat 6: Morales7-PRO ($2 in chips)
Morales7-PRO: posts small blind $0.01
Emag fo Dog: posts big blind $0.02
*** HOLE CARDS ***
Earco: folds
SidneyCrosby8: folds
LAMUS_PL: raises $0.02 to $0.04
Morales7-PRO: folds
Emag fo Dog: folds
Uncalled bet ($0.02) returned to LAMUS_PL
LAMUS_PL collected $0.05 from pot
LAMUS_PL: doesn't show hand
*** SUMMARY ***
Total pot $0.05 | Rake $0
Seat 1: Emag fo Dog (big blind) folded before Flop
Seat 2: Earco folded before Flop (didn't bet)
Seat 4: SidneyCrosby8 folded before Flop (didn't bet)
Seat 5: LAMUS_PL (button) collected ($0.05)
Seat 6: Morales7-PRO (small blind) folded before Flop


PokerStars Hand #238171561830:  Hold'em No Limit ($0.01/$0.02 USD) - 2022/08/23 14:21:19 ET
Table 'Equinox IV' 6-max Seat #6 is the button
Seat 1: Emag fo Dog ($2.20 in chips)
Seat 2: Earco ($1.90 in chips)
Seat 4: SidneyCrosby8 ($2.06 in chips)
Seat 5: LAMUS_PL ($3.97 in chips)
Seat 6: Morales7-PRO ($2 in chips)
Emag fo Dog: posts small blind $0.01
Earco: posts big blind $0.02
*** HOLE CARDS ***
SidneyCrosby8: folds
LAMUS_PL: raises $0.03 to $0.05
Morales7-PRO: folds
Emag fo Dog: calls $0.04
Earco: calls $0.03
*** FLOP *** [Qs Ts 8h]
Emag fo Dog: bets $0.02
Earco: folds
LAMUS_PL: raises $0.12 to $0.14
Emag fo Dog: folds
Uncalled bet ($0.12) returned to LAMUS_PL
LAMUS_PL collected $0.18 from pot
LAMUS_PL: doesn't show hand
*** SUMMARY ***
Total pot $0.19 | Rake $0.01
Board [Qs Ts 8h]
Seat 1: Emag fo Dog (small blind) folded on the Flop
Seat 2: Earco (big blind) folded on the Flop
Seat 4: SidneyCrosby8 folded before Flop (didn't bet)
Seat 5: LAMUS_PL collected ($0.18)
Seat 6: Morales7-PRO (button) folded before Flop (didn't bet)


PokerStars Hand #238171575587:  Hold'em No Limit ($0.01/$0.02 USD) - 2022/08/23 14:21:58 ET
Table 'Equinox IV' 6-max Seat #1 is the button
Seat 1: Emag fo Dog ($2.13 in chips)
Seat 2: Earco ($1.85 in chips)
Seat 4: SidneyCrosby8 ($2.06 in chips)
Seat 5: LAMUS_PL ($4.08 in chips)
Seat 6: Morales7-PRO ($2 in chips)
Earco: posts small blind $0.01
SidneyCrosby8: posts big blind $0.02
*** HOLE CARDS ***
LAMUS_PL: raises $0.04 to $0.06
Morales7-PRO: folds
Emag fo Dog: folds
Earco: folds
SidneyCrosby8: folds
Uncalled bet ($0.04) returned to LAMUS_PL
LAMUS_PL collected $0.05 from pot
Pasztor868 was removed from the table for failing to post
Pasztor868 leaves the table
LAMUS_PL: doesn't show hand
*** SUMMARY ***
Total pot $0.05 | Rake $0
Seat 1: Emag fo Dog (button) folded before Flop (didn't bet)
Seat 2: Earco (small blind) folded before Flop
Seat 4: SidneyCrosby8 (big blind) folded before Flop
Seat 5: LAMUS_PL collected ($0.05)
Seat 6: Morales7-PRO folded before Flop (didn't bet)


PokerStars Hand #238171580321:  Hold'em No Limit ($0.01/$0.02 USD) - 2022/08/23 14:22:12 ET
Table 'Equinox IV' 6-max Seat #2 is the button
Seat 1: Emag fo Dog ($2.13 in chips)
Seat 2: Earco ($1.84 in chips)
Seat 4: SidneyCrosby8 ($2.04 in chips)
Seat 5: LAMUS_PL ($4.11 in chips)
Seat 6: Morales7-PRO ($2 in chips)
SidneyCrosby8: posts small blind $0.01
LAMUS_PL: posts big blind $0.02
*** HOLE CARDS ***
Morales7-PRO: folds
Emag fo Dog: folds
Earco: raises $0.04 to $0.06
SidneyCrosby8: folds
LAMUS_PL: calls $0.04
*** FLOP *** [7s 9c 9d]
DonFoka joins the table at seat #3
LAMUS_PL: checks
Earco: checks
*** TURN *** [7s 9c 9d] [Th]
LAMUS_PL: bets $0.09
Earco: folds
Uncalled bet ($0.09) returned to LAMUS_PL
LAMUS_PL collected $0.13 from pot
LAMUS_PL: doesn't show hand
*** SUMMARY ***
Total pot $0.13 | Rake $0
Board [7s 9c 9d Th]
Seat 1: Emag fo Dog folded before Flop (didn't bet)
Seat 2: Earco (button) folded on the Turn
Seat 4: SidneyCrosby8 (small blind) folded before Flop
Seat 5: LAMUS_PL (big blind) collected ($0.13)
Seat 6: Morales7-PRO folded before Flop (didn't bet)


PokerStars Hand #238171592590:  Hold'em No Limit ($0.01/$0.02 USD) - 2022/08/23 14:22:47 ET
Table 'Equinox IV' 6-max Seat #4 is the button
Seat 1: Emag fo Dog ($2.13 in chips)
Seat 2: Earco ($2 in chips)
Seat 3: DonFoka ($1.60 in chips)
Seat 4: SidneyCrosby8 ($2.03 in chips)
Seat 5: LAMUS_PL ($4.18 in chips)
Seat 6: Morales7-PRO ($2 in chips)
LAMUS_PL: posts small blind $0.01
Morales7-PRO: posts big blind $0.02
DonFoka: posts big blind $0.02
*** HOLE CARDS ***
Emag fo Dog: raises $0.04 to $0.06
Earco: folds
DonFoka: calls $0.04
SidneyCrosby8: folds
LAMUS_PL: folds
Morales7-PRO: folds
*** FLOP *** [7d Qd 7s]
Emag fo Dog: bets $0.02
DonFoka: folds
Uncalled bet ($0.02) returned to Emag fo Dog
Emag fo Dog collected $0.14 from pot
Emag fo Dog: doesn't show hand
*** SUMMARY ***
Total pot $0.15 | Rake $0.01
Board [7d Qd 7s]
Seat 1: Emag fo Dog collected ($0.14)
Seat 2: Earco folded before Flop (didn't bet)
Seat 3: DonFoka folded on the Flop
Seat 4: SidneyCrosby8 (button) folded before Flop (didn't bet)
Seat 5: LAMUS_PL (small blind) folded before Flop
Seat 6: Morales7-PRO (big blind) folded before Flop


PokerStars Hand #238171605095:  Hold'em No Limit ($0.01/$0.02 USD) - 2022/08/23 14:23:22 ET
Table 'Equinox IV' 6-max Seat #5 is the button
Seat 1: Emag fo Dog ($2.21 in chips)
Seat 2: Earco ($2 in chips)
Seat 3: DonFoka ($1.54 in chips)
Seat 4: SidneyCrosby8 ($2.03 in chips)
Seat 5: LAMUS_PL ($4.17 in chips)
Seat 6: Morales7-PRO ($2 in chips)
Morales7-PRO: posts small blind $0.01
Emag fo Dog: posts big blind $0.02
*** HOLE CARDS ***
Earco: folds
DonFoka: calls $0.02
SidneyCrosby8: folds
LAMUS_PL: raises $0.06 to $0.08
Morales7-PRO: folds
Emag fo Dog: calls $0.06
DonFoka: calls $0.06
*** FLOP *** [5d 9d 2h]
Emag fo Dog: bets $0.02
DonFoka: calls $0.02
LAMUS_PL: calls $0.02
*** TURN *** [5d 9d 2h] [4h]
Emag fo Dog: bets $0.02
DonFoka: calls $0.02
LAMUS_PL: raises $0.27 to $0.29
Emag fo Dog: calls $0.27
DonFoka: calls $0.27
*** RIVER *** [5d 9d 2h 4h] [6c]
Emag fo Dog: bets $0.02
DonFoka: folds
LAMUS_PL: raises $0.78 to $0.80
Emag fo Dog: folds
Uncalled bet ($0.78) returned to LAMUS_PL
LAMUS_PL collected $1.17 from pot
LAMUS_PL: doesn't show hand
*** SUMMARY ***
Total pot $1.22 | Rake $0.05
Board [5d 9d 2h 4h 6c]
Seat 1: Emag fo Dog (big blind) folded on the River
Seat 2: Earco folded before Flop (didn't bet)
Seat 3: DonFoka folded on the River
Seat 4: SidneyCrosby8 folded before Flop (didn't bet)
Seat 5: LAMUS_PL (button) collected ($1.17)
Seat 6: Morales7-PRO (small blind) folded before Flop


PokerStars Hand #238171638306:  Hold'em No Limit ($0.01/$0.02 USD) - 2022/08/23 14:24:56 ET
Table 'Equinox IV' 6-max Seat #6 is the button
Seat 1: Emag fo Dog ($1.80 in chips)
Seat 2: Earco ($2 in chips)
Seat 3: DonFoka ($1.15 in chips)
Seat 4: SidneyCrosby8 ($2.03 in chips)
Seat 5: LAMUS_PL ($4.93 in chips)
Seat 6: Morales7-PRO ($2 in chips)
Emag fo Dog: posts small blind $0.01
Earco: posts big blind $0.02
*** HOLE CARDS ***
DonFoka: calls $0.02
SidneyCrosby8: folds
LAMUS_PL: raises $0.06 to $0.08
Morales7-PRO: folds
Emag fo Dog: folds
Earco: folds
DonFoka: calls $0.06
*** FLOP *** [Th 3d 5h]
DonFoka: checks
LAMUS_PL: bets $0.12
DonFoka: calls $0.12
*** TURN *** [Th 3d 5h] [Qh]
DonFoka: checks
LAMUS_PL: checks
*** RIVER *** [Th 3d 5h Qh] [4d]
DonFoka: checks
LAMUS_PL: bets $0.27
DonFoka: folds
Uncalled bet ($0.27) returned to LAMUS_PL
LAMUS_PL collected $0.41 from pot
LAMUS_PL: doesn't show hand
*** SUMMARY ***
Total pot $0.43 | Rake $0.02
Board [Th 3d 5h Qh 4d]
Seat 1: Emag fo Dog (small blind) folded before Flop
Seat 2: Earco (big blind) folded before Flop
Seat 3: DonFoka folded on the River
Seat 4: SidneyCrosby8 folded before Flop (didn't bet)
Seat 5: LAMUS_PL collected ($0.41)
Seat 6: Morales7-PRO (button) folded before Flop (didn't bet)


PokerStars Hand #238171662567:  Hold'em No Limit ($0.01/$0.02 USD) - 2022/08/23 14:26:05 ET
Table 'Equinox IV' 6-max Seat #1 is the button
Seat 1: Emag fo Dog ($1.79 in chips)
Seat 2: Earco ($1.98 in chips)
Seat 3: DonFoka ($0.95 in chips)
Seat 4: SidneyCrosby8 ($2.03 in chips)
Seat 5: LAMUS_PL ($5.14 in chips)
Seat 6: Morales7-PRO ($2 in chips)
Earco: posts small blind $0.01
DonFoka: posts big blind $0.02
*** HOLE CARDS ***
SidneyCrosby8: raises $0.04 to $0.06
LAMUS_PL: folds
Morales7-PRO: folds
Emag fo Dog: folds
Earco: folds
DonFoka: calls $0.04
*** FLOP *** [7s 6s Tc]
DonFoka: bets $0.02
SidneyCrosby8: calls $0.02
*** TURN *** [7s 6s Tc] [7c]
DonFoka is disconnected
DonFoka has timed out while disconnected
DonFoka: checks
SidneyCrosby8: checks
*** RIVER *** [7s 6s Tc 7c] [2d]
DonFoka is connected
DonFoka has timed out
DonFoka: checks
SidneyCrosby8: checks
*** SHOW DOWN ***
DonFoka: shows [5s 4s] (a pair of Sevens)
SidneyCrosby8: shows [Ad Js] (a pair of Sevens - Ace kicker)
SidneyCrosby8 collected $0.16 from pot
*** SUMMARY ***
Total pot $0.17 | Rake $0.01
Board [7s 6s Tc 7c 2d]
Seat 1: Emag fo Dog (button) folded before Flop (didn't bet)
Seat 2: Earco (small blind) folded before Flop
Seat 3: DonFoka (big blind) showed [5s 4s] and lost with a pair of Sevens
Seat 4: SidneyCrosby8 showed [Ad Js] and won ($0.16) with a pair of Sevens
Seat 5: LAMUS_PL folded before Flop (didn't bet)
Seat 6: Morales7-PRO folded before Flop (didn't bet)


PokerStars Hand #238171694616:  Hold'em No Limit ($0.01/$0.02 USD) - 2022/08/23 14:27:37 ET
Table 'Equinox IV' 6-max Seat #2 is the button
Seat 1: Emag fo Dog ($1.79 in chips)
Seat 2: Earco ($1.97 in chips)
Seat 3: DonFoka ($0.87 in chips)
Seat 4: SidneyCrosby8 ($2.11 in chips)
Seat 5: LAMUS_PL ($5.14 in chips)
Seat 6: Morales7-PRO ($2 in chips)
DonFoka: posts small blind $0.01
SidneyCrosby8: posts big blind $0.02
*** HOLE CARDS ***
LAMUS_PL: folds
Morales7-PRO: raises $0.04 to $0.06
Emag fo Dog: calls $0.06
Earco: folds
DonFoka: calls $0.05
SidneyCrosby8: calls $0.04
*** FLOP *** [Kh 7c 5s]
DonFoka: checks
SidneyCrosby8: checks
Morales7-PRO: checks
Emag fo Dog: bets $0.02
DonFoka: folds
SidneyCrosby8: calls $0.02
Morales7-PRO: raises $0.14 to $0.16
Emag fo Dog: folds
SidneyCrosby8: folds
Uncalled bet ($0.14) returned to Morales7-PRO
Morales7-PRO collected $0.29 from pot
Morales7-PRO: doesn't show hand
*** SUMMARY ***
Total pot $0.30 | Rake $0.01
Board [Kh 7c 5s]
Seat 1: Emag fo Dog folded on the Flop
Seat 2: Earco (button) folded before Flop (didn't bet)
Seat 3: DonFoka (small blind) folded on the Flop
Seat 4: SidneyCrosby8 (big blind) folded on the Flop
Seat 5: LAMUS_PL folded before Flop (didn't bet)
Seat 6: Morales7-PRO collected ($0.29)


PokerStars Hand #238171715968:  Hold'em No Limit ($0.01/$0.02 USD) - 2022/08/23 14:28:38 ET
Table 'Equinox IV' 6-max Seat #3 is the button
Seat 1: Emag fo Dog ($1.71 in chips)
Seat 2: Earco ($1.97 in chips)
Seat 3: DonFoka ($0.81 in chips)
Seat 4: SidneyCrosby8 ($2.03 in chips)
Seat 5: LAMUS_PL ($5.14 in chips)
Seat 6: Morales7-PRO ($2.21 in chips)
SidneyCrosby8: posts small blind $0.01
LAMUS_PL: posts big blind $0.02
*** HOLE CARDS ***
Morales7-PRO: folds
Emag fo Dog: raises $0.04 to $0.06
Earco: calls $0.06
DonFoka: calls $0.06
SidneyCrosby8: folds
LAMUS_PL: folds
*** FLOP *** [3s 5s 6c]
Emag fo Dog: bets $0.02
Earco: calls $0.02
DonFoka: calls $0.02
*** TURN *** [3s 5s 6c] [6h]
Emag fo Dog: bets $0.02
Earco: folds
DonFoka: raises $0.02 to $0.04
Emag fo Dog: calls $0.02
*** RIVER *** [3s 5s 6c 6h] [9c]
Emag fo Dog: bets $0.02
DonFoka: raises $0.02 to $0.04
Emag fo Dog: calls $0.02
*** SHOW DOWN ***
DonFoka: shows [6d 7h] (three of a kind, Sixes)
Emag fo Dog: mucks hand
DonFoka collected $0.41 from pot
*** SUMMARY ***
Total pot $0.43 | Rake $0.02
Board [3s 5s 6c 6h 9c]
Seat 1: Emag fo Dog mucked
Seat 2: Earco folded on the Turn
Seat 3: DonFoka (button) showed [6d 7h] and won ($0.41) with three of a kind, Sixes
Seat 4: SidneyCrosby8 (small blind) folded before Flop
Seat 5: LAMUS_PL (big blind) folded before Flop
Seat 6: Morales7-PRO folded before Flop (didn't bet)


PokerStars Hand #238171745092:  Hold'em No Limit ($0.01/$0.02 USD) - 2022/08/23 14:30:02 ET
Table 'Equinox IV' 6-max Seat #4 is the button
Seat 1: Emag fo Dog ($1.68 in chips)
Seat 2: Earco ($1.89 in chips)
Seat 3: DonFoka ($1.06 in chips)
Seat 4: SidneyCrosby8 ($2.02 in chips)
Seat 5: LAMUS_PL ($5.12 in chips)
Seat 6: Morales7-PRO ($2.21 in chips)
LAMUS_PL: posts small blind $0.01
Morales7-PRO: posts big blind $0.02
*** HOLE CARDS ***
Emag fo Dog: folds
Earco: folds
DonFoka has timed out
DonFoka: folds
SidneyCrosby8: raises $0.04 to $0.06
LAMUS_PL: folds
Morales7-PRO: raises $0.12 to $0.18
SidneyCrosby8: calls $0.12
*** FLOP *** [9d 5s Ks]
Morales7-PRO: checks
SidneyCrosby8: checks
*** TURN *** [9d 5s Ks] [8s]
DonFoka leaves the table
Morales7-PRO: checks
SidneyCrosby8: bets $0.20
mupe44 joins the table at seat #3
Morales7-PRO: calls $0.20
*** RIVER *** [9d 5s Ks 8s] [2h]
Morales7-PRO: checks
SidneyCrosby8: bets $0.48
Morales7-PRO: folds
Uncalled bet ($0.48) returned to SidneyCrosby8
SidneyCrosby8 collected $0.74 from pot
SidneyCrosby8: doesn't show hand
*** SUMMARY ***
Total pot $0.77 | Rake $0.03
Board [9d 5s Ks 8s 2h]
Seat 1: Emag fo Dog folded before Flop (didn't bet)
Seat 2: Earco folded before Flop (didn't bet)
Seat 3: DonFoka folded before Flop (didn't bet)
Seat 4: SidneyCrosby8 (button) collected ($0.74)
Seat 5: LAMUS_PL (small blind) folded before Flop
Seat 6: Morales7-PRO (big blind) folded on the River


PokerStars Hand #238171772526:  Hold'em No Limit ($0.01/$0.02 USD) - 2022/08/23 14:31:20 ET
Table 'Equinox IV' 6-max Seat #5 is the button
Seat 1: Emag fo Dog ($1.68 in chips)
Seat 2: Earco ($1.89 in chips)
Seat 4: SidneyCrosby8 ($2.38 in chips)
Seat 5: LAMUS_PL ($5.11 in chips)
Seat 6: Morales7-PRO ($2 in chips)
Morales7-PRO: posts small blind $0.01
Emag fo Dog: posts big blind $0.02
mupe44: sits out
*** HOLE CARDS ***
Earco: folds
SidneyCrosby8: folds
LAMUS_PL: raises $0.04 to $0.06
Morales7-PRO: folds
Emag fo Dog: folds
Uncalled bet ($0.04) returned to LAMUS_PL
LAMUS_PL collected $0.05 from pot
LAMUS_PL: doesn't show hand
*** SUMMARY ***
Total pot $0.05 | Rake $0
Seat 1: Emag fo Dog (big blind) folded before Flop
Seat 2: Earco folded before Flop (didn't bet)
Seat 4: SidneyCrosby8 folded before Flop (didn't bet)
Seat 5: LAMUS_PL (button) collected ($0.05)
Seat 6: Morales7-PRO (small blind) folded before Flop


PokerStars Hand #238171775957:  Hold'em No Limit ($0.01/$0.02 USD) - 2022/08/23 14:31:30 ET
Table 'Equinox IV' 6-max Seat #6 is the button
Seat 1: Emag fo Dog ($1.68 in chips)
Seat 2: Earco ($1.89 in chips)
Seat 3: mupe44 ($0.80 in chips)
Seat 4: SidneyCrosby8 ($2.38 in chips)
Seat 5: LAMUS_PL ($5.14 in chips)
Seat 6: Morales7-PRO ($2 in chips)
Emag fo Dog: posts small blind $0.01
Earco: posts big blind $0.02
mupe44: posts big blind $0.02
*** HOLE CARDS ***
mupe44: checks
SidneyCrosby8: raises $0.08 to $0.10
LAMUS_PL: folds
Morales7-PRO: folds
Emag fo Dog: folds
Earco: folds
mupe44: calls $0.08
*** FLOP *** [2h Jh 2c]
mupe44: bets $0.11
SidneyCrosby8: folds
Uncalled bet ($0.11) returned to mupe44
mupe44 collected $0.22 from pot
*** SUMMARY ***
Total pot $0.23 | Rake $0.01
Board [2h Jh 2c]
Seat 1: Emag fo Dog (small blind) folded before Flop
Seat 2: Earco (big blind) folded before Flop
Seat 3: mupe44 collected ($0.22)
Seat 4: SidneyCrosby8 folded on the Flop
Seat 5: LAMUS_PL folded before Flop (didn't bet)
Seat 6: Morales7-PRO (button) folded before Flop (didn't bet)


PokerStars Hand #238171789124:  Hold'em No Limit ($0.01/$0.02 USD) - 2022/08/23 14:32:07 ET
Table 'Equinox IV' 6-max Seat #1 is the button
Seat 1: Emag fo Dog ($1.68 in chips)
Seat 2: Earco ($1.87 in chips)
Seat 5: LAMUS_PL ($5.14 in chips)
Seat 6: Morales7-PRO ($2 in chips)
Earco: posts small blind $0.01
mupe44 has timed out
mupe44: is sitting out
LAMUS_PL: posts big blind $0.02
*** HOLE CARDS ***
Morales7-PRO: folds
Emag fo Dog: folds
Earco: folds
Uncalled bet ($0.01) returned to LAMUS_PL
LAMUS_PL collected $0.02 from pot
LAMUS_PL: doesn't show hand
*** SUMMARY ***
Total pot $0.02 | Rake $0
Seat 1: Emag fo Dog (button) folded before Flop (didn't bet)
Seat 2: Earco (small blind) folded before Flop
Seat 5: LAMUS_PL (big blind) collected ($0.02)
Seat 6: Morales7-PRO folded before Flop (didn't bet)


PokerStars Hand #238171797713:  Hold'em No Limit ($0.01/$0.02 USD) - 2022/08/23 14:32:32 ET
Table 'Equinox IV' 6-max Seat #2 is the button
Seat 1: Emag fo Dog ($1.68 in chips)
Seat 2: Earco ($1.86 in chips)
Seat 5: LAMUS_PL ($5.15 in chips)
Seat 6: Morales7-PRO ($2 in chips)
LAMUS_PL: posts small blind $0.01
Morales7-PRO: posts big blind $0.02
*** HOLE CARDS ***
Emag fo Dog: folds
Earco: raises $0.04 to $0.06
LAMUS_PL: folds
Morales7-PRO: folds
Uncalled bet ($0.04) returned to Earco
Earco collected $0.05 from pot
Earco: doesn't show hand
*** SUMMARY ***
Total pot $0.05 | Rake $0
Seat 1: Emag fo Dog folded before Flop (didn't bet)
Seat 2: Earco (button) collected ($0.05)
Seat 5: LAMUS_PL (small blind) folded before Flop
Seat 6: Morales7-PRO (big blind) folded before Flop


PokerStars Hand #238171821446:  Hold'em No Limit ($0.01/$0.02 USD) - 2022/08/23 14:32:48 ET
Table 'Equinox IV' 6-max Seat #5 is the button
Seat 1: Emag fo Dog ($1.68 in chips)
Seat 2: Earco ($1.89 in chips)
Seat 3: mupe44 ($0.92 in chips)
Seat 5: LAMUS_PL ($5.14 in chips)
Seat 6: Morales7-PRO ($2 in chips)
Morales7-PRO: posts small blind $0.01
Emag fo Dog: posts big blind $0.02
mupe44: posts small & big blinds $0.03
*** HOLE CARDS ***
Earco: raises $0.04 to $0.06
mupe44: folds
LAMUS_PL: calls $0.06
Morales7-PRO: folds
Emag fo Dog: calls $0.04
*** FLOP *** [Jd As Ts]
Emag fo Dog: bets $0.02
Earco: folds
LAMUS_PL: folds
Uncalled bet ($0.02) returned to Emag fo Dog
Emag fo Dog collected $0.21 from pot
Emag fo Dog: doesn't show hand
*** SUMMARY ***
Total pot $0.22 | Rake $0.01
Board [Jd As Ts]
Seat 1: Emag fo Dog (big blind) collected ($0.21)
Seat 2: Earco folded on the Flop
Seat 3: mupe44 folded before Flop (didn't bet)
Seat 5: LAMUS_PL (button) folded on the Flop
Seat 6: Morales7-PRO (small blind) folded before Flop


PokerStars Hand #238171834442:  Hold'em No Limit ($0.01/$0.02 USD) - 2022/08/23 14:33:25 ET
Table 'Equinox IV' 6-max Seat #6 is the button
Seat 1: Emag fo Dog ($1.83 in chips)
Seat 2: Earco ($1.83 in chips)
Seat 3: mupe44 ($0.89 in chips)
Seat 5: LAMUS_PL ($5.08 in chips)
Seat 6: Morales7-PRO ($2 in chips)
Emag fo Dog: posts small blind $0.01
Earco: posts big blind $0.02
*** HOLE CARDS ***
mupe44: folds
LAMUS_PL: folds
Morales7-PRO: folds
Emag fo Dog: raises $0.03 to $0.05
Earco: calls $0.03
*** FLOP *** [Qd 3h 9c]
Emag fo Dog: bets $0.02
Earco: raises $0.06 to $0.08
Emag fo Dog: calls $0.06
*** TURN *** [Qd 3h 9c] [7c]
Emag fo Dog: bets $0.02
Earco: raises $0.15 to $0.17
Emag fo Dog: folds
Uncalled bet ($0.15) returned to Earco
Earco collected $0.29 from pot
Earco: doesn't show hand
*** SUMMARY ***
Total pot $0.30 | Rake $0.01
Board [Qd 3h 9c 7c]
Seat 1: Emag fo Dog (small blind) folded on the Turn
Seat 2: Earco (big blind) collected ($0.29)
Seat 3: mupe44 folded before Flop (didn't bet)
Seat 5: LAMUS_PL folded before Flop (didn't bet)
Seat 6: Morales7-PRO (button) folded before Flop (didn't bet)


PokerStars Hand #238171854410:  Hold'em No Limit ($0.01/$0.02 USD) - 2022/08/23 14:34:23 ET
Table 'Equinox IV' 6-max Seat #1 is the button
Seat 1: Emag fo Dog ($1.68 in chips)
Seat 2: Earco ($1.97 in chips)
Seat 3: mupe44 ($0.89 in chips)
Seat 5: LAMUS_PL ($5.08 in chips)
Seat 6: Morales7-PRO ($2 in chips)
Earco: posts small blind $0.01
mupe44: posts big blind $0.02
*** HOLE CARDS ***
LAMUS_PL: raises $0.04 to $0.06
Morales7-PRO: folds
Emag fo Dog: folds
Earco: raises $0.14 to $0.20
mupe44: folds
LAMUS_PL: folds
Uncalled bet ($0.14) returned to Earco
Earco collected $0.14 from pot
Earco: doesn't show hand
*** SUMMARY ***
Total pot $0.14 | Rake $0
Seat 1: Emag fo Dog (button) folded before Flop (didn't bet)
Seat 2: Earco (small blind) collected ($0.14)
Seat 3: mupe44 (big blind) folded before Flop
Seat 5: LAMUS_PL folded before Flop
Seat 6: Morales7-PRO folded before Flop (didn't bet)


PokerStars Hand #238171866225:  Hold'em No Limit ($0.01/$0.02 USD) - 2022/08/23 14:34:57 ET
Table 'Equinox IV' 6-max Seat #2 is the button
Seat 1: Emag fo Dog ($1.68 in chips)
Seat 2: Earco ($2.05 in chips)
Seat 3: mupe44 ($0.87 in chips)
Seat 4: SidneyCrosby8 ($2.28 in chips)
Seat 5: LAMUS_PL ($5.02 in chips)
Seat 6: Morales7-PRO ($2 in chips)
mupe44: posts small blind $0.01
SidneyCrosby8: posts big blind $0.02
*** HOLE CARDS ***
LAMUS_PL: raises $0.04 to $0.06
Morales7-PRO: folds
Emag fo Dog: calls $0.06
Earco: calls $0.06
mupe44: folds
SidneyCrosby8: calls $0.04
*** FLOP *** [5c 5s 9s]
SidneyCrosby8: checks
LAMUS_PL: checks
Emag fo Dog: bets $0.02
Earco: calls $0.02
SidneyCrosby8: folds
LAMUS_PL: folds
*** TURN *** [5c 5s 9s] [9d]
Emag fo Dog: bets $0.02
Earco: calls $0.02
*** RIVER *** [5c 5s 9s 9d] [3s]
Emag fo Dog: bets $0.02
Earco: calls $0.02
*** SHOW DOWN ***
Emag fo Dog: shows [Tc Kd] (two pair, Nines and Fives)
Earco: shows [4s 2s] (a flush, Nine high)
Earco collected $0.36 from pot
*** SUMMARY ***
Total pot $0.37 | Rake $0.01
Board [5c 5s 9s 9d 3s]
Seat 1: Emag fo Dog showed [Tc Kd] and lost with two pair, Nines and Fives
Seat 2: Earco (button) showed [4s 2s] and won ($0.36) with a flush, Nine high
Seat 3: mupe44 (small blind) folded before Flop
Seat 4: SidneyCrosby8 (big blind) folded on the Flop
Seat 5: LAMUS_PL folded on the Flop
Seat 6: Morales7-PRO folded before Flop (didn't bet)


PokerStars Hand #238171882179:  Hold'em No Limit ($0.01/$0.02 USD) - 2022/08/23 14:35:43 ET
Table 'Equinox IV' 6-max Seat #3 is the button
Seat 1: Emag fo Dog ($1.68 in chips)
Seat 2: Earco ($2.29 in chips)
Seat 3: mupe44 ($0.86 in chips)
Seat 4: SidneyCrosby8 ($2.22 in chips)
Seat 5: LAMUS_PL ($4.96 in chips)
Seat 6: Morales7-PRO ($2 in chips)
SidneyCrosby8: posts small blind $0.01
LAMUS_PL: posts big blind $0.02
*** HOLE CARDS ***
Morales7-PRO: folds
Emag fo Dog: folds
Earco: folds
mupe44: raises $0.02 to $0.04
SidneyCrosby8: folds
LAMUS_PL: calls $0.02
*** FLOP *** [2h Kc 9c]
LAMUS_PL: checks
mupe44: bets $0.04
LAMUS_PL: raises $0.11 to $0.15
mupe44: calls $0.11
*** TURN *** [2h Kc 9c] [Tc]
LAMUS_PL: checks
mupe44: checks
*** RIVER *** [2h Kc 9c Tc] [7d]
LAMUS_PL: bets $0.25
mupe44: folds
Uncalled bet ($0.25) returned to LAMUS_PL
LAMUS_PL collected $0.38 from pot
LAMUS_PL: doesn't show hand
*** SUMMARY ***
Total pot $0.39 | Rake $0.01
Board [2h Kc 9c Tc 7d]
Seat 1: Emag fo Dog folded before Flop (didn't bet)
Seat 2: Earco folded before Flop (didn't bet)
Seat 3: mupe44 (button) folded on the River
Seat 4: SidneyCrosby8 (small blind) folded before Flop
Seat 5: LAMUS_PL (big blind) collected ($0.38)
Seat 6: Morales7-PRO folded before Flop (didn't bet)


PokerStars Hand #238171907956:  Hold'em No Limit ($0.01/$0.02 USD) - 2022/08/23 14:36:56 ET
Table 'Equinox IV' 6-max Seat #4 is the button
Seat 1: Emag fo Dog ($1.68 in chips)
Seat 2: Earco ($2.29 in chips)
Seat 3: mupe44 ($0.67 in chips)
Seat 4: SidneyCrosby8 ($2.21 in chips)
Seat 5: LAMUS_PL ($5.15 in chips)
Seat 6: Morales7-PRO ($2 in chips)
LAMUS_PL: posts small blind $0.01
Morales7-PRO: posts big blind $0.02
*** HOLE CARDS ***
Emag fo Dog: folds
Earco: folds
mupe44: raises $0.02 to $0.04
SidneyCrosby8: folds
LAMUS_PL: folds
Morales7-PRO: folds
Uncalled bet ($0.02) returned to mupe44
mupe44 collected $0.05 from pot
*** SUMMARY ***
Total pot $0.05 | Rake $0
Seat 1: Emag fo Dog folded before Flop (didn't bet)
Seat 2: Earco folded before Flop (didn't bet)
Seat 3: mupe44 collected ($0.05)
Seat 4: SidneyCrosby8 (button) folded before Flop (didn't bet)
Seat 5: LAMUS_PL (small blind) folded before Flop
Seat 6: Morales7-PRO (big blind) folded before Flop


PokerStars Hand #238171918254:  Hold'em No Limit ($0.01/$0.02 USD) - 2022/08/23 14:37:25 ET
Table 'Equinox IV' 6-max Seat #5 is the button
Seat 1: Emag fo Dog ($1.68 in chips)
Seat 2: Earco ($2.29 in chips)
Seat 3: mupe44 ($0.70 in chips)
Seat 4: SidneyCrosby8 ($2.21 in chips)
Seat 5: LAMUS_PL ($5.14 in chips)
Seat 6: Morales7-PRO ($2 in chips)
Morales7-PRO: posts small blind $0.01
Emag fo Dog: posts big blind $0.02
*** HOLE CARDS ***
Earco: folds
mupe44: calls $0.02
SidneyCrosby8: folds
LAMUS_PL: raises $0.06 to $0.08
Morales7-PRO: folds
Emag fo Dog: folds
mupe44: calls $0.06
*** FLOP *** [9c Jd 6d]
mupe44: checks
LAMUS_PL: bets $0.12
mupe44: folds
Uncalled bet ($0.12) returned to LAMUS_PL
LAMUS_PL collected $0.18 from pot
LAMUS_PL: doesn't show hand
*** SUMMARY ***
Total pot $0.19 | Rake $0.01
Board [9c Jd 6d]
Seat 1: Emag fo Dog (big blind) folded before Flop
Seat 2: Earco folded before Flop (didn't bet)
Seat 3: mupe44 folded on the Flop
Seat 4: SidneyCrosby8 folded before Flop (didn't bet)
Seat 5: LAMUS_PL (button) collected ($0.18)
Seat 6: Morales7-PRO (small blind) folded before Flop


PokerStars Hand #238171936903:  Hold'em No Limit ($0.01/$0.02 USD) - 2022/08/23 14:38:18 ET
Table 'Equinox IV' 6-max Seat #6 is the button
Seat 1: Emag fo Dog ($1.68 in chips)
Seat 2: Earco ($2.29 in chips)
Seat 3: mupe44 ($0.62 in chips)
Seat 4: SidneyCrosby8 ($2.21 in chips)
Seat 5: LAMUS_PL ($5.24 in chips)
Seat 6: Morales7-PRO ($2 in chips)
Emag fo Dog: posts small blind $0.01
Earco: posts big blind $0.02
*** HOLE CARDS ***
mupe44: folds
SidneyCrosby8: folds
LAMUS_PL: raises $0.03 to $0.05
Morales7-PRO: folds
Emag fo Dog: raises $0.18 to $0.23
Earco: folds
LAMUS_PL: calls $0.18
*** FLOP *** [8c 4h Jd]
Emag fo Dog: bets $0.29
LAMUS_PL: calls $0.29
*** TURN *** [8c 4h Jd] [3d]
Emag fo Dog: bets $0.02
LAMUS_PL: calls $0.02
*** RIVER *** [8c 4h Jd 3d] [8h]
Emag fo Dog: bets $0.02
LAMUS_PL: calls $0.02
*** SHOW DOWN ***
Emag fo Dog: shows [4c 7c] (two pair, Eights and Fours)
LAMUS_PL: mucks hand
Emag fo Dog collected $1.10 from pot
*** SUMMARY ***
Total pot $1.14 | Rake $0.04
Board [8c 4h Jd 3d 8h]
Seat 1: Emag fo Dog (small blind) showed [4c 7c] and won ($1.10) with two pair, Eights and Fours
Seat 2: Earco (big blind) folded before Flop
Seat 3: mupe44 folded before Flop (didn't bet)
Seat 4: SidneyCrosby8 folded before Flop (didn't bet)
Seat 5: LAMUS_PL mucked
Seat 6: Morales7-PRO (button) folded before Flop (didn't bet)


PokerStars Hand #238171960972:  Hold'em No Limit ($0.01/$0.02 USD) - 2022/08/23 14:39:26 ET
Table 'Equinox IV' 6-max Seat #1 is the button
Seat 1: Emag fo Dog ($2.22 in chips)
Seat 2: Earco ($2.27 in chips)
Seat 3: mupe44 ($0.62 in chips)
Seat 4: SidneyCrosby8 ($2.21 in chips)
Seat 5: LAMUS_PL ($4.68 in chips)
Seat 6: Morales7-PRO ($2 in chips)
Earco: posts small blind $0.01
mupe44: posts big blind $0.02
*** HOLE CARDS ***
SidneyCrosby8: raises $0.04 to $0.06
LAMUS_PL: folds
Morales7-PRO: folds
Emag fo Dog: calls $0.06
Earco: calls $0.05
mupe44: folds
*** FLOP *** [3s 8c 7c]
Earco: checks
SidneyCrosby8: bets $0.06
mupe44 leaves the table
Emag fo Dog: folds
Special One4444 joins the table at seat #3
Earco: folds
Uncalled bet ($0.06) returned to SidneyCrosby8
SidneyCrosby8 collected $0.19 from pot
SidneyCrosby8: doesn't show hand
*** SUMMARY ***
Total pot $0.20 | Rake $0.01
Board [3s 8c 7c]
Seat 1: Emag fo Dog (button) folded on the Flop
Seat 2: Earco (small blind) folded on the Flop
Seat 3: mupe44 (big blind) folded before Flop
Seat 4: SidneyCrosby8 collected ($0.19)
Seat 5: LAMUS_PL folded before Flop (didn't bet)
Seat 6: Morales7-PRO folded before Flop (didn't bet)


PokerStars Hand #238171976503:  Hold'em No Limit ($0.01/$0.02 USD) - 2022/08/23 14:40:10 ET
Table 'Equinox IV' 6-max Seat #2 is the button
Seat 1: Emag fo Dog ($2.16 in chips)
Seat 2: Earco ($2.21 in chips)
Seat 4: SidneyCrosby8 ($2.34 in chips)
Seat 5: LAMUS_PL ($4.68 in chips)
Seat 6: Morales7-PRO ($2 in chips)
SidneyCrosby8: posts small blind $0.01
LAMUS_PL: posts big blind $0.02
*** HOLE CARDS ***
Morales7-PRO: folds
Emag fo Dog: raises $0.03 to $0.05
Earco: calls $0.05
SidneyCrosby8: folds
LAMUS_PL: calls $0.03
*** FLOP *** [Qc 5c Qh]
LAMUS_PL: checks
Emag fo Dog: bets $0.02
Earco: calls $0.02
LAMUS_PL: calls $0.02
*** TURN *** [Qc 5c Qh] [2c]
LAMUS_PL: checks
Emag fo Dog: bets $0.02
Earco: calls $0.02
LAMUS_PL: calls $0.02
*** RIVER *** [Qc 5c Qh 2c] [4s]
LAMUS_PL: checks
Emag fo Dog: bets $0.11
Earco: calls $0.11
LAMUS_PL: folds
*** SHOW DOWN ***
Emag fo Dog: shows [7h 7c] (two pair, Queens and Sevens)
Earco: shows [9d 9s] (two pair, Queens and Nines)
Earco collected $0.48 from pot
*** SUMMARY ***
Total pot $0.50 | Rake $0.02
Board [Qc 5c Qh 2c 4s]
Seat 1: Emag fo Dog showed [7h 7c] and lost with two pair, Queens and Sevens
Seat 2: Earco (button) showed [9d 9s] and won ($0.48) with two pair, Queens and Nines
Seat 4: SidneyCrosby8 (small blind) folded before Flop
Seat 5: LAMUS_PL (big blind) folded on the River
Seat 6: Morales7-PRO folded before Flop (didn't bet)


PokerStars Hand #238171999434:  Hold'em No Limit ($0.01/$0.02 USD) - 2022/08/23 14:41:14 ET
Table 'Equinox IV' 6-max Seat #4 is the button
Seat 1: Emag fo Dog ($1.96 in chips)
Seat 2: Earco ($2.49 in chips)
Seat 4: SidneyCrosby8 ($2.33 in chips)
Seat 5: LAMUS_PL ($4.59 in chips)
Seat 6: Morales7-PRO ($2 in chips)
LAMUS_PL: posts small blind $0.01
Morales7-PRO: posts big blind $0.02
Special One4444: sits out
*** HOLE CARDS ***
Emag fo Dog: folds
Earco: folds
SidneyCrosby8: folds
LAMUS_PL: folds
Uncalled bet ($0.01) returned to Morales7-PRO
Morales7-PRO collected $0.02 from pot
Morales7-PRO: doesn't show hand
*** SUMMARY ***
Total pot $0.02 | Rake $0
Seat 1: Emag fo Dog folded before Flop (didn't bet)
Seat 2: Earco folded before Flop (didn't bet)
Seat 4: SidneyCrosby8 (button) folded before Flop (didn't bet)
Seat 5: LAMUS_PL (small blind) folded before Flop
Seat 6: Morales7-PRO (big blind) collected ($0.02)


PokerStars Hand #238172003173:  Hold'em No Limit ($0.01/$0.02 USD) - 2022/08/23 14:41:25 ET
Table 'Equinox IV' 6-max Seat #5 is the button
Seat 1: Emag fo Dog ($1.96 in chips)
Seat 2: Earco ($2.49 in chips)
Seat 4: SidneyCrosby8 ($2.33 in chips)
Seat 5: LAMUS_PL ($4.58 in chips)
Seat 6: Morales7-PRO ($2.01 in chips)
Morales7-PRO: posts small blind $0.01
Emag fo Dog: posts big blind $0.02
Special One4444: sits out
*** HOLE CARDS ***
Earco: raises $0.04 to $0.06
SidneyCrosby8: folds
LAMUS_PL: calls $0.06
Morales7-PRO: folds
Emag fo Dog: folds
*** FLOP *** [Jh 7c 3s]
Earco: checks
LAMUS_PL: bets $0.09
Earco: folds
Uncalled bet ($0.09) returned to LAMUS_PL
LAMUS_PL collected $0.14 from pot
LAMUS_PL: doesn't show hand
*** SUMMARY ***
Total pot $0.15 | Rake $0.01
Board [Jh 7c 3s]
Seat 1: Emag fo Dog (big blind) folded before Flop
Seat 2: Earco folded on the Flop
Seat 4: SidneyCrosby8 folded before Flop (didn't bet)
Seat 5: LAMUS_PL (button) collected ($0.14)
Seat 6: Morales7-PRO (small blind) folded before Flop


PokerStars Hand #238172013113:  Hold'em No Limit ($0.01/$0.02 USD) - 2022/08/23 14:41:53 ET
Table 'Equinox IV' 6-max Seat #6 is the button
Seat 1: Emag fo Dog ($1.94 in chips)
Seat 2: Earco ($2.43 in chips)
Seat 4: SidneyCrosby8 ($2.33 in chips)
Seat 5: LAMUS_PL ($4.66 in chips)
Seat 6: Morales7-PRO ($2 in chips)
Emag fo Dog: posts small blind $0.01
Earco: posts big blind $0.02
Special One4444: sits out
*** HOLE CARDS ***
SidneyCrosby8: folds
LAMUS_PL: folds
Morales7-PRO: folds
Emag fo Dog: raises $0.03 to $0.05
Earco: folds
Uncalled bet ($0.03) returned to Emag fo Dog
Emag fo Dog collected $0.04 from pot
Emag fo Dog: doesn't show hand
*** SUMMARY ***
Total pot $0.04 | Rake $0
Seat 1: Emag fo Dog (small blind) collected ($0.04)
Seat 2: Earco (big blind) folded before Flop
Seat 4: SidneyCrosby8 folded before Flop (didn't bet)
Seat 5: LAMUS_PL folded before Flop (didn't bet)
Seat 6: Morales7-PRO (button) folded before Flop (didn't bet)


PokerStars Hand #238172017249:  Hold'em No Limit ($0.01/$0.02 USD) - 2022/08/23 14:42:05 ET
Table 'Equinox IV' 6-max Seat #1 is the button
Seat 1: Emag fo Dog ($1.96 in chips)
Seat 2: Earco ($2.41 in chips)
Seat 3: Special One4444 ($2 in chips)
Seat 4: SidneyCrosby8 ($2.33 in chips)
Seat 6: Morales7-PRO ($2 in chips)
Earco: posts small blind $0.01
Special One4444: posts big blind $0.02
*** HOLE CARDS ***
SidneyCrosby8: raises $0.04 to $0.06
Morales7-PRO: folds
Emag fo Dog: folds
Earco: folds
Special One4444: folds
Uncalled bet ($0.04) returned to SidneyCrosby8
SidneyCrosby8 collected $0.05 from pot
SidneyCrosby8: doesn't show hand
*** SUMMARY ***
Total pot $0.05 | Rake $0
Seat 1: Emag fo Dog (button) folded before Flop (didn't bet)
Seat 2: Earco (small blind) folded before Flop
Seat 3: Special One4444 (big blind) folded before Flop
Seat 4: SidneyCrosby8 collected ($0.05)
Seat 6: Morales7-PRO folded before Flop (didn't bet)


PokerStars Hand #238172022699:  Hold'em No Limit ($0.01/$0.02 USD) - 2022/08/23 14:42:20 ET
Table 'Equinox IV' 6-max Seat #2 is the button
Seat 1: Emag fo Dog ($1.96 in chips)
Seat 2: Earco ($2.40 in chips)
Seat 3: Special One4444 ($1.98 in chips)
Seat 4: SidneyCrosby8 ($2.36 in chips)
Seat 6: Morales7-PRO ($2 in chips)
Special One4444: posts small blind $0.01
SidneyCrosby8: posts big blind $0.02
*** HOLE CARDS ***
Morales7-PRO: raises $0.04 to $0.06
Emag fo Dog: calls $0.06
Earco: calls $0.06
Special One4444: folds
SidneyCrosby8: calls $0.04
*** FLOP *** [8s 3h 8h]
SidneyCrosby8: checks
Morales7-PRO: checks
Emag fo Dog: bets $0.02
Earco: calls $0.02
SidneyCrosby8: calls $0.02
Morales7-PRO: raises $0.18 to $0.20
Emag fo Dog: folds
Earco: folds
SidneyCrosby8: folds
Uncalled bet ($0.18) returned to Morales7-PRO
Morales7-PRO collected $0.32 from pot
Morales7-PRO: doesn't show hand
*** SUMMARY ***
Total pot $0.33 | Rake $0.01
Board [8s 3h 8h]
Seat 1: Emag fo Dog folded on the Flop
Seat 2: Earco (button) folded on the Flop
Seat 3: Special One4444 (small blind) folded before Flop
Seat 4: SidneyCrosby8 (big blind) folded on the Flop
Seat 6: Morales7-PRO collected ($0.32)


PokerStars Hand #238172045462:  Hold'em No Limit ($0.01/$0.02 USD) - 2022/08/23 14:43:25 ET
Table 'Equinox IV' 6-max Seat #3 is the button
Seat 1: Emag fo Dog ($1.88 in chips)
Seat 2: Earco ($2.32 in chips)
Seat 3: Special One4444 ($1.97 in chips)
Seat 4: SidneyCrosby8 ($2.28 in chips)
Seat 6: Morales7-PRO ($2.24 in chips)
SidneyCrosby8: posts small blind $0.01
Morales7-PRO: posts big blind $0.02
*** HOLE CARDS ***
Emag fo Dog: raises $0.04 to $0.06
Earco: folds
Special One4444: folds
SidneyCrosby8: folds
Morales7-PRO: folds
Uncalled bet ($0.04) returned to Emag fo Dog
Emag fo Dog collected $0.05 from pot
Emag fo Dog: doesn't show hand
*** SUMMARY ***
Total pot $0.05 | Rake $0
Seat 1: Emag fo Dog collected ($0.05)
Seat 2: Earco folded before Flop (didn't bet)
Seat 3: Special One4444 (button) folded before Flop (didn't bet)
Seat 4: SidneyCrosby8 (small blind) folded before Flop
Seat 6: Morales7-PRO (big blind) folded before Flop


PokerStars Hand #238172048976:  Hold'em No Limit ($0.01/$0.02 USD) - 2022/08/23 14:43:35 ET
Table 'Equinox IV' 6-max Seat #4 is the button
Seat 1: Emag fo Dog ($1.91 in chips)
Seat 2: Earco ($2.32 in chips)
Seat 3: Special One4444 ($1.97 in chips)
Seat 4: SidneyCrosby8 ($2.27 in chips)
Seat 6: Morales7-PRO ($2.22 in chips)
Morales7-PRO: posts small blind $0.01
Emag fo Dog: posts big blind $0.02
*** HOLE CARDS ***
Earco: raises $0.04 to $0.06
Special One4444: folds
SidneyCrosby8: folds
Morales7-PRO: folds
Emag fo Dog: folds
Uncalled bet ($0.04) returned to Earco
Earco collected $0.05 from pot
Earco: doesn't show hand
*** SUMMARY ***
Total pot $0.05 | Rake $0
Seat 1: Emag fo Dog (big blind) folded before Flop
Seat 2: Earco collected ($0.05)
Seat 3: Special One4444 folded before Flop (didn't bet)
Seat 4: SidneyCrosby8 (button) folded before Flop (didn't bet)
Seat 6: Morales7-PRO (small blind) folded before Flop


PokerStars Hand #238172053483:  Hold'em No Limit ($0.01/$0.02 USD) - 2022/08/23 14:43:48 ET
Table 'Equinox IV' 6-max Seat #6 is the button
Seat 1: Emag fo Dog ($1.89 in chips)
Seat 2: Earco ($2.35 in chips)
Seat 3: Special One4444 ($1.97 in chips)
Seat 4: SidneyCrosby8 ($2.27 in chips)
Seat 6: Morales7-PRO ($2.21 in chips)
Emag fo Dog: posts small blind $0.01
Earco: posts big blind $0.02
*** HOLE CARDS ***
Special One4444: folds
SidneyCrosby8: folds
Morales7-PRO: folds
Emag fo Dog: folds
Uncalled bet ($0.01) returned to Earco
Earco collected $0.02 from pot
Earco: doesn't show hand
*** SUMMARY ***
Total pot $0.02 | Rake $0
Seat 1: Emag fo Dog (small blind) folded before Flop
Seat 2: Earco (big blind) collected ($0.02)
Seat 3: Special One4444 folded before Flop (didn't bet)
Seat 4: SidneyCrosby8 folded before Flop (didn't bet)
Seat 6: Morales7-PRO (button) folded before Flop (didn't bet)


PokerStars Hand #238172058283:  Hold'em No Limit ($0.01/$0.02 USD) - 2022/08/23 14:44:01 ET
Table 'Equinox IV' 6-max Seat #1 is the button
Seat 1: Emag fo Dog ($1.88 in chips)
Seat 2: Earco ($2.36 in chips)
Seat 3: Special One4444 ($1.97 in chips)
Seat 4: SidneyCrosby8 ($2.27 in chips)
Seat 6: Morales7-PRO ($2.21 in chips)
Earco: posts small blind $0.01
Special One4444: posts big blind $0.02
*** HOLE CARDS ***
SidneyCrosby8: raises $0.04 to $0.06
Morales7-PRO: folds
Emag fo Dog: folds
Earco: folds
Special One4444: calls $0.04
*** FLOP *** [Qs Qh Jh]
Special One4444: bets $0.06
SidneyCrosby8: calls $0.06
*** TURN *** [Qs Qh Jh] [Js]
Special One4444: bets $0.10
SidneyCrosby8: calls $0.10
*** RIVER *** [Qs Qh Jh Js] [7s]
Special One4444: checks
SidneyCrosby8: bets $0.46
Special One4444: folds
Uncalled bet ($0.46) returned to SidneyCrosby8
SidneyCrosby8 collected $0.43 from pot
SidneyCrosby8: doesn't show hand
*** SUMMARY ***
Total pot $0.45 | Rake $0.02
Board [Qs Qh Jh Js 7s]
Seat 1: Emag fo Dog (button) folded before Flop (didn't bet)
Seat 2: Earco (small blind) folded before Flop
Seat 3: Special One4444 (big blind) folded on the River
Seat 4: SidneyCrosby8 collected ($0.43)
Seat 6: Morales7-PRO folded before Flop (didn't bet)


PokerStars Hand #238172074351:  Hold'em No Limit ($0.01/$0.02 USD) - 2022/08/23 14:44:47 ET
Table 'Equinox IV' 6-max Seat #2 is the button
Seat 1: Emag fo Dog ($1.88 in chips)
Seat 2: Earco ($2.35 in chips)
Seat 3: Special One4444 ($1.75 in chips)
Seat 4: SidneyCrosby8 ($2.48 in chips)
Seat 6: Morales7-PRO ($2.21 in chips)
Special One4444: posts small blind $0.01
SidneyCrosby8: posts big blind $0.02
*** HOLE CARDS ***
Morales7-PRO: folds
Emag fo Dog: raises $0.03 to $0.05
Earco: folds
Special One4444: raises $0.05 to $0.10
SidneyCrosby8: folds
Emag fo Dog: calls $0.05
*** FLOP *** [Td 5c Jh]
Special One4444: bets $0.04
Emag fo Dog: folds
Uncalled bet ($0.04) returned to Special One4444
Special One4444 collected $0.21 from pot
*** SUMMARY ***
Total pot $0.22 | Rake $0.01
Board [Td 5c Jh]
Seat 1: Emag fo Dog folded on the Flop
Seat 2: Earco (button) folded before Flop (didn't bet)
Seat 3: Special One4444 (small blind) collected ($0.21)
Seat 4: SidneyCrosby8 (big blind) folded before Flop
Seat 6: Morales7-PRO folded before Flop (didn't bet)


PokerStars Hand #238172085083:  Hold'em No Limit ($0.01/$0.02 USD) - 2022/08/23 14:45:16 ET
Table 'Equinox IV' 6-max Seat #3 is the button
Seat 1: Emag fo Dog ($1.78 in chips)
Seat 2: Earco ($2.35 in chips)
Seat 3: Special One4444 ($1.86 in chips)
Seat 4: SidneyCrosby8 ($2.46 in chips)
Seat 6: Morales7-PRO ($2.21 in chips)
SidneyCrosby8: posts small blind $0.01
Morales7-PRO: posts big blind $0.02
*** HOLE CARDS ***
Emag fo Dog: raises $0.04 to $0.06
Earco: folds
Special One4444: folds
SidneyCrosby8: folds
Morales7-PRO: folds
Uncalled bet ($0.04) returned to Emag fo Dog
Emag fo Dog collected $0.05 from pot
Emag fo Dog: doesn't show hand
*** SUMMARY ***
Total pot $0.05 | Rake $0
Seat 1: Emag fo Dog collected ($0.05)
Seat 2: Earco folded before Flop (didn't bet)
Seat 3: Special One4444 (button) folded before Flop (didn't bet)
Seat 4: SidneyCrosby8 (small blind) folded before Flop
Seat 6: Morales7-PRO (big blind) folded before Flop


PokerStars Hand #238172091029:  Hold'em No Limit ($0.01/$0.02 USD) - 2022/08/23 14:45:33 ET
Table 'Equinox IV' 6-max Seat #4 is the button
Seat 1: Emag fo Dog ($1.81 in chips)
Seat 2: Earco ($2.35 in chips)
Seat 3: Special One4444 ($1.86 in chips)
Seat 4: SidneyCrosby8 ($2.45 in chips)
Seat 6: Morales7-PRO ($2.19 in chips)
Morales7-PRO: posts small blind $0.01
Emag fo Dog: posts big blind $0.02
*** HOLE CARDS ***
Earco: folds
Special One4444: raises $0.04 to $0.06
SidneyCrosby8: folds
Morales7-PRO: folds
Emag fo Dog: folds
Uncalled bet ($0.04) returned to Special One4444
Special One4444 collected $0.05 from pot
*** SUMMARY ***
Total pot $0.05 | Rake $0
Seat 1: Emag fo Dog (big blind) folded before Flop
Seat 2: Earco folded before Flop (didn't bet)
Seat 3: Special One4444 collected ($0.05)
Seat 4: SidneyCrosby8 (button) folded before Flop (didn't bet)
Seat 6: Morales7-PRO (small blind) folded before Flop


PokerStars Hand #238172096149:  Hold'em No Limit ($0.01/$0.02 USD) - 2022/08/23 14:45:47 ET
Table 'Equinox IV' 6-max Seat #6 is the button
Seat 1: Emag fo Dog ($1.79 in chips)
Seat 2: Earco ($2.35 in chips)
Seat 3: Special One4444 ($1.89 in chips)
Seat 4: SidneyCrosby8 ($2.45 in chips)
Seat 6: Morales7-PRO ($2.18 in chips)
Emag fo Dog: posts small blind $0.01
Earco: posts big blind $0.02
LAMUS_PL: sits out
*** HOLE CARDS ***
Special One4444: folds
SidneyCrosby8: folds
Morales7-PRO: raises $0.03 to $0.05
Emag fo Dog: raises $0.18 to $0.23
Earco: folds
Morales7-PRO: calls $0.18
*** FLOP *** [Ad 3c 8d]
Emag fo Dog: bets $0.28
Morales7-PRO: folds
Uncalled bet ($0.28) returned to Emag fo Dog
Emag fo Dog collected $0.46 from pot
Emag fo Dog: doesn't show hand
*** SUMMARY ***
Total pot $0.48 | Rake $0.02
Board [Ad 3c 8d]
Seat 1: Emag fo Dog (small blind) collected ($0.46)
Seat 2: Earco (big blind) folded before Flop
Seat 3: Special One4444 folded before Flop (didn't bet)
Seat 4: SidneyCrosby8 folded before Flop (didn't bet)
Seat 6: Morales7-PRO (button) folded on the Flop


PokerStars Hand #238172106931:  Hold'em No Limit ($0.01/$0.02 USD) - 2022/08/23 14:46:17 ET
Table 'Equinox IV' 6-max Seat #1 is the button
Seat 1: Emag fo Dog ($2.02 in chips)
Seat 2: Earco ($2.33 in chips)
Seat 3: Special One4444 ($1.89 in chips)
Seat 4: SidneyCrosby8 ($2.45 in chips)
Seat 6: Morales7-PRO ($2 in chips)
Earco: posts small blind $0.01
Special One4444: posts big blind $0.02
LAMUS_PL: sits out
*** HOLE CARDS ***
SidneyCrosby8: folds
Morales7-PRO: raises $0.04 to $0.06
Emag fo Dog: folds
Earco: folds
Special One4444: folds
Uncalled bet ($0.04) returned to Morales7-PRO
Morales7-PRO collected $0.05 from pot
Morales7-PRO: doesn't show hand
*** SUMMARY ***
Total pot $0.05 | Rake $0
Seat 1: Emag fo Dog (button) folded before Flop (didn't bet)
Seat 2: Earco (small blind) folded before Flop
Seat 3: Special One4444 (big blind) folded before Flop
Seat 4: SidneyCrosby8 folded before Flop (didn't bet)
Seat 6: Morales7-PRO collected ($0.05)


PokerStars Hand #238172111267:  Hold'em No Limit ($0.01/$0.02 USD) - 2022/08/23 14:46:29 ET
Table 'Equinox IV' 6-max Seat #2 is the button
Seat 1: Emag fo Dog ($2.02 in chips)
Seat 2: Earco ($2.32 in chips)
Seat 3: Special One4444 ($1.87 in chips)
Seat 4: SidneyCrosby8 ($2.45 in chips)
Seat 6: Morales7-PRO ($2.03 in chips)
Special One4444: posts small blind $0.01
SidneyCrosby8: posts big blind $0.02
LAMUS_PL: sits out
*** HOLE CARDS ***
Morales7-PRO: raises $0.04 to $0.06
Emag fo Dog: folds
Earco: folds
Special One4444: folds
SidneyCrosby8: folds
Uncalled bet ($0.04) returned to Morales7-PRO
Morales7-PRO collected $0.05 from pot
Morales7-PRO: doesn't show hand
*** SUMMARY ***
Total pot $0.05 | Rake $0
Seat 1: Emag fo Dog folded before Flop (didn't bet)
Seat 2: Earco (button) folded before Flop (didn't bet)
Seat 3: Special One4444 (small blind) folded before Flop
Seat 4: SidneyCrosby8 (big blind) folded before Flop
Seat 6: Morales7-PRO collected ($0.05)


PokerStars Hand #238172116370:  Hold'em No Limit ($0.01/$0.02 USD) - 2022/08/23 14:46:44 ET
Table 'Equinox IV' 6-max Seat #3 is the button
Seat 1: Emag fo Dog ($2.02 in chips)
Seat 2: Earco ($2.32 in chips)
Seat 3: Special One4444 ($1.86 in chips)
Seat 4: SidneyCrosby8 ($2.43 in chips)
Seat 5: LAMUS_PL ($4.66 in chips)
Seat 6: Morales7-PRO ($2.06 in chips)
SidneyCrosby8: posts small blind $0.01
LAMUS_PL: posts big blind $0.02
*** HOLE CARDS ***
Morales7-PRO: folds
Emag fo Dog: folds
Earco: folds
Special One4444: raises $0.04 to $0.06
SidneyCrosby8: folds
LAMUS_PL: calls $0.04
*** FLOP *** [4c 8s 6h]
LAMUS_PL: bets $0.09
Special One4444: folds
Uncalled bet ($0.09) returned to LAMUS_PL
LAMUS_PL collected $0.13 from pot
LAMUS_PL: doesn't show hand
*** SUMMARY ***
Total pot $0.13 | Rake $0
Board [4c 8s 6h]
Seat 1: Emag fo Dog folded before Flop (didn't bet)
Seat 2: Earco folded before Flop (didn't bet)
Seat 3: Special One4444 (button) folded on the Flop
Seat 4: SidneyCrosby8 (small blind) folded before Flop
Seat 5: LAMUS_PL (big blind) collected ($0.13)
Seat 6: Morales7-PRO folded before Flop (didn't bet)


PokerStars Hand #238172131904:  Hold'em No Limit ($0.01/$0.02 USD) - 2022/08/23 14:47:27 ET
Table 'Equinox IV' 6-max Seat #4 is the button
Seat 1: Emag fo Dog ($2.02 in chips)
Seat 2: Earco ($2.32 in chips)
Seat 3: Special One4444 ($1.80 in chips)
Seat 4: SidneyCrosby8 ($2.42 in chips)
Seat 5: LAMUS_PL ($4.73 in chips)
Seat 6: Morales7-PRO ($2.06 in chips)
LAMUS_PL: posts small blind $0.01
Morales7-PRO: posts big blind $0.02
*** HOLE CARDS ***
Emag fo Dog: raises $0.04 to $0.06
Earco: folds
Special One4444: folds
SidneyCrosby8: folds
LAMUS_PL: calls $0.05
Morales7-PRO: folds
*** FLOP *** [Qc 6d Td]
LAMUS_PL: checks
Emag fo Dog: bets $0.02
LAMUS_PL: calls $0.02
*** TURN *** [Qc 6d Td] [3d]
LAMUS_PL: checks
Emag fo Dog: checks
*** RIVER *** [Qc 6d Td 3d] [Jh]
LAMUS_PL: checks
Emag fo Dog: checks
*** SHOW DOWN ***
LAMUS_PL: shows [Jc Ac] (a pair of Jacks)
Emag fo Dog: mucks hand
LAMUS_PL collected $0.17 from pot
*** SUMMARY ***
Total pot $0.18 | Rake $0.01
Board [Qc 6d Td 3d Jh]
Seat 1: Emag fo Dog mucked
Seat 2: Earco folded before Flop (didn't bet)
Seat 3: Special One4444 folded before Flop (didn't bet)
Seat 4: SidneyCrosby8 (button) folded before Flop (didn't bet)
Seat 5: LAMUS_PL (small blind) showed [Jc Ac] and won ($0.17) with a pair of Jacks
Seat 6: Morales7-PRO (big blind) folded before Flop


PokerStars Hand #238172142915:  Hold'em No Limit ($0.01/$0.02 USD) - 2022/08/23 14:47:57 ET
Table 'Equinox IV' 6-max Seat #5 is the button
Seat 1: Emag fo Dog ($1.94 in chips)
Seat 2: Earco ($2.32 in chips)
Seat 3: Special One4444 ($1.80 in chips)
Seat 4: SidneyCrosby8 ($2.42 in chips)
Seat 5: LAMUS_PL ($4.82 in chips)
Seat 6: Morales7-PRO ($2.04 in chips)
Morales7-PRO: posts small blind $0.01
Emag fo Dog: posts big blind $0.02
*** HOLE CARDS ***
Earco: folds
Special One4444: folds
SidneyCrosby8: folds
LAMUS_PL: folds
Morales7-PRO: raises $0.04 to $0.06
Emag fo Dog: folds
Uncalled bet ($0.04) returned to Morales7-PRO
Morales7-PRO collected $0.04 from pot
Morales7-PRO: doesn't show hand
*** SUMMARY ***
Total pot $0.04 | Rake $0
Seat 1: Emag fo Dog (big blind) folded before Flop
Seat 2: Earco folded before Flop (didn't bet)
Seat 3: Special One4444 folded before Flop (didn't bet)
Seat 4: SidneyCrosby8 folded before Flop (didn't bet)
Seat 5: LAMUS_PL (button) folded before Flop (didn't bet)
Seat 6: Morales7-PRO (small blind) collected ($0.04)


PokerStars Hand #238172148319:  Hold'em No Limit ($0.01/$0.02 USD) - 2022/08/23 14:48:12 ET
Table 'Equinox IV' 6-max Seat #6 is the button
Seat 1: Emag fo Dog ($1.92 in chips)
Seat 2: Earco ($2.32 in chips)
Seat 3: Special One4444 ($1.80 in chips)
Seat 4: SidneyCrosby8 ($2.42 in chips)
Seat 5: LAMUS_PL ($4.82 in chips)
Seat 6: Morales7-PRO ($2.06 in chips)
Emag fo Dog: posts small blind $0.01
Earco: posts big blind $0.02
*** HOLE CARDS ***
Special One4444: raises $0.04 to $0.06
SidneyCrosby8: folds
LAMUS_PL: calls $0.06
Morales7-PRO: folds
Emag fo Dog: folds
Earco: calls $0.04
*** FLOP *** [6h 7d 8h]
Earco: checks
Special One4444: bets $0.10
LAMUS_PL: calls $0.10
Earco: folds
*** TURN *** [6h 7d 8h] [Ts]
Special One4444: checks
LAMUS_PL: bets $0.17
Special One4444: folds
Uncalled bet ($0.17) returned to LAMUS_PL
LAMUS_PL collected $0.38 from pot
LAMUS_PL: doesn't show hand
*** SUMMARY ***
Total pot $0.39 | Rake $0.01
Board [6h 7d 8h Ts]
Seat 1: Emag fo Dog (small blind) folded before Flop
Seat 2: Earco (big blind) folded on the Flop
Seat 3: Special One4444 folded on the Turn
Seat 4: SidneyCrosby8 folded before Flop (didn't bet)
Seat 5: LAMUS_PL collected ($0.38)
Seat 6: Morales7-PRO (button) folded before Flop (didn't bet)


PokerStars Hand #238172168051:  Hold'em No Limit ($0.01/$0.02 USD) - 2022/08/23 14:49:07 ET
Table 'Equinox IV' 6-max Seat #1 is the button
Seat 1: Emag fo Dog ($1.91 in chips)
Seat 2: Earco ($2.26 in chips)
Seat 3: Special One4444 ($1.64 in chips)
Seat 4: SidneyCrosby8 ($2.42 in chips)
Seat 5: LAMUS_PL ($5.04 in chips)
Seat 6: Morales7-PRO ($2.06 in chips)
Earco: posts small blind $0.01
Special One4444: posts big blind $0.02
*** HOLE CARDS ***
SidneyCrosby8: folds
LAMUS_PL: folds
Morales7-PRO: raises $0.04 to $0.06
Emag fo Dog: raises $0.17 to $0.23
Earco: folds
Special One4444: folds
Morales7-PRO: folds
Uncalled bet ($0.17) returned to Emag fo Dog
Emag fo Dog collected $0.15 from pot
Emag fo Dog: doesn't show hand
*** SUMMARY ***
Total pot $0.15 | Rake $0
Seat 1: Emag fo Dog (button) collected ($0.15)
Seat 2: Earco (small blind) folded before Flop
Seat 3: Special One4444 (big blind) folded before Flop
Seat 4: SidneyCrosby8 folded before Flop (didn't bet)
Seat 5: LAMUS_PL folded before Flop (didn't bet)
Seat 6: Morales7-PRO folded before Flop


PokerStars Hand #238172188887:  Hold'em No Limit ($0.01/$0.02 USD) - 2022/08/23 14:50:04 ET
Table 'Equinox IV' 6-max Seat #3 is the button
Seat 1: Emag fo Dog ($2 in chips)
Seat 2: Earco ($2.46 in chips)
Seat 3: Special One4444 ($1.41 in chips)
Seat 4: SidneyCrosby8 ($2.40 in chips)
Seat 5: LAMUS_PL ($5.04 in chips)
Seat 6: Morales7-PRO ($2 in chips)
SidneyCrosby8: posts small blind $0.01
LAMUS_PL: posts big blind $0.02
*** HOLE CARDS ***
Morales7-PRO: folds
Emag fo Dog: folds
Earco: raises $0.04 to $0.06
Special One4444: folds
SidneyCrosby8: folds
LAMUS_PL: calls $0.04
*** FLOP *** [6d 5d As]
LAMUS_PL: checks
Earco: checks
*** TURN *** [6d 5d As] [5s]
LAMUS_PL: bets $0.06
Earco: calls $0.06
*** RIVER *** [6d 5d As 5s] [7h]
LAMUS_PL: bets $0.16
Earco: folds
Uncalled bet ($0.16) returned to LAMUS_PL
LAMUS_PL collected $0.24 from pot
LAMUS_PL: doesn't show hand
*** SUMMARY ***
Total pot $0.25 | Rake $0.01
Board [6d 5d As 5s 7h]
Seat 1: Emag fo Dog folded before Flop (didn't bet)
Seat 2: Earco folded on the River
Seat 3: Special One4444 (button) folded before Flop (didn't bet)
Seat 4: SidneyCrosby8 (small blind) folded before Flop
Seat 5: LAMUS_PL (big blind) collected ($0.24)
Seat 6: Morales7-PRO folded before Flop (didn't bet)


PokerStars Hand #238172202148:  Hold'em No Limit ($0.01/$0.02 USD) - 2022/08/23 14:50:41 ET
Table 'Equinox IV' 6-max Seat #4 is the button
Seat 1: Emag fo Dog ($2 in chips)
Seat 2: Earco ($2.34 in chips)
Seat 3: Special One4444 ($1.41 in chips)
Seat 4: SidneyCrosby8 ($2.39 in chips)
Seat 5: LAMUS_PL ($5.16 in chips)
Seat 6: Morales7-PRO ($2 in chips)
LAMUS_PL: posts small blind $0.01
Morales7-PRO: posts big blind $0.02
*** HOLE CARDS ***
Emag fo Dog: folds
Earco: folds
Special One4444: folds
SidneyCrosby8: folds
LAMUS_PL: folds
Uncalled bet ($0.01) returned to Morales7-PRO
Morales7-PRO collected $0.02 from pot
Morales7-PRO: doesn't show hand
*** SUMMARY ***
Total pot $0.02 | Rake $0
Seat 1: Emag fo Dog folded before Flop (didn't bet)
Seat 2: Earco folded before Flop (didn't bet)
Seat 3: Special One4444 folded before Flop (didn't bet)
Seat 4: SidneyCrosby8 (button) folded before Flop (didn't bet)
Seat 5: LAMUS_PL (small blind) folded before Flop
Seat 6: Morales7-PRO (big blind) collected ($0.02)


PokerStars Hand #238172205926:  Hold'em No Limit ($0.01/$0.02 USD) - 2022/08/23 14:50:51 ET
Table 'Equinox IV' 6-max Seat #5 is the button
Seat 1: Emag fo Dog ($2 in chips)
Seat 2: Earco ($2.34 in chips)
Seat 3: Special One4444 ($1.41 in chips)
Seat 4: SidneyCrosby8 ($2.39 in chips)
Seat 5: LAMUS_PL ($5.15 in chips)
Seat 6: Morales7-PRO ($2.01 in chips)
Morales7-PRO: posts small blind $0.01
Emag fo Dog: posts big blind $0.02
*** HOLE CARDS ***
Earco: folds
Special One4444: folds
SidneyCrosby8: folds
LAMUS_PL: raises $0.02 to $0.04
Morales7-PRO: folds
Emag fo Dog: raises $0.19 to $0.23
LAMUS_PL: calls $0.19
*** FLOP *** [7d 6h 8h]
Emag fo Dog: bets $0.02
LAMUS_PL: folds
Uncalled bet ($0.02) returned to Emag fo Dog
Emag fo Dog collected $0.45 from pot
Emag fo Dog: doesn't show hand
*** SUMMARY ***
Total pot $0.47 | Rake $0.02
Board [7d 6h 8h]
Seat 1: Emag fo Dog (big blind) collected ($0.45)
Seat 2: Earco folded before Flop (didn't bet)
Seat 3: Special One4444 folded before Flop (didn't bet)
Seat 4: SidneyCrosby8 folded before Flop (didn't bet)
Seat 5: LAMUS_PL (button) folded on the Flop
Seat 6: Morales7-PRO (small blind) folded before Flop


PokerStars Hand #238172224767:  Hold'em No Limit ($0.01/$0.02 USD) - 2022/08/23 14:51:44 ET
Table 'Equinox IV' 6-max Seat #6 is the button
Seat 1: Emag fo Dog ($2.22 in chips)
Seat 2: Earco ($2.34 in chips)
Seat 3: Special One4444 ($1.41 in chips)
Seat 4: SidneyCrosby8 ($2.39 in chips)
Seat 5: LAMUS_PL ($4.92 in chips)
Seat 6: Morales7-PRO ($2 in chips)
Emag fo Dog: posts small blind $0.01
Earco: posts big blind $0.02
*** HOLE CARDS ***
Special One4444: folds
SidneyCrosby8: folds
LAMUS_PL: raises $0.03 to $0.05
Morales7-PRO: folds
Emag fo Dog: folds
Earco: calls $0.03
*** FLOP *** [2c 3d 6h]
Earco: checks
LAMUS_PL: bets $0.07
Earco: calls $0.07
*** TURN *** [2c 3d 6h] [8s]
Earco: checks
LAMUS_PL: bets $0.16
Earco: calls $0.16
*** RIVER *** [2c 3d 6h 8s] [As]
Earco: checks
LAMUS_PL: bets $0.36
Earco: calls $0.36
*** SHOW DOWN ***
LAMUS_PL: shows [6c 6d] (three of a kind, Sixes)
Earco: mucks hand
LAMUS_PL collected $1.23 from pot
*** SUMMARY ***
Total pot $1.29 | Rake $0.06
Board [2c 3d 6h 8s As]
Seat 1: Emag fo Dog (small blind) folded before Flop
Seat 2: Earco (big blind) mucked
Seat 3: Special One4444 folded before Flop (didn't bet)
Seat 4: SidneyCrosby8 folded before Flop (didn't bet)
Seat 5: LAMUS_PL showed [6c 6d] and won ($1.23) with three of a kind, Sixes
Seat 6: Morales7-PRO (button) folded before Flop (didn't bet)


PokerStars Hand #238172248560:  Hold'em No Limit ($0.01/$0.02 USD) - 2022/08/23 14:52:50 ET
Table 'Equinox IV' 6-max Seat #1 is the button
Seat 1: Emag fo Dog ($2.21 in chips)
Seat 2: Earco ($2 in chips)
Seat 3: Special One4444 ($1.41 in chips)
Seat 4: SidneyCrosby8 ($2.39 in chips)
Seat 5: LAMUS_PL ($5.51 in chips)
Seat 6: Morales7-PRO ($2 in chips)
Earco: posts small blind $0.01
Special One4444: posts big blind $0.02
*** HOLE CARDS ***
SidneyCrosby8: folds
LAMUS_PL: raises $0.04 to $0.06
Morales7-PRO: folds
Emag fo Dog: calls $0.06
Earco: calls $0.05
Special One4444: folds
*** FLOP *** [8h 5d 6s]
Earco: bets $0.13
LAMUS_PL: calls $0.13
Emag fo Dog: folds
*** TURN *** [8h 5d 6s] [Jc]
Earco: bets $0.22
LAMUS_PL: calls $0.22
*** RIVER *** [8h 5d 6s Jc] [3d]
Earco: checks
LAMUS_PL: checks
*** SHOW DOWN ***
Earco: shows [9s 8d] (a pair of Eights)
LAMUS_PL: shows [7s Js] (a pair of Jacks)
LAMUS_PL collected $0.86 from pot
*** SUMMARY ***
Total pot $0.90 | Rake $0.04
Board [8h 5d 6s Jc 3d]
Seat 1: Emag fo Dog (button) folded on the Flop
Seat 2: Earco (small blind) showed [9s 8d] and lost with a pair of Eights
Seat 3: Special One4444 (big blind) folded before Flop
Seat 4: SidneyCrosby8 folded before Flop (didn't bet)
Seat 5: LAMUS_PL showed [7s Js] and won ($0.86) with a pair of Jacks
Seat 6: Morales7-PRO folded before Flop (didn't bet)


PokerStars Hand #238172265511:  Hold'em No Limit ($0.01/$0.02 USD) - 2022/08/23 14:53:37 ET
Table 'Equinox IV' 6-max Seat #2 is the button
Seat 1: Emag fo Dog ($2.15 in chips)
Seat 2: Earco ($2 in chips)
Seat 3: Special One4444 ($1.39 in chips)
Seat 4: SidneyCrosby8 ($2.39 in chips)
Seat 5: LAMUS_PL ($5.96 in chips)
Seat 6: Morales7-PRO ($2 in chips)
Special One4444: posts small blind $0.01
SidneyCrosby8: posts big blind $0.02
*** HOLE CARDS ***
LAMUS_PL: folds
Morales7-PRO: folds
Emag fo Dog: raises $0.03 to $0.05
Earco: folds
Special One4444: folds
SidneyCrosby8: folds
Uncalled bet ($0.03) returned to Emag fo Dog
Emag fo Dog collected $0.05 from pot
Emag fo Dog: doesn't show hand
*** SUMMARY ***
Total pot $0.05 | Rake $0
Seat 1: Emag fo Dog collected ($0.05)
Seat 2: Earco (button) folded before Flop (didn't bet)
Seat 3: Special One4444 (small blind) folded before Flop
Seat 4: SidneyCrosby8 (big blind) folded before Flop
Seat 5: LAMUS_PL folded before Flop (didn't bet)
Seat 6: Morales7-PRO folded before Flop (didn't bet)


PokerStars Hand #238172270493:  Hold'em No Limit ($0.01/$0.02 USD) - 2022/08/23 14:53:52 ET
Table 'Equinox IV' 6-max Seat #3 is the button
Seat 1: Emag fo Dog ($2.18 in chips)
Seat 2: Earco ($2 in chips)
Seat 3: Special One4444 ($1.38 in chips)
Seat 4: SidneyCrosby8 ($2.37 in chips)
Seat 5: LAMUS_PL ($5.96 in chips)
Seat 6: Morales7-PRO ($2 in chips)
SidneyCrosby8: posts small blind $0.01
LAMUS_PL: posts big blind $0.02
*** HOLE CARDS ***
Morales7-PRO: folds
Emag fo Dog: raises $0.04 to $0.06
Earco: folds
Special One4444: folds
SidneyCrosby8: folds
LAMUS_PL: calls $0.04
*** FLOP *** [Ts Jh 4s]
LAMUS_PL: checks
Emag fo Dog: bets $0.02
LAMUS_PL: raises $0.11 to $0.13
Emag fo Dog: folds
Uncalled bet ($0.11) returned to LAMUS_PL
LAMUS_PL collected $0.16 from pot
LAMUS_PL: doesn't show hand
*** SUMMARY ***
Total pot $0.17 | Rake $0.01
Board [Ts Jh 4s]
Seat 1: Emag fo Dog folded on the Flop
Seat 2: Earco folded before Flop (didn't bet)
Seat 3: Special One4444 (button) folded before Flop (didn't bet)
Seat 4: SidneyCrosby8 (small blind) folded before Flop
Seat 5: LAMUS_PL (big blind) collected ($0.16)
Seat 6: Morales7-PRO folded before Flop (didn't bet)


PokerStars Hand #238172284121:  Hold'em No Limit ($0.01/$0.02 USD) - 2022/08/23 14:54:30 ET
Table 'Equinox IV' 6-max Seat #4 is the button
Seat 1: Emag fo Dog ($2.10 in chips)
Seat 2: Earco ($2 in chips)
Seat 3: Special One4444 ($1.38 in chips)
Seat 4: SidneyCrosby8 ($2.36 in chips)
Seat 5: LAMUS_PL ($6.04 in chips)
Seat 6: Morales7-PRO ($2 in chips)
LAMUS_PL: posts small blind $0.01
Morales7-PRO: posts big blind $0.02
*** HOLE CARDS ***
Emag fo Dog: raises $0.04 to $0.06
Earco: folds
Special One4444: folds
SidneyCrosby8: folds
LAMUS_PL: folds
Morales7-PRO: calls $0.04
*** FLOP *** [Ah Qh 2c]
Morales7-PRO: checks
Emag fo Dog: bets $0.02
Morales7-PRO: raises $0.10 to $0.12
Emag fo Dog: folds
Uncalled bet ($0.10) returned to Morales7-PRO
Morales7-PRO collected $0.16 from pot
Morales7-PRO: doesn't show hand
*** SUMMARY ***
Total pot $0.17 | Rake $0.01
Board [Ah Qh 2c]
Seat 1: Emag fo Dog folded on the Flop
Seat 2: Earco folded before Flop (didn't bet)
Seat 3: Special One4444 folded before Flop (didn't bet)
Seat 4: SidneyCrosby8 (button) folded before Flop (didn't bet)
Seat 5: LAMUS_PL (small blind) folded before Flop
Seat 6: Morales7-PRO (big blind) collected ($0.16)


PokerStars Hand #238172296920:  Hold'em No Limit ($0.01/$0.02 USD) - 2022/08/23 14:55:06 ET
Table 'Equinox IV' 6-max Seat #5 is the button
Seat 1: Emag fo Dog ($2.02 in chips)
Seat 2: Earco ($2 in chips)
Seat 3: Special One4444 ($1.38 in chips)
Seat 4: SidneyCrosby8 ($2.36 in chips)
Seat 5: LAMUS_PL ($6.03 in chips)
Seat 6: Morales7-PRO ($2.08 in chips)
Morales7-PRO: posts small blind $0.01
Emag fo Dog: posts big blind $0.02
*** HOLE CARDS ***
Earco: raises $0.04 to $0.06
Special One4444: raises $0.04 to $0.10
SidneyCrosby8: raises $0.18 to $0.28
LAMUS_PL: folds
Morales7-PRO: folds
Emag fo Dog: folds
Earco: folds
Special One4444: calls $0.18
*** FLOP *** [2s 8c 8s]
Special One4444: bets $0.14
SidneyCrosby8: calls $0.14
*** TURN *** [2s 8c 8s] [Th]
Special One4444: checks
SidneyCrosby8: checks
*** RIVER *** [2s 8c 8s Th] [3c]
Special One4444: checks
SidneyCrosby8: checks
*** SHOW DOWN ***
Special One4444: shows [Ac Jc] (a pair of Eights)
SidneyCrosby8: shows [Ad Ks] (a pair of Eights - Ace+King kicker)
SidneyCrosby8 collected $0.90 from pot
*** SUMMARY ***
Total pot $0.93 | Rake $0.03
Board [2s 8c 8s Th 3c]
Seat 1: Emag fo Dog (big blind) folded before Flop
Seat 2: Earco folded before Flop
Seat 3: Special One4444 showed [Ac Jc] and lost with a pair of Eights
Seat 4: SidneyCrosby8 showed [Ad Ks] and won ($0.90) with a pair of Eights
Seat 5: LAMUS_PL (button) folded before Flop (didn't bet)
Seat 6: Morales7-PRO (small blind) folded before Flop


PokerStars Hand #238172311537:  Hold'em No Limit ($0.01/$0.02 USD) - 2022/08/23 14:55:57 ET
Table 'Equinox IV' 6-max Seat #6 is the button
Seat 1: Emag fo Dog ($2 in chips)
Seat 2: Earco ($1.94 in chips)
Seat 3: Special One4444 ($0.96 in chips)
Seat 4: SidneyCrosby8 ($2.84 in chips)
Seat 5: LAMUS_PL ($6.03 in chips)
Seat 6: Morales7-PRO ($2.07 in chips)
Emag fo Dog: posts small blind $0.01
Earco: posts big blind $0.02
*** HOLE CARDS ***
Special One4444: folds
SidneyCrosby8: folds
LAMUS_PL: raises $0.03 to $0.05
Morales7-PRO: raises $0.13 to $0.18
Emag fo Dog: folds
Earco: folds
LAMUS_PL: folds
Uncalled bet ($0.13) returned to Morales7-PRO
Morales7-PRO collected $0.13 from pot
Morales7-PRO: doesn't show hand
*** SUMMARY ***
Total pot $0.13 | Rake $0
Seat 1: Emag fo Dog (small blind) folded before Flop
Seat 2: Earco (big blind) folded before Flop
Seat 3: Special One4444 folded before Flop (didn't bet)
Seat 4: SidneyCrosby8 folded before Flop (didn't bet)
Seat 5: LAMUS_PL folded before Flop
Seat 6: Morales7-PRO (button) collected ($0.13)


PokerStars Hand #238172316565:  Hold'em No Limit ($0.01/$0.02 USD) - 2022/08/23 14:56:15 ET
Table 'Equinox IV' 6-max Seat #1 is the button
Seat 1: Emag fo Dog ($1.99 in chips)
Seat 2: Earco ($1.92 in chips)
Seat 3: Special One4444 ($0.96 in chips)
Seat 4: SidneyCrosby8 ($2.84 in chips)
Seat 5: LAMUS_PL ($5.98 in chips)
Seat 6: Morales7-PRO ($2.15 in chips)
Earco: posts small blind $0.01
Special One4444: posts big blind $0.02
*** HOLE CARDS ***
SidneyCrosby8: folds
LAMUS_PL: folds
Morales7-PRO: folds
Emag fo Dog: raises $0.03 to $0.05
Earco: folds
Special One4444: folds
Uncalled bet ($0.03) returned to Emag fo Dog
Emag fo Dog collected $0.05 from pot
Emag fo Dog: doesn't show hand
*** SUMMARY ***
Total pot $0.05 | Rake $0
Seat 1: Emag fo Dog (button) collected ($0.05)
Seat 2: Earco (small blind) folded before Flop
Seat 3: Special One4444 (big blind) folded before Flop
Seat 4: SidneyCrosby8 folded before Flop (didn't bet)
Seat 5: LAMUS_PL folded before Flop (didn't bet)
Seat 6: Morales7-PRO folded before Flop (didn't bet)


PokerStars Hand #238172320831:  Hold'em No Limit ($0.01/$0.02 USD) - 2022/08/23 14:56:31 ET
Table 'Equinox IV' 6-max Seat #2 is the button
Seat 1: Emag fo Dog ($2.02 in chips)
Seat 2: Earco ($1.91 in chips)
Seat 3: Special One4444 ($0.94 in chips)
Seat 4: SidneyCrosby8 ($2.84 in chips)
Seat 5: LAMUS_PL ($5.98 in chips)
Seat 6: Morales7-PRO ($2.15 in chips)
Special One4444: posts small blind $0.01
SidneyCrosby8: posts big blind $0.02
*** HOLE CARDS ***
LAMUS_PL: folds
Morales7-PRO: folds
Emag fo Dog: raises $0.03 to $0.05
Earco: raises $0.09 to $0.14
Special One4444: folds
SidneyCrosby8: folds
Emag fo Dog: calls $0.09
*** FLOP *** [3d 9c 5d]
Emag fo Dog: bets $0.02
Earco: calls $0.02
*** TURN *** [3d 9c 5d] [Ad]
Emag fo Dog: bets $0.02
Earco: calls $0.02
*** RIVER *** [3d 9c 5d Ad] [Kc]
Emag fo Dog: bets $0.02
Earco: raises $0.21 to $0.23
Emag fo Dog: folds
Uncalled bet ($0.21) returned to Earco
Earco collected $0.41 from pot
Earco: doesn't show hand
*** SUMMARY ***
Total pot $0.43 | Rake $0.02
Board [3d 9c 5d Ad Kc]
Seat 1: Emag fo Dog folded on the River
Seat 2: Earco (button) collected ($0.41)
Seat 3: Special One4444 (small blind) folded before Flop
Seat 4: SidneyCrosby8 (big blind) folded before Flop
Seat 5: LAMUS_PL folded before Flop (didn't bet)
Seat 6: Morales7-PRO folded before Flop (didn't bet)


PokerStars Hand #238172337150:  Hold'em No Limit ($0.01/$0.02 USD) - 2022/08/23 14:57:31 ET
Table 'Equinox IV' 6-max Seat #3 is the button
Seat 1: Emag fo Dog ($1.82 in chips)
Seat 2: Earco ($2.12 in chips)
Seat 3: Special One4444 ($0.93 in chips)
Seat 4: SidneyCrosby8 ($2.82 in chips)
Seat 5: LAMUS_PL ($5.98 in chips)
Seat 6: Morales7-PRO ($2.15 in chips)
SidneyCrosby8: posts small blind $0.01
LAMUS_PL: posts big blind $0.02
*** HOLE CARDS ***
Morales7-PRO: folds
Emag fo Dog: folds
Earco: folds
Special One4444: folds
SidneyCrosby8: folds
Uncalled bet ($0.01) returned to LAMUS_PL
LAMUS_PL collected $0.02 from pot
LAMUS_PL: doesn't show hand
*** SUMMARY ***
Total pot $0.02 | Rake $0
Seat 1: Emag fo Dog folded before Flop (didn't bet)
Seat 2: Earco folded before Flop (didn't bet)
Seat 3: Special One4444 (button) folded before Flop (didn't bet)
Seat 4: SidneyCrosby8 (small blind) folded before Flop
Seat 5: LAMUS_PL (big blind) collected ($0.02)
Seat 6: Morales7-PRO folded before Flop (didn't bet)


PokerStars Hand #238172340227:  Hold'em No Limit ($0.01/$0.02 USD) - 2022/08/23 14:57:42 ET
Table 'Equinox IV' 6-max Seat #4 is the button
Seat 1: Emag fo Dog ($1.82 in chips)
Seat 2: Earco ($2.12 in chips)
Seat 3: Special One4444 ($0.93 in chips)
Seat 4: SidneyCrosby8 ($2.81 in chips)
Seat 5: LAMUS_PL ($5.99 in chips)
Seat 6: Morales7-PRO ($2.15 in chips)
LAMUS_PL: posts small blind $0.01
Morales7-PRO: posts big blind $0.02
*** HOLE CARDS ***
Emag fo Dog: raises $0.04 to $0.06
Earco: folds
Special One4444: folds
SidneyCrosby8: folds
LAMUS_PL: folds
Morales7-PRO: folds
Uncalled bet ($0.04) returned to Emag fo Dog
Emag fo Dog collected $0.05 from pot
Emag fo Dog: doesn't show hand
*** SUMMARY ***
Total pot $0.05 | Rake $0
Seat 1: Emag fo Dog collected ($0.05)
Seat 2: Earco folded before Flop (didn't bet)
Seat 3: Special One4444 folded before Flop (didn't bet)
Seat 4: SidneyCrosby8 (button) folded before Flop (didn't bet)
Seat 5: LAMUS_PL (small blind) folded before Flop
Seat 6: Morales7-PRO (big blind) folded before Flop


PokerStars Hand #238172343130:  Hold'em No Limit ($0.01/$0.02 USD) - 2022/08/23 14:57:53 ET
Table 'Equinox IV' 6-max Seat #5 is the button
Seat 2: Earco ($2.12 in chips)
Seat 3: Special One4444 ($0.93 in chips)
Seat 4: SidneyCrosby8 ($2.81 in chips)
Seat 5: LAMUS_PL ($5.98 in chips)
Seat 6: Morales7-PRO ($2.13 in chips)
Morales7-PRO: posts small blind $0.01
Emag fo Dog: is sitting out
Earco: posts big blind $0.02
*** HOLE CARDS ***
Special One4444: folds
SidneyCrosby8: raises $0.04 to $0.06
LAMUS_PL: calls $0.06
Emag fo Dog leaves the table
Morales7-PRO: folds
Earco: calls $0.04
*** FLOP *** [4h 3s 9h]
Earco: checks
SidneyCrosby8: checks
LAMUS_PL: checks
*** TURN *** [4h 3s 9h] [Kc]
Earco: checks
SidneyCrosby8: bets $0.09
Jh0nTravolta joins the table at seat #1
LAMUS_PL: calls $0.09
Earco: calls $0.09
*** RIVER *** [4h 3s 9h Kc] [Th]
Earco: checks
SidneyCrosby8: checks
LAMUS_PL: checks
*** SHOW DOWN ***
Earco: shows [As 9c] (a pair of Nines)
SidneyCrosby8: shows [Ts Kd] (two pair, Kings and Tens)
LAMUS_PL: mucks hand
SidneyCrosby8 collected $0.44 from pot
*** SUMMARY ***
Total pot $0.46 | Rake $0.02
Board [4h 3s 9h Kc Th]
Seat 2: Earco (big blind) showed [As 9c] and lost with a pair of Nines
Seat 3: Special One4444 folded before Flop (didn't bet)
Seat 4: SidneyCrosby8 showed [Ts Kd] and won ($0.44) with two pair, Kings and Tens
Seat 5: LAMUS_PL (button) mucked
Seat 6: Morales7-PRO (small blind) folded before Flop


PokerStars Hand #238172355175:  Hold'em No Limit ($0.01/$0.02 USD) - 2022/08/23 14:58:37 ET
Table 'Equinox IV' 6-max Seat #6 is the button
Seat 2: Earco ($1.97 in chips)
Seat 3: Special One4444 ($0.93 in chips)
Seat 4: SidneyCrosby8 ($3.10 in chips)
Seat 5: LAMUS_PL ($5.83 in chips)
Seat 6: Morales7-PRO ($2.12 in chips)
Earco: posts small blind $0.01
Special One4444: posts big blind $0.02
*** HOLE CARDS ***
SidneyCrosby8: folds
LAMUS_PL: folds
Morales7-PRO: folds
Earco: folds
Uncalled bet ($0.01) returned to Special One4444
Special One4444 collected $0.02 from pot
*** SUMMARY ***
Total pot $0.02 | Rake $0
Seat 2: Earco (small blind) folded before Flop
Seat 3: Special One4444 (big blind) collected ($0.02)
Seat 4: SidneyCrosby8 folded before Flop (didn't bet)
Seat 5: LAMUS_PL folded before Flop (didn't bet)
Seat 6: Morales7-PRO (button) folded before Flop (didn't bet)


PokerStars Hand #238172357627:  Hold'em No Limit ($0.01/$0.02 USD) - 2022/08/23 14:58:46 ET
Table 'Equinox IV' 6-max Seat #2 is the button
Seat 2: Earco ($1.96 in chips)
Seat 3: Special One4444 ($0.94 in chips)
Seat 4: SidneyCrosby8 ($3.10 in chips)
Seat 5: LAMUS_PL ($5.83 in chips)
Seat 6: Morales7-PRO ($2.12 in chips)
Special One4444: posts small blind $0.01
SidneyCrosby8: posts big blind $0.02
Jh0nTravolta: sits out
*** HOLE CARDS ***
LAMUS_PL: raises $0.04 to $0.06
Morales7-PRO: raises $0.12 to $0.18
Earco: calls $0.18
Special One4444: folds
SidneyCrosby8: folds
LAMUS_PL: calls $0.12
*** FLOP *** [Tc 4s 4h]
LAMUS_PL: checks
Morales7-PRO: bets $0.18
Earco: calls $0.18
LAMUS_PL: raises $0.72 to $0.90
Morales7-PRO: folds
Earco: folds
Uncalled bet ($0.72) returned to LAMUS_PL
LAMUS_PL collected $1.06 from pot
LAMUS_PL: doesn't show hand
*** SUMMARY ***
Total pot $1.11 | Rake $0.05
Board [Tc 4s 4h]
Seat 2: Earco (button) folded on the Flop
Seat 3: Special One4444 (small blind) folded before Flop
Seat 4: SidneyCrosby8 (big blind) folded before Flop
Seat 5: LAMUS_PL collected ($1.06)
Seat 6: Morales7-PRO folded on the Flop


PokerStars Hand #238172370740:  Hold'em No Limit ($0.01/$0.02 USD) - 2022/08/23 14:59:34 ET
Table 'Equinox IV' 6-max Seat #3 is the button
Seat 2: Earco ($2 in chips)
Seat 3: Special One4444 ($0.93 in chips)
Seat 4: SidneyCrosby8 ($3.08 in chips)
Seat 5: LAMUS_PL ($6.53 in chips)
Seat 6: Morales7-PRO ($2 in chips)
SidneyCrosby8: posts small blind $0.01
LAMUS_PL: posts big blind $0.02
Jh0nTravolta: sits out
*** HOLE CARDS ***
Morales7-PRO: folds
Earco: folds
Special One4444: raises $0.04 to $0.06
SidneyCrosby8: folds
LAMUS_PL: raises $0.16 to $0.22
Special One4444: calls $0.16
*** FLOP *** [8s 6h 2d]
LAMUS_PL: bets $0.28
Special One4444: folds
Uncalled bet ($0.28) returned to LAMUS_PL
LAMUS_PL collected $0.43 from pot
LAMUS_PL: doesn't show hand
*** SUMMARY ***
Total pot $0.45 | Rake $0.02
Board [8s 6h 2d]
Seat 2: Earco folded before Flop (didn't bet)
Seat 3: Special One4444 (button) folded on the Flop
Seat 4: SidneyCrosby8 (small blind) folded before Flop
Seat 5: LAMUS_PL (big blind) collected ($0.43)
Seat 6: Morales7-PRO folded before Flop (didn't bet)


PokerStars Hand #238172381945:  Hold'em No Limit ($0.01/$0.02 USD) - 2022/08/23 15:00:13 ET
Table 'Equinox IV' 6-max Seat #4 is the button
Seat 2: Earco ($2 in chips)
Seat 3: Special One4444 ($0.71 in chips)
Seat 4: SidneyCrosby8 ($3.07 in chips)
Seat 5: LAMUS_PL ($6.74 in chips)
Seat 6: Morales7-PRO ($2 in chips)
LAMUS_PL: posts small blind $0.01
Morales7-PRO: posts big blind $0.02
Jh0nTravolta: sits out
*** HOLE CARDS ***
Earco: folds
Special One4444: folds
SidneyCrosby8: folds
LAMUS_PL: folds
Uncalled bet ($0.01) returned to Morales7-PRO
Morales7-PRO collected $0.02 from pot
Morales7-PRO: doesn't show hand
*** SUMMARY ***
Total pot $0.02 | Rake $0
Seat 2: Earco folded before Flop (didn't bet)
Seat 3: Special One4444 folded before Flop (didn't bet)
Seat 4: SidneyCrosby8 (button) folded before Flop (didn't bet)
Seat 5: LAMUS_PL (small blind) folded before Flop
Seat 6: Morales7-PRO (big blind) collected ($0.02)


PokerStars Hand #238172384565:  Hold'em No Limit ($0.01/$0.02 USD) - 2022/08/23 15:00:23 ET
Table 'Equinox IV' 6-max Seat #5 is the button
Seat 1: Jh0nTravolta ($2 in chips)
Seat 2: Earco ($2 in chips)
Seat 3: Special One4444 ($0.71 in chips)
Seat 4: SidneyCrosby8 ($3.07 in chips)
Seat 5: LAMUS_PL ($6.73 in chips)
Seat 6: Morales7-PRO ($2.01 in chips)
Morales7-PRO: posts small blind $0.01
Jh0nTravolta: posts big blind $0.02
*** HOLE CARDS ***
Earco: folds
Special One4444: raises $0.08 to $0.10
SidneyCrosby8: folds
LAMUS_PL: calls $0.10
Morales7-PRO: folds
Jh0nTravolta: folds
*** FLOP *** [Kh Ts 9c]
Special One4444: bets $0.16
LAMUS_PL: folds
Uncalled bet ($0.16) returned to Special One4444
Special One4444 collected $0.22 from pot
*** SUMMARY ***
Total pot $0.23 | Rake $0.01
Board [Kh Ts 9c]
Seat 1: Jh0nTravolta (big blind) folded before Flop
Seat 2: Earco folded before Flop (didn't bet)
Seat 3: Special One4444 collected ($0.22)
Seat 4: SidneyCrosby8 folded before Flop (didn't bet)
Seat 5: LAMUS_PL (button) folded on the Flop
Seat 6: Morales7-PRO (small blind) folded before Flop


PokerStars Hand #238172396263:  Hold'em No Limit ($0.01/$0.02 USD) - 2022/08/23 15:01:02 ET
Table 'Equinox IV' 6-max Seat #6 is the button
Seat 1: Jh0nTravolta ($2 in chips)
Seat 2: Earco ($2 in chips)
Seat 3: Special One4444 ($0.83 in chips)
Seat 5: LAMUS_PL ($6.63 in chips)
Seat 6: Morales7-PRO ($2 in chips)
Jh0nTravolta: posts small blind $0.01
Earco: posts big blind $0.02
*** HOLE CARDS ***
Special One4444: folds
LAMUS_PL: folds
Morales7-PRO: folds
Jh0nTravolta: folds
Uncalled bet ($0.01) returned to Earco
Earco collected $0.02 from pot
Earco: doesn't show hand
*** SUMMARY ***
Total pot $0.02 | Rake $0
Seat 1: Jh0nTravolta (small blind) folded before Flop
Seat 2: Earco (big blind) collected ($0.02)
Seat 3: Special One4444 folded before Flop (didn't bet)
Seat 5: LAMUS_PL folded before Flop (didn't bet)
Seat 6: Morales7-PRO (button) folded before Flop (didn't bet)


PokerStars Hand #238172400774:  Hold'em No Limit ($0.01/$0.02 USD) - 2022/08/23 15:01:16 ET
Table 'Equinox IV' 6-max Seat #1 is the button
Seat 1: Jh0nTravolta ($2 in chips)
Seat 2: Earco ($2.01 in chips)
Seat 3: Special One4444 ($0.83 in chips)
Seat 4: SidneyCrosby8 ($3.07 in chips)
Seat 5: LAMUS_PL ($6.63 in chips)
Seat 6: Morales7-PRO ($2 in chips)
Earco: posts small blind $0.01
Special One4444: posts big blind $0.02
*** HOLE CARDS ***
SidneyCrosby8: folds
LAMUS_PL: folds
Morales7-PRO: folds
Jh0nTravolta: folds
Earco: folds
Uncalled bet ($0.01) returned to Special One4444
Special One4444 collected $0.02 from pot
*** SUMMARY ***
Total pot $0.02 | Rake $0
Seat 1: Jh0nTravolta (button) folded before Flop (didn't bet)
Seat 2: Earco (small blind) folded before Flop
Seat 3: Special One4444 (big blind) collected ($0.02)
Seat 4: SidneyCrosby8 folded before Flop (didn't bet)
Seat 5: LAMUS_PL folded before Flop (didn't bet)
Seat 6: Morales7-PRO folded before Flop (didn't bet)


PokerStars Hand #238172405787:  Hold'em No Limit ($0.01/$0.02 USD) - 2022/08/23 15:01:31 ET
Table 'Equinox IV' 6-max Seat #2 is the button
Seat 1: Jh0nTravolta ($2 in chips)
Seat 2: Earco ($2 in chips)
Seat 3: Special One4444 ($0.84 in chips)
Seat 4: SidneyCrosby8 ($3.07 in chips)
Seat 5: LAMUS_PL ($6.63 in chips)
Seat 6: Morales7-PRO ($2 in chips)
Special One4444: posts small blind $0.01
SidneyCrosby8: posts big blind $0.02
*** HOLE CARDS ***
LAMUS_PL: raises $0.04 to $0.06
Morales7-PRO: folds
Jh0nTravolta: folds
Earco: folds
Special One4444: calls $0.05
SidneyCrosby8: folds
*** FLOP *** [2d 4s Jh]
Special One4444: checks
LAMUS_PL: bets $0.09
Special One4444: folds
Uncalled bet ($0.09) returned to LAMUS_PL
LAMUS_PL collected $0.14 from pot
LAMUS_PL: doesn't show hand
*** SUMMARY ***
Total pot $0.14 | Rake $0
Board [2d 4s Jh]
Seat 1: Jh0nTravolta folded before Flop (didn't bet)
Seat 2: Earco (button) folded before Flop (didn't bet)
Seat 3: Special One4444 (small blind) folded on the Flop
Seat 4: SidneyCrosby8 (big blind) folded before Flop
Seat 5: LAMUS_PL collected ($0.14)
Seat 6: Morales7-PRO folded before Flop (didn't bet)


PokerStars Hand #238172414910:  Hold'em No Limit ($0.01/$0.02 USD) - 2022/08/23 15:01:59 ET
Table 'Equinox IV' 6-max Seat #3 is the button
Seat 1: Jh0nTravolta ($2 in chips)
Seat 2: Earco ($2 in chips)
Seat 3: Special One4444 ($0.78 in chips)
Seat 4: SidneyCrosby8 ($3.05 in chips)
Seat 5: LAMUS_PL ($6.71 in chips)
Seat 6: Morales7-PRO ($2 in chips)
SidneyCrosby8: posts small blind $0.01
LAMUS_PL: posts big blind $0.02
*** HOLE CARDS ***
Morales7-PRO: folds
Jh0nTravolta: folds
Earco: raises $0.04 to $0.06
Special One4444: folds
SidneyCrosby8: folds
LAMUS_PL: folds
Uncalled bet ($0.04) returned to Earco
Earco collected $0.05 from pot
Earco: doesn't show hand
*** SUMMARY ***
Total pot $0.05 | Rake $0
Seat 1: Jh0nTravolta folded before Flop (didn't bet)
Seat 2: Earco collected ($0.05)
Seat 3: Special One4444 (button) folded before Flop (didn't bet)
Seat 4: SidneyCrosby8 (small blind) folded before Flop
Seat 5: LAMUS_PL (big blind) folded before Flop
Seat 6: Morales7-PRO folded before Flop (didn't bet)


PokerStars Hand #238172419325:  Hold'em No Limit ($0.01/$0.02 USD) - 2022/08/23 15:02:11 ET
Table 'Equinox IV' 6-max Seat #4 is the button
Seat 1: Jh0nTravolta ($2 in chips)
Seat 2: Earco ($2.03 in chips)
Seat 3: Special One4444 ($0.78 in chips)
Seat 4: SidneyCrosby8 ($3.04 in chips)
Seat 5: LAMUS_PL ($6.69 in chips)
Seat 6: Morales7-PRO ($2 in chips)
LAMUS_PL: posts small blind $0.01
Morales7-PRO: posts big blind $0.02
*** HOLE CARDS ***
Jh0nTravolta: raises $0.03 to $0.05
Earco: calls $0.05
Special One4444: calls $0.05
SidneyCrosby8: folds
LAMUS_PL: calls $0.04
Morales7-PRO: folds
*** FLOP *** [Ad 9d 3s]
LAMUS_PL: checks
Jh0nTravolta: checks
Earco: checks
Special One4444: bets $0.10
LAMUS_PL: folds
Jh0nTravolta: folds
Earco: calls $0.10
*** TURN *** [Ad 9d 3s] [Ts]
Earco: checks
Special One4444: bets $0.41
Earco: folds
Uncalled bet ($0.41) returned to Special One4444
Special One4444 collected $0.41 from pot
*** SUMMARY ***
Total pot $0.42 | Rake $0.01
Board [Ad 9d 3s Ts]
Seat 1: Jh0nTravolta folded on the Flop
Seat 2: Earco folded on the Turn
Seat 3: Special One4444 collected ($0.41)
Seat 4: SidneyCrosby8 (button) folded before Flop (didn't bet)
Seat 5: LAMUS_PL (small blind) folded on the Flop
Seat 6: Morales7-PRO (big blind) folded before Flop


PokerStars Hand #238172439281:  Hold'em No Limit ($0.01/$0.02 USD) - 2022/08/23 15:03:07 ET
Table 'Equinox IV' 6-max Seat #5 is the button
Seat 1: Jh0nTravolta ($2 in chips)
Seat 2: Earco ($1.88 in chips)
Seat 3: Special One4444 ($1.04 in chips)
Seat 4: SidneyCrosby8 ($3.04 in chips)
Seat 5: LAMUS_PL ($6.64 in chips)
Seat 6: Morales7-PRO ($2 in chips)
Morales7-PRO: posts small blind $0.01
Jh0nTravolta: posts big blind $0.02
*** HOLE CARDS ***
Earco: folds
Special One4444: folds
SidneyCrosby8: folds
LAMUS_PL: raises $0.02 to $0.04
Morales7-PRO: folds
Jh0nTravolta: folds
Uncalled bet ($0.02) returned to LAMUS_PL
LAMUS_PL collected $0.05 from pot
LAMUS_PL: doesn't show hand
*** SUMMARY ***
Total pot $0.05 | Rake $0
Seat 1: Jh0nTravolta (big blind) folded before Flop
Seat 2: Earco folded before Flop (didn't bet)
Seat 3: Special One4444 folded before Flop (didn't bet)
Seat 4: SidneyCrosby8 folded before Flop (didn't bet)
Seat 5: LAMUS_PL (button) collected ($0.05)
Seat 6: Morales7-PRO (small blind) folded before Flop


PokerStars Hand #238172443384:  Hold'em No Limit ($0.01/$0.02 USD) - 2022/08/23 15:03:18 ET
Table 'Equinox IV' 6-max Seat #6 is the button
Seat 1: Jh0nTravolta ($2 in chips)
Seat 2: Earco ($1.88 in chips)
Seat 3: Special One4444 ($1.04 in chips)
Seat 4: SidneyCrosby8 ($3.04 in chips)
Seat 5: LAMUS_PL ($6.67 in chips)
Seat 6: Morales7-PRO ($2 in chips)
Jh0nTravolta: posts small blind $0.01
Earco: posts big blind $0.02
*** HOLE CARDS ***
Special One4444: raises $0.04 to $0.06
SidneyCrosby8: folds
LAMUS_PL: folds
Morales7-PRO: raises $0.12 to $0.18
Jh0nTravolta: folds
Earco: folds
Special One4444: folds
Uncalled bet ($0.12) returned to Morales7-PRO
Morales7-PRO collected $0.15 from pot
Morales7-PRO: doesn't show hand
*** SUMMARY ***
Total pot $0.15 | Rake $0
Seat 1: Jh0nTravolta (small blind) folded before Flop
Seat 2: Earco (big blind) folded before Flop
Seat 3: Special One4444 folded before Flop
Seat 4: SidneyCrosby8 folded before Flop (didn't bet)
Seat 5: LAMUS_PL folded before Flop (didn't bet)
Seat 6: Morales7-PRO (button) collected ($0.15)


PokerStars Hand #238172454745:  Hold'em No Limit ($0.01/$0.02 USD) - 2022/08/23 15:03:50 ET
Table 'Equinox IV' 6-max Seat #1 is the button
Seat 1: Jh0nTravolta ($2 in chips)
Seat 2: Earco ($1.86 in chips)
Seat 3: Special One4444 ($0.98 in chips)
Seat 4: SidneyCrosby8 ($3.04 in chips)
Seat 5: LAMUS_PL ($6.67 in chips)
Seat 6: Morales7-PRO ($2.09 in chips)
Earco: posts small blind $0.01
Special One4444: posts big blind $0.02
*** HOLE CARDS ***
SidneyCrosby8: folds
LAMUS_PL: folds
Morales7-PRO: folds
Jh0nTravolta: raises $0.03 to $0.05
Earco: folds
Special One4444: folds
Uncalled bet ($0.03) returned to Jh0nTravolta
Jh0nTravolta collected $0.05 from pot
Jh0nTravolta: doesn't show hand
*** SUMMARY ***
Total pot $0.05 | Rake $0
Seat 1: Jh0nTravolta (button) collected ($0.05)
Seat 2: Earco (small blind) folded before Flop
Seat 3: Special One4444 (big blind) folded before Flop
Seat 4: SidneyCrosby8 folded before Flop (didn't bet)
Seat 5: LAMUS_PL folded before Flop (didn't bet)
Seat 6: Morales7-PRO folded before Flop (didn't bet)


PokerStars Hand #238172461881:  Hold'em No Limit ($0.01/$0.02 USD) - 2022/08/23 15:04:10 ET
Table 'Equinox IV' 6-max Seat #2 is the button
Seat 1: Jh0nTravolta ($2.03 in chips)
Seat 2: Earco ($1.85 in chips)
Seat 3: Special One4444 ($1.98 in chips)
Seat 4: SidneyCrosby8 ($3.04 in chips)
Seat 5: LAMUS_PL ($6.67 in chips)
Seat 6: Morales7-PRO ($2.09 in chips)
Special One4444: posts small blind $0.01
SidneyCrosby8: posts big blind $0.02
*** HOLE CARDS ***
LAMUS_PL: folds
Morales7-PRO: folds
Jh0nTravolta: folds
Earco: folds
Special One4444: folds
Uncalled bet ($0.01) returned to SidneyCrosby8
SidneyCrosby8 collected $0.02 from pot
SidneyCrosby8: doesn't show hand
*** SUMMARY ***
Total pot $0.02 | Rake $0
Seat 1: Jh0nTravolta folded before Flop (didn't bet)
Seat 2: Earco (button) folded before Flop (didn't bet)
Seat 3: Special One4444 (small blind) folded before Flop
Seat 4: SidneyCrosby8 (big blind) collected ($0.02)
Seat 5: LAMUS_PL folded before Flop (didn't bet)
Seat 6: Morales7-PRO folded before Flop (didn't bet)


PokerStars Hand #238172470159:  Hold'em No Limit ($0.01/$0.02 USD) - 2022/08/23 15:04:33 ET
Table 'Equinox IV' 6-max Seat #3 is the button
Seat 1: Jh0nTravolta ($2.03 in chips)
Seat 2: Earco ($1.85 in chips)
Seat 3: Special One4444 ($1.99 in chips)
Seat 4: SidneyCrosby8 ($3.05 in chips)
Seat 5: LAMUS_PL ($6.67 in chips)
Seat 6: Morales7-PRO ($2.09 in chips)
SidneyCrosby8: posts small blind $0.01
LAMUS_PL: posts big blind $0.02
*** HOLE CARDS ***
Morales7-PRO: folds
Jh0nTravolta: raises $0.03 to $0.05
Earco: folds
Special One4444: folds
SidneyCrosby8: folds
LAMUS_PL: calls $0.03
*** FLOP *** [2s 7d 7c]
LAMUS_PL: checks
Jh0nTravolta: bets $0.04
LAMUS_PL: folds
Uncalled bet ($0.04) returned to Jh0nTravolta
Jh0nTravolta collected $0.11 from pot
Jh0nTravolta: doesn't show hand
*** SUMMARY ***
Total pot $0.11 | Rake $0
Board [2s 7d 7c]
Seat 1: Jh0nTravolta collected ($0.11)
Seat 2: Earco folded before Flop (didn't bet)
Seat 3: Special One4444 (button) folded before Flop (didn't bet)
Seat 4: SidneyCrosby8 (small blind) folded before Flop
Seat 5: LAMUS_PL (big blind) folded on the Flop
Seat 6: Morales7-PRO folded before Flop (didn't bet)


PokerStars Hand #238172478470:  Hold'em No Limit ($0.01/$0.02 USD) - 2022/08/23 15:04:56 ET
Table 'Equinox IV' 6-max Seat #4 is the button
Seat 1: Jh0nTravolta ($2.09 in chips)
Seat 2: Earco ($1.85 in chips)
Seat 3: Special One4444 ($1.99 in chips)
Seat 4: SidneyCrosby8 ($3.04 in chips)
Seat 5: LAMUS_PL ($6.62 in chips)
Seat 6: Morales7-PRO ($2.09 in chips)
LAMUS_PL: posts small blind $0.01
Morales7-PRO: posts big blind $0.02
*** HOLE CARDS ***
Jh0nTravolta: folds
Earco: folds
Special One4444: raises $0.04 to $0.06
SidneyCrosby8: folds
LAMUS_PL: folds
Morales7-PRO: folds
Uncalled bet ($0.04) returned to Special One4444
Special One4444 collected $0.05 from pot
*** SUMMARY ***
Total pot $0.05 | Rake $0
Seat 1: Jh0nTravolta folded before Flop (didn't bet)
Seat 2: Earco folded before Flop (didn't bet)
Seat 3: Special One4444 collected ($0.05)
Seat 4: SidneyCrosby8 (button) folded before Flop (didn't bet)
Seat 5: LAMUS_PL (small blind) folded before Flop
Seat 6: Morales7-PRO (big blind) folded before Flop


PokerStars Hand #238172488412:  Hold'em No Limit ($0.01/$0.02 USD) - 2022/08/23 15:05:22 ET
Table 'Equinox IV' 6-max Seat #5 is the button
Seat 1: Jh0nTravolta ($2.09 in chips)
Seat 2: Earco ($1.85 in chips)
Seat 3: Special One4444 ($2.02 in chips)
Seat 4: SidneyCrosby8 ($3.04 in chips)
Seat 5: LAMUS_PL ($6.61 in chips)
Seat 6: Morales7-PRO ($2.07 in chips)
Morales7-PRO: posts small blind $0.01
Jh0nTravolta: posts big blind $0.02
*** HOLE CARDS ***
Earco: folds
Special One4444: folds
SidneyCrosby8: folds
LAMUS_PL: raises $0.02 to $0.04
Morales7-PRO: raises $0.14 to $0.18
Jh0nTravolta: folds
LAMUS_PL: folds
Uncalled bet ($0.14) returned to Morales7-PRO
Morales7-PRO collected $0.10 from pot
Morales7-PRO: doesn't show hand
*** SUMMARY ***
Total pot $0.10 | Rake $0
Seat 1: Jh0nTravolta (big blind) folded before Flop
Seat 2: Earco folded before Flop (didn't bet)
Seat 3: Special One4444 folded before Flop (didn't bet)
Seat 4: SidneyCrosby8 folded before Flop (didn't bet)
Seat 5: LAMUS_PL (button) folded before Flop
Seat 6: Morales7-PRO (small blind) collected ($0.10)


PokerStars Hand #238172513004:  Hold'em No Limit ($0.01/$0.02 USD) - 2022/08/23 15:05:49 ET
Table 'Equinox IV' 6-max Seat #6 is the button
Seat 1: Jh0nTravolta ($2.07 in chips)
Seat 2: Earco ($1.85 in chips)
Seat 3: Special One4444 ($2.02 in chips)
Seat 4: SidneyCrosby8 ($3.04 in chips)
Seat 5: LAMUS_PL ($6.57 in chips)
Seat 6: Morales7-PRO ($2.13 in chips)
Jh0nTravolta: posts small blind $0.01
Earco: posts big blind $0.02
*** HOLE CARDS ***
Special One4444: folds
SidneyCrosby8: folds
LAMUS_PL: folds
Morales7-PRO: folds
Jh0nTravolta: raises $0.03 to $0.05
Earco: raises $0.10 to $0.15
Jh0nTravolta: folds
Uncalled bet ($0.10) returned to Earco
Earco collected $0.10 from pot
Earco: doesn't show hand
*** SUMMARY ***
Total pot $0.10 | Rake $0
Seat 1: Jh0nTravolta (small blind) folded before Flop
Seat 2: Earco (big blind) collected ($0.10)
Seat 3: Special One4444 folded before Flop (didn't bet)
Seat 4: SidneyCrosby8 folded before Flop (didn't bet)
Seat 5: LAMUS_PL folded before Flop (didn't bet)
Seat 6: Morales7-PRO (button) folded before Flop (didn't bet)


PokerStars Hand #238172524493:  Hold'em No Limit ($0.01/$0.02 USD) - 2022/08/23 15:06:19 ET
Table 'Equinox IV' 6-max Seat #1 is the button
Seat 1: Jh0nTravolta ($2.02 in chips)
Seat 2: Earco ($1.90 in chips)
Seat 3: Special One4444 ($2.02 in chips)
Seat 4: SidneyCrosby8 ($3.04 in chips)
Seat 5: LAMUS_PL ($6.57 in chips)
Seat 6: Morales7-PRO ($2.13 in chips)
Earco: posts small blind $0.01
Special One4444: posts big blind $0.02
*** HOLE CARDS ***
SidneyCrosby8: folds
LAMUS_PL: folds
Morales7-PRO: folds
Jh0nTravolta: raises $0.03 to $0.05
Earco: folds
Special One4444: folds
Uncalled bet ($0.03) returned to Jh0nTravolta
Jh0nTravolta collected $0.05 from pot
Jh0nTravolta: doesn't show hand
*** SUMMARY ***
Total pot $0.05 | Rake $0
Seat 1: Jh0nTravolta (button) collected ($0.05)
Seat 2: Earco (small blind) folded before Flop
Seat 3: Special One4444 (big blind) folded before Flop
Seat 4: SidneyCrosby8 folded before Flop (didn't bet)
Seat 5: LAMUS_PL folded before Flop (didn't bet)
Seat 6: Morales7-PRO folded before Flop (didn't bet)


PokerStars Hand #238172531135:  Hold'em No Limit ($0.01/$0.02 USD) - 2022/08/23 15:06:37 ET
Table 'Equinox IV' 6-max Seat #2 is the button
Seat 1: Jh0nTravolta ($2.05 in chips)
Seat 2: Earco ($1.89 in chips)
Seat 3: Special One4444 ($2 in chips)
Seat 4: SidneyCrosby8 ($3.04 in chips)
Seat 5: LAMUS_PL ($6.57 in chips)
Seat 6: Morales7-PRO ($2.13 in chips)
Special One4444: posts small blind $0.01
SidneyCrosby8: posts big blind $0.02
*** HOLE CARDS ***
LAMUS_PL: folds
Morales7-PRO: folds
Jh0nTravolta: folds
Earco: folds
Special One4444: raises $0.04 to $0.06
SidneyCrosby8: raises $0.14 to $0.20
Special One4444: folds
Uncalled bet ($0.14) returned to SidneyCrosby8
SidneyCrosby8 collected $0.12 from pot
SidneyCrosby8: doesn't show hand
*** SUMMARY ***
Total pot $0.12 | Rake $0
Seat 1: Jh0nTravolta folded before Flop (didn't bet)
Seat 2: Earco (button) folded before Flop (didn't bet)
Seat 3: Special One4444 (small blind) folded before Flop
Seat 4: SidneyCrosby8 (big blind) collected ($0.12)
Seat 5: LAMUS_PL folded before Flop (didn't bet)
Seat 6: Morales7-PRO folded before Flop (didn't bet)


PokerStars Hand #238172537924:  Hold'em No Limit ($0.01/$0.02 USD) - 2022/08/23 15:06:55 ET
Table 'Equinox IV' 6-max Seat #3 is the button
Seat 1: Jh0nTravolta ($2.05 in chips)
Seat 2: Earco ($1.89 in chips)
Seat 3: Special One4444 ($1.94 in chips)
Seat 4: SidneyCrosby8 ($3.10 in chips)
Seat 5: LAMUS_PL ($6.57 in chips)
Seat 6: Morales7-PRO ($2.13 in chips)
SidneyCrosby8: posts small blind $0.01
LAMUS_PL: posts big blind $0.02
*** HOLE CARDS ***
Morales7-PRO: folds
Jh0nTravolta: raises $0.03 to $0.05
Earco: folds
Special One4444: folds
SidneyCrosby8: folds
LAMUS_PL: calls $0.03
*** FLOP *** [4h Ts Th]
LAMUS_PL: checks
Jh0nTravolta: bets $0.04
LAMUS_PL: folds
Uncalled bet ($0.04) returned to Jh0nTravolta
Jh0nTravolta collected $0.11 from pot
Jh0nTravolta: doesn't show hand
*** SUMMARY ***
Total pot $0.11 | Rake $0
Board [4h Ts Th]
Seat 1: Jh0nTravolta collected ($0.11)
Seat 2: Earco folded before Flop (didn't bet)
Seat 3: Special One4444 (button) folded before Flop (didn't bet)
Seat 4: SidneyCrosby8 (small blind) folded before Flop
Seat 5: LAMUS_PL (big blind) folded on the Flop
Seat 6: Morales7-PRO folded before Flop (didn't bet)


PokerStars Hand #238172548224:  Hold'em No Limit ($0.01/$0.02 USD) - 2022/08/23 15:07:23 ET
Table 'Equinox IV' 6-max Seat #4 is the button
Seat 1: Jh0nTravolta ($2.11 in chips)
Seat 2: Earco ($1.89 in chips)
Seat 3: Special One4444 ($1.94 in chips)
Seat 4: SidneyCrosby8 ($3.09 in chips)
Seat 5: LAMUS_PL ($6.52 in chips)
Seat 6: Morales7-PRO ($2.13 in chips)
LAMUS_PL: posts small blind $0.01
Morales7-PRO: posts big blind $0.02
*** HOLE CARDS ***
Jh0nTravolta: folds
Earco: folds
Special One4444: folds
SidneyCrosby8: folds
LAMUS_PL: raises $0.04 to $0.06
Morales7-PRO: calls $0.04
*** FLOP *** [2c 5d 3s]
LAMUS_PL: bets $0.08
Morales7-PRO: calls $0.08
*** TURN *** [2c 5d 3s] [7s]
LAMUS_PL: bets $0.24
Morales7-PRO: raises $0.50 to $0.74
LAMUS_PL: calls $0.50
*** RIVER *** [2c 5d 3s 7s] [2s]
LAMUS_PL: checks
Morales7-PRO: bets $1.25 and is all-in
LAMUS_PL: calls $1.25
*** SHOW DOWN ***
Morales7-PRO: shows [4c Ah] (a straight, Ace to Five)
LAMUS_PL: shows [Tc Th] (two pair, Tens and Deuces)
Morales7-PRO collected $4.11 from pot
*** SUMMARY ***
Total pot $4.26 | Rake $0.15
Board [2c 5d 3s 7s 2s]
Seat 1: Jh0nTravolta folded before Flop (didn't bet)
Seat 2: Earco folded before Flop (didn't bet)
Seat 3: Special One4444 folded before Flop (didn't bet)
Seat 4: SidneyCrosby8 (button) folded before Flop (didn't bet)
Seat 5: LAMUS_PL (small blind) showed [Tc Th] and lost with two pair, Tens and Deuces
Seat 6: Morales7-PRO (big blind) showed [4c Ah] and won ($4.11) with a straight, Ace to Five


PokerStars Hand #238172573929:  Hold'em No Limit ($0.01/$0.02 USD) - 2022/08/23 15:08:31 ET
Table 'Equinox IV' 6-max Seat #5 is the button
Seat 1: Jh0nTravolta ($2.11 in chips)
Seat 2: Earco ($1.89 in chips)
Seat 3: Special One4444 ($1.94 in chips)
Seat 4: SidneyCrosby8 ($3.09 in chips)
Seat 5: LAMUS_PL ($4.39 in chips)
Seat 6: Morales7-PRO ($4.11 in chips)
Morales7-PRO: posts small blind $0.01
Jh0nTravolta: posts big blind $0.02
*** HOLE CARDS ***
Earco: raises $0.04 to $0.06
Special One4444: folds
SidneyCrosby8: folds
LAMUS_PL: folds
Morales7-PRO: folds
Jh0nTravolta: folds
Uncalled bet ($0.04) returned to Earco
Earco collected $0.05 from pot
Earco: doesn't show hand
*** SUMMARY ***
Total pot $0.05 | Rake $0
Seat 1: Jh0nTravolta (big blind) folded before Flop
Seat 2: Earco collected ($0.05)
Seat 3: Special One4444 folded before Flop (didn't bet)
Seat 4: SidneyCrosby8 folded before Flop (didn't bet)
Seat 5: LAMUS_PL (button) folded before Flop (didn't bet)
Seat 6: Morales7-PRO (small blind) folded before Flop


PokerStars Hand #238172580287:  Hold'em No Limit ($0.01/$0.02 USD) - 2022/08/23 15:08:48 ET
Table 'Equinox IV' 6-max Seat #6 is the button
Seat 1: Jh0nTravolta ($2.09 in chips)
Seat 3: Special One4444 ($1.94 in chips)
Seat 4: SidneyCrosby8 ($3.09 in chips)
Seat 5: LAMUS_PL ($4.39 in chips)
Seat 6: Morales7-PRO ($4.10 in chips)
Jh0nTravolta: posts small blind $0.01
Earco: is sitting out
Special One4444: posts big blind $0.02
*** HOLE CARDS ***
SidneyCrosby8: folds
Earco leaves the table
LAMUS_PL: folds
Morales7-PRO: raises $0.03 to $0.05
Jh0nTravolta: folds
Special One4444: folds
Uncalled bet ($0.03) returned to Morales7-PRO
Morales7-PRO collected $0.05 from pot
Morales7-PRO: doesn't show hand
*** SUMMARY ***
Total pot $0.05 | Rake $0
Seat 1: Jh0nTravolta (small blind) folded before Flop
Seat 3: Special One4444 (big blind) folded before Flop
Seat 4: SidneyCrosby8 folded before Flop (didn't bet)
Seat 5: LAMUS_PL folded before Flop (didn't bet)
Seat 6: Morales7-PRO (button) collected ($0.05)


PokerStars Hand #238172585524:  Hold'em No Limit ($0.01/$0.02 USD) - 2022/08/23 15:09:02 ET
Table 'Equinox IV' 6-max Seat #1 is the button
Seat 1: Jh0nTravolta ($2.08 in chips)
Seat 3: Special One4444 ($1.92 in chips)
Seat 4: SidneyCrosby8 ($3.09 in chips)
Seat 5: LAMUS_PL ($4.39 in chips)
Seat 6: Morales7-PRO ($4.13 in chips)
Special One4444: posts small blind $0.01
SidneyCrosby8: posts big blind $0.02
*** HOLE CARDS ***
karl8282 joins the table at seat #2
LAMUS_PL: folds
Morales7-PRO: folds
Jh0nTravolta: raises $0.03 to $0.05
Special One4444: folds
SidneyCrosby8: calls $0.03
*** FLOP *** [5c Th Ts]
SidneyCrosby8: checks
Jh0nTravolta: bets $0.04
SidneyCrosby8: calls $0.04
*** TURN *** [5c Th Ts] [2c]
SidneyCrosby8: checks
Jh0nTravolta: checks
*** RIVER *** [5c Th Ts 2c] [8c]
SidneyCrosby8: bets $0.08
Jh0nTravolta: folds
Uncalled bet ($0.08) returned to SidneyCrosby8
SidneyCrosby8 collected $0.18 from pot
SidneyCrosby8: doesn't show hand
*** SUMMARY ***
Total pot $0.19 | Rake $0.01
Board [5c Th Ts 2c 8c]
Seat 1: Jh0nTravolta (button) folded on the River
Seat 3: Special One4444 (small blind) folded before Flop
Seat 4: SidneyCrosby8 (big blind) collected ($0.18)
Seat 5: LAMUS_PL folded before Flop (didn't bet)
Seat 6: Morales7-PRO folded before Flop (didn't bet)


PokerStars Hand #238172608814:  Hold'em No Limit ($0.01/$0.02 USD) - 2022/08/23 15:10:04 ET
Table 'Equinox IV' 6-max Seat #3 is the button
Seat 1: Jh0nTravolta ($2 in chips)
Seat 2: karl8282 ($1.60 in chips)
Seat 3: Special One4444 ($1.91 in chips)
Seat 4: SidneyCrosby8 ($3.18 in chips)
Seat 5: LAMUS_PL ($4.39 in chips)
Seat 6: Morales7-PRO ($4.13 in chips)
SidneyCrosby8: posts small blind $0.01
LAMUS_PL: posts big blind $0.02
karl8282: posts big blind $0.02
*** HOLE CARDS ***
Morales7-PRO: raises $0.08 to $0.10
Jh0nTravolta: folds
karl8282: calls $0.08
Special One4444: folds
SidneyCrosby8: folds
LAMUS_PL: folds
*** FLOP *** [2h 9h 3c]
Morales7-PRO: bets $0.07
karl8282: calls $0.07
*** TURN *** [2h 9h 3c] [4c]
Morales7-PRO: checks
karl8282: bets $1.43 and is all-in
Morales7-PRO: folds
Uncalled bet ($1.43) returned to karl8282
karl8282 collected $0.36 from pot
*** SUMMARY ***
Total pot $0.37 | Rake $0.01
Board [2h 9h 3c 4c]
Seat 1: Jh0nTravolta folded before Flop (didn't bet)
Seat 2: karl8282 collected ($0.36)
Seat 3: Special One4444 (button) folded before Flop (didn't bet)
Seat 4: SidneyCrosby8 (small blind) folded before Flop
Seat 5: LAMUS_PL (big blind) folded before Flop
Seat 6: Morales7-PRO folded on the Turn


PokerStars Hand #238172622219:  Hold'em No Limit ($0.01/$0.02 USD) - 2022/08/23 15:10:40 ET
Table 'Equinox IV' 6-max Seat #4 is the button
Seat 1: Jh0nTravolta ($2 in chips)
Seat 2: karl8282 ($1.79 in chips)
Seat 3: Special One4444 ($1.91 in chips)
Seat 4: SidneyCrosby8 ($3.17 in chips)
Seat 5: LAMUS_PL ($4.37 in chips)
Seat 6: Morales7-PRO ($3.96 in chips)
LAMUS_PL: posts small blind $0.01
Morales7-PRO: posts big blind $0.02
*** HOLE CARDS ***
Jh0nTravolta: folds
karl8282: folds
Special One4444: folds
SidneyCrosby8: raises $0.04 to $0.06
LAMUS_PL: raises $0.16 to $0.22
Morales7-PRO: folds
SidneyCrosby8: folds
Uncalled bet ($0.16) returned to LAMUS_PL
LAMUS_PL collected $0.14 from pot
LAMUS_PL: doesn't show hand
*** SUMMARY ***
Total pot $0.14 | Rake $0
Seat 1: Jh0nTravolta folded before Flop (didn't bet)
Seat 2: karl8282 folded before Flop (didn't bet)
Seat 3: Special One4444 folded before Flop (didn't bet)
Seat 4: SidneyCrosby8 (button) folded before Flop
Seat 5: LAMUS_PL (small blind) collected ($0.14)
Seat 6: Morales7-PRO (big blind) folded before Flop


PokerStars Hand #238172631505:  Hold'em No Limit ($0.01/$0.02 USD) - 2022/08/23 15:11:04 ET
Table 'Equinox IV' 6-max Seat #5 is the button
Seat 1: Jh0nTravolta ($2 in chips)
Seat 2: karl8282 ($1.79 in chips)
Seat 3: Special One4444 ($1.91 in chips)
Seat 4: SidneyCrosby8 ($3.11 in chips)
Seat 5: LAMUS_PL ($4.45 in chips)
Seat 6: Morales7-PRO ($3.94 in chips)
Morales7-PRO: posts small blind $0.01
Jh0nTravolta: posts big blind $0.02
*** HOLE CARDS ***
karl8282: calls $0.02
Special One4444: folds
SidneyCrosby8: folds
LAMUS_PL: folds
Morales7-PRO: raises $0.08 to $0.10
Jh0nTravolta: folds
karl8282: calls $0.08
*** FLOP *** [3d 6c 5c]
Morales7-PRO: checks
karl8282: bets $0.12
Morales7-PRO: calls $0.12
*** TURN *** [3d 6c 5c] [2d]
Morales7-PRO: checks
karl8282: bets $0.44
Morales7-PRO: folds
Uncalled bet ($0.44) returned to karl8282
karl8282 collected $0.44 from pot
*** SUMMARY ***
Total pot $0.46 | Rake $0.02
Board [3d 6c 5c 2d]
Seat 1: Jh0nTravolta (big blind) folded before Flop
Seat 2: karl8282 collected ($0.44)
Seat 3: Special One4444 folded before Flop (didn't bet)
Seat 4: SidneyCrosby8 folded before Flop (didn't bet)
Seat 5: LAMUS_PL (button) folded before Flop (didn't bet)
Seat 6: Morales7-PRO (small blind) folded on the Turn


PokerStars Hand #238172652907:  Hold'em No Limit ($0.01/$0.02 USD) - 2022/08/23 15:12:00 ET
Table 'Equinox IV' 6-max Seat #6 is the button
Seat 1: Jh0nTravolta ($2 in chips)
Seat 2: karl8282 ($2.01 in chips)
Seat 3: Special One4444 ($1.91 in chips)
Seat 4: SidneyCrosby8 ($3.11 in chips)
Seat 5: LAMUS_PL ($4.45 in chips)
Seat 6: Morales7-PRO ($3.72 in chips)
Jh0nTravolta: posts small blind $0.01
karl8282: posts big blind $0.02
*** HOLE CARDS ***
Special One4444: folds
SidneyCrosby8: folds
LAMUS_PL: raises $0.03 to $0.05
Morales7-PRO: folds
Jh0nTravolta: folds
karl8282: folds
Uncalled bet ($0.03) returned to LAMUS_PL
LAMUS_PL collected $0.05 from pot
LAMUS_PL: doesn't show hand
*** SUMMARY ***
Total pot $0.05 | Rake $0
Seat 1: Jh0nTravolta (small blind) folded before Flop
Seat 2: karl8282 (big blind) folded before Flop
Seat 3: Special One4444 folded before Flop (didn't bet)
Seat 4: SidneyCrosby8 folded before Flop (didn't bet)
Seat 5: LAMUS_PL collected ($0.05)
Seat 6: Morales7-PRO (button) folded before Flop (didn't bet)


PokerStars Hand #238172665665:  Hold'em No Limit ($0.01/$0.02 USD) - 2022/08/23 15:12:34 ET
Table 'Equinox IV' 6-max Seat #1 is the button
Seat 1: Jh0nTravolta ($2 in chips)
Seat 2: karl8282 ($1.99 in chips)
Seat 3: Special One4444 ($1.91 in chips)
Seat 5: LAMUS_PL ($4.48 in chips)
Seat 6: Morales7-PRO ($3.72 in chips)
karl8282: posts small blind $0.01
Special One4444: posts big blind $0.02
*** HOLE CARDS ***
LAMUS_PL: folds
Morales7-PRO: folds
Jh0nTravolta: raises $0.03 to $0.05
karl8282: folds
Special One4444: calls $0.03
*** FLOP *** [3s 6c 6d]
Special One4444: checks
Jh0nTravolta: bets $0.04
Special One4444: calls $0.04
*** TURN *** [3s 6c 6d] [Ah]
Special One4444: bets $0.06
Jh0nTravolta: calls $0.06
*** RIVER *** [3s 6c 6d Ah] [Kh]
Special One4444: bets $0.30
Jh0nTravolta: calls $0.30
*** SHOW DOWN ***
Special One4444: shows [3d Ad] (two pair, Aces and Sixes)
Jh0nTravolta: shows [7s As] (two pair, Aces and Sixes)
Special One4444 collected $0.44 from pot
Jh0nTravolta collected $0.44 from pot
*** SUMMARY ***
Total pot $0.91 | Rake $0.03
Board [3s 6c 6d Ah Kh]
Seat 1: Jh0nTravolta (button) showed [7s As] and won ($0.44) with two pair, Aces and Sixes
Seat 2: karl8282 (small blind) folded before Flop
Seat 3: Special One4444 (big blind) showed [3d Ad] and won ($0.44) with two pair, Aces and Sixes
Seat 5: LAMUS_PL folded before Flop (didn't bet)
Seat 6: Morales7-PRO folded before Flop (didn't bet)


PokerStars Hand #238172730581:  Hold'em No Limit ($0.01/$0.02 USD) - 2022/08/23 15:15:24 ET
Table 'Equinox IV' 6-max Seat #3 is the button
Seat 1: Jh0nTravolta ($2.50 in chips)
Seat 2: karl8282 ($1.98 in chips)
Seat 3: Special One4444 ($1.89 in chips)
Seat 4: SidneyCrosby8 ($3.09 in chips)
Seat 5: LAMUS_PL ($4.48 in chips)
Seat 6: Morales7-PRO ($3.21 in chips)
SidneyCrosby8: posts small blind $0.01
LAMUS_PL: posts big blind $0.02
*** HOLE CARDS ***
Morales7-PRO: folds
Jh0nTravolta: folds
karl8282: folds
Special One4444: folds
SidneyCrosby8: folds
Uncalled bet ($0.01) returned to LAMUS_PL
LAMUS_PL collected $0.02 from pot
LAMUS_PL: doesn't show hand
*** SUMMARY ***
Total pot $0.02 | Rake $0
Seat 1: Jh0nTravolta folded before Flop (didn't bet)
Seat 2: karl8282 folded before Flop (didn't bet)
Seat 3: Special One4444 (button) folded before Flop (didn't bet)
Seat 4: SidneyCrosby8 (small blind) folded before Flop
Seat 5: LAMUS_PL (big blind) collected ($0.02)
Seat 6: Morales7-PRO folded before Flop (didn't bet)


PokerStars Hand #238172701330:  Hold'em No Limit ($0.01/$0.02 USD) - 2022/08/23 15:14:08 ET
Table 'Equinox IV' 6-max Seat #2 is the button
Seat 1: Jh0nTravolta ($2 in chips)
Seat 2: karl8282 ($1.98 in chips)
Seat 3: Special One4444 ($1.90 in chips)
Seat 4: SidneyCrosby8 ($3.11 in chips)
Seat 5: LAMUS_PL ($4.48 in chips)
Seat 6: Morales7-PRO ($3.72 in chips)
Special One4444: posts small blind $0.01
SidneyCrosby8: posts big blind $0.02
*** HOLE CARDS ***
LAMUS_PL: folds
Morales7-PRO: raises $0.04 to $0.06
Jh0nTravolta: raises $0.12 to $0.18
karl8282: folds
Special One4444: folds
SidneyCrosby8: folds
Morales7-PRO: calls $0.12
*** FLOP *** [7c Ts Jh]
Morales7-PRO: checks
Jh0nTravolta: bets $0.13
Morales7-PRO: calls $0.13
*** TURN *** [7c Ts Jh] [Js]
Morales7-PRO: checks
Jh0nTravolta: bets $0.20
Morales7-PRO: calls $0.20
*** RIVER *** [7c Ts Jh Js] [Tc]
Morales7-PRO: checks
Jh0nTravolta: bets $0.67
Morales7-PRO: folds
Uncalled bet ($0.67) returned to Jh0nTravolta
Jh0nTravolta collected $1.01 from pot
Jh0nTravolta: doesn't show hand
*** SUMMARY ***
Total pot $1.05 | Rake $0.04
Board [7c Ts Jh Js Tc]
Seat 1: Jh0nTravolta collected ($1.01)
Seat 2: karl8282 (button) folded before Flop (didn't bet)
Seat 3: Special One4444 (small blind) folded before Flop
Seat 4: SidneyCrosby8 (big blind) folded before Flop
Seat 5: LAMUS_PL folded before Flop (didn't bet)
Seat 6: Morales7-PRO folded on the River


PokerStars Hand #238172733393:  Hold'em No Limit ($0.01/$0.02 USD) - 2022/08/23 15:15:31 ET
Table 'Equinox IV' 6-max Seat #4 is the button
Seat 1: Jh0nTravolta ($2.50 in chips)
Seat 2: karl8282 ($1.98 in chips)
Seat 3: Special One4444 ($1.89 in chips)
Seat 4: SidneyCrosby8 ($3.08 in chips)
Seat 5: LAMUS_PL ($4.49 in chips)
Seat 6: Morales7-PRO ($3.21 in chips)
LAMUS_PL: posts small blind $0.01
Morales7-PRO: posts big blind $0.02
*** HOLE CARDS ***
Jh0nTravolta: folds
karl8282: raises $0.04 to $0.06
Special One4444: folds
SidneyCrosby8: folds
LAMUS_PL: raises $0.16 to $0.22
Morales7-PRO: folds
karl8282: raises $0.48 to $0.70
LAMUS_PL: folds
Uncalled bet ($0.48) returned to karl8282
karl8282 collected $0.46 from pot
*** SUMMARY ***
Total pot $0.46 | Rake $0
Seat 1: Jh0nTravolta folded before Flop (didn't bet)
Seat 2: karl8282 collected ($0.46)
Seat 3: Special One4444 folded before Flop (didn't bet)
Seat 4: SidneyCrosby8 (button) folded before Flop (didn't bet)
Seat 5: LAMUS_PL (small blind) folded before Flop
Seat 6: Morales7-PRO (big blind) folded before Flop


PokerStars Hand #238172751249:  Hold'em No Limit ($0.01/$0.02 USD) - 2022/08/23 15:16:18 ET
Table 'Equinox IV' 6-max Seat #5 is the button
Seat 1: Jh0nTravolta ($2.50 in chips)
Seat 2: karl8282 ($2.22 in chips)
Seat 3: Special One4444 ($1.89 in chips)
Seat 4: SidneyCrosby8 ($3.08 in chips)
Seat 5: LAMUS_PL ($4.27 in chips)
Seat 6: Morales7-PRO ($3.19 in chips)
Morales7-PRO: posts small blind $0.01
Jh0nTravolta: posts big blind $0.02
*** HOLE CARDS ***
karl8282: folds
Special One4444: folds
SidneyCrosby8: raises $0.04 to $0.06
LAMUS_PL: calls $0.06
Morales7-PRO: raises $0.18 to $0.24
Jh0nTravolta: folds
SidneyCrosby8: folds
LAMUS_PL: calls $0.18
*** FLOP *** [8s 5d 9h]
Morales7-PRO: bets $0.17
LAMUS_PL: calls $0.17
*** TURN *** [8s 5d 9h] [3h]
Morales7-PRO: checks
LAMUS_PL: checks
*** RIVER *** [8s 5d 9h 3h] [As]
Morales7-PRO: checks
LAMUS_PL: checks
*** SHOW DOWN ***
Morales7-PRO: shows [Ah Jc] (a pair of Aces)
LAMUS_PL: mucks hand
Morales7-PRO collected $0.87 from pot
*** SUMMARY ***
Total pot $0.90 | Rake $0.03
Board [8s 5d 9h 3h As]
Seat 1: Jh0nTravolta (big blind) folded before Flop
Seat 2: karl8282 folded before Flop (didn't bet)
Seat 3: Special One4444 folded before Flop (didn't bet)
Seat 4: SidneyCrosby8 folded before Flop
Seat 5: LAMUS_PL (button) mucked
Seat 6: Morales7-PRO (small blind) showed [Ah Jc] and won ($0.87) with a pair of Aces


PokerStars Hand #238172779784:  Hold'em No Limit ($0.01/$0.02 USD) - 2022/08/23 15:17:33 ET
Table 'Equinox IV' 6-max Seat #6 is the button
Seat 1: Jh0nTravolta ($2.48 in chips)
Seat 2: karl8282 ($2.22 in chips)
Seat 3: Special One4444 ($1.89 in chips)
Seat 4: SidneyCrosby8 ($3.02 in chips)
Seat 5: LAMUS_PL ($3.86 in chips)
Seat 6: Morales7-PRO ($3.65 in chips)
Jh0nTravolta: posts small blind $0.01
karl8282: posts big blind $0.02
*** HOLE CARDS ***
Special One4444: folds
SidneyCrosby8: folds
LAMUS_PL: raises $0.03 to $0.05
Morales7-PRO: raises $0.11 to $0.16
Jh0nTravolta: folds
karl8282: folds
LAMUS_PL: folds
Uncalled bet ($0.11) returned to Morales7-PRO
Morales7-PRO collected $0.13 from pot
Morales7-PRO: doesn't show hand
*** SUMMARY ***
Total pot $0.13 | Rake $0
Seat 1: Jh0nTravolta (small blind) folded before Flop
Seat 2: karl8282 (big blind) folded before Flop
Seat 3: Special One4444 folded before Flop (didn't bet)
Seat 4: SidneyCrosby8 folded before Flop (didn't bet)
Seat 5: LAMUS_PL folded before Flop
Seat 6: Morales7-PRO (button) collected ($0.13)


PokerStars Hand #238172789644:  Hold'em No Limit ($0.01/$0.02 USD) - 2022/08/23 15:17:58 ET
Table 'Equinox IV' 6-max Seat #1 is the button
Seat 1: Jh0nTravolta ($2.47 in chips)
Seat 2: karl8282 ($2.20 in chips)
Seat 3: Special One4444 ($1.89 in chips)
Seat 4: SidneyCrosby8 ($3.02 in chips)
Seat 5: LAMUS_PL ($3.81 in chips)
Seat 6: Morales7-PRO ($3.73 in chips)
karl8282: posts small blind $0.01
Special One4444: posts big blind $0.02
*** HOLE CARDS ***
SidneyCrosby8: folds
LAMUS_PL: raises $0.04 to $0.06
Morales7-PRO: folds
Jh0nTravolta: raises $0.12 to $0.18
karl8282: folds
Special One4444: folds
LAMUS_PL: calls $0.12
*** FLOP *** [4c Qd 5c]
LAMUS_PL: checks
Jh0nTravolta: bets $0.13
LAMUS_PL: calls $0.13
*** TURN *** [4c Qd 5c] [Kd]
LAMUS_PL: checks
Jh0nTravolta: checks
*** RIVER *** [4c Qd 5c Kd] [7s]
LAMUS_PL: checks
Jh0nTravolta: bets $0.42
LAMUS_PL: folds
Uncalled bet ($0.42) returned to Jh0nTravolta
Jh0nTravolta collected $0.63 from pot
Jh0nTravolta: doesn't show hand
*** SUMMARY ***
Total pot $0.65 | Rake $0.02
Board [4c Qd 5c Kd 7s]
Seat 1: Jh0nTravolta (button) collected ($0.63)
Seat 2: karl8282 (small blind) folded before Flop
Seat 3: Special One4444 (big blind) folded before Flop
Seat 4: SidneyCrosby8 folded before Flop (didn't bet)
Seat 5: LAMUS_PL folded on the River
Seat 6: Morales7-PRO folded before Flop (didn't bet)


PokerStars Hand #238172822153:  Hold'em No Limit ($0.01/$0.02 USD) - 2022/08/23 15:19:23 ET
Table 'Equinox IV' 6-max Seat #2 is the button
Seat 1: Jh0nTravolta ($2.79 in chips)
Seat 2: karl8282 ($2.19 in chips)
Seat 3: Special One4444 ($1.87 in chips)
Seat 4: SidneyCrosby8 ($3.02 in chips)
Seat 5: LAMUS_PL ($3.50 in chips)
Seat 6: Morales7-PRO ($3.73 in chips)
Special One4444: posts small blind $0.01
SidneyCrosby8: posts big blind $0.02
*** HOLE CARDS ***
LAMUS_PL: raises $0.04 to $0.06
Morales7-PRO: folds
Jh0nTravolta: raises $0.12 to $0.18
karl8282: folds
Special One4444: folds
SidneyCrosby8: folds
LAMUS_PL: calls $0.12
*** FLOP *** [7c 6c 3c]
LAMUS_PL: checks
Jh0nTravolta: bets $0.13
LAMUS_PL: raises $0.21 to $0.34
Jh0nTravolta: calls $0.21
*** TURN *** [7c 6c 3c] [9s]
LAMUS_PL: checks
Jh0nTravolta: bets $0.34
LAMUS_PL: calls $0.34
*** RIVER *** [7c 6c 3c 9s] [9h]
LAMUS_PL: checks
Jh0nTravolta: bets $1.93 and is all-in
LAMUS_PL: folds
Uncalled bet ($1.93) returned to Jh0nTravolta
Jh0nTravolta collected $1.69 from pot
Jh0nTravolta: doesn't show hand
*** SUMMARY ***
Total pot $1.75 | Rake $0.06
Board [7c 6c 3c 9s 9h]
Seat 1: Jh0nTravolta collected ($1.69)
Seat 2: karl8282 (button) folded before Flop (didn't bet)
Seat 3: Special One4444 (small blind) folded before Flop
Seat 4: SidneyCrosby8 (big blind) folded before Flop
Seat 5: LAMUS_PL folded on the River
Seat 6: Morales7-PRO folded before Flop (didn't bet)


PokerStars Hand #238172859038:  Hold'em No Limit ($0.01/$0.02 USD) - 2022/08/23 15:20:59 ET
Table 'Equinox IV' 6-max Seat #3 is the button
Seat 1: Jh0nTravolta ($3.62 in chips)
Seat 2: karl8282 ($2.19 in chips)
Seat 3: Special One4444 ($1.86 in chips)
Seat 4: SidneyCrosby8 ($3 in chips)
Seat 6: Morales7-PRO ($3.73 in chips)
SidneyCrosby8: posts small blind $0.01
LAMUS_PL: is sitting out
LAMUS_PL leaves the table
Morales7-PRO: posts big blind $0.02
*** HOLE CARDS ***
Jh0nTravolta: folds
karl8282: calls $0.02
Special One4444: folds
SidneyCrosby8: folds
Morales7-PRO: raises $0.08 to $0.10
karl8282: calls $0.08
*** FLOP *** [Js 5h 2h]
Morales7-PRO: bets $0.15
karl8282: folds
Uncalled bet ($0.15) returned to Morales7-PRO
Morales7-PRO collected $0.20 from pot
Morales7-PRO: doesn't show hand
*** SUMMARY ***
Total pot $0.21 | Rake $0.01
Board [Js 5h 2h]
Seat 1: Jh0nTravolta folded before Flop (didn't bet)
Seat 2: karl8282 folded on the Flop
Seat 3: Special One4444 (button) folded before Flop (didn't bet)
Seat 4: SidneyCrosby8 (small blind) folded before Flop
Seat 6: Morales7-PRO (big blind) collected ($0.20)


PokerStars Hand #238172870490:  Hold'em No Limit ($0.01/$0.02 USD) - 2022/08/23 15:21:29 ET
Table 'Equinox IV' 6-max Seat #4 is the button
Seat 1: Jh0nTravolta ($3.62 in chips)
Seat 2: karl8282 ($2.09 in chips)
Seat 3: Special One4444 ($1.86 in chips)
Seat 4: SidneyCrosby8 ($2.99 in chips)
Seat 6: Morales7-PRO ($3.83 in chips)
Morales7-PRO: posts small blind $0.01
Jh0nTravolta: posts big blind $0.02
*** HOLE CARDS ***
Phantomasz1 joins the table at seat #5
karl8282: raises $0.02 to $0.04
Special One4444: folds
SidneyCrosby8: folds
Morales7-PRO: folds
Jh0nTravolta: folds
Uncalled bet ($0.02) returned to karl8282
karl8282 collected $0.05 from pot
*** SUMMARY ***
Total pot $0.05 | Rake $0
Seat 1: Jh0nTravolta (big blind) folded before Flop
Seat 2: karl8282 collected ($0.05)
Seat 3: Special One4444 folded before Flop (didn't bet)
Seat 4: SidneyCrosby8 (button) folded before Flop (didn't bet)
Seat 6: Morales7-PRO (small blind) folded before Flop


PokerStars Hand #238172874843:  Hold'em No Limit ($0.01/$0.02 USD) - 2022/08/23 15:21:40 ET
Table 'Equinox IV' 6-max Seat #6 is the button
Seat 1: Jh0nTravolta ($3.60 in chips)
Seat 2: karl8282 ($2.12 in chips)
Seat 3: Special One4444 ($1.86 in chips)
Seat 4: SidneyCrosby8 ($2.99 in chips)
Seat 6: Morales7-PRO ($3.82 in chips)
Jh0nTravolta: posts small blind $0.01
karl8282: posts big blind $0.02
Phantomasz1: sits out
*** HOLE CARDS ***
Special One4444: raises $0.04 to $0.06
SidneyCrosby8: folds
Morales7-PRO: folds
Jh0nTravolta: folds
karl8282: calls $0.04
*** FLOP *** [As 5h Js]
karl8282: checks
Special One4444: bets $0.10
karl8282: calls $0.10
*** TURN *** [As 5h Js] [8s]
karl8282: checks
Special One4444: checks
*** RIVER *** [As 5h Js 8s] [Kd]
karl8282: bets $0.18
Special One4444: calls $0.18
*** SHOW DOWN ***
karl8282: shows [7d 7h] (a pair of Sevens)
Special One4444: shows [Kc Qh] (a pair of Kings)
Special One4444 collected $0.67 from pot
*** SUMMARY ***
Total pot $0.69 | Rake $0.02
Board [As 5h Js 8s Kd]
Seat 1: Jh0nTravolta (small blind) folded before Flop
Seat 2: karl8282 (big blind) showed [7d 7h] and lost with a pair of Sevens
Seat 3: Special One4444 showed [Kc Qh] and won ($0.67) with a pair of Kings
Seat 4: SidneyCrosby8 folded before Flop (didn't bet)
Seat 6: Morales7-PRO (button) folded before Flop (didn't bet)


PokerStars Hand #238172887026:  Hold'em No Limit ($0.01/$0.02 USD) - 2022/08/23 15:22:12 ET
Table 'Equinox IV' 6-max Seat #1 is the button
Seat 1: Jh0nTravolta ($3.59 in chips)
Seat 2: karl8282 ($1.78 in chips)
Seat 3: Special One4444 ($2.19 in chips)
Seat 4: SidneyCrosby8 ($2.99 in chips)
Seat 6: Morales7-PRO ($3.82 in chips)
karl8282: posts small blind $0.01
Special One4444: posts big blind $0.02
Phantomasz1: sits out
*** HOLE CARDS ***
SidneyCrosby8: folds
Morales7-PRO: folds
Jh0nTravolta: raises $0.03 to $0.05
karl8282: folds
Special One4444: calls $0.03
*** FLOP *** [5h 7s 3d]
Special One4444: checks
Jh0nTravolta: bets $0.04
Special One4444: calls $0.04
*** TURN *** [5h 7s 3d] [Kd]
Special One4444: checks
Jh0nTravolta: checks
*** RIVER *** [5h 7s 3d Kd] [Qh]
Special One4444: bets $0.12
Jh0nTravolta: folds
Uncalled bet ($0.12) returned to Special One4444
Special One4444 collected $0.18 from pot
karl8282 is disconnected
*** SUMMARY ***
Total pot $0.19 | Rake $0.01
Board [5h 7s 3d Kd Qh]
Seat 1: Jh0nTravolta (button) folded on the River
Seat 2: karl8282 (small blind) folded before Flop
Seat 3: Special One4444 (big blind) collected ($0.18)
Seat 4: SidneyCrosby8 folded before Flop (didn't bet)
Seat 6: Morales7-PRO folded before Flop (didn't bet)


PokerStars Hand #238172902674:  Hold'em No Limit ($0.01/$0.02 USD) - 2022/08/23 15:22:53 ET
Table 'Equinox IV' 6-max Seat #2 is the button
Seat 1: Jh0nTravolta ($3.50 in chips)
Seat 2: karl8282 ($1.77 in chips)
Seat 3: Special One4444 ($2.28 in chips)
Seat 4: SidneyCrosby8 ($2.99 in chips)
Seat 6: Morales7-PRO ($3.82 in chips)
Special One4444: posts small blind $0.01
SidneyCrosby8: posts big blind $0.02
Phantomasz1: sits out
*** HOLE CARDS ***
Morales7-PRO: folds
Jh0nTravolta: folds
karl8282: calls $0.02
Special One4444: folds
SidneyCrosby8: checks
*** FLOP *** [Td Kd Js]
SidneyCrosby8: checks
karl8282: checks
*** TURN *** [Td Kd Js] [4s]
SidneyCrosby8: checks
karl8282: checks
*** RIVER *** [Td Kd Js 4s] [Ks]
SidneyCrosby8: checks
karl8282: checks
*** SHOW DOWN ***
SidneyCrosby8: shows [Th 2c] (two pair, Kings and Tens)
karl8282: mucks hand
SidneyCrosby8 collected $0.05 from pot
*** SUMMARY ***
Total pot $0.05 | Rake $0
Board [Td Kd Js 4s Ks]
Seat 1: Jh0nTravolta folded before Flop (didn't bet)
Seat 2: karl8282 (button) mucked
Seat 3: Special One4444 (small blind) folded before Flop
Seat 4: SidneyCrosby8 (big blind) showed [Th 2c] and won ($0.05) with two pair, Kings and Tens
Seat 6: Morales7-PRO folded before Flop (didn't bet)


PokerStars Hand #238172912029:  Hold'em No Limit ($0.01/$0.02 USD) - 2022/08/23 15:23:17 ET
Table 'Equinox IV' 6-max Seat #3 is the button
Seat 1: Jh0nTravolta ($3.50 in chips)
Seat 2: karl8282 ($1.75 in chips)
Seat 3: Special One4444 ($2.27 in chips)
Seat 4: SidneyCrosby8 ($3.02 in chips)
Seat 5: Phantomasz1 ($2 in chips)
Seat 6: Morales7-PRO ($3.82 in chips)
SidneyCrosby8: posts small blind $0.01
Phantomasz1: posts big blind $0.02
*** HOLE CARDS ***
Morales7-PRO: folds
Jh0nTravolta: raises $0.03 to $0.05
karl8282: calls $0.05
Special One4444: folds
SidneyCrosby8: folds
Phantomasz1: calls $0.03
*** FLOP *** [9h 8h Qs]
Phantomasz1: checks
Jh0nTravolta: bets $0.05
karl8282: calls $0.05
Phantomasz1: folds
*** TURN *** [9h 8h Qs] [Ah]
Jh0nTravolta: checks
karl8282: bets $0.14
Jh0nTravolta: calls $0.14
*** RIVER *** [9h 8h Qs Ah] [5h]
Jh0nTravolta: checks
karl8282: checks
*** SHOW DOWN ***
Jh0nTravolta: shows [Jc Js] (a pair of Jacks)
karl8282: mucks hand
Jh0nTravolta collected $0.52 from pot
*** SUMMARY ***
Total pot $0.54 | Rake $0.02
Board [9h 8h Qs Ah 5h]
Seat 1: Jh0nTravolta showed [Jc Js] and won ($0.52) with a pair of Jacks
Seat 2: karl8282 mucked
Seat 3: Special One4444 (button) folded before Flop (didn't bet)
Seat 4: SidneyCrosby8 (small blind) folded before Flop
Seat 5: Phantomasz1 (big blind) folded on the Flop
Seat 6: Morales7-PRO folded before Flop (didn't bet)


PokerStars Hand #238172943699:  Hold'em No Limit ($0.01/$0.02 USD) - 2022/08/23 15:24:39 ET
Table 'Equinox IV' 6-max Seat #4 is the button
Seat 1: Jh0nTravolta ($3.78 in chips)
Seat 2: karl8282 ($1.51 in chips)
Seat 3: Special One4444 ($2.27 in chips)
Seat 4: SidneyCrosby8 ($3.01 in chips)
Seat 5: Phantomasz1 ($2 in chips)
Seat 6: Morales7-PRO ($3.82 in chips)
Phantomasz1: posts small blind $0.01
Morales7-PRO: posts big blind $0.02
*** HOLE CARDS ***
Jh0nTravolta: folds
karl8282: calls $0.02
Special One4444: raises $0.04 to $0.06
SidneyCrosby8: folds
Phantomasz1: folds
Morales7-PRO: folds
karl8282: calls $0.04
*** FLOP *** [8c 7c 2d]
karl8282: checks
Special One4444: checks
*** TURN *** [8c 7c 2d] [As]
karl8282: checks
Special One4444: checks
*** RIVER *** [8c 7c 2d As] [Ac]
karl8282: checks
Special One4444: checks
*** SHOW DOWN ***
karl8282: shows [3d Kd] (a pair of Aces)
Special One4444: mucks hand
karl8282 collected $0.14 from pot
*** SUMMARY ***
Total pot $0.15 | Rake $0.01
Board [8c 7c 2d As Ac]
Seat 1: Jh0nTravolta folded before Flop (didn't bet)
Seat 2: karl8282 showed [3d Kd] and won ($0.14) with a pair of Aces
Seat 3: Special One4444 mucked
Seat 4: SidneyCrosby8 (button) folded before Flop (didn't bet)
Seat 5: Phantomasz1 (small blind) folded before Flop
Seat 6: Morales7-PRO (big blind) folded before Flop


PokerStars Hand #238172960058:  Hold'em No Limit ($0.01/$0.02 USD) - 2022/08/23 15:25:23 ET
Table 'Equinox IV' 6-max Seat #5 is the button
Seat 1: Jh0nTravolta ($3.78 in chips)
Seat 2: karl8282 ($1.59 in chips)
Seat 3: Special One4444 ($2.21 in chips)
Seat 4: SidneyCrosby8 ($3.01 in chips)
Seat 5: Phantomasz1 ($2 in chips)
Seat 6: Morales7-PRO ($3.80 in chips)
Morales7-PRO: posts small blind $0.01
Jh0nTravolta: posts big blind $0.02
*** HOLE CARDS ***
karl8282: raises $0.08 to $0.10
Special One4444: folds
SidneyCrosby8: folds
Phantomasz1: calls $0.10
Morales7-PRO: folds
Jh0nTravolta: folds
*** FLOP *** [Ad 5c Ks]
karl8282: checks
Phantomasz1: bets $0.14
karl8282: calls $0.14
*** TURN *** [Ad 5c Ks] [7c]
karl8282: checks
Phantomasz1: bets $0.22
karl8282: folds
Uncalled bet ($0.22) returned to Phantomasz1
Phantomasz1 collected $0.49 from pot
Phantomasz1: doesn't show hand
*** SUMMARY ***
Total pot $0.51 | Rake $0.02
Board [Ad 5c Ks 7c]
Seat 1: Jh0nTravolta (big blind) folded before Flop
Seat 2: karl8282 folded on the Turn
Seat 3: Special One4444 folded before Flop (didn't bet)
Seat 4: SidneyCrosby8 folded before Flop (didn't bet)
Seat 5: Phantomasz1 (button) collected ($0.49)
Seat 6: Morales7-PRO (small blind) folded before Flop


PokerStars Hand #238172983912:  Hold'em No Limit ($0.01/$0.02 USD) - 2022/08/23 15:26:25 ET
Table 'Equinox IV' 6-max Seat #6 is the button
Seat 1: Jh0nTravolta ($3.76 in chips)
Seat 2: karl8282 ($1.35 in chips)
Seat 3: Special One4444 ($2.21 in chips)
Seat 4: SidneyCrosby8 ($3.01 in chips)
Seat 5: Phantomasz1 ($2.25 in chips)
Seat 6: Morales7-PRO ($3.79 in chips)
Jh0nTravolta: posts small blind $0.01
karl8282: posts big blind $0.02
*** HOLE CARDS ***
Special One4444: folds
SidneyCrosby8: folds
Phantomasz1: folds
Morales7-PRO: folds
Jh0nTravolta: raises $0.04 to $0.06
karl8282: folds
Uncalled bet ($0.04) returned to Jh0nTravolta
Jh0nTravolta collected $0.04 from pot
Jh0nTravolta: doesn't show hand
*** SUMMARY ***
Total pot $0.04 | Rake $0
Seat 1: Jh0nTravolta (small blind) collected ($0.04)
Seat 2: karl8282 (big blind) folded before Flop
Seat 3: Special One4444 folded before Flop (didn't bet)
Seat 4: SidneyCrosby8 folded before Flop (didn't bet)
Seat 5: Phantomasz1 folded before Flop (didn't bet)
Seat 6: Morales7-PRO (button) folded before Flop (didn't bet)


PokerStars Hand #238172992891:  Hold'em No Limit ($0.01/$0.02 USD) - 2022/08/23 15:26:49 ET
Table 'Equinox IV' 6-max Seat #1 is the button
Seat 1: Jh0nTravolta ($3.78 in chips)
Seat 2: karl8282 ($1.33 in chips)
Seat 3: Special One4444 ($2.21 in chips)
Seat 4: SidneyCrosby8 ($3.01 in chips)
Seat 5: Phantomasz1 ($2.25 in chips)
Seat 6: Morales7-PRO ($3.79 in chips)
karl8282: posts small blind $0.01
Special One4444: posts big blind $0.02
*** HOLE CARDS ***
SidneyCrosby8: folds
Phantomasz1: folds
Morales7-PRO: folds
Jh0nTravolta: folds
karl8282: raises $0.02 to $0.04
Special One4444: calls $0.02
*** FLOP *** [Td 8c 4c]
karl8282: checks
Special One4444: bets $0.06
karl8282: calls $0.06
*** TURN *** [Td 8c 4c] [Ad]
karl8282: checks
Special One4444: bets $0.06
karl8282: calls $0.06
*** RIVER *** [Td 8c 4c Ad] [3h]
karl8282: checks
Special One4444: bets $0.10
karl8282: calls $0.10
*** SHOW DOWN ***
Special One4444: shows [Qd 8h] (a pair of Eights)
karl8282: mucks hand
Special One4444 collected $0.50 from pot
*** SUMMARY ***
Total pot $0.52 | Rake $0.02
Board [Td 8c 4c Ad 3h]
Seat 1: Jh0nTravolta (button) folded before Flop (didn't bet)
Seat 2: karl8282 (small blind) mucked
Seat 3: Special One4444 (big blind) showed [Qd 8h] and won ($0.50) with a pair of Eights
Seat 4: SidneyCrosby8 folded before Flop (didn't bet)
Seat 5: Phantomasz1 folded before Flop (didn't bet)
Seat 6: Morales7-PRO folded before Flop (didn't bet)


PokerStars Hand #238173009335:  Hold'em No Limit ($0.01/$0.02 USD) - 2022/08/23 15:27:33 ET
Table 'Equinox IV' 6-max Seat #2 is the button
Seat 1: Jh0nTravolta ($3.78 in chips)
Seat 2: karl8282 ($1.07 in chips)
Seat 3: Special One4444 ($2.45 in chips)
Seat 4: SidneyCrosby8 ($3.01 in chips)
Seat 5: Phantomasz1 ($2.25 in chips)
Seat 6: Morales7-PRO ($3.79 in chips)
Special One4444: posts small blind $0.01
SidneyCrosby8: posts big blind $0.02
*** HOLE CARDS ***
Phantomasz1: raises $0.05 to $0.07
Morales7-PRO: folds
Jh0nTravolta: folds
karl8282: folds
Special One4444: raises $0.05 to $0.12
SidneyCrosby8: folds
Phantomasz1: raises $0.36 to $0.48
Special One4444: calls $0.36
*** FLOP *** [4c 2h 4s]
Special One4444: bets $0.47
Phantomasz1: calls $0.47
*** TURN *** [4c 2h 4s] [Ac]
Special One4444: bets $1.50 and is all-in
Phantomasz1: folds
Uncalled bet ($1.50) returned to Special One4444
Special One4444 collected $1.85 from pot
*** SUMMARY ***
Total pot $1.92 | Rake $0.07
Board [4c 2h 4s Ac]
Seat 1: Jh0nTravolta folded before Flop (didn't bet)
Seat 2: karl8282 (button) folded before Flop (didn't bet)
Seat 3: Special One4444 (small blind) collected ($1.85)
Seat 4: SidneyCrosby8 (big blind) folded before Flop
Seat 5: Phantomasz1 folded on the Turn
Seat 6: Morales7-PRO folded before Flop (didn't bet)


PokerStars Hand #238173035191:  Hold'em No Limit ($0.01/$0.02 USD) - 2022/08/23 15:28:41 ET
Table 'Equinox IV' 6-max Seat #3 is the button
Seat 1: Jh0nTravolta ($3.78 in chips)
Seat 2: karl8282 ($1.07 in chips)
Seat 3: Special One4444 ($3.35 in chips)
Seat 4: SidneyCrosby8 ($2.99 in chips)
Seat 5: Phantomasz1 ($2 in chips)
Seat 6: Morales7-PRO ($3.79 in chips)
SidneyCrosby8: posts small blind $0.01
Phantomasz1: posts big blind $0.02
*** HOLE CARDS ***
Morales7-PRO: raises $0.04 to $0.06
Jh0nTravolta: folds
karl8282: calls $0.06
Special One4444: folds
SidneyCrosby8: folds
Phantomasz1: calls $0.04
*** FLOP *** [6h 5c Ac]
Phantomasz1: bets $0.10
Morales7-PRO: raises $0.30 to $0.40
karl8282: folds
Phantomasz1: folds
Uncalled bet ($0.30) returned to Morales7-PRO
Morales7-PRO collected $0.38 from pot
Morales7-PRO: doesn't show hand
*** SUMMARY ***
Total pot $0.39 | Rake $0.01
Board [6h 5c Ac]
Seat 1: Jh0nTravolta folded before Flop (didn't bet)
Seat 2: karl8282 folded on the Flop
Seat 3: Special One4444 (button) folded before Flop (didn't bet)
Seat 4: SidneyCrosby8 (small blind) folded before Flop
Seat 5: Phantomasz1 (big blind) folded on the Flop
Seat 6: Morales7-PRO collected ($0.38)


PokerStars Hand #238173051058:  Hold'em No Limit ($0.01/$0.02 USD) - 2022/08/23 15:29:23 ET
Table 'Equinox IV' 6-max Seat #4 is the button
Seat 1: Jh0nTravolta ($3.78 in chips)
Seat 2: karl8282 ($1.01 in chips)
Seat 3: Special One4444 ($3.35 in chips)
Seat 4: SidneyCrosby8 ($2.98 in chips)
Seat 5: Phantomasz1 ($2 in chips)
Seat 6: Morales7-PRO ($4.01 in chips)
Phantomasz1: posts small blind $0.01
Morales7-PRO: posts big blind $0.02
*** HOLE CARDS ***
Jh0nTravolta: folds
karl8282: folds
Special One4444: folds
SidneyCrosby8: raises $0.02 to $0.04
Phantomasz1: calls $0.03
Morales7-PRO: folds
*** FLOP *** [5d Jh 8h]
Phantomasz1: checks
SidneyCrosby8: checks
*** TURN *** [5d Jh 8h] [2h]
Phantomasz1: checks
SidneyCrosby8: checks
*** RIVER *** [5d Jh 8h 2h] [5h]
Phantomasz1: bets $1.96 and is all-in
SidneyCrosby8: folds
Uncalled bet ($1.96) returned to Phantomasz1
Phantomasz1 collected $0.10 from pot
Phantomasz1: doesn't show hand
*** SUMMARY ***
Total pot $0.10 | Rake $0
Board [5d Jh 8h 2h 5h]
Seat 1: Jh0nTravolta folded before Flop (didn't bet)
Seat 2: karl8282 folded before Flop (didn't bet)
Seat 3: Special One4444 folded before Flop (didn't bet)
Seat 4: SidneyCrosby8 (button) folded on the River
Seat 5: Phantomasz1 (small blind) collected ($0.10)
Seat 6: Morales7-PRO (big blind) folded before Flop


PokerStars Hand #238173067897:  Hold'em No Limit ($0.01/$0.02 USD) - 2022/08/23 15:30:07 ET
Table 'Equinox IV' 6-max Seat #5 is the button
Seat 1: Jh0nTravolta ($3.78 in chips)
Seat 2: karl8282 ($1.01 in chips)
Seat 3: Special One4444 ($3.35 in chips)
Seat 4: SidneyCrosby8 ($2.94 in chips)
Seat 5: Phantomasz1 ($2.06 in chips)
Seat 6: Morales7-PRO ($3.99 in chips)
Morales7-PRO: posts small blind $0.01
Jh0nTravolta: posts big blind $0.02
*** HOLE CARDS ***
karl8282: calls $0.02
Special One4444: folds
SidneyCrosby8: folds
Phantomasz1: folds
Morales7-PRO: raises $0.08 to $0.10
Jh0nTravolta: folds
karl8282: folds
Uncalled bet ($0.08) returned to Morales7-PRO
Morales7-PRO collected $0.06 from pot
Morales7-PRO: doesn't show hand
*** SUMMARY ***
Total pot $0.06 | Rake $0
Seat 1: Jh0nTravolta (big blind) folded before Flop
Seat 2: karl8282 folded before Flop
Seat 3: Special One4444 folded before Flop (didn't bet)
Seat 4: SidneyCrosby8 folded before Flop (didn't bet)
Seat 5: Phantomasz1 (button) folded before Flop (didn't bet)
Seat 6: Morales7-PRO (small blind) collected ($0.06)


PokerStars Hand #238173080826:  Hold'em No Limit ($0.01/$0.02 USD) - 2022/08/23 15:30:41 ET
Table 'Equinox IV' 6-max Seat #6 is the button
Seat 1: Jh0nTravolta ($3.76 in chips)
Seat 2: karl8282 ($0.99 in chips)
Seat 3: Special One4444 ($3.35 in chips)
Seat 4: SidneyCrosby8 ($2.94 in chips)
Seat 5: Phantomasz1 ($2.06 in chips)
Seat 6: Morales7-PRO ($4.03 in chips)
Jh0nTravolta: posts small blind $0.01
karl8282: posts big blind $0.02
*** HOLE CARDS ***
Special One4444: folds
SidneyCrosby8: folds
Phantomasz1: raises $0.05 to $0.07
Morales7-PRO: folds
Jh0nTravolta: folds
karl8282: calls $0.05
*** FLOP *** [9c Tc 4d]
karl8282: checks
Phantomasz1: bets $0.11
karl8282: calls $0.11
*** TURN *** [9c Tc 4d] [5h]
karl8282: checks
Phantomasz1: bets $0.29
karl8282: calls $0.29
*** RIVER *** [9c Tc 4d 5h] [8h]
karl8282: checks
Phantomasz1: checks
*** SHOW DOWN ***
karl8282: shows [2s 9s] (a pair of Nines)
Phantomasz1: mucks hand
karl8282 collected $0.92 from pot
*** SUMMARY ***
Total pot $0.95 | Rake $0.03
Board [9c Tc 4d 5h 8h]
Seat 1: Jh0nTravolta (small blind) folded before Flop
Seat 2: karl8282 (big blind) showed [2s 9s] and won ($0.92) with a pair of Nines
Seat 3: Special One4444 folded before Flop (didn't bet)
Seat 4: SidneyCrosby8 folded before Flop (didn't bet)
Seat 5: Phantomasz1 mucked
Seat 6: Morales7-PRO (button) folded before Flop (didn't bet)


PokerStars Hand #238173103196:  Hold'em No Limit ($0.01/$0.02 USD) - 2022/08/23 15:31:40 ET
Table 'Equinox IV' 6-max Seat #1 is the button
Seat 1: Jh0nTravolta ($3.75 in chips)
Seat 2: karl8282 ($1.44 in chips)
Seat 3: Special One4444 ($3.35 in chips)
Seat 4: SidneyCrosby8 ($2.94 in chips)
Seat 5: Phantomasz1 ($2 in chips)
Seat 6: Morales7-PRO ($4.03 in chips)
karl8282: posts small blind $0.01
Special One4444: posts big blind $0.02
*** HOLE CARDS ***
SidneyCrosby8: folds
Phantomasz1: folds
Morales7-PRO: raises $0.04 to $0.06
Jh0nTravolta: calls $0.06
karl8282: calls $0.05
Special One4444: calls $0.04
*** FLOP *** [2c 8c 8s]
karl8282: checks
Special One4444: checks
Morales7-PRO: checks
Jh0nTravolta: checks
*** TURN *** [2c 8c 8s] [5h]
karl8282: checks
Special One4444: checks
Morales7-PRO: bets $0.07
Phantomasz1 leaves the table
Jh0nTravolta: folds
karl8282: folds
Special One4444: folds
Uncalled bet ($0.07) returned to Morales7-PRO
Morales7-PRO collected $0.23 from pot
Morales7-PRO: doesn't show hand
*** SUMMARY ***
Total pot $0.24 | Rake $0.01
Board [2c 8c 8s 5h]
Seat 1: Jh0nTravolta (button) folded on the Turn
Seat 2: karl8282 (small blind) folded on the Turn
Seat 3: Special One4444 (big blind) folded on the Turn
Seat 4: SidneyCrosby8 folded before Flop (didn't bet)
Seat 5: Phantomasz1 folded before Flop (didn't bet)
Seat 6: Morales7-PRO collected ($0.23)


PokerStars Hand #238173131266:  Hold'em No Limit ($0.01/$0.02 USD) - 2022/08/23 15:32:53 ET
Table 'Equinox IV' 6-max Seat #2 is the button
Seat 1: Jh0nTravolta ($3.69 in chips)
Seat 2: karl8282 ($1.38 in chips)
Seat 3: Special One4444 ($3.29 in chips)
Seat 6: Morales7-PRO ($4.20 in chips)
Special One4444: posts small blind $0.01
Morales7-PRO: posts big blind $0.02
*** HOLE CARDS ***
Jh0nTravolta: raises $0.03 to $0.05
customdry244 joins the table at seat #5
karl8282: calls $0.05
Special One4444: folds
Morales7-PRO: folds
*** FLOP *** [Jc Ad 8h]
Jh0nTravolta: bets $0.04
karl8282: calls $0.04
*** TURN *** [Jc Ad 8h] [6s]
Jh0nTravolta: bets $0.13
karl8282: calls $0.13
*** RIVER *** [Jc Ad 8h 6s] [5c]
Jh0nTravolta: checks
karl8282: checks
*** SHOW DOWN ***
Jh0nTravolta: shows [Ah 4h] (a pair of Aces)
karl8282: shows [9d As] (a pair of Aces - Jack+Nine kicker)
karl8282 collected $0.45 from pot
*** SUMMARY ***
Total pot $0.47 | Rake $0.02
Board [Jc Ad 8h 6s 5c]
Seat 1: Jh0nTravolta showed [Ah 4h] and lost with a pair of Aces
Seat 2: karl8282 (button) showed [9d As] and won ($0.45) with a pair of Aces
Seat 3: Special One4444 (small blind) folded before Flop
Seat 6: Morales7-PRO (big blind) folded before Flop


PokerStars Hand #238173151894:  Hold'em No Limit ($0.01/$0.02 USD) - 2022/08/23 15:33:41 ET
Table 'Equinox IV' 6-max Seat #3 is the button
Seat 1: Jh0nTravolta ($3.47 in chips)
Seat 2: karl8282 ($1.61 in chips)
Seat 3: Special One4444 ($3.28 in chips)
Seat 6: Morales7-PRO ($4.18 in chips)
Morales7-PRO: posts small blind $0.01
Jh0nTravolta: posts big blind $0.02
*** HOLE CARDS ***
karl8282: folds
Special One4444: folds
Morales7-PRO: raises $0.04 to $0.06
Jh0nTravolta: folds
Uncalled bet ($0.04) returned to Morales7-PRO
Morales7-PRO collected $0.04 from pot
Morales7-PRO: doesn't show hand
*** SUMMARY ***
Total pot $0.04 | Rake $0
Seat 1: Jh0nTravolta (big blind) folded before Flop
Seat 2: karl8282 folded before Flop (didn't bet)
Seat 3: Special One4444 (button) folded before Flop (didn't bet)
Seat 6: Morales7-PRO (small blind) collected ($0.04)


PokerStars Hand #238173155821:  Hold'em No Limit ($0.01/$0.02 USD) - 2022/08/23 15:33:51 ET
Table 'Equinox IV' 6-max Seat #6 is the button
Seat 1: Jh0nTravolta ($3.45 in chips)
Seat 2: karl8282 ($1.61 in chips)
Seat 3: Special One4444 ($3.28 in chips)
Seat 6: Morales7-PRO ($4.20 in chips)
Jh0nTravolta: posts small blind $0.01
karl8282: posts big blind $0.02
SidneyCrosby8: sits out
customdry244: sits out
*** HOLE CARDS ***
Special One4444: folds
Morales7-PRO: folds
Jh0nTravolta: folds
Uncalled bet ($0.01) returned to karl8282
karl8282 collected $0.02 from pot
*** SUMMARY ***
Total pot $0.02 | Rake $0
Seat 1: Jh0nTravolta (small blind) folded before Flop
Seat 2: karl8282 (big blind) collected ($0.02)
Seat 3: Special One4444 folded before Flop (didn't bet)
Seat 6: Morales7-PRO (button) folded before Flop (didn't bet)


PokerStars Hand #238173162385:  Hold'em No Limit ($0.01/$0.02 USD) - 2022/08/23 15:34:09 ET
Table 'Equinox IV' 6-max Seat #1 is the button
Seat 1: Jh0nTravolta ($3.44 in chips)
Seat 2: karl8282 ($1.62 in chips)
Seat 3: Special One4444 ($3.28 in chips)
Seat 6: Morales7-PRO ($4.20 in chips)
karl8282: posts small blind $0.01
Special One4444: posts big blind $0.02
SidneyCrosby8: sits out
customdry244: sits out
*** HOLE CARDS ***
Morales7-PRO: folds
Jh0nTravolta: folds
karl8282: calls $0.01
Special One4444: checks
*** FLOP *** [8d Qh Ah]
karl8282: checks
Special One4444: checks
*** TURN *** [8d Qh Ah] [Qd]
karl8282: bets $0.02
Special One4444: folds
Uncalled bet ($0.02) returned to karl8282
karl8282 collected $0.04 from pot
*** SUMMARY ***
Total pot $0.04 | Rake $0
Board [8d Qh Ah Qd]
Seat 1: Jh0nTravolta (button) folded before Flop (didn't bet)
Seat 2: karl8282 (small blind) collected ($0.04)
Seat 3: Special One4444 (big blind) folded on the Turn
Seat 6: Morales7-PRO folded before Flop (didn't bet)


PokerStars Hand #238173171408:  Hold'em No Limit ($0.01/$0.02 USD) - 2022/08/23 15:34:32 ET
Table 'Equinox IV' 6-max Seat #2 is the button
Seat 1: Jh0nTravolta ($3.44 in chips)
Seat 2: karl8282 ($1.64 in chips)
Seat 3: Special One4444 ($3.26 in chips)
Seat 4: SidneyCrosby8 ($2.94 in chips)
Seat 6: Morales7-PRO ($4.20 in chips)
Special One4444: posts small blind $0.01
SidneyCrosby8: posts big blind $0.02
customdry244: sits out
*** HOLE CARDS ***
Morales7-PRO: folds
Jh0nTravolta: folds
karl8282: folds
Special One4444: folds
Uncalled bet ($0.01) returned to SidneyCrosby8
SidneyCrosby8 collected $0.02 from pot
SidneyCrosby8: doesn't show hand
*** SUMMARY ***
Total pot $0.02 | Rake $0
Seat 1: Jh0nTravolta folded before Flop (didn't bet)
Seat 2: karl8282 (button) folded before Flop (didn't bet)
Seat 3: Special One4444 (small blind) folded before Flop
Seat 4: SidneyCrosby8 (big blind) collected ($0.02)
Seat 6: Morales7-PRO folded before Flop (didn't bet)


PokerStars Hand #238173178841:  Hold'em No Limit ($0.01/$0.02 USD) - 2022/08/23 15:34:52 ET
Table 'Equinox IV' 6-max Seat #3 is the button
Seat 1: Jh0nTravolta ($3.44 in chips)
Seat 2: karl8282 ($1.64 in chips)
Seat 3: Special One4444 ($3.25 in chips)
Seat 4: SidneyCrosby8 ($2.95 in chips)
Seat 5: customdry244 ($1.60 in chips)
Seat 6: Morales7-PRO ($4.20 in chips)
SidneyCrosby8: posts small blind $0.01
customdry244: posts big blind $0.02
*** HOLE CARDS ***
Morales7-PRO: raises $0.04 to $0.06
Jh0nTravolta: folds
karl8282: calls $0.06
Special One4444: folds
SidneyCrosby8: folds
customdry244: folds
*** FLOP *** [4c 7h 8d]
Morales7-PRO: checks
karl8282: bets $0.14
Morales7-PRO: calls $0.14
*** TURN *** [4c 7h 8d] [7c]
Morales7-PRO: checks
karl8282: bets $0.20
Morales7-PRO: folds
Uncalled bet ($0.20) returned to karl8282
karl8282 collected $0.41 from pot
*** SUMMARY ***
Total pot $0.43 | Rake $0.02
Board [4c 7h 8d 7c]
Seat 1: Jh0nTravolta folded before Flop (didn't bet)
Seat 2: karl8282 collected ($0.41)
Seat 3: Special One4444 (button) folded before Flop (didn't bet)
Seat 4: SidneyCrosby8 (small blind) folded before Flop
Seat 5: customdry244 (big blind) folded before Flop
Seat 6: Morales7-PRO folded on the Turn


PokerStars Hand #238173198293:  Hold'em No Limit ($0.01/$0.02 USD) - 2022/08/23 15:35:43 ET
Table 'Equinox IV' 6-max Seat #4 is the button
Seat 1: Jh0nTravolta ($3.44 in chips)
Seat 2: karl8282 ($1.85 in chips)
Seat 3: Special One4444 ($3.25 in chips)
Seat 4: SidneyCrosby8 ($2.94 in chips)
Seat 5: customdry244 ($1.58 in chips)
Seat 6: Morales7-PRO ($4 in chips)
customdry244: posts small blind $0.01
Morales7-PRO: posts big blind $0.02
*** HOLE CARDS ***
Jh0nTravolta: folds
karl8282: raises $0.04 to $0.06
Special One4444: folds
SidneyCrosby8: folds
customdry244: calls $0.05
Morales7-PRO: folds
*** FLOP *** [6h 3d 7h]
customdry244: checks
karl8282: checks
*** TURN *** [6h 3d 7h] [5s]
customdry244: checks
karl8282: checks
*** RIVER *** [6h 3d 7h 5s] [2c]
customdry244: bets $0.08
karl8282: folds
Uncalled bet ($0.08) returned to customdry244
customdry244 collected $0.14 from pot
*** SUMMARY ***
Total pot $0.14 | Rake $0
Board [6h 3d 7h 5s 2c]
Seat 1: Jh0nTravolta folded before Flop (didn't bet)
Seat 2: karl8282 folded on the River
Seat 3: Special One4444 folded before Flop (didn't bet)
Seat 4: SidneyCrosby8 (button) folded before Flop (didn't bet)
Seat 5: customdry244 (small blind) collected ($0.14)
Seat 6: Morales7-PRO (big blind) folded before Flop


PokerStars Hand #238173218575:  Hold'em No Limit ($0.01/$0.02 USD) - 2022/08/23 15:36:36 ET
Table 'Equinox IV' 6-max Seat #5 is the button
Seat 1: Jh0nTravolta ($3.44 in chips)
Seat 2: karl8282 ($1.79 in chips)
Seat 3: Special One4444 ($3.25 in chips)
Seat 4: SidneyCrosby8 ($2.94 in chips)
Seat 5: customdry244 ($1.66 in chips)
Seat 6: Morales7-PRO ($3.98 in chips)
Morales7-PRO: posts small blind $0.01
Jh0nTravolta: posts big blind $0.02
*** HOLE CARDS ***
karl8282: folds
Special One4444: raises $0.04 to $0.06
SidneyCrosby8: folds
karl8282 leaves the table
customdry244: raises $0.04 to $0.10
Morales7-PRO: folds
Jh0nTravolta: folds
Special One4444: calls $0.04
*** FLOP *** [7s Jd Th]
Ramirres joins the table at seat #2
Special One4444: checks
customdry244: bets $0.20
Special One4444: folds
Uncalled bet ($0.20) returned to customdry244
customdry244 collected $0.22 from pot
*** SUMMARY ***
Total pot $0.23 | Rake $0.01
Board [7s Jd Th]
Seat 1: Jh0nTravolta (big blind) folded before Flop
Seat 2: karl8282 folded before Flop (didn't bet)
Seat 3: Special One4444 folded on the Flop
Seat 4: SidneyCrosby8 folded before Flop (didn't bet)
Seat 5: customdry244 (button) collected ($0.22)
Seat 6: Morales7-PRO (small blind) folded before Flop


PokerStars Hand #238173228787:  Hold'em No Limit ($0.01/$0.02 USD) - 2022/08/23 15:37:02 ET
Table 'Equinox IV' 6-max Seat #6 is the button
Seat 1: Jh0nTravolta ($3.42 in chips)
Seat 2: Ramirres ($2 in chips)
Seat 3: Special One4444 ($3.15 in chips)
Seat 4: SidneyCrosby8 ($2.94 in chips)
Seat 5: customdry244 ($1.78 in chips)
Seat 6: Morales7-PRO ($3.97 in chips)
Jh0nTravolta: posts small blind $0.01
Ramirres: posts big blind $0.02
*** HOLE CARDS ***
Special One4444: raises $0.04 to $0.06
SidneyCrosby8: folds
customdry244: folds
Morales7-PRO: folds
Jh0nTravolta: folds
Ramirres: folds
Uncalled bet ($0.04) returned to Special One4444
Special One4444 collected $0.05 from pot
*** SUMMARY ***
Total pot $0.05 | Rake $0
Seat 1: Jh0nTravolta (small blind) folded before Flop
Seat 2: Ramirres (big blind) folded before Flop
Seat 3: Special One4444 collected ($0.05)
Seat 4: SidneyCrosby8 folded before Flop (didn't bet)
Seat 5: customdry244 folded before Flop (didn't bet)
Seat 6: Morales7-PRO (button) folded before Flop (didn't bet)


PokerStars Hand #238173234072:  Hold'em No Limit ($0.01/$0.02 USD) - 2022/08/23 15:37:16 ET
Table 'Equinox IV' 6-max Seat #1 is the button
Seat 1: Jh0nTravolta ($3.41 in chips)
Seat 2: Ramirres ($2 in chips)
Seat 3: Special One4444 ($3.18 in chips)
Seat 5: customdry244 ($1.78 in chips)
Seat 6: Morales7-PRO ($3.97 in chips)
Ramirres: posts small blind $0.01
Special One4444: posts big blind $0.02
*** HOLE CARDS ***
customdry244: folds
Morales7-PRO: folds
Jh0nTravolta: folds
Ramirres: raises $0.03 to $0.05
Special One4444: folds
Uncalled bet ($0.03) returned to Ramirres
Ramirres collected $0.04 from pot
*** SUMMARY ***
Total pot $0.04 | Rake $0
Seat 1: Jh0nTravolta (button) folded before Flop (didn't bet)
Seat 2: Ramirres (small blind) collected ($0.04)
Seat 3: Special One4444 (big blind) folded before Flop
Seat 5: customdry244 folded before Flop (didn't bet)
Seat 6: Morales7-PRO folded before Flop (didn't bet)


PokerStars Hand #238173244063:  Hold'em No Limit ($0.01/$0.02 USD) - 2022/08/23 15:37:42 ET
Table 'Equinox IV' 6-max Seat #2 is the button
Seat 1: Jh0nTravolta ($3.41 in chips)
Seat 2: Ramirres ($2.02 in chips)
Seat 3: Special One4444 ($3.16 in chips)
Seat 5: customdry244 ($1.78 in chips)
Seat 6: Morales7-PRO ($3.97 in chips)
Special One4444: posts small blind $0.01
customdry244: posts big blind $0.02
*** HOLE CARDS ***
Morales7-PRO: raises $0.04 to $0.06
Jh0nTravolta: raises $0.12 to $0.18
Ramirres: folds
Special One4444: folds
customdry244: folds
Morales7-PRO: raises $0.30 to $0.48
Jh0nTravolta: calls $0.30
*** FLOP *** [6c 9h 4c]
Morales7-PRO: bets $0.31
Jh0nTravolta: calls $0.31
*** TURN *** [6c 9h 4c] [4h]
Morales7-PRO: checks
Jh0nTravolta: checks
*** RIVER *** [6c 9h 4c 4h] [5h]
Morales7-PRO: checks
Jh0nTravolta: bets $1.55
Morales7-PRO: calls $1.55
*** SHOW DOWN ***
Jh0nTravolta: shows [Ad Kc] (a pair of Fours)
Morales7-PRO: shows [Ks 9s] (two pair, Nines and Fours)
Morales7-PRO collected $4.55 from pot
*** SUMMARY ***
Total pot $4.71 | Rake $0.16
Board [6c 9h 4c 4h 5h]
Seat 1: Jh0nTravolta showed [Ad Kc] and lost with a pair of Fours
Seat 2: Ramirres (button) folded before Flop (didn't bet)
Seat 3: Special One4444 (small blind) folded before Flop
Seat 5: customdry244 (big blind) folded before Flop
Seat 6: Morales7-PRO showed [Ks 9s] and won ($4.55) with two pair, Nines and Fours


PokerStars Hand #238173269395:  Hold'em No Limit ($0.01/$0.02 USD) - 2022/08/23 15:38:49 ET
Table 'Equinox IV' 6-max Seat #3 is the button
Seat 1: Jh0nTravolta ($2 in chips)
Seat 2: Ramirres ($2.02 in chips)
Seat 3: Special One4444 ($3.15 in chips)
Seat 5: customdry244 ($1.76 in chips)
Seat 6: Morales7-PRO ($6.18 in chips)
customdry244: posts small blind $0.01
Morales7-PRO: posts big blind $0.02
*** HOLE CARDS ***
Jh0nTravolta has timed out
Jh0nTravolta: folds
Ramirres: raises $0.03 to $0.05
Special One4444: folds
customdry244: calls $0.04
Morales7-PRO: calls $0.03
*** FLOP *** [8h 3s 4h]
customdry244: checks
Morales7-PRO: checks
Ramirres: bets $0.09
customdry244: folds
Jh0nTravolta leaves the table
Morales7-PRO: calls $0.09
*** TURN *** [8h 3s 4h] [6s]
Morales7-PRO: checks
Ramirres: bets $0.21
Morales7-PRO: calls $0.21
*** RIVER *** [8h 3s 4h 6s] [8s]
Morales7-PRO: checks
Ramirres: bets $0.48
Morales7-PRO: calls $0.48
*** SHOW DOWN ***
Ramirres: shows [4c Ac] (two pair, Eights and Fours)
Morales7-PRO: shows [7d 7s] (two pair, Eights and Sevens)
Morales7-PRO collected $1.65 from pot
*** SUMMARY ***
Total pot $1.71 | Rake $0.06
Board [8h 3s 4h 6s 8s]
Seat 1: Jh0nTravolta folded before Flop (didn't bet)
Seat 2: Ramirres showed [4c Ac] and lost with two pair, Eights and Fours
Seat 3: Special One4444 (button) folded before Flop (didn't bet)
Seat 5: customdry244 (small blind) folded on the Flop
Seat 6: Morales7-PRO (big blind) showed [7d 7s] and won ($1.65) with two pair, Eights and Sevens


PokerStars Hand #238173292244:  Hold'em No Limit ($0.01/$0.02 USD) - 2022/08/23 15:39:48 ET
Table 'Equinox IV' 6-max Seat #5 is the button
Seat 2: Ramirres ($2 in chips)
Seat 3: Special One4444 ($3.15 in chips)
Seat 5: customdry244 ($1.71 in chips)
Seat 6: Morales7-PRO ($7 in chips)
Morales7-PRO: posts small blind $0.01
Ramirres: posts big blind $0.02
SidneyCrosby8: sits out
*** HOLE CARDS ***
Special One4444: folds
customdry244: folds
Morales7-PRO: raises $0.04 to $0.06
Ramirres: folds
Uncalled bet ($0.04) returned to Morales7-PRO
Morales7-PRO collected $0.04 from pot
Morales7-PRO: doesn't show hand
*** SUMMARY ***
Total pot $0.04 | Rake $0
Seat 2: Ramirres (big blind) folded before Flop
Seat 3: Special One4444 folded before Flop (didn't bet)
Seat 5: customdry244 (button) folded before Flop (didn't bet)
Seat 6: Morales7-PRO (small blind) collected ($0.04)


PokerStars Hand #238173296499:  Hold'em No Limit ($0.01/$0.02 USD) - 2022/08/23 15:40:00 ET
Table 'Equinox IV' 6-max Seat #6 is the button
Seat 2: Ramirres ($2 in chips)
Seat 3: Special One4444 ($3.15 in chips)
Seat 5: customdry244 ($1.71 in chips)
Seat 6: Morales7-PRO ($7.02 in chips)
Ramirres: posts small blind $0.01
Special One4444: posts big blind $0.02
SidneyCrosby8: sits out
*** HOLE CARDS ***
customdry244: raises $0.02 to $0.04
Morales7-PRO: folds
Ramirres: folds
Special One4444: folds
Uncalled bet ($0.02) returned to customdry244
customdry244 collected $0.05 from pot
*** SUMMARY ***
Total pot $0.05 | Rake $0
Seat 2: Ramirres (small blind) folded before Flop
Seat 3: Special One4444 (big blind) folded before Flop
Seat 5: customdry244 collected ($0.05)
Seat 6: Morales7-PRO (button) folded before Flop (didn't bet)


PokerStars Hand #238173301325:  Hold'em No Limit ($0.01/$0.02 USD) - 2022/08/23 15:40:12 ET
Table 'Equinox IV' 6-max Seat #2 is the button
Seat 2: Ramirres ($2 in chips)
Seat 3: Special One4444 ($3.13 in chips)
Seat 4: SidneyCrosby8 ($2.94 in chips)
Seat 5: customdry244 ($1.74 in chips)
Seat 6: Morales7-PRO ($7.02 in chips)
Special One4444: posts small blind $0.01
SidneyCrosby8: posts big blind $0.02
*** HOLE CARDS ***
customdry244: raises $0.02 to $0.04
Morales7-PRO: folds
Ramirres: folds
Special One4444: raises $0.02 to $0.06
SidneyCrosby8: folds
customdry244: raises $0.02 to $0.08
Special One4444: calls $0.02
*** FLOP *** [7s Jc Tc]
Special One4444: checks
customdry244: bets $0.12
Special One4444: folds
Uncalled bet ($0.12) returned to customdry244
customdry244 collected $0.17 from pot
*** SUMMARY ***
Total pot $0.18 | Rake $0.01
Board [7s Jc Tc]
Seat 2: Ramirres (button) folded before Flop (didn't bet)
Seat 3: Special One4444 (small blind) folded on the Flop
Seat 4: SidneyCrosby8 (big blind) folded before Flop
Seat 5: customdry244 collected ($0.17)
Seat 6: Morales7-PRO folded before Flop (didn't bet)


PokerStars Hand #238173312438:  Hold'em No Limit ($0.01/$0.02 USD) - 2022/08/23 15:40:42 ET
Table 'Equinox IV' 6-max Seat #3 is the button
Seat 2: Ramirres ($2 in chips)
Seat 3: Special One4444 ($3.05 in chips)
Seat 4: SidneyCrosby8 ($2.92 in chips)
Seat 5: customdry244 ($1.83 in chips)
Seat 6: Morales7-PRO ($7.02 in chips)
SidneyCrosby8: posts small blind $0.01
customdry244: posts big blind $0.02
*** HOLE CARDS ***
Morales7-PRO: folds
Ramirres: raises $0.03 to $0.05
Special One4444: folds
SidneyCrosby8: folds
customdry244: calls $0.03
*** FLOP *** [8s Qh As]
Alewel338 joins the table at seat #1
customdry244: bets $0.04
Ramirres: calls $0.04
*** TURN *** [8s Qh As] [4h]
customdry244: checks
Ramirres: checks
*** RIVER *** [8s Qh As 4h] [Tc]
customdry244: bets $0.06
Ramirres: raises $0.12 to $0.18
customdry244: calls $0.12
*** SHOW DOWN ***
Ramirres: shows [Ts Qd] (two pair, Queens and Tens)
customdry244: mucks hand
Ramirres collected $0.53 from pot
*** SUMMARY ***
Total pot $0.55 | Rake $0.02
Board [8s Qh As 4h Tc]
Seat 2: Ramirres showed [Ts Qd] and won ($0.53) with two pair, Queens and Tens
Seat 3: Special One4444 (button) folded before Flop (didn't bet)
Seat 4: SidneyCrosby8 (small blind) folded before Flop
Seat 5: customdry244 (big blind) mucked
Seat 6: Morales7-PRO folded before Flop (didn't bet)


PokerStars Hand #238173334330:  Hold'em No Limit ($0.01/$0.02 USD) - 2022/08/23 15:41:28 ET
Table 'Equinox IV' 6-max Seat #4 is the button
Seat 2: Ramirres ($2.26 in chips)
Seat 3: Special One4444 ($3.05 in chips)
Seat 4: SidneyCrosby8 ($2.91 in chips)
Seat 5: customdry244 ($1.56 in chips)
Seat 6: Morales7-PRO ($7.02 in chips)
customdry244: posts small blind $0.01
Morales7-PRO: posts big blind $0.02
Alewel338: sits out
*** HOLE CARDS ***
Ramirres: folds
Special One4444: folds
SidneyCrosby8: folds
customdry244: calls $0.01
Morales7-PRO: checks
*** FLOP *** [2h 6s 5d]
customdry244: bets $0.08
Morales7-PRO: calls $0.08
*** TURN *** [2h 6s 5d] [7d]
customdry244: checks
Morales7-PRO: checks
*** RIVER *** [2h 6s 5d 7d] [9d]
customdry244: bets $0.12
Morales7-PRO: folds
Uncalled bet ($0.12) returned to customdry244
customdry244 collected $0.19 from pot
*** SUMMARY ***
Total pot $0.20 | Rake $0.01
Board [2h 6s 5d 7d 9d]
Seat 2: Ramirres folded before Flop (didn't bet)
Seat 3: Special One4444 folded before Flop (didn't bet)
Seat 4: SidneyCrosby8 (button) folded before Flop (didn't bet)
Seat 5: customdry244 (small blind) collected ($0.19)
Seat 6: Morales7-PRO (big blind) folded on the River


PokerStars Hand #238173349718:  Hold'em No Limit ($0.01/$0.02 USD) - 2022/08/23 15:42:08 ET
Table 'Equinox IV' 6-max Seat #5 is the button
Seat 1: Alewel338 ($0.80 in chips)
Seat 2: Ramirres ($2.26 in chips)
Seat 3: Special One4444 ($3.05 in chips)
Seat 4: SidneyCrosby8 ($2.91 in chips)
Seat 5: customdry244 ($1.65 in chips)
Seat 6: Morales7-PRO ($6.92 in chips)
Morales7-PRO: posts small blind $0.01
Alewel338: posts big blind $0.02
*** HOLE CARDS ***
Ramirres: folds
Special One4444: raises $0.04 to $0.06
SidneyCrosby8: raises $0.14 to $0.20
customdry244: folds
Morales7-PRO: folds
Alewel338: folds
Special One4444: calls $0.14
*** FLOP *** [3s 4d 9d]
Special One4444: checks
SidneyCrosby8: bets $0.28
Special One4444: folds
Uncalled bet ($0.28) returned to SidneyCrosby8
SidneyCrosby8 collected $0.41 from pot
SidneyCrosby8: doesn't show hand
*** SUMMARY ***
Total pot $0.43 | Rake $0.02
Board [3s 4d 9d]
Seat 1: Alewel338 (big blind) folded before Flop
Seat 2: Ramirres folded before Flop (didn't bet)
Seat 3: Special One4444 folded on the Flop
Seat 4: SidneyCrosby8 collected ($0.41)
Seat 5: customdry244 (button) folded before Flop (didn't bet)
Seat 6: Morales7-PRO (small blind) folded before Flop


PokerStars Hand #238173359651:  Hold'em No Limit ($0.01/$0.02 USD) - 2022/08/23 15:42:34 ET
Table 'Equinox IV' 6-max Seat #6 is the button
Seat 1: Alewel338 ($0.78 in chips)
Seat 2: Ramirres ($2.26 in chips)
Seat 3: Special One4444 ($2.85 in chips)
Seat 4: SidneyCrosby8 ($3.12 in chips)
Seat 5: customdry244 ($1.65 in chips)
Seat 6: Morales7-PRO ($6.91 in chips)
Alewel338: posts small blind $0.01
Ramirres: posts big blind $0.02
*** HOLE CARDS ***
Special One4444: raises $0.04 to $0.06
SidneyCrosby8: calls $0.06
customdry244: folds
Morales7-PRO: folds
Alewel338: folds
Ramirres: folds
*** FLOP *** [Ks Tc 6h]
Special One4444: bets $0.08
SidneyCrosby8: calls $0.08
*** TURN *** [Ks Tc 6h] [Jh]
Special One4444: bets $0.14
SidneyCrosby8: raises $0.40 to $0.54
Special One4444: calls $0.40
*** RIVER *** [Ks Tc 6h Jh] [9c]
Special One4444: checks
SidneyCrosby8: bets $1.14
Special One4444: calls $1.14
*** SHOW DOWN ***
SidneyCrosby8: shows [Ac Qc] (a straight, Ten to Ace)
Special One4444: mucks hand
SidneyCrosby8 collected $3.54 from pot
*** SUMMARY ***
Total pot $3.67 | Rake $0.13
Board [Ks Tc 6h Jh 9c]
Seat 1: Alewel338 (small blind) folded before Flop
Seat 2: Ramirres (big blind) folded before Flop
Seat 3: Special One4444 mucked
Seat 4: SidneyCrosby8 showed [Ac Qc] and won ($3.54) with a straight, Ten to Ace
Seat 5: customdry244 folded before Flop (didn't bet)
Seat 6: Morales7-PRO (button) folded before Flop (didn't bet)


PokerStars Hand #238173382797:  Hold'em No Limit ($0.01/$0.02 USD) - 2022/08/23 15:43:35 ET
Table 'Equinox IV' 6-max Seat #1 is the button
Seat 1: Alewel338 ($0.77 in chips)
Seat 2: Ramirres ($2.24 in chips)
Seat 3: Special One4444 ($1.03 in chips)
Seat 4: SidneyCrosby8 ($4.84 in chips)
Seat 5: customdry244 ($1.65 in chips)
Seat 6: Morales7-PRO ($6.91 in chips)
Ramirres: posts small blind $0.01
Special One4444: posts big blind $0.02
*** HOLE CARDS ***
SidneyCrosby8: folds
customdry244: folds
Morales7-PRO: folds
Alewel338: raises $0.04 to $0.06
Ramirres: folds
Special One4444: folds
Uncalled bet ($0.04) returned to Alewel338
Alewel338 collected $0.05 from pot
*** SUMMARY ***
Total pot $0.05 | Rake $0
Seat 1: Alewel338 (button) collected ($0.05)
Seat 2: Ramirres (small blind) folded before Flop
Seat 3: Special One4444 (big blind) folded before Flop
Seat 4: SidneyCrosby8 folded before Flop (didn't bet)
Seat 5: customdry244 folded before Flop (didn't bet)
Seat 6: Morales7-PRO folded before Flop (didn't bet)


PokerStars Hand #238173390723:  Hold'em No Limit ($0.01/$0.02 USD) - 2022/08/23 15:43:56 ET
Table 'Equinox IV' 6-max Seat #2 is the button
Seat 1: Alewel338 ($0.80 in chips)
Seat 2: Ramirres ($2.23 in chips)
Seat 3: Special One4444 ($1.01 in chips)
Seat 4: SidneyCrosby8 ($4.84 in chips)
Seat 5: customdry244 ($1.65 in chips)
Seat 6: Morales7-PRO ($6.91 in chips)
Special One4444: posts small blind $0.01
SidneyCrosby8: posts big blind $0.02
*** HOLE CARDS ***
customdry244: raises $0.02 to $0.04
Morales7-PRO: folds
Alewel338: calls $0.04
Ramirres: raises $0.20 to $0.24
Special One4444: folds
SidneyCrosby8: folds
customdry244: calls $0.20
Alewel338: calls $0.20
*** FLOP *** [9c Kc Ad]
customdry244: bets $1.41 and is all-in
Alewel338: folds
Ramirres: folds
Uncalled bet ($1.41) returned to customdry244
customdry244 collected $0.72 from pot
*** SUMMARY ***
Total pot $0.75 | Rake $0.03
Board [9c Kc Ad]
Seat 1: Alewel338 folded on the Flop
Seat 2: Ramirres (button) folded on the Flop
Seat 3: Special One4444 (small blind) folded before Flop
Seat 4: SidneyCrosby8 (big blind) folded before Flop
Seat 5: customdry244 collected ($0.72)
Seat 6: Morales7-PRO folded before Flop (didn't bet)


PokerStars Hand #238173402447:  Hold'em No Limit ($0.01/$0.02 USD) - 2022/08/23 15:44:27 ET
Table 'Equinox IV' 6-max Seat #3 is the button
Seat 1: Alewel338 ($0.56 in chips)
Seat 2: Ramirres ($2 in chips)
Seat 3: Special One4444 ($1 in chips)
Seat 4: SidneyCrosby8 ($4.82 in chips)
Seat 5: customdry244 ($2.13 in chips)
Seat 6: Morales7-PRO ($6.91 in chips)
SidneyCrosby8: posts small blind $0.01
customdry244: posts big blind $0.02
*** HOLE CARDS ***
Morales7-PRO: folds
Alewel338: folds
Ramirres: folds
Special One4444: folds
SidneyCrosby8: folds
Uncalled bet ($0.01) returned to customdry244
customdry244 collected $0.02 from pot
*** SUMMARY ***
Total pot $0.02 | Rake $0
Seat 1: Alewel338 folded before Flop (didn't bet)
Seat 2: Ramirres folded before Flop (didn't bet)
Seat 3: Special One4444 (button) folded before Flop (didn't bet)
Seat 4: SidneyCrosby8 (small blind) folded before Flop
Seat 5: customdry244 (big blind) collected ($0.02)
Seat 6: Morales7-PRO folded before Flop (didn't bet)


PokerStars Hand #238173407967:  Hold'em No Limit ($0.01/$0.02 USD) - 2022/08/23 15:44:41 ET
Table 'Equinox IV' 6-max Seat #4 is the button
Seat 1: Alewel338 ($0.56 in chips)
Seat 2: Ramirres ($2 in chips)
Seat 3: Special One4444 ($1 in chips)
Seat 4: SidneyCrosby8 ($4.81 in chips)
Seat 5: customdry244 ($2.14 in chips)
Seat 6: Morales7-PRO ($6.91 in chips)
customdry244: posts small blind $0.01
Morales7-PRO: posts big blind $0.02
*** HOLE CARDS ***
Alewel338: raises $0.04 to $0.06
Ramirres: folds
Special One4444: raises $0.04 to $0.10
SidneyCrosby8: folds
customdry244: folds
Morales7-PRO: folds
Alewel338: calls $0.04
*** FLOP *** [Ks As 4h]
Alewel338: bets $0.11
Special One4444: folds
Uncalled bet ($0.11) returned to Alewel338
Alewel338 collected $0.22 from pot
*** SUMMARY ***
Total pot $0.23 | Rake $0.01
Board [Ks As 4h]
Seat 1: Alewel338 collected ($0.22)
Seat 2: Ramirres folded before Flop (didn't bet)
Seat 3: Special One4444 folded on the Flop
Seat 4: SidneyCrosby8 (button) folded before Flop (didn't bet)
Seat 5: customdry244 (small blind) folded before Flop
Seat 6: Morales7-PRO (big blind) folded before Flop


PokerStars Hand #238173418171:  Hold'em No Limit ($0.01/$0.02 USD) - 2022/08/23 15:45:08 ET
Table 'Equinox IV' 6-max Seat #5 is the button
Seat 1: Alewel338 ($0.68 in chips)
Seat 2: Ramirres ($2 in chips)
Seat 3: Special One4444 ($0.90 in chips)
Seat 4: SidneyCrosby8 ($4.81 in chips)
Seat 5: customdry244 ($2.13 in chips)
Seat 6: Morales7-PRO ($6.89 in chips)
Morales7-PRO: posts small blind $0.01
Alewel338: posts big blind $0.02
*** HOLE CARDS ***
Ramirres: folds
Special One4444: folds
Special One4444 leaves the table
SidneyCrosby8: raises $0.04 to $0.06
customdry244: raises $0.04 to $0.10
Morales7-PRO: folds
Alewel338: calls $0.08
SidneyCrosby8: calls $0.04
*** FLOP *** [Qs Jd 7d]
Valkyrja955 joins the table at seat #3
Alewel338: checks
SidneyCrosby8: checks
customdry244: bets $2.03 and is all-in
Alewel338: calls $0.58 and is all-in
SidneyCrosby8: folds
Uncalled bet ($1.45) returned to customdry244
*** TURN *** [Qs Jd 7d] [6s]
*** RIVER *** [Qs Jd 7d 6s] [9c]
*** SHOW DOWN ***
Alewel338: shows [8h Ts] (a straight, Eight to Queen)
customdry244: shows [Ac Js] (a pair of Jacks)
Alewel338 collected $1.42 from pot
*** SUMMARY ***
Total pot $1.47 | Rake $0.05
Board [Qs Jd 7d 6s 9c]
Seat 1: Alewel338 (big blind) showed [8h Ts] and won ($1.42) with a straight, Eight to Queen
Seat 2: Ramirres folded before Flop (didn't bet)
Seat 3: Special One4444 folded before Flop (didn't bet)
Seat 4: SidneyCrosby8 folded on the Flop
Seat 5: customdry244 (button) showed [Ac Js] and lost with a pair of Jacks
Seat 6: Morales7-PRO (small blind) folded before Flop


PokerStars Hand #238173451832:  Hold'em No Limit ($0.01/$0.02 USD) - 2022/08/23 15:46:37 ET
Table 'Equinox IV' 6-max Seat #1 is the button
Seat 1: Alewel338 ($1.62 in chips)
Seat 2: Ramirres ($2 in chips)
Seat 3: Valkyrja955 ($0.80 in chips)
Seat 4: SidneyCrosby8 ($4.71 in chips)
Seat 5: customdry244 ($1.43 in chips)
Seat 6: Morales7-PRO ($6.88 in chips)
Ramirres: posts small blind $0.01
Valkyrja955: posts big blind $0.02
*** HOLE CARDS ***
SidneyCrosby8: folds
customdry244: raises $0.02 to $0.04
Morales7-PRO: folds
Alewel338: folds
Ramirres: folds
Valkyrja955: folds
Uncalled bet ($0.02) returned to customdry244
customdry244 collected $0.05 from pot
*** SUMMARY ***
Total pot $0.05 | Rake $0
Seat 1: Alewel338 (button) folded before Flop (didn't bet)
Seat 2: Ramirres (small blind) folded before Flop
Seat 3: Valkyrja955 (big blind) folded before Flop
Seat 4: SidneyCrosby8 folded before Flop (didn't bet)
Seat 5: customdry244 collected ($0.05)
Seat 6: Morales7-PRO folded before Flop (didn't bet)


PokerStars Hand #238173437243:  Hold'em No Limit ($0.01/$0.02 USD) - 2022/08/23 15:45:58 ET
Table 'Equinox IV' 6-max Seat #6 is the button
Seat 1: Alewel338 ($1.42 in chips)
Seat 2: Ramirres ($2 in chips)
Seat 4: SidneyCrosby8 ($4.71 in chips)
Seat 5: customdry244 ($1.45 in chips)
Seat 6: Morales7-PRO ($6.88 in chips)
Alewel338: posts small blind $0.01
Ramirres: posts big blind $0.02
Valkyrja955: sits out
*** HOLE CARDS ***
SidneyCrosby8: folds
customdry244: calls $0.02
Morales7-PRO: folds
Alewel338: raises $0.04 to $0.06
Ramirres: raises $0.12 to $0.18
customdry244: folds
Alewel338: raises $0.12 to $0.30
Ramirres: folds
Uncalled bet ($0.12) returned to Alewel338
Alewel338 collected $0.38 from pot
*** SUMMARY ***
Total pot $0.38 | Rake $0
Seat 1: Alewel338 (small blind) collected ($0.38)
Seat 2: Ramirres (big blind) folded before Flop
Seat 4: SidneyCrosby8 folded before Flop (didn't bet)
Seat 5: customdry244 folded before Flop
Seat 6: Morales7-PRO (button) folded before Flop (didn't bet)


PokerStars Hand #238173455639:  Hold'em No Limit ($0.01/$0.02 USD) - 2022/08/23 15:46:47 ET
Table 'Equinox IV' 6-max Seat #2 is the button
Seat 1: Alewel338 ($1.62 in chips)
Seat 2: Ramirres ($2 in chips)
Seat 3: Valkyrja955 ($0.78 in chips)
Seat 5: customdry244 ($1.46 in chips)
Seat 6: Morales7-PRO ($6.88 in chips)
Valkyrja955: posts small blind $0.01
SidneyCrosby8: is sitting out
customdry244: posts big blind $0.02
*** HOLE CARDS ***
SidneyCrosby8 leaves the table
Morales7-PRO: folds
Alewel338: raises $0.04 to $0.06
RWN/NWR joins the table at seat #4
Ramirres: folds
Valkyrja955: folds
customdry244: calls $0.04
*** FLOP *** [Kh 5s 3d]
customdry244: checks
Alewel338: bets $0.06
customdry244: calls $0.06
*** TURN *** [Kh 5s 3d] [4c]
customdry244: checks
Alewel338: checks
*** RIVER *** [Kh 5s 3d 4c] [8s]
customdry244: checks
Alewel338: checks
*** SHOW DOWN ***
customdry244: shows [Th 9c] (high card King)
Alewel338: shows [As 3c] (a pair of Threes)
Alewel338 collected $0.24 from pot
*** SUMMARY ***
Total pot $0.25 | Rake $0.01
Board [Kh 5s 3d 4c 8s]
Seat 1: Alewel338 showed [As 3c] and won ($0.24) with a pair of Threes
Seat 2: Ramirres (button) folded before Flop (didn't bet)
Seat 3: Valkyrja955 (small blind) folded before Flop
Seat 5: customdry244 (big blind) showed [Th 9c] and lost with high card King
Seat 6: Morales7-PRO folded before Flop (didn't bet)


PokerStars Hand #238173470103:  Hold'em No Limit ($0.01/$0.02 USD) - 2022/08/23 15:47:25 ET
Table 'Equinox IV' 6-max Seat #3 is the button
Seat 1: Alewel338 ($1.74 in chips)
Seat 2: Ramirres ($2 in chips)
Seat 3: Valkyrja955 ($0.77 in chips)
Seat 5: customdry244 ($1.34 in chips)
Seat 6: Morales7-PRO ($6.88 in chips)
customdry244: posts small blind $0.01
Morales7-PRO: posts big blind $0.02
*** HOLE CARDS ***
Alewel338: raises $0.04 to $0.06
Ramirres: folds
Valkyrja955: folds
customdry244: folds
Morales7-PRO: calls $0.04
*** FLOP *** [Ks 5h 8h]
Morales7-PRO: checks
Alewel338: bets $0.02
Morales7-PRO: raises $0.13 to $0.15
Alewel338: folds
Uncalled bet ($0.13) returned to Morales7-PRO
Morales7-PRO collected $0.16 from pot
Morales7-PRO: doesn't show hand
*** SUMMARY ***
Total pot $0.17 | Rake $0.01
Board [Ks 5h 8h]
Seat 1: Alewel338 folded on the Flop
Seat 2: Ramirres folded before Flop (didn't bet)
Seat 3: Valkyrja955 (button) folded before Flop (didn't bet)
Seat 5: customdry244 (small blind) folded before Flop
Seat 6: Morales7-PRO (big blind) collected ($0.16)


PokerStars Hand #238173484398:  Hold'em No Limit ($0.01/$0.02 USD) - 2022/08/23 15:48:02 ET
Table 'Equinox IV' 6-max Seat #5 is the button
Seat 1: Alewel338 ($1.66 in chips)
Seat 2: Ramirres ($2 in chips)
Seat 3: Valkyrja955 ($0.77 in chips)
Seat 5: customdry244 ($1.33 in chips)
Seat 6: Morales7-PRO ($6.96 in chips)
Morales7-PRO: posts small blind $0.01
Alewel338: posts big blind $0.02
RWN/NWR: sits out
*** HOLE CARDS ***
Ramirres: folds
Valkyrja955: folds
customdry244: raises $0.02 to $0.04
Morales7-PRO: folds
Alewel338: folds
Uncalled bet ($0.02) returned to customdry244
customdry244 collected $0.05 from pot
*** SUMMARY ***
Total pot $0.05 | Rake $0
Seat 1: Alewel338 (big blind) folded before Flop
Seat 2: Ramirres folded before Flop (didn't bet)
Seat 3: Valkyrja955 folded before Flop (didn't bet)
Seat 5: customdry244 (button) collected ($0.05)
Seat 6: Morales7-PRO (small blind) folded before Flop


PokerStars Hand #238173488594:  Hold'em No Limit ($0.01/$0.02 USD) - 2022/08/23 15:48:13 ET
Table 'Equinox IV' 6-max Seat #6 is the button
Seat 1: Alewel338 ($1.64 in chips)
Seat 2: Ramirres ($2 in chips)
Seat 3: Valkyrja955 ($0.77 in chips)
Seat 4: RWN/NWR ($2 in chips)
Seat 5: customdry244 ($1.36 in chips)
Seat 6: Morales7-PRO ($6.95 in chips)
Alewel338: posts small blind $0.01
Ramirres: posts big blind $0.02
RWN/NWR: posts big blind $0.02
*** HOLE CARDS ***
Valkyrja955: folds
RWN/NWR: checks
customdry244: folds
Morales7-PRO: folds
Alewel338: raises $0.04 to $0.06
Ramirres: calls $0.04
RWN/NWR: calls $0.04
*** FLOP *** [Td 4c Kd]
customdry244 is disconnected
Alewel338: bets $0.08
Ramirres: folds
RWN/NWR: folds
Uncalled bet ($0.08) returned to Alewel338
Alewel338 collected $0.17 from pot
*** SUMMARY ***
Total pot $0.18 | Rake $0.01
Board [Td 4c Kd]
Seat 1: Alewel338 (small blind) collected ($0.17)
Seat 2: Ramirres (big blind) folded on the Flop
Seat 3: Valkyrja955 folded before Flop (didn't bet)
Seat 4: RWN/NWR folded on the Flop
Seat 5: customdry244 folded before Flop (didn't bet)
Seat 6: Morales7-PRO (button) folded before Flop (didn't bet)


PokerStars Hand #238173510201:  Hold'em No Limit ($0.01/$0.02 USD) - 2022/08/23 15:49:10 ET
Table 'Equinox IV' 6-max Seat #1 is the button
Seat 1: Alewel338 ($1.75 in chips)
Seat 2: Ramirres ($2 in chips)
Seat 3: Valkyrja955 ($0.77 in chips)
Seat 4: RWN/NWR ($1.94 in chips)
Seat 5: customdry244 ($1.36 in chips)
Seat 6: Morales7-PRO ($6.95 in chips)
Ramirres: posts small blind $0.01
Valkyrja955: posts big blind $0.02
*** HOLE CARDS ***
RWN/NWR: folds
customdry244 has timed out while disconnected
customdry244: folds
Morales7-PRO: folds
Alewel338: folds
Ramirres: raises $0.03 to $0.05
Valkyrja955: folds
Uncalled bet ($0.03) returned to Ramirres
Ramirres collected $0.04 from pot
*** SUMMARY ***
Total pot $0.04 | Rake $0
Seat 1: Alewel338 (button) folded before Flop (didn't bet)
Seat 2: Ramirres (small blind) collected ($0.04)
Seat 3: Valkyrja955 (big blind) folded before Flop
Seat 4: RWN/NWR folded before Flop (didn't bet)
Seat 5: customdry244 folded before Flop (didn't bet)
Seat 6: Morales7-PRO folded before Flop (didn't bet)


PokerStars Hand #238173524948:  Hold'em No Limit ($0.01/$0.02 USD) - 2022/08/23 15:49:49 ET
Table 'Equinox IV' 6-max Seat #3 is the button
Seat 1: Alewel338 ($1.78 in chips)
Seat 2: Ramirres ($2.02 in chips)
Seat 3: Valkyrja955 ($0.74 in chips)
Seat 4: RWN/NWR ($1.92 in chips)
RWN/NWR: posts small blind $0.01
Morales7-PRO: is sitting out
Alewel338: posts big blind $0.02
*** HOLE CARDS ***
Morales7-PRO leaves the table
Ramirres: folds
Valkyrja955: folds
RWN/NWR: folds
Uncalled bet ($0.01) returned to Alewel338
Alewel338 collected $0.02 from pot
*** SUMMARY ***
Total pot $0.02 | Rake $0
Seat 1: Alewel338 (big blind) collected ($0.02)
Seat 2: Ramirres folded before Flop (didn't bet)
Seat 3: Valkyrja955 (button) folded before Flop (didn't bet)
Seat 4: RWN/NWR (small blind) folded before Flop


PokerStars Hand #238173520133:  Hold'em No Limit ($0.01/$0.02 USD) - 2022/08/23 15:49:36 ET
Table 'Equinox IV' 6-max Seat #2 is the button
Seat 1: Alewel338 ($1.75 in chips)
Seat 2: Ramirres ($2.02 in chips)
Seat 3: Valkyrja955 ($0.75 in chips)
Seat 4: RWN/NWR ($1.94 in chips)
Seat 6: Morales7-PRO ($6.95 in chips)
Valkyrja955: posts small blind $0.01
RWN/NWR: posts big blind $0.02
*** HOLE CARDS ***
Morales7-PRO: folds
Alewel338: raises $0.04 to $0.06
Ramirres: folds
Valkyrja955: folds
RWN/NWR: folds
Uncalled bet ($0.04) returned to Alewel338
Alewel338 collected $0.05 from pot
*** SUMMARY ***
Total pot $0.05 | Rake $0
Seat 1: Alewel338 collected ($0.05)
Seat 2: Ramirres (button) folded before Flop (didn't bet)
Seat 3: Valkyrja955 (small blind) folded before Flop
Seat 4: RWN/NWR (big blind) folded before Flop
Seat 6: Morales7-PRO folded before Flop (didn't bet)


PokerStars Hand #238173528145:  Hold'em No Limit ($0.01/$0.02 USD) - 2022/08/23 15:49:57 ET
Table 'Equinox IV' 6-max Seat #4 is the button
Seat 1: Alewel338 ($1.79 in chips)
Seat 3: Valkyrja955 ($0.74 in chips)
Seat 4: RWN/NWR ($1.91 in chips)
Alewel338: posts small blind $0.01
Ramirres: is sitting out
Valkyrja955: posts big blind $0.02
*** HOLE CARDS ***
Ramirres leaves the table
MrDonRich joins the table at seat #6
RWN/NWR: folds
Alewel338: calls $0.01
Valkyrja955: checks
*** FLOP *** [Kd Jd 9d]
Alewel338: bets $0.02
Valkyrja955: folds
Uncalled bet ($0.02) returned to Alewel338
Alewel338 collected $0.04 from pot
*** SUMMARY ***
Total pot $0.04 | Rake $0
Board [Kd Jd 9d]
Seat 1: Alewel338 (small blind) collected ($0.04)
Seat 3: Valkyrja955 (big blind) folded on the Flop
Seat 4: RWN/NWR (button) folded before Flop (didn't bet)


PokerStars Hand #238173536415:  Hold'em No Limit ($0.01/$0.02 USD) - 2022/08/23 15:50:18 ET
Table 'Equinox IV' 6-max Seat #1 is the button
Seat 1: Alewel338 ($1.81 in chips)
Seat 3: Valkyrja955 ($0.72 in chips)
Seat 4: RWN/NWR ($1.91 in chips)
Valkyrja955: posts small blind $0.01
RWN/NWR: posts big blind $0.02
customdry244: sits out
MrDonRich: sits out
*** HOLE CARDS ***
Alewel338: raises $0.04 to $0.06
Valkyrja955: folds
TorusPower joins the table at seat #2
RWN/NWR: calls $0.04
*** FLOP *** [Kd 8c 3h]
RWN/NWR: checks
Alewel338: bets $0.06
RWN/NWR: calls $0.06
*** TURN *** [Kd 8c 3h] [2h]
RWN/NWR: checks
Alewel338: checks
*** RIVER *** [Kd 8c 3h 2h] [8h]
RWN/NWR: bets $0.04
Alewel338: calls $0.04
*** SHOW DOWN ***
RWN/NWR: shows [6d 3d] (two pair, Eights and Threes)
Alewel338: shows [Ad 3s] (two pair, Eights and Threes - Ace kicker)
Alewel338 collected $0.32 from pot
*** SUMMARY ***
Total pot $0.33 | Rake $0.01
Board [Kd 8c 3h 2h 8h]
Seat 1: Alewel338 (button) showed [Ad 3s] and won ($0.32) with two pair, Eights and Threes
Seat 3: Valkyrja955 (small blind) folded before Flop
Seat 4: RWN/NWR (big blind) showed [6d 3d] and lost with two pair, Eights and Threes


PokerStars Hand #238173553123:  Hold'em No Limit ($0.01/$0.02 USD) - 2022/08/23 15:51:02 ET
Table 'Equinox IV' 6-max Seat #3 is the button
Seat 1: Alewel338 ($1.97 in chips)
Seat 2: TorusPower ($2 in chips)
Seat 3: Valkyrja955 ($0.71 in chips)
Seat 4: RWN/NWR ($1.75 in chips)
Seat 5: customdry244 ($1.36 in chips)
RWN/NWR: posts small blind $0.01
customdry244: posts big blind $0.02
MrDonRich: sits out
TorusPower: posts big blind $0.02
*** HOLE CARDS ***
Alewel338: raises $0.04 to $0.06
TorusPower: calls $0.04
Valkyrja955: folds
RWN/NWR: raises $0.24 to $0.30
customdry244: folds
Alewel338: folds
TorusPower: calls $0.24
*** FLOP *** [Qc 7h 6s]
RWN/NWR: bets $0.47
TorusPower: raises $1.23 to $1.70 and is all-in
RWN/NWR: calls $0.98 and is all-in
Uncalled bet ($0.25) returned to TorusPower
*** TURN *** [Qc 7h 6s] [7c]
*** RIVER *** [Qc 7h 6s 7c] [2h]
*** SHOW DOWN ***
RWN/NWR: shows [Ks Kd] (two pair, Kings and Sevens)
TorusPower: shows [9c Qh] (two pair, Queens and Sevens)
RWN/NWR collected $3.45 from pot
*** SUMMARY ***
Total pot $3.58 | Rake $0.13
Board [Qc 7h 6s 7c 2h]
Seat 1: Alewel338 folded before Flop
Seat 2: TorusPower showed [9c Qh] and lost with two pair, Queens and Sevens
Seat 3: Valkyrja955 (button) folded before Flop (didn't bet)
Seat 4: RWN/NWR (small blind) showed [Ks Kd] and won ($3.45) with two pair, Kings and Sevens
Seat 5: customdry244 (big blind) folded before Flop


PokerStars Hand #238173573575:  Hold'em No Limit ($0.01/$0.02 USD) - 2022/08/23 15:51:56 ET
Table 'Equinox IV' 6-max Seat #4 is the button
Seat 1: Alewel338 ($1.91 in chips)
Seat 2: TorusPower ($0.25 in chips)
Seat 3: Valkyrja955 ($0.71 in chips)
Seat 4: RWN/NWR ($3.45 in chips)
Seat 5: customdry244 ($1.34 in chips)
Seat 6: MrDonRich ($2 in chips)
customdry244: posts small blind $0.01
MrDonRich: posts big blind $0.02
*** HOLE CARDS ***
Alewel338: raises $0.04 to $0.06
TorusPower: raises $0.19 to $0.25 and is all-in
Valkyrja955: folds
RWN/NWR: folds
customdry244: calls $0.24
MrDonRich: raises $1.75 to $2 and is all-in
Alewel338: folds
customdry244: calls $1.09 and is all-in
Uncalled bet ($0.66) returned to MrDonRich
*** FLOP *** [2d 6s 5c]
*** TURN *** [2d 6s 5c] [5h]
*** RIVER *** [2d 6s 5c 5h] [Jd]
*** SHOW DOWN ***
customdry244: shows [8d 8s] (two pair, Eights and Fives)
MrDonRich: shows [As Ks] (a pair of Fives)
customdry244 collected $2.11 from side pot
TorusPower: shows [Qh 8c] (a pair of Fives)
customdry244 collected $0.78 from main pot
*** SUMMARY ***
Total pot $2.99 Main pot $0.78. Side pot $2.11. | Rake $0.10
Board [2d 6s 5c 5h Jd]
Seat 1: Alewel338 folded before Flop
Seat 2: TorusPower showed [Qh 8c] and lost with a pair of Fives
Seat 3: Valkyrja955 folded before Flop (didn't bet)
Seat 4: RWN/NWR (button) folded before Flop (didn't bet)
Seat 5: customdry244 (small blind) showed [8d 8s] and won ($2.89) with two pair, Eights and Fives
Seat 6: MrDonRich (big blind) showed [As Ks] and lost with a pair of Fives


PokerStars Hand #238173594163:  Hold'em No Limit ($0.01/$0.02 USD) - 2022/08/23 15:52:36 ET
Table 'Equinox IV' 6-max Seat #5 is the button
Seat 1: Alewel338 ($1.85 in chips)
Seat 3: Valkyrja955 ($0.71 in chips)
Seat 4: RWN/NWR ($3.45 in chips)
Seat 5: customdry244 ($2.89 in chips)
Seat 6: MrDonRich ($2 in chips)
MrDonRich: posts small blind $0.01
Alewel338: posts big blind $0.02
*** HOLE CARDS ***
Valkyrja955: folds
RWN/NWR: folds
customdry244: calls $0.02
MrDonRich: calls $0.01
TorusPower leaves the table
Alewel338: raises $0.04 to $0.06
customdry244: calls $0.04
MrDonRich: calls $0.04
*** FLOP *** [7s 3h 2c]
MrDonRich: checks
Alewel338: bets $0.08
customdry244: folds
NIKITCHENKO0729 joins the table at seat #2
MrDonRich: raises $0.08 to $0.16
Alewel338: calls $0.08
*** TURN *** [7s 3h 2c] [7d]
MrDonRich: checks
Alewel338: checks
*** RIVER *** [7s 3h 2c 7d] [2h]
MrDonRich: checks
Alewel338: bets $0.24
MrDonRich: calls $0.24
*** SHOW DOWN ***
Alewel338: shows [4s As] (two pair, Sevens and Deuces)
MrDonRich: shows [3d 3c] (a full house, Threes full of Sevens)
MrDonRich collected $0.95 from pot
*** SUMMARY ***
Total pot $0.98 | Rake $0.03
Board [7s 3h 2c 7d 2h]
Seat 1: Alewel338 (big blind) showed [4s As] and lost with two pair, Sevens and Deuces
Seat 3: Valkyrja955 folded before Flop (didn't bet)
Seat 4: RWN/NWR folded before Flop (didn't bet)
Seat 5: customdry244 (button) folded on the Flop
Seat 6: MrDonRich (small blind) showed [3d 3c] and won ($0.95) with a full house, Threes full of Sevens


PokerStars Hand #238173618104:  Hold'em No Limit ($0.01/$0.02 USD) - 2022/08/23 15:53:38 ET
Table 'Equinox IV' 6-max Seat #6 is the button
Seat 1: Alewel338 ($1.39 in chips)
Seat 2: NIKITCHENKO0729 ($0.80 in chips)
Seat 3: Valkyrja955 ($0.71 in chips)
Seat 4: RWN/NWR ($3.45 in chips)
Seat 5: customdry244 ($2.83 in chips)
Seat 6: MrDonRich ($2.49 in chips)
Alewel338: posts small blind $0.01
NIKITCHENKO0729: posts big blind $0.02
*** HOLE CARDS ***
Valkyrja955: folds
RWN/NWR: folds
customdry244: folds
MrDonRich: folds
Alewel338: folds
Uncalled bet ($0.01) returned to NIKITCHENKO0729
NIKITCHENKO0729 collected $0.02 from pot
*** SUMMARY ***
Total pot $0.02 | Rake $0
Seat 1: Alewel338 (small blind) folded before Flop
Seat 2: NIKITCHENKO0729 (big blind) collected ($0.02)
Seat 3: Valkyrja955 folded before Flop (didn't bet)
Seat 4: RWN/NWR folded before Flop (didn't bet)
Seat 5: customdry244 folded before Flop (didn't bet)
Seat 6: MrDonRich (button) folded before Flop (didn't bet)


PokerStars Hand #238173622537:  Hold'em No Limit ($0.01/$0.02 USD) - 2022/08/23 15:53:50 ET
Table 'Equinox IV' 6-max Seat #1 is the button
Seat 1: Alewel338 ($1.38 in chips)
Seat 2: NIKITCHENKO0729 ($0.81 in chips)
Seat 3: Valkyrja955 ($0.71 in chips)
Seat 4: RWN/NWR ($3.45 in chips)
Seat 5: customdry244 ($2.83 in chips)
Seat 6: MrDonRich ($2.49 in chips)
NIKITCHENKO0729: posts small blind $0.01
Valkyrja955: posts big blind $0.02
*** HOLE CARDS ***
RWN/NWR: folds
customdry244: folds
MrDonRich: folds
Alewel338: folds
Alewel338 leaves the table
NIKITCHENKO0729: folds
Uncalled bet ($0.01) returned to Valkyrja955
Valkyrja955 collected $0.02 from pot
*** SUMMARY ***
Total pot $0.02 | Rake $0
Seat 1: Alewel338 (button) folded before Flop (didn't bet)
Seat 2: NIKITCHENKO0729 (small blind) folded before Flop
Seat 3: Valkyrja955 (big blind) collected ($0.02)
Seat 4: RWN/NWR folded before Flop (didn't bet)
Seat 5: customdry244 folded before Flop (didn't bet)
Seat 6: MrDonRich folded before Flop (didn't bet)


PokerStars Hand #238173649491:  Hold'em No Limit ($0.01/$0.02 USD) - 2022/08/23 15:55:00 ET
Table 'Equinox IV' 6-max Seat #3 is the button
Seat 2: NIKITCHENKO0729 ($0.80 in chips)
Seat 3: Valkyrja955 ($0.98 in chips)
Seat 4: RWN/NWR ($3.43 in chips)
Seat 5: customdry244 ($2.83 in chips)
Seat 6: MrDonRich ($2 in chips)
RWN/NWR: posts small blind $0.01
customdry244: posts big blind $0.02
maraljero: sits out
*** HOLE CARDS ***
MrDonRich: folds
NIKITCHENKO0729: calls $0.02
Valkyrja955: folds
RWN/NWR: calls $0.01
customdry244: checks
*** FLOP *** [2c Ah 8h]
RWN/NWR: checks
customdry244: checks
NIKITCHENKO0729: bets $0.02
RWN/NWR: folds
customdry244: folds
Uncalled bet ($0.02) returned to NIKITCHENKO0729
NIKITCHENKO0729 collected $0.06 from pot
*** SUMMARY ***
Total pot $0.06 | Rake $0
Board [2c Ah 8h]
Seat 2: NIKITCHENKO0729 collected ($0.06)
Seat 3: Valkyrja955 (button) folded before Flop (didn't bet)
Seat 4: RWN/NWR (small blind) folded on the Flop
Seat 5: customdry244 (big blind) folded on the Flop
Seat 6: MrDonRich folded before Flop (didn't bet)


PokerStars Hand #238173659889:  Hold'em No Limit ($0.01/$0.02 USD) - 2022/08/23 15:55:32 ET
Table 'Equinox IV' 6-max Seat #4 is the button
Seat 2: NIKITCHENKO0729 ($0.84 in chips)
Seat 3: Valkyrja955 ($0.98 in chips)
Seat 4: RWN/NWR ($3.41 in chips)
Seat 5: customdry244 ($2.81 in chips)
Seat 6: MrDonRich ($2 in chips)
customdry244: posts small blind $0.01
MrDonRich: posts big blind $0.02
maraljero: sits out
*** HOLE CARDS ***
NIKITCHENKO0729: folds
Valkyrja955: calls $0.02
RWN/NWR has timed out
RWN/NWR: folds
customdry244: calls $0.01
MrDonRich: checks
*** FLOP *** [8h 9s Td]
customdry244: bets $0.04
MrDonRich: folds
Valkyrja955: calls $0.04
*** TURN *** [8h 9s Td] [Ts]
customdry244: bets $0.04
Valkyrja955: calls $0.04
*** RIVER *** [8h 9s Td Ts] [2d]
customdry244: checks
Valkyrja955: checks
*** SHOW DOWN ***
customdry244: shows [9c 5s] (two pair, Tens and Nines)
Valkyrja955: mucks hand
customdry244 collected $0.21 from pot
*** SUMMARY ***
Total pot $0.22 | Rake $0.01
Board [8h 9s Td Ts 2d]
Seat 2: NIKITCHENKO0729 folded before Flop (didn't bet)
Seat 3: Valkyrja955 mucked
Seat 4: RWN/NWR (button) folded before Flop (didn't bet)
Seat 5: customdry244 (small blind) showed [9c 5s] and won ($0.21) with two pair, Tens and Nines
Seat 6: MrDonRich (big blind) folded on the Flop


PokerStars Hand #238173676491:  Hold'em No Limit ($0.01/$0.02 USD) - 2022/08/23 15:56:30 ET
Table 'Equinox IV' 6-max Seat #5 is the button
Seat 1: maraljero ($1.37 in chips)
Seat 2: NIKITCHENKO0729 ($0.84 in chips)
Seat 3: Valkyrja955 ($0.88 in chips)
Seat 4: RWN/NWR ($3.41 in chips)
Seat 5: customdry244 ($2.92 in chips)
Seat 6: MrDonRich ($1.98 in chips)
MrDonRich: posts small blind $0.01
maraljero: posts big blind $0.02
*** HOLE CARDS ***
NIKITCHENKO0729: folds
Valkyrja955: folds
RWN/NWR: folds
customdry244: folds
MrDonRich: calls $0.01
maraljero: checks
*** FLOP *** [5s Ah Th]
MrDonRich: checks
maraljero: checks
*** TURN *** [5s Ah Th] [4s]
MrDonRich: checks
maraljero: checks
*** RIVER *** [5s Ah Th 4s] [Qc]
MrDonRich: checks
maraljero: bets $0.02
MrDonRich: folds
Uncalled bet ($0.02) returned to maraljero
maraljero collected $0.04 from pot
maraljero: doesn't show hand
*** SUMMARY ***
Total pot $0.04 | Rake $0
Board [5s Ah Th 4s Qc]
Seat 1: maraljero (big blind) collected ($0.04)
Seat 2: NIKITCHENKO0729 folded before Flop (didn't bet)
Seat 3: Valkyrja955 folded before Flop (didn't bet)
Seat 4: RWN/NWR folded before Flop (didn't bet)
Seat 5: customdry244 (button) folded before Flop (didn't bet)
Seat 6: MrDonRich (small blind) folded on the River


PokerStars Hand #238173685193:  Hold'em No Limit ($0.01/$0.02 USD) - 2022/08/23 15:57:01 ET
Table 'Equinox IV' 6-max Seat #6 is the button
Seat 1: maraljero ($1.39 in chips)
Seat 2: NIKITCHENKO0729 ($0.84 in chips)
Seat 3: Valkyrja955 ($0.88 in chips)
Seat 4: RWN/NWR ($3.41 in chips)
Seat 5: customdry244 ($2.92 in chips)
Seat 6: MrDonRich ($1.96 in chips)
maraljero: posts small blind $0.01
NIKITCHENKO0729: posts big blind $0.02
*** HOLE CARDS ***
Valkyrja955: folds
RWN/NWR: folds
customdry244: folds
MrDonRich: calls $0.02
maraljero: calls $0.01
NIKITCHENKO0729: checks
*** FLOP *** [6h 7d 9s]
maraljero: bets $0.02
NIKITCHENKO0729: calls $0.02
MrDonRich: raises $0.02 to $0.04
maraljero: calls $0.02
NIKITCHENKO0729: calls $0.02
*** TURN *** [6h 7d 9s] [Ah]
maraljero: bets $0.08
NIKITCHENKO0729: raises $0.08 to $0.16
MrDonRich: raises $1.74 to $1.90 and is all-in
maraljero: folds
NIKITCHENKO0729: calls $0.62 and is all-in
Uncalled bet ($1.12) returned to MrDonRich
*** RIVER *** [6h 7d 9s Ah] [5h]
*** SHOW DOWN ***
NIKITCHENKO0729: shows [6s Ad] (two pair, Aces and Sixes)
MrDonRich: shows [9h 9c] (three of a kind, Nines)
MrDonRich collected $1.76 from pot
*** SUMMARY ***
Total pot $1.82 | Rake $0.06
Board [6h 7d 9s Ah 5h]
Seat 1: maraljero (small blind) folded on the Turn
Seat 2: NIKITCHENKO0729 (big blind) showed [6s Ad] and lost with two pair, Aces and Sixes
Seat 3: Valkyrja955 folded before Flop (didn't bet)
Seat 4: RWN/NWR folded before Flop (didn't bet)
Seat 5: customdry244 folded before Flop (didn't bet)
Seat 6: MrDonRich (button) showed [9h 9c] and won ($1.76) with three of a kind, Nines


PokerStars Hand #238173710449:  Hold'em No Limit ($0.01/$0.02 USD) - 2022/08/23 15:58:24 ET
Table 'Equinox IV' 6-max Seat #1 is the button
Seat 1: maraljero ($1.25 in chips)
Seat 3: Valkyrja955 ($0.88 in chips)
Seat 4: RWN/NWR ($3.41 in chips)
Seat 5: customdry244 ($2.92 in chips)
Seat 6: MrDonRich ($2.88 in chips)
Valkyrja955: posts small blind $0.01
RWN/NWR: posts big blind $0.02
*** HOLE CARDS ***
customdry244: calls $0.02
MrDonRich: calls $0.02
maraljero: folds
Valkyrja955: raises $0.02 to $0.04
RWN/NWR: folds
customdry244: calls $0.02
MrDonRich: calls $0.02
*** FLOP *** [8c As Ks]
NIKITCHENKO0729 leaves the table
Valkyrja955: bets $0.02
customdry244: calls $0.02
Haliankou joins the table at seat #2
MrDonRich: calls $0.02
*** TURN *** [8c As Ks] [3s]
Valkyrja955: bets $0.02
customdry244: calls $0.02
MrDonRich: folds
*** RIVER *** [8c As Ks 3s] [Kd]
Valkyrja955: bets $0.11
customdry244: folds
Uncalled bet ($0.11) returned to Valkyrja955
Valkyrja955 collected $0.23 from pot
*** SUMMARY ***
Total pot $0.24 | Rake $0.01
Board [8c As Ks 3s Kd]
Seat 1: maraljero (button) folded before Flop (didn't bet)
Seat 3: Valkyrja955 (small blind) collected ($0.23)
Seat 4: RWN/NWR (big blind) folded before Flop
Seat 5: customdry244 folded on the River
Seat 6: MrDonRich folded on the Turn


PokerStars Hand #238173724439:  Hold'em No Limit ($0.01/$0.02 USD) - 2022/08/23 15:59:12 ET
Table 'Equinox IV' 6-max Seat #3 is the button
Seat 1: maraljero ($1.25 in chips)
Seat 3: Valkyrja955 ($1.03 in chips)
Seat 4: RWN/NWR ($3.39 in chips)
Seat 5: customdry244 ($2.84 in chips)
Seat 6: MrDonRich ($2.82 in chips)
RWN/NWR: posts small blind $0.01
customdry244: posts big blind $0.02
Haliankou: sits out
*** HOLE CARDS ***
MrDonRich: raises $0.04 to $0.06
maraljero: calls $0.06
Valkyrja955: calls $0.06
RWN/NWR: calls $0.05
customdry244: calls $0.04
*** FLOP *** [Qs 4c Kh]
RWN/NWR: checks
customdry244: bets $0.30
MrDonRich: folds
maraljero: folds
Valkyrja955: calls $0.30
RWN/NWR: folds
*** TURN *** [Qs 4c Kh] [2d]
customdry244: checks
Valkyrja955: bets $0.02
customdry244: raises $0.26 to $0.28
Valkyrja955: calls $0.26
*** RIVER *** [Qs 4c Kh 2d] [9d]
customdry244: checks
Valkyrja955: checks
*** SHOW DOWN ***
customdry244: shows [Kc 6h] (a pair of Kings)
Valkyrja955: shows [Jc Kd] (a pair of Kings - Queen+Jack kicker)
Valkyrja955 collected $1.41 from pot
*** SUMMARY ***
Total pot $1.46 | Rake $0.05
Board [Qs 4c Kh 2d 9d]
Seat 1: maraljero folded on the Flop
Seat 3: Valkyrja955 (button) showed [Jc Kd] and won ($1.41) with a pair of Kings
Seat 4: RWN/NWR (small blind) folded on the Flop
Seat 5: customdry244 (big blind) showed [Kc 6h] and lost with a pair of Kings
Seat 6: MrDonRich folded on the Flop


PokerStars Hand #238173745764:  Hold'em No Limit ($0.01/$0.02 USD) - 2022/08/23 16:00:25 ET
Table 'Equinox IV' 6-max Seat #4 is the button
Seat 1: maraljero ($1.19 in chips)
Seat 3: Valkyrja955 ($1.80 in chips)
Seat 4: RWN/NWR ($3.33 in chips)
Seat 5: customdry244 ($2.20 in chips)
Seat 6: MrDonRich ($2.76 in chips)
customdry244: posts small blind $0.01
MrDonRich: posts big blind $0.02
Haliankou: sits out
*** HOLE CARDS ***
maraljero: folds
Valkyrja955: folds
RWN/NWR: raises $0.02 to $0.04
customdry244: calls $0.03
MrDonRich: calls $0.02
*** FLOP *** [Qh 4s Jc]
customdry244: checks
MrDonRich: checks
RWN/NWR: bets $0.08
customdry244: folds
MrDonRich: folds
Uncalled bet ($0.08) returned to RWN/NWR
RWN/NWR collected $0.12 from pot
*** SUMMARY ***
Total pot $0.12 | Rake $0
Board [Qh 4s Jc]
Seat 1: maraljero folded before Flop (didn't bet)
Seat 3: Valkyrja955 folded before Flop (didn't bet)
Seat 4: RWN/NWR (button) collected ($0.12)
Seat 5: customdry244 (small blind) folded on the Flop
Seat 6: MrDonRich (big blind) folded on the Flop


PokerStars Hand #238173756199:  Hold'em No Limit ($0.01/$0.02 USD) - 2022/08/23 16:00:58 ET
Table 'Equinox IV' 6-max Seat #5 is the button
Seat 1: maraljero ($1.19 in chips)
Seat 3: Valkyrja955 ($1.80 in chips)
Seat 4: RWN/NWR ($3.41 in chips)
Seat 5: customdry244 ($2.16 in chips)
Seat 6: MrDonRich ($2.72 in chips)
MrDonRich: posts small blind $0.01
maraljero: posts big blind $0.02
Haliankou: sits out
*** HOLE CARDS ***
Valkyrja955: folds
RWN/NWR: folds
customdry244: folds
MrDonRich: folds
Uncalled bet ($0.01) returned to maraljero
maraljero collected $0.02 from pot
maraljero: doesn't show hand
*** SUMMARY ***
Total pot $0.02 | Rake $0
Seat 1: maraljero (big blind) collected ($0.02)
Seat 3: Valkyrja955 folded before Flop (didn't bet)
Seat 4: RWN/NWR folded before Flop (didn't bet)
Seat 5: customdry244 (button) folded before Flop (didn't bet)
Seat 6: MrDonRich (small blind) folded before Flop


PokerStars Hand #238173759891:  Hold'em No Limit ($0.01/$0.02 USD) - 2022/08/23 16:01:09 ET
Table 'Equinox IV' 6-max Seat #6 is the button
Seat 1: maraljero ($1.20 in chips)
Seat 2: Haliankou ($1.60 in chips)
Seat 3: Valkyrja955 ($1.80 in chips)
Seat 4: RWN/NWR ($3.41 in chips)
Seat 5: customdry244 ($2.16 in chips)
Seat 6: MrDonRich ($2.71 in chips)
maraljero: posts small blind $0.01
Haliankou: posts big blind $0.02
*** HOLE CARDS ***
Valkyrja955: folds
RWN/NWR: folds
customdry244: raises $0.02 to $0.04
MrDonRich: folds
maraljero: calls $0.03
Haliankou: folds
*** FLOP *** [Th 2c 5h]
maraljero: checks
customdry244: checks
*** TURN *** [Th 2c 5h] [9c]
maraljero: bets $0.04
customdry244: calls $0.04
*** RIVER *** [Th 2c 5h 9c] [5c]
maraljero: checks
customdry244: checks
*** SHOW DOWN ***
maraljero: shows [2h Kh] (two pair, Fives and Deuces)
customdry244: mucks hand
maraljero collected $0.17 from pot
*** SUMMARY ***
Total pot $0.18 | Rake $0.01
Board [Th 2c 5h 9c 5c]
Seat 1: maraljero (small blind) showed [2h Kh] and won ($0.17) with two pair, Fives and Deuces
Seat 2: Haliankou (big blind) folded before Flop
Seat 3: Valkyrja955 folded before Flop (didn't bet)
Seat 4: RWN/NWR folded before Flop (didn't bet)
Seat 5: customdry244 mucked
Seat 6: MrDonRich (button) folded before Flop (didn't bet)


PokerStars Hand #238173769256:  Hold'em No Limit ($0.01/$0.02 USD) - 2022/08/23 16:01:37 ET
Table 'Equinox IV' 6-max Seat #1 is the button
Seat 1: maraljero ($1.29 in chips)
Seat 2: Haliankou ($1.58 in chips)
Seat 3: Valkyrja955 ($1.80 in chips)
Seat 4: RWN/NWR ($3.41 in chips)
Seat 5: customdry244 ($2.08 in chips)
Seat 6: MrDonRich ($2.71 in chips)
Haliankou: posts small blind $0.01
Valkyrja955: posts big blind $0.02
*** HOLE CARDS ***
RWN/NWR: raises $0.02 to $0.04
customdry244: calls $0.04
MrDonRich: folds
maraljero: folds
Haliankou: folds
Valkyrja955: calls $0.02
*** FLOP *** [Kc 2d Qs]
Valkyrja955: checks
RWN/NWR: checks
customdry244: checks
*** TURN *** [Kc 2d Qs] [Ts]
Valkyrja955: checks
RWN/NWR: checks
customdry244: bets $0.06
Valkyrja955: folds
RWN/NWR: calls $0.06
*** RIVER *** [Kc 2d Qs Ts] [3c]
RWN/NWR: checks
customdry244: bets $0.38
RWN/NWR: folds
Uncalled bet ($0.38) returned to customdry244
customdry244 collected $0.24 from pot
*** SUMMARY ***
Total pot $0.25 | Rake $0.01
Board [Kc 2d Qs Ts 3c]
Seat 1: maraljero (button) folded before Flop (didn't bet)
Seat 2: Haliankou (small blind) folded before Flop
Seat 3: Valkyrja955 (big blind) folded on the Turn
Seat 4: RWN/NWR folded on the River
Seat 5: customdry244 collected ($0.24)
Seat 6: MrDonRich folded before Flop (didn't bet)


PokerStars Hand #238173794230:  Hold'em No Limit ($0.01/$0.02 USD) - 2022/08/23 16:02:44 ET
Table 'Equinox IV' 6-max Seat #2 is the button
Seat 1: maraljero ($1.29 in chips)
Seat 2: Haliankou ($1.57 in chips)
Seat 3: Valkyrja955 ($1.76 in chips)
Seat 4: RWN/NWR ($3.31 in chips)
Seat 5: customdry244 ($2.22 in chips)
Seat 6: MrDonRich ($2.71 in chips)
Valkyrja955: posts small blind $0.01
RWN/NWR: posts big blind $0.02
*** HOLE CARDS ***
customdry244: folds
MrDonRich: folds
maraljero: folds
Haliankou: folds
Valkyrja955: calls $0.01
RWN/NWR: checks
*** FLOP *** [2c Ah 6h]
Valkyrja955: checks
RWN/NWR: bets $0.04
Valkyrja955: folds
Uncalled bet ($0.04) returned to RWN/NWR
RWN/NWR collected $0.04 from pot
*** SUMMARY ***
Total pot $0.04 | Rake $0
Board [2c Ah 6h]
Seat 1: maraljero folded before Flop (didn't bet)
Seat 2: Haliankou (button) folded before Flop (didn't bet)
Seat 3: Valkyrja955 (small blind) folded on the Flop
Seat 4: RWN/NWR (big blind) collected ($0.04)
Seat 5: customdry244 folded before Flop (didn't bet)
Seat 6: MrDonRich folded before Flop (didn't bet)


PokerStars Hand #238173807450:  Hold'em No Limit ($0.01/$0.02 USD) - 2022/08/23 16:03:18 ET
Table 'Equinox IV' 6-max Seat #3 is the button
Seat 1: maraljero ($1.29 in chips)
Seat 2: Haliankou ($1.57 in chips)
Seat 3: Valkyrja955 ($1.74 in chips)
Seat 4: RWN/NWR ($3.33 in chips)
Seat 5: customdry244 ($2.22 in chips)
Seat 6: MrDonRich ($2.71 in chips)
RWN/NWR: posts small blind $0.01
customdry244: posts big blind $0.02
*** HOLE CARDS ***
MrDonRich: folds
maraljero: raises $0.02 to $0.04
Haliankou: raises $0.02 to $0.06
Valkyrja955: folds
RWN/NWR: calls $0.05
customdry244: folds
maraljero: calls $0.02
*** FLOP *** [Kh 4d 8h]
RWN/NWR: checks
maraljero: bets $0.08
Haliankou: calls $0.08
RWN/NWR: calls $0.08
*** TURN *** [Kh 4d 8h] [3d]
RWN/NWR: checks
maraljero: checks
Haliankou: bets $0.21
RWN/NWR: calls $0.21
maraljero: calls $0.21
*** RIVER *** [Kh 4d 8h 3d] [7h]
RWN/NWR: checks
maraljero: checks
Haliankou: checks
*** SHOW DOWN ***
RWN/NWR: shows [6s 5d] (a straight, Four to Eight)
maraljero: mucks hand
Haliankou: mucks hand
RWN/NWR collected $1.03 from pot
*** SUMMARY ***
Total pot $1.07 | Rake $0.04
Board [Kh 4d 8h 3d 7h]
Seat 1: maraljero mucked
Seat 2: Haliankou mucked
Seat 3: Valkyrja955 (button) folded before Flop (didn't bet)
Seat 4: RWN/NWR (small blind) showed [6s 5d] and won ($1.03) with a straight, Four to Eight
Seat 5: customdry244 (big blind) folded before Flop
Seat 6: MrDonRich folded before Flop (didn't bet)


PokerStars Hand #238173831705:  Hold'em No Limit ($0.01/$0.02 USD) - 2022/08/23 16:04:22 ET
Table 'Equinox IV' 6-max Seat #4 is the button
Seat 1: maraljero ($0.94 in chips)
Seat 2: Haliankou ($1.22 in chips)
Seat 3: Valkyrja955 ($1.74 in chips)
Seat 4: RWN/NWR ($4.01 in chips)
Seat 5: customdry244 ($2.20 in chips)
Seat 6: MrDonRich ($2.71 in chips)
customdry244: posts small blind $0.01
MrDonRich: posts big blind $0.02
*** HOLE CARDS ***
maraljero has timed out
maraljero: folds
Haliankou: folds
Valkyrja955: folds
RWN/NWR: folds
customdry244: calls $0.01
MrDonRich: checks
*** FLOP *** [Qd 6h Kh]
customdry244: bets $0.02
MrDonRich: folds
Uncalled bet ($0.02) returned to customdry244
customdry244 collected $0.04 from pot
*** SUMMARY ***
Total pot $0.04 | Rake $0
Board [Qd 6h Kh]
Seat 1: maraljero folded before Flop (didn't bet)
Seat 2: Haliankou folded before Flop (didn't bet)
Seat 3: Valkyrja955 folded before Flop (didn't bet)
Seat 4: RWN/NWR (button) folded before Flop (didn't bet)
Seat 5: customdry244 (small blind) collected ($0.04)
Seat 6: MrDonRich (big blind) folded on the Flop


PokerStars Hand #238173841891:  Hold'em No Limit ($0.01/$0.02 USD) - 2022/08/23 16:04:49 ET
Table 'Equinox IV' 6-max Seat #5 is the button
Seat 1: maraljero ($0.94 in chips)
Seat 2: Haliankou ($1.22 in chips)
Seat 3: Valkyrja955 ($1.74 in chips)
Seat 4: RWN/NWR ($4.01 in chips)
Seat 5: customdry244 ($2.22 in chips)
Seat 6: MrDonRich ($2.69 in chips)
MrDonRich: posts small blind $0.01
maraljero: posts big blind $0.02
*** HOLE CARDS ***
Haliankou: folds
Valkyrja955: folds
RWN/NWR: folds
customdry244: folds
MrDonRich: calls $0.01
maraljero: raises $0.06 to $0.08
MrDonRich: folds
Uncalled bet ($0.06) returned to maraljero
maraljero collected $0.04 from pot
maraljero: doesn't show hand
*** SUMMARY ***
Total pot $0.04 | Rake $0
Seat 1: maraljero (big blind) collected ($0.04)
Seat 2: Haliankou folded before Flop (didn't bet)
Seat 3: Valkyrja955 folded before Flop (didn't bet)
Seat 4: RWN/NWR folded before Flop (didn't bet)
Seat 5: customdry244 (button) folded before Flop (didn't bet)
Seat 6: MrDonRich (small blind) folded before Flop


PokerStars Hand #238173850881:  Hold'em No Limit ($0.01/$0.02 USD) - 2022/08/23 16:05:12 ET
Table 'Equinox IV' 6-max Seat #6 is the button
Seat 1: maraljero ($0.96 in chips)
Seat 2: Haliankou ($1.22 in chips)
Seat 3: Valkyrja955 ($1.74 in chips)
Seat 4: RWN/NWR ($4.01 in chips)
Seat 5: customdry244 ($2.22 in chips)
Seat 6: MrDonRich ($2.67 in chips)
maraljero: posts small blind $0.01
Haliankou: posts big blind $0.02
*** HOLE CARDS ***
Valkyrja955: folds
RWN/NWR: raises $0.02 to $0.04
customdry244: folds
MrDonRich: calls $0.04
maraljero: calls $0.03
Haliankou: folds
*** FLOP *** [Ah 6d Qc]
maraljero: checks
RWN/NWR: bets $0.04
MrDonRich: raises $0.04 to $0.08
maraljero: folds
RWN/NWR: calls $0.04
*** TURN *** [Ah 6d Qc] [6c]
RWN/NWR: bets $0.04
MrDonRich: raises $0.10 to $0.14
RWN/NWR: folds
Uncalled bet ($0.10) returned to MrDonRich
MrDonRich collected $0.37 from pot
MrDonRich: doesn't show hand
*** SUMMARY ***
Total pot $0.38 | Rake $0.01
Board [Ah 6d Qc 6c]
Seat 1: maraljero (small blind) folded on the Flop
Seat 2: Haliankou (big blind) folded before Flop
Seat 3: Valkyrja955 folded before Flop (didn't bet)
Seat 4: RWN/NWR folded on the Turn
Seat 5: customdry244 folded before Flop (didn't bet)
Seat 6: MrDonRich (button) collected ($0.37)


PokerStars Hand #238173878264:  Hold'em No Limit ($0.01/$0.02 USD) - 2022/08/23 16:06:13 ET
Table 'Equinox IV' 6-max Seat #1 is the button
Seat 1: maraljero ($0.92 in chips)
Seat 2: Haliankou ($1.20 in chips)
Seat 3: Valkyrja955 ($1.74 in chips)
Seat 4: RWN/NWR ($3.85 in chips)
Seat 5: customdry244 ($2.22 in chips)
Seat 6: MrDonRich ($2.88 in chips)
Haliankou: posts small blind $0.01
Valkyrja955: posts big blind $0.02
*** HOLE CARDS ***
RWN/NWR: folds
customdry244: calls $0.02
MrDonRich: raises $0.07 to $0.09
maraljero: folds
Haliankou: folds
Valkyrja955: folds
customdry244: folds
Uncalled bet ($0.07) returned to MrDonRich
MrDonRich collected $0.07 from pot
MrDonRich: doesn't show hand
*** SUMMARY ***
Total pot $0.07 | Rake $0
Seat 1: maraljero (button) folded before Flop (didn't bet)
Seat 2: Haliankou (small blind) folded before Flop
Seat 3: Valkyrja955 (big blind) folded before Flop
Seat 4: RWN/NWR folded before Flop (didn't bet)
Seat 5: customdry244 folded before Flop
Seat 6: MrDonRich collected ($0.07)


PokerStars Hand #238173887613:  Hold'em No Limit ($0.01/$0.02 USD) - 2022/08/23 16:06:37 ET
Table 'Equinox IV' 6-max Seat #2 is the button
Seat 1: maraljero ($0.92 in chips)
Seat 2: Haliankou ($1.19 in chips)
Seat 3: Valkyrja955 ($1.72 in chips)
Seat 4: RWN/NWR ($3.85 in chips)
Seat 5: customdry244 ($2.20 in chips)
Seat 6: MrDonRich ($2.93 in chips)
Valkyrja955: posts small blind $0.01
RWN/NWR: posts big blind $0.02
*** HOLE CARDS ***
customdry244: folds
MrDonRich: calls $0.02
maraljero: raises $0.04 to $0.06
Haliankou: folds
Valkyrja955: folds
RWN/NWR: folds
MrDonRich: calls $0.04
*** FLOP *** [Kd 9d 6h]
MrDonRich: checks
maraljero: bets $0.10
MrDonRich: folds
Uncalled bet ($0.10) returned to maraljero
maraljero collected $0.14 from pot
maraljero: doesn't show hand
*** SUMMARY ***
Total pot $0.15 | Rake $0.01
Board [Kd 9d 6h]
Seat 1: maraljero collected ($0.14)
Seat 2: Haliankou (button) folded before Flop (didn't bet)
Seat 3: Valkyrja955 (small blind) folded before Flop
Seat 4: RWN/NWR (big blind) folded before Flop
Seat 5: customdry244 folded before Flop (didn't bet)
Seat 6: MrDonRich folded on the Flop


PokerStars Hand #238173901621:  Hold'em No Limit ($0.01/$0.02 USD) - 2022/08/23 16:07:14 ET
Table 'Equinox IV' 6-max Seat #3 is the button
Seat 1: maraljero ($1 in chips)
Seat 2: Haliankou ($1.19 in chips)
Seat 3: Valkyrja955 ($1.71 in chips)
Seat 4: RWN/NWR ($3.83 in chips)
Seat 5: customdry244 ($2.20 in chips)
Seat 6: MrDonRich ($2.87 in chips)
RWN/NWR: posts small blind $0.01
customdry244: posts big blind $0.02
*** HOLE CARDS ***
MrDonRich: folds
maraljero: folds
Haliankou: folds
Valkyrja955: folds
Valkyrja955 leaves the table
RWN/NWR: folds
Uncalled bet ($0.01) returned to customdry244
customdry244 collected $0.02 from pot
*** SUMMARY ***
Total pot $0.02 | Rake $0
Seat 1: maraljero folded before Flop (didn't bet)
Seat 2: Haliankou folded before Flop (didn't bet)
Seat 3: Valkyrja955 (button) folded before Flop (didn't bet)
Seat 4: RWN/NWR (small blind) folded before Flop
Seat 5: customdry244 (big blind) collected ($0.02)
Seat 6: MrDonRich folded before Flop (didn't bet)


PokerStars Hand #238173907696:  Hold'em No Limit ($0.01/$0.02 USD) - 2022/08/23 16:07:29 ET
Table 'Equinox IV' 6-max Seat #4 is the button
Seat 1: maraljero ($1 in chips)
Seat 2: Haliankou ($1.19 in chips)
Seat 4: RWN/NWR ($3.82 in chips)
Seat 5: customdry244 ($2.21 in chips)
Seat 6: MrDonRich ($2.87 in chips)
customdry244: posts small blind $0.01
MrDonRich: posts big blind $0.02
*** HOLE CARDS ***
AAvers joins the table at seat #3
maraljero: folds
Haliankou: folds
RWN/NWR: folds
customdry244: calls $0.01
MrDonRich: checks
*** FLOP *** [7c 8h Qd]
customdry244: checks
MrDonRich: bets $0.03
customdry244: calls $0.03
*** TURN *** [7c 8h Qd] [Ac]
customdry244: checks
MrDonRich: checks
*** RIVER *** [7c 8h Qd Ac] [8s]
customdry244: checks
MrDonRich: checks
*** SHOW DOWN ***
customdry244: shows [5d 2h] (a pair of Eights)
MrDonRich: shows [Th Qh] (two pair, Queens and Eights)
MrDonRich collected $0.10 from pot
*** SUMMARY ***
Total pot $0.10 | Rake $0
Board [7c 8h Qd Ac 8s]
Seat 1: maraljero folded before Flop (didn't bet)
Seat 2: Haliankou folded before Flop (didn't bet)
Seat 4: RWN/NWR (button) folded before Flop (didn't bet)
Seat 5: customdry244 (small blind) showed [5d 2h] and lost with a pair of Eights
Seat 6: MrDonRich (big blind) showed [Th Qh] and won ($0.10) with two pair, Queens and Eights


PokerStars Hand #238173916812:  Hold'em No Limit ($0.01/$0.02 USD) - 2022/08/23 16:07:53 ET
Table 'Equinox IV' 6-max Seat #5 is the button
Seat 1: maraljero ($1 in chips)
Seat 2: Haliankou ($1.19 in chips)
Seat 4: RWN/NWR ($3.82 in chips)
Seat 5: customdry244 ($2.16 in chips)
Seat 6: MrDonRich ($2.92 in chips)
MrDonRich: posts small blind $0.01
maraljero: posts big blind $0.02
AAvers: sits out
*** HOLE CARDS ***
Haliankou: folds
RWN/NWR: folds
customdry244: calls $0.02
MrDonRich: calls $0.01
maraljero: raises $0.04 to $0.06
customdry244: calls $0.04
MrDonRich: calls $0.04
*** FLOP *** [8h 2c Tc]
MrDonRich: bets $0.11
maraljero: calls $0.11
customdry244: calls $0.11
*** TURN *** [8h 2c Tc] [4d]
MrDonRich: bets $0.49
maraljero: folds
customdry244: folds
Uncalled bet ($0.49) returned to MrDonRich
MrDonRich collected $0.49 from pot
MrDonRich: doesn't show hand
*** SUMMARY ***
Total pot $0.51 | Rake $0.02
Board [8h 2c Tc 4d]
Seat 1: maraljero (big blind) folded on the Turn
Seat 2: Haliankou folded before Flop (didn't bet)
Seat 4: RWN/NWR folded before Flop (didn't bet)
Seat 5: customdry244 (button) folded on the Turn
Seat 6: MrDonRich (small blind) collected ($0.49)


PokerStars Hand #238173937468:  Hold'em No Limit ($0.01/$0.02 USD) - 2022/08/23 16:08:46 ET
Table 'Equinox IV' 6-max Seat #6 is the button
Seat 1: maraljero ($0.83 in chips)
Seat 2: Haliankou ($1.19 in chips)
Seat 4: RWN/NWR ($3.82 in chips)
Seat 5: customdry244 ($1.99 in chips)
Seat 6: MrDonRich ($3.24 in chips)
maraljero: posts small blind $0.01
Haliankou: posts big blind $0.02
AAvers: sits out
*** HOLE CARDS ***
RWN/NWR: folds
customdry244: folds
MrDonRich: folds
maraljero: raises $0.02 to $0.04
Haliankou: raises $0.04 to $0.08
maraljero: calls $0.04
*** FLOP *** [4h Qs Qh]
maraljero: checks
Haliankou: bets $0.07
maraljero: folds
Uncalled bet ($0.07) returned to Haliankou
Haliankou collected $0.15 from pot
Haliankou: doesn't show hand
*** SUMMARY ***
Total pot $0.16 | Rake $0.01
Board [4h Qs Qh]
Seat 1: maraljero (small blind) folded on the Flop
Seat 2: Haliankou (big blind) collected ($0.15)
Seat 4: RWN/NWR folded before Flop (didn't bet)
Seat 5: customdry244 folded before Flop (didn't bet)
Seat 6: MrDonRich (button) folded before Flop (didn't bet)


PokerStars Hand #238173947494:  Hold'em No Limit ($0.01/$0.02 USD) - 2022/08/23 16:09:12 ET
Table 'Equinox IV' 6-max Seat #1 is the button
Seat 1: maraljero ($0.75 in chips)
Seat 2: Haliankou ($1.26 in chips)
Seat 3: AAvers ($2 in chips)
Seat 4: RWN/NWR ($3.82 in chips)
Seat 5: customdry244 ($1.99 in chips)
Seat 6: MrDonRich ($3.24 in chips)
Haliankou: posts small blind $0.01
AAvers: posts big blind $0.02
*** HOLE CARDS ***
RWN/NWR: raises $0.02 to $0.04
customdry244: folds
MrDonRich: calls $0.04
maraljero: folds
Haliankou: raises $0.02 to $0.06
AAvers: calls $0.04
RWN/NWR: calls $0.02
MrDonRich: calls $0.02
*** FLOP *** [8s 4c 6h]
Haliankou: bets $0.12
AAvers: folds
RWN/NWR: folds
MrDonRich: folds
Uncalled bet ($0.12) returned to Haliankou
Haliankou collected $0.23 from pot
Haliankou: doesn't show hand
*** SUMMARY ***
Total pot $0.24 | Rake $0.01
Board [8s 4c 6h]
Seat 1: maraljero (button) folded before Flop (didn't bet)
Seat 2: Haliankou (small blind) collected ($0.23)
Seat 3: AAvers (big blind) folded on the Flop
Seat 4: RWN/NWR folded on the Flop
Seat 5: customdry244 folded before Flop (didn't bet)
Seat 6: MrDonRich folded on the Flop


PokerStars Hand #238173972196:  Hold'em No Limit ($0.01/$0.02 USD) - 2022/08/23 16:10:16 ET
Table 'Equinox IV' 6-max Seat #2 is the button
Seat 1: maraljero ($0.75 in chips)
Seat 2: Haliankou ($1.43 in chips)
Seat 3: AAvers ($2 in chips)
Seat 4: RWN/NWR ($3.76 in chips)
Seat 5: customdry244 ($1.99 in chips)
Seat 6: MrDonRich ($3.18 in chips)
AAvers: posts small blind $0.01
RWN/NWR: posts big blind $0.02
*** HOLE CARDS ***
customdry244: folds
MrDonRich: folds
maraljero: folds
Haliankou: folds
AAvers: raises $0.04 to $0.06
RWN/NWR: calls $0.04
*** FLOP *** [Qs 9d 2s]
AAvers: bets $0.05
RWN/NWR: raises $0.07 to $0.12
AAvers: folds
Uncalled bet ($0.07) returned to RWN/NWR
RWN/NWR collected $0.21 from pot
*** SUMMARY ***
Total pot $0.22 | Rake $0.01
Board [Qs 9d 2s]
Seat 1: maraljero folded before Flop (didn't bet)
Seat 2: Haliankou (button) folded before Flop (didn't bet)
Seat 3: AAvers (small blind) folded on the Flop
Seat 4: RWN/NWR (big blind) collected ($0.21)
Seat 5: customdry244 folded before Flop (didn't bet)
Seat 6: MrDonRich folded before Flop (didn't bet)


PokerStars Hand #238173987679:  Hold'em No Limit ($0.01/$0.02 USD) - 2022/08/23 16:10:57 ET
Table 'Equinox IV' 6-max Seat #3 is the button
Seat 1: maraljero ($0.75 in chips)
Seat 2: Haliankou ($1.43 in chips)
Seat 3: AAvers ($2 in chips)
Seat 4: RWN/NWR ($3.86 in chips)
Seat 5: customdry244 ($1.99 in chips)
Seat 6: MrDonRich ($3.18 in chips)
RWN/NWR: posts small blind $0.01
customdry244: posts big blind $0.02
*** HOLE CARDS ***
MrDonRich: folds
maraljero: raises $0.02 to $0.04
Haliankou: folds
AAvers: folds
RWN/NWR: calls $0.03
customdry244: calls $0.02
*** FLOP *** [2d Ad 7d]
RWN/NWR: bets $0.06
customdry244: raises $1.89 to $1.95 and is all-in
maraljero: folds
RWN/NWR: calls $1.89
*** TURN *** [2d Ad 7d] [7c]
*** RIVER *** [2d Ad 7d 7c] [Qc]
*** SHOW DOWN ***
RWN/NWR: shows [Td 8d] (a flush, Ace high)
customdry244: shows [6s 7h] (three of a kind, Sevens)
RWN/NWR cashed out the hand for $3.74 | Cash Out Fee $0.04
customdry244 cashed out the hand for $0.10
*** SUMMARY ***
Total pot $4.02 | Rake $0.14
Board [2d Ad 7d 7c Qc]
Seat 1: maraljero folded on the Flop
Seat 2: Haliankou folded before Flop (didn't bet)
Seat 3: AAvers (button) folded before Flop (didn't bet)
Seat 4: RWN/NWR (small blind) showed [Td 8d] and won ($3.88) with a flush, Ace high (pot not awarded as player cashed out)
Seat 5: customdry244 (big blind) showed [6s 7h] and lost with three of a kind, Sevens (cashed out).
Seat 6: MrDonRich folded before Flop (didn't bet)


PokerStars Hand #238174008804:  Hold'em No Limit ($0.01/$0.02 USD) - 2022/08/23 16:11:52 ET
Table 'Equinox IV' 6-max Seat #4 is the button
Seat 1: maraljero ($0.71 in chips)
Seat 2: Haliankou ($1.43 in chips)
Seat 3: AAvers ($2 in chips)
Seat 4: RWN/NWR ($5.61 in chips)
Seat 5: customdry244 ($0.10 in chips)
Seat 6: MrDonRich ($3.18 in chips)
customdry244: posts small blind $0.01
MrDonRich: posts big blind $0.02
*** HOLE CARDS ***
maraljero: raises $0.02 to $0.04
Haliankou: folds
AAvers: folds
RWN/NWR: folds
customdry244: raises $0.06 to $0.10 and is all-in
MrDonRich: folds
maraljero: calls $0.06
*** FLOP *** [3c Tc 8d]
*** TURN *** [3c Tc 8d] [7h]
*** RIVER *** [3c Tc 8d 7h] [Jc]
*** SHOW DOWN ***
customdry244: shows [8h As] (a pair of Eights)
maraljero: shows [Ah 3d] (a pair of Threes)
customdry244 collected $0.21 from pot
*** SUMMARY ***
Total pot $0.22 | Rake $0.01
Board [3c Tc 8d 7h Jc]
Seat 1: maraljero showed [Ah 3d] and lost with a pair of Threes
Seat 2: Haliankou folded before Flop (didn't bet)
Seat 3: AAvers folded before Flop (didn't bet)
Seat 4: RWN/NWR (button) folded before Flop (didn't bet)
Seat 5: customdry244 (small blind) showed [8h As] and won ($0.21) with a pair of Eights
Seat 6: MrDonRich (big blind) folded before Flop


PokerStars Hand #238174022395:  Hold'em No Limit ($0.01/$0.02 USD) - 2022/08/23 16:12:27 ET
Table 'Equinox IV' 6-max Seat #5 is the button
Seat 1: maraljero ($0.61 in chips)
Seat 2: Haliankou ($1.43 in chips)
Seat 3: AAvers ($2 in chips)
Seat 4: RWN/NWR ($5.61 in chips)
Seat 5: customdry244 ($0.21 in chips)
Seat 6: MrDonRich ($3.16 in chips)
MrDonRich: posts small blind $0.01
maraljero: posts big blind $0.02
*** HOLE CARDS ***
Haliankou: folds
AAvers: folds
RWN/NWR: folds
customdry244: raises $0.19 to $0.21 and is all-in
MrDonRich: folds
maraljero: calls $0.19
*** FLOP *** [Th 8d 6h]
*** TURN *** [Th 8d 6h] [Tc]
*** RIVER *** [Th 8d 6h Tc] [3h]
*** SHOW DOWN ***
maraljero: shows [Qs Qc] (two pair, Queens and Tens)
customdry244: shows [Kc Jc] (a pair of Tens)
maraljero collected $0.41 from pot
*** SUMMARY ***
Total pot $0.43 | Rake $0.02
Board [Th 8d 6h Tc 3h]
Seat 1: maraljero (big blind) showed [Qs Qc] and won ($0.41) with two pair, Queens and Tens
Seat 2: Haliankou folded before Flop (didn't bet)
Seat 3: AAvers folded before Flop (didn't bet)
Seat 4: RWN/NWR folded before Flop (didn't bet)
Seat 5: customdry244 (button) showed [Kc Jc] and lost with a pair of Tens
Seat 6: MrDonRich (small blind) folded before Flop


PokerStars Hand #238174032237:  Hold'em No Limit ($0.01/$0.02 USD) - 2022/08/23 16:12:53 ET
Table 'Equinox IV' 6-max Seat #6 is the button
Seat 1: maraljero ($0.81 in chips)
Seat 2: Haliankou ($1.43 in chips)
Seat 3: AAvers ($2 in chips)
Seat 4: RWN/NWR ($5.61 in chips)
Seat 6: MrDonRich ($3.15 in chips)
maraljero: posts small blind $0.01
Haliankou: posts big blind $0.02
*** HOLE CARDS ***
AAvers: folds
RWN/NWR: folds
MrDonRich: calls $0.02
maraljero: raises $0.06 to $0.08
Haliankou: folds
MrDonRich: calls $0.06
*** FLOP *** [8c 5h 2d]
maraljero: bets $0.08
MrDonRich: raises $0.08 to $0.16
maraljero: calls $0.08
*** TURN *** [8c 5h 2d] [Kc]
maraljero: checks
MrDonRich: checks
*** RIVER *** [8c 5h 2d Kc] [Js]
maraljero: checks
MrDonRich: checks
*** SHOW DOWN ***
maraljero: shows [Ac Qh] (high card Ace)
MrDonRich: shows [6h 6s] (a pair of Sixes)
MrDonRich collected $0.48 from pot
*** SUMMARY ***
Total pot $0.50 | Rake $0.02
Board [8c 5h 2d Kc Js]
Seat 1: maraljero (small blind) showed [Ac Qh] and lost with high card Ace
Seat 2: Haliankou (big blind) folded before Flop
Seat 3: AAvers folded before Flop (didn't bet)
Seat 4: RWN/NWR folded before Flop (didn't bet)
Seat 6: MrDonRich (button) showed [6h 6s] and won ($0.48) with a pair of Sixes


PokerStars Hand #238174044132:  Hold'em No Limit ($0.01/$0.02 USD) - 2022/08/23 16:13:24 ET
Table 'Equinox IV' 6-max Seat #1 is the button
Seat 1: maraljero ($0.57 in chips)
Seat 2: Haliankou ($1.41 in chips)
Seat 3: AAvers ($2 in chips)
Seat 4: RWN/NWR ($5.61 in chips)
Seat 6: MrDonRich ($3.39 in chips)
Haliankou: posts small blind $0.01
AAvers: posts big blind $0.02
*** HOLE CARDS ***
RWN/NWR: raises $0.02 to $0.04
MrDonRich: folds
maraljero: raises $0.53 to $0.57 and is all-in
Haliankou: folds
AAvers: folds
RWN/NWR: folds
Uncalled bet ($0.53) returned to maraljero
maraljero collected $0.11 from pot
maraljero: doesn't show hand
*** SUMMARY ***
Total pot $0.11 | Rake $0
Seat 1: maraljero (button) collected ($0.11)
Seat 2: Haliankou (small blind) folded before Flop
Seat 3: AAvers (big blind) folded before Flop
Seat 4: RWN/NWR folded before Flop
Seat 6: MrDonRich folded before Flop (didn't bet)


PokerStars Hand #238174052115:  Hold'em No Limit ($0.01/$0.02 USD) - 2022/08/23 16:13:45 ET
Table 'Equinox IV' 6-max Seat #2 is the button
Seat 1: maraljero ($0.64 in chips)
Seat 2: Haliankou ($1.40 in chips)
Seat 3: AAvers ($2 in chips)
Seat 4: RWN/NWR ($5.57 in chips)
Seat 6: MrDonRich ($3.39 in chips)
AAvers: posts small blind $0.01
RWN/NWR: posts big blind $0.02
*** HOLE CARDS ***
MrDonRich: folds
maraljero: folds
Haliankou: folds
AAvers: raises $0.04 to $0.06
RWN/NWR: folds
Uncalled bet ($0.04) returned to AAvers
AAvers collected $0.04 from pot
*** SUMMARY ***
Total pot $0.04 | Rake $0
Seat 1: maraljero folded before Flop (didn't bet)
Seat 2: Haliankou (button) folded before Flop (didn't bet)
Seat 3: AAvers (small blind) collected ($0.04)
Seat 4: RWN/NWR (big blind) folded before Flop
Seat 6: MrDonRich folded before Flop (didn't bet)


PokerStars Hand #238174056439:  Hold'em No Limit ($0.01/$0.02 USD) - 2022/08/23 16:13:56 ET
Table 'Equinox IV' 6-max Seat #3 is the button
Seat 1: maraljero ($0.64 in chips)
Seat 2: Haliankou ($1.40 in chips)
Seat 3: AAvers ($2.02 in chips)
Seat 4: RWN/NWR ($5.55 in chips)
Seat 6: MrDonRich ($3.39 in chips)
RWN/NWR: posts small blind $0.01
MrDonRich: posts big blind $0.02
*** HOLE CARDS ***
customdry244 is disconnected
maraljero: raises $0.02 to $0.04
Haliankou: folds
AAvers: folds
RWN/NWR: folds
MrDonRich: calls $0.02
*** FLOP *** [Tc Td 3d]
MrDonRich: checks
maraljero: bets $0.04
MrDonRich: folds
Uncalled bet ($0.04) returned to maraljero
maraljero collected $0.09 from pot
maraljero: doesn't show hand
*** SUMMARY ***
Total pot $0.09 | Rake $0
Board [Tc Td 3d]
Seat 1: maraljero collected ($0.09)
Seat 2: Haliankou folded before Flop (didn't bet)
Seat 3: AAvers (button) folded before Flop (didn't bet)
Seat 4: RWN/NWR (small blind) folded before Flop
Seat 6: MrDonRich (big blind) folded on the Flop


PokerStars Hand #238174064687:  Hold'em No Limit ($0.01/$0.02 USD) - 2022/08/23 16:14:18 ET
Table 'Equinox IV' 6-max Seat #4 is the button
Seat 1: maraljero ($0.69 in chips)
Seat 2: Haliankou ($1.40 in chips)
Seat 3: AAvers ($2.02 in chips)
Seat 4: RWN/NWR ($5.54 in chips)
Seat 6: MrDonRich ($3.35 in chips)
MrDonRich: posts small blind $0.01
maraljero: posts big blind $0.02
*** HOLE CARDS ***
Haliankou: folds
AAvers: folds
RWN/NWR: folds
MrDonRich: folds
Uncalled bet ($0.01) returned to maraljero
maraljero collected $0.02 from pot
maraljero: doesn't show hand
*** SUMMARY ***
Total pot $0.02 | Rake $0
Seat 1: maraljero (big blind) collected ($0.02)
Seat 2: Haliankou folded before Flop (didn't bet)
Seat 3: AAvers folded before Flop (didn't bet)
Seat 4: RWN/NWR (button) folded before Flop (didn't bet)
Seat 6: MrDonRich (small blind) folded before Flop


PokerStars Hand #238174071060:  Hold'em No Limit ($0.01/$0.02 USD) - 2022/08/23 16:14:34 ET
Table 'Equinox IV' 6-max Seat #6 is the button
Seat 1: maraljero ($0.70 in chips)
Seat 2: Haliankou ($1.40 in chips)
Seat 3: AAvers ($2.02 in chips)
Seat 4: RWN/NWR ($5.54 in chips)
Seat 6: MrDonRich ($3.34 in chips)
maraljero: posts small blind $0.01
Haliankou: posts big blind $0.02
*** HOLE CARDS ***
AAvers: folds
RWN/NWR: raises $0.02 to $0.04
MrDonRich: folds
maraljero: folds
Haliankou: folds
Uncalled bet ($0.02) returned to RWN/NWR
RWN/NWR collected $0.05 from pot
*** SUMMARY ***
Total pot $0.05 | Rake $0
Seat 1: maraljero (small blind) folded before Flop
Seat 2: Haliankou (big blind) folded before Flop
Seat 3: AAvers folded before Flop (didn't bet)
Seat 4: RWN/NWR collected ($0.05)
Seat 6: MrDonRich (button) folded before Flop (didn't bet)


PokerStars Hand #238174077302:  Hold'em No Limit ($0.01/$0.02 USD) - 2022/08/23 16:14:51 ET
Table 'Equinox IV' 6-max Seat #1 is the button
Seat 1: maraljero ($0.69 in chips)
Seat 2: Haliankou ($1.38 in chips)
Seat 3: AAvers ($2.02 in chips)
Seat 4: RWN/NWR ($5.57 in chips)
Seat 6: MrDonRich ($3.34 in chips)
Haliankou: posts small blind $0.01
AAvers: posts big blind $0.02
*** HOLE CARDS ***
RWN/NWR: folds
MrDonRich: folds
maraljero: raises $0.02 to $0.04
Haliankou: folds
AAvers: folds
Uncalled bet ($0.02) returned to maraljero
maraljero collected $0.05 from pot
maraljero: doesn't show hand
*** SUMMARY ***
Total pot $0.05 | Rake $0
Seat 1: maraljero (button) collected ($0.05)
Seat 2: Haliankou (small blind) folded before Flop
Seat 3: AAvers (big blind) folded before Flop
Seat 4: RWN/NWR folded before Flop (didn't bet)
Seat 6: MrDonRich folded before Flop (didn't bet)


PokerStars Hand #238174080810:  Hold'em No Limit ($0.01/$0.02 USD) - 2022/08/23 16:15:00 ET
Table 'Equinox IV' 6-max Seat #2 is the button
Seat 1: maraljero ($0.72 in chips)
Seat 2: Haliankou ($1.37 in chips)
Seat 3: AAvers ($2 in chips)
Seat 4: RWN/NWR ($5.57 in chips)
Seat 6: MrDonRich ($3.34 in chips)
AAvers: posts small blind $0.01
RWN/NWR: posts big blind $0.02
*** HOLE CARDS ***
MrDonRich: folds
maraljero: folds
Haliankou: folds
AAvers: folds
Uncalled bet ($0.01) returned to RWN/NWR
RWN/NWR collected $0.02 from pot
*** SUMMARY ***
Total pot $0.02 | Rake $0
Seat 1: maraljero folded before Flop (didn't bet)
Seat 2: Haliankou (button) folded before Flop (didn't bet)
Seat 3: AAvers (small blind) folded before Flop
Seat 4: RWN/NWR (big blind) collected ($0.02)
Seat 6: MrDonRich folded before Flop (didn't bet)


PokerStars Hand #238174086143:  Hold'em No Limit ($0.01/$0.02 USD) - 2022/08/23 16:15:13 ET
Table 'Equinox IV' 6-max Seat #3 is the button
Seat 1: maraljero ($0.72 in chips)
Seat 2: Haliankou ($1.37 in chips)
Seat 3: AAvers ($2 in chips)
Seat 4: RWN/NWR ($5.58 in chips)
Seat 6: MrDonRich ($3.34 in chips)
RWN/NWR: posts small blind $0.01
MrDonRich: posts big blind $0.02
*** HOLE CARDS ***
maraljero: raises $0.02 to $0.04
Haliankou: folds
AAvers: calls $0.04
RWN/NWR: folds
MrDonRich: calls $0.02
*** FLOP *** [2c 8d Th]
MrDonRich: checks
maraljero: checks
AAvers: bets $0.05
MrDonRich: raises $0.05 to $0.10
maraljero: folds
AAvers: folds
Uncalled bet ($0.05) returned to MrDonRich
MrDonRich collected $0.22 from pot
MrDonRich: doesn't show hand
*** SUMMARY ***
Total pot $0.23 | Rake $0.01
Board [2c 8d Th]
Seat 1: maraljero folded on the Flop
Seat 2: Haliankou folded before Flop (didn't bet)
Seat 3: AAvers (button) folded on the Flop
Seat 4: RWN/NWR (small blind) folded before Flop
Seat 6: MrDonRich (big blind) collected ($0.22)


PokerStars Hand #238174102028:  Hold'em No Limit ($0.01/$0.02 USD) - 2022/08/23 16:15:54 ET
Table 'Equinox IV' 6-max Seat #4 is the button
Seat 1: maraljero ($0.68 in chips)
Seat 2: Haliankou ($1.37 in chips)
Seat 3: AAvers ($2 in chips)
Seat 4: RWN/NWR ($5.57 in chips)
Seat 6: MrDonRich ($3.47 in chips)
MrDonRich: posts small blind $0.01
maraljero: posts big blind $0.02
*** HOLE CARDS ***
Haliankou: folds
AAvers: folds
RWN/NWR: folds
MrDonRich: folds
Uncalled bet ($0.01) returned to maraljero
maraljero collected $0.02 from pot
maraljero: doesn't show hand
*** SUMMARY ***
Total pot $0.02 | Rake $0
Seat 1: maraljero (big blind) collected ($0.02)
Seat 2: Haliankou folded before Flop (didn't bet)
Seat 3: AAvers folded before Flop (didn't bet)
Seat 4: RWN/NWR (button) folded before Flop (didn't bet)
Seat 6: MrDonRich (small blind) folded before Flop


PokerStars Hand #238174106903:  Hold'em No Limit ($0.01/$0.02 USD) - 2022/08/23 16:16:06 ET
Table 'Equinox IV' 6-max Seat #6 is the button
Seat 1: maraljero ($0.69 in chips)
Seat 2: Haliankou ($1.37 in chips)
Seat 3: AAvers ($2 in chips)
Seat 4: RWN/NWR ($5.57 in chips)
Seat 6: MrDonRich ($3.46 in chips)
maraljero: posts small blind $0.01
Haliankou: posts big blind $0.02
*** HOLE CARDS ***
AAvers: folds
RWN/NWR: folds
MrDonRich: folds
maraljero: folds
Uncalled bet ($0.01) returned to Haliankou
Haliankou collected $0.02 from pot
Haliankou: doesn't show hand
*** SUMMARY ***
Total pot $0.02 | Rake $0
Seat 1: maraljero (small blind) folded before Flop
Seat 2: Haliankou (big blind) collected ($0.02)
Seat 3: AAvers folded before Flop (didn't bet)
Seat 4: RWN/NWR folded before Flop (didn't bet)
Seat 6: MrDonRich (button) folded before Flop (didn't bet)


PokerStars Hand #238174112202:  Hold'em No Limit ($0.01/$0.02 USD) - 2022/08/23 16:16:20 ET
Table 'Equinox IV' 6-max Seat #1 is the button
Seat 1: maraljero ($0.68 in chips)
Seat 2: Haliankou ($1.38 in chips)
Seat 3: AAvers ($2 in chips)
Seat 4: RWN/NWR ($5.57 in chips)
Seat 6: MrDonRich ($3.46 in chips)
Haliankou: posts small blind $0.01
AAvers: posts big blind $0.02
*** HOLE CARDS ***
RWN/NWR: raises $0.02 to $0.04
MrDonRich: folds
maraljero: folds
Haliankou: folds
AAvers: folds
Uncalled bet ($0.02) returned to RWN/NWR
RWN/NWR collected $0.05 from pot
*** SUMMARY ***
Total pot $0.05 | Rake $0
Seat 1: maraljero (button) folded before Flop (didn't bet)
Seat 2: Haliankou (small blind) folded before Flop
Seat 3: AAvers (big blind) folded before Flop
Seat 4: RWN/NWR collected ($0.05)
Seat 6: MrDonRich folded before Flop (didn't bet)


PokerStars Hand #238174120736:  Hold'em No Limit ($0.01/$0.02 USD) - 2022/08/23 16:16:41 ET
Table 'Equinox IV' 6-max Seat #2 is the button
Seat 1: maraljero ($0.68 in chips)
Seat 2: Haliankou ($1.37 in chips)
Seat 3: AAvers ($2 in chips)
Seat 4: RWN/NWR ($5.60 in chips)
Seat 6: MrDonRich ($3.46 in chips)
AAvers: posts small blind $0.01
RWN/NWR: posts big blind $0.02
*** HOLE CARDS ***
MrDonRich: folds
maraljero: raises $0.02 to $0.04
Haliankou: folds
AAvers: folds
RWN/NWR: calls $0.02
*** FLOP *** [Jc 7h 4c]
RWN/NWR: checks
maraljero: bets $0.06
RWN/NWR: calls $0.06
*** TURN *** [Jc 7h 4c] [2c]
RWN/NWR: checks
maraljero: checks
*** RIVER *** [Jc 7h 4c 2c] [8d]
RWN/NWR: checks
maraljero: checks
*** SHOW DOWN ***
RWN/NWR: shows [6d 8s] (a pair of Eights)
maraljero: mucks hand
RWN/NWR collected $0.20 from pot
*** SUMMARY ***
Total pot $0.21 | Rake $0.01
Board [Jc 7h 4c 2c 8d]
Seat 1: maraljero mucked
Seat 2: Haliankou (button) folded before Flop (didn't bet)
Seat 3: AAvers (small blind) folded before Flop
Seat 4: RWN/NWR (big blind) showed [6d 8s] and won ($0.20) with a pair of Eights
Seat 6: MrDonRich folded before Flop (didn't bet)


PokerStars Hand #238174132759:  Hold'em No Limit ($0.01/$0.02 USD) - 2022/08/23 16:17:12 ET
Table 'Equinox IV' 6-max Seat #3 is the button
Seat 1: maraljero ($0.58 in chips)
Seat 2: Haliankou ($1.37 in chips)
Seat 3: AAvers ($2 in chips)
Seat 4: RWN/NWR ($5.70 in chips)
Seat 6: MrDonRich ($3.46 in chips)
RWN/NWR: posts small blind $0.01
MrDonRich: posts big blind $0.02
*** HOLE CARDS ***
maraljero: folds
Haliankou: raises $0.04 to $0.06
AAvers: folds
RWN/NWR: calls $0.05
MrDonRich: folds
*** FLOP *** [Ts 2s 8d]
RWN/NWR: checks
Haliankou: bets $0.07
RWN/NWR: folds
Uncalled bet ($0.07) returned to Haliankou
Haliankou collected $0.14 from pot
Haliankou: doesn't show hand
*** SUMMARY ***
Total pot $0.14 | Rake $0
Board [Ts 2s 8d]
Seat 1: maraljero folded before Flop (didn't bet)
Seat 2: Haliankou collected ($0.14)
Seat 3: AAvers (button) folded before Flop (didn't bet)
Seat 4: RWN/NWR (small blind) folded on the Flop
Seat 6: MrDonRich (big blind) folded before Flop


PokerStars Hand #238174144678:  Hold'em No Limit ($0.01/$0.02 USD) - 2022/08/23 16:17:43 ET
Table 'Equinox IV' 6-max Seat #4 is the button
Seat 1: maraljero ($0.58 in chips)
Seat 2: Haliankou ($1.45 in chips)
Seat 3: AAvers ($2 in chips)
Seat 4: RWN/NWR ($5.64 in chips)
Seat 6: MrDonRich ($3.44 in chips)
MrDonRich: posts small blind $0.01
maraljero: posts big blind $0.02
*** HOLE CARDS ***
Haliankou: folds
AAvers: folds
RWN/NWR: folds
MrDonRich: folds
Uncalled bet ($0.01) returned to maraljero
maraljero collected $0.02 from pot
maraljero: doesn't show hand
*** SUMMARY ***
Total pot $0.02 | Rake $0
Seat 1: maraljero (big blind) collected ($0.02)
Seat 2: Haliankou folded before Flop (didn't bet)
Seat 3: AAvers folded before Flop (didn't bet)
Seat 4: RWN/NWR (button) folded before Flop (didn't bet)
Seat 6: MrDonRich (small blind) folded before Flop


PokerStars Hand #238174153062:  Hold'em No Limit ($0.01/$0.02 USD) - 2022/08/23 16:18:04 ET
Table 'Equinox IV' 6-max Seat #6 is the button
Seat 1: maraljero ($0.59 in chips)
Seat 2: Haliankou ($1.45 in chips)
Seat 3: AAvers ($2 in chips)
Seat 4: RWN/NWR ($5.64 in chips)
Seat 6: MrDonRich ($3.43 in chips)
maraljero: posts small blind $0.01
Haliankou: posts big blind $0.02
*** HOLE CARDS ***
AAvers: folds
RWN/NWR: raises $0.02 to $0.04
MrDonRich: calls $0.04
maraljero: folds
Haliankou: folds
*** FLOP *** [5c 6d Jc]
RWN/NWR: bets $0.02
MrDonRich: calls $0.02
*** TURN *** [5c 6d Jc] [Ks]
RWN/NWR: checks
MrDonRich: bets $0.09
RWN/NWR: folds
Uncalled bet ($0.09) returned to MrDonRich
MrDonRich collected $0.14 from pot
MrDonRich: doesn't show hand
*** SUMMARY ***
Total pot $0.15 | Rake $0.01
Board [5c 6d Jc Ks]
Seat 1: maraljero (small blind) folded before Flop
Seat 2: Haliankou (big blind) folded before Flop
Seat 3: AAvers folded before Flop (didn't bet)
Seat 4: RWN/NWR folded on the Turn
Seat 6: MrDonRich (button) collected ($0.14)


PokerStars Hand #238174179216:  Hold'em No Limit ($0.01/$0.02 USD) - 2022/08/23 16:18:56 ET
Table 'Equinox IV' 6-max Seat #1 is the button
Seat 1: maraljero ($0.58 in chips)
Seat 2: Haliankou ($1.43 in chips)
Seat 3: AAvers ($2 in chips)
Seat 4: RWN/NWR ($5.58 in chips)
Seat 6: MrDonRich ($3.51 in chips)
Haliankou: posts small blind $0.01
AAvers: posts big blind $0.02
*** HOLE CARDS ***
RWN/NWR: folds
MrDonRich: calls $0.02
maraljero: calls $0.02
Haliankou: folds
AAvers: checks
*** FLOP *** [Ks 4c Ah]
AAvers: checks
MrDonRich: checks
maraljero: bets $0.04
AAvers: folds
MrDonRich: calls $0.04
*** TURN *** [Ks 4c Ah] [7c]
MrDonRich: checks
maraljero: bets $0.10
MrDonRich: calls $0.10
*** RIVER *** [Ks 4c Ah 7c] [Th]
MrDonRich: checks
maraljero: bets $0.14
MrDonRich: folds
Uncalled bet ($0.14) returned to maraljero
maraljero collected $0.34 from pot
maraljero: doesn't show hand
*** SUMMARY ***
Total pot $0.35 | Rake $0.01
Board [Ks 4c Ah 7c Th]
Seat 1: maraljero (button) collected ($0.34)
Seat 2: Haliankou (small blind) folded before Flop
Seat 3: AAvers (big blind) folded on the Flop
Seat 4: RWN/NWR folded before Flop (didn't bet)
Seat 6: MrDonRich folded on the River


PokerStars Hand #238174199556:  Hold'em No Limit ($0.01/$0.02 USD) - 2022/08/23 16:19:48 ET
Table 'Equinox IV' 6-max Seat #2 is the button
Seat 1: maraljero ($0.76 in chips)
Seat 2: Haliankou ($1.42 in chips)
Seat 3: AAvers ($2 in chips)
Seat 4: RWN/NWR ($5.58 in chips)
Seat 6: MrDonRich ($3.35 in chips)
AAvers: posts small blind $0.01
RWN/NWR: posts big blind $0.02
*** HOLE CARDS ***
MrDonRich: calls $0.02
maraljero: calls $0.02
Haliankou: folds
AAvers: raises $0.10 to $0.12
RWN/NWR: calls $0.10
MrDonRich: folds
maraljero: folds
*** FLOP *** [7s 3h 9s]
AAvers: bets $0.18
RWN/NWR: calls $0.18
*** TURN *** [7s 3h 9s] [2d]
AAvers: bets $0.25
RWN/NWR: folds
Uncalled bet ($0.25) returned to AAvers
AAvers collected $0.62 from pot
*** SUMMARY ***
Total pot $0.64 | Rake $0.02
Board [7s 3h 9s 2d]
Seat 1: maraljero folded before Flop
Seat 2: Haliankou (button) folded before Flop (didn't bet)
Seat 3: AAvers (small blind) collected ($0.62)
Seat 4: RWN/NWR (big blind) folded on the Turn
Seat 6: MrDonRich folded before Flop


PokerStars Hand #238174242479:  Hold'em No Limit ($0.01/$0.02 USD) - 2022/08/23 16:21:37 ET
Table 'Equinox IV' 6-max Seat #3 is the button
Seat 1: maraljero ($0.74 in chips)
Seat 2: Haliankou ($1.42 in chips)
Seat 3: AAvers ($2.32 in chips)
Seat 4: RWN/NWR ($5.28 in chips)
Seat 6: MrDonRich ($3.33 in chips)
RWN/NWR: posts small blind $0.01
MrDonRich: posts big blind $0.02
*** HOLE CARDS ***
maraljero: folds
Haliankou: folds
AAvers: raises $0.02 to $0.04
RWN/NWR: folds
MrDonRich: raises $0.09 to $0.13
AAvers: folds
Uncalled bet ($0.09) returned to MrDonRich
MrDonRich collected $0.09 from pot
customdry244 was removed from the table for failing to post
customdry244 leaves the table
MrDonRich: doesn't show hand
*** SUMMARY ***
Total pot $0.09 | Rake $0
Seat 1: maraljero folded before Flop (didn't bet)
Seat 2: Haliankou folded before Flop (didn't bet)
Seat 3: AAvers (button) folded before Flop
Seat 4: RWN/NWR (small blind) folded before Flop
Seat 6: MrDonRich (big blind) collected ($0.09)


PokerStars Hand #238174258806:  Hold'em No Limit ($0.01/$0.02 USD) - 2022/08/23 16:22:18 ET
Table 'Equinox IV' 6-max Seat #4 is the button
Seat 1: maraljero ($0.74 in chips)
Seat 2: Haliankou ($1.42 in chips)
Seat 3: AAvers ($2.28 in chips)
Seat 4: RWN/NWR ($5.27 in chips)
Seat 6: MrDonRich ($3.38 in chips)
MrDonRich: posts small blind $0.01
maraljero: posts big blind $0.02
*** HOLE CARDS ***
Haliankou: folds
AAvers: folds
Estepario_KA joins the table at seat #5
RWN/NWR: raises $0.02 to $0.04
MrDonRich: raises $0.10 to $0.14
maraljero: calls $0.12
RWN/NWR: calls $0.10
*** FLOP *** [9c 8c 6d]
MrDonRich: bets $0.27
maraljero: raises $0.33 to $0.60 and is all-in
RWN/NWR: folds
MrDonRich: calls $0.33
*** TURN *** [9c 8c 6d] [5s]
*** RIVER *** [9c 8c 6d 5s] [Qd]
*** SHOW DOWN ***
MrDonRich: shows [Ad Ac] (a pair of Aces)
maraljero: shows [5d 9d] (two pair, Nines and Fives)
maraljero collected $1.56 from pot
*** SUMMARY ***
Total pot $1.62 | Rake $0.06
Board [9c 8c 6d 5s Qd]
Seat 1: maraljero (big blind) showed [5d 9d] and won ($1.56) with two pair, Nines and Fives
Seat 2: Haliankou folded before Flop (didn't bet)
Seat 3: AAvers folded before Flop (didn't bet)
Seat 4: RWN/NWR (button) folded on the Flop
Seat 6: MrDonRich (small blind) showed [Ad Ac] and lost with a pair of Aces


PokerStars Hand #238174280721:  Hold'em No Limit ($0.01/$0.02 USD) - 2022/08/23 16:23:14 ET
Table 'Equinox IV' 6-max Seat #6 is the button
Seat 1: maraljero ($1.56 in chips)
Seat 2: Haliankou ($1.42 in chips)
Seat 3: AAvers ($2.28 in chips)
Seat 4: RWN/NWR ($5.13 in chips)
Seat 6: MrDonRich ($2.64 in chips)
maraljero: posts small blind $0.01
Haliankou: posts big blind $0.02
Estepario_KA: sits out
*** HOLE CARDS ***
AAvers: folds
RWN/NWR: raises $0.04 to $0.06
MrDonRich: folds
maraljero: calls $0.05
Haliankou: folds
*** FLOP *** [Js 5h Qc]
maraljero: checks
RWN/NWR: bets $0.07
maraljero: calls $0.07
*** TURN *** [Js 5h Qc] [Ah]
maraljero: checks
RWN/NWR: checks
*** RIVER *** [Js 5h Qc Ah] [9d]
maraljero: checks
RWN/NWR: bets $0.08
maraljero: folds
Uncalled bet ($0.08) returned to RWN/NWR
RWN/NWR collected $0.27 from pot
*** SUMMARY ***
Total pot $0.28 | Rake $0.01
Board [Js 5h Qc Ah 9d]
Seat 1: maraljero (small blind) folded on the River
Seat 2: Haliankou (big blind) folded before Flop
Seat 3: AAvers folded before Flop (didn't bet)
Seat 4: RWN/NWR collected ($0.27)
Seat 6: MrDonRich (button) folded before Flop (didn't bet)


PokerStars Hand #238174297316:  Hold'em No Limit ($0.01/$0.02 USD) - 2022/08/23 16:23:56 ET
Table 'Equinox IV' 6-max Seat #1 is the button
Seat 1: maraljero ($1.43 in chips)
Seat 2: Haliankou ($1.40 in chips)
Seat 3: AAvers ($2.28 in chips)
Seat 4: RWN/NWR ($5.27 in chips)
Seat 6: MrDonRich ($2.64 in chips)
Haliankou: posts small blind $0.01
AAvers: posts big blind $0.02
Estepario_KA: sits out
*** HOLE CARDS ***
RWN/NWR: folds
MrDonRich: folds
maraljero: raises $0.02 to $0.04
Haliankou: folds
AAvers: folds
Uncalled bet ($0.02) returned to maraljero
maraljero collected $0.05 from pot
maraljero: doesn't show hand
*** SUMMARY ***
Total pot $0.05 | Rake $0
Seat 1: maraljero (button) collected ($0.05)
Seat 2: Haliankou (small blind) folded before Flop
Seat 3: AAvers (big blind) folded before Flop
Seat 4: RWN/NWR folded before Flop (didn't bet)
Seat 6: MrDonRich folded before Flop (didn't bet)


PokerStars Hand #238174305968:  Hold'em No Limit ($0.01/$0.02 USD) - 2022/08/23 16:24:19 ET
Table 'Equinox IV' 6-max Seat #2 is the button
Seat 1: maraljero ($1.46 in chips)
Seat 2: Haliankou ($1.39 in chips)
Seat 3: AAvers ($2.26 in chips)
Seat 4: RWN/NWR ($5.27 in chips)
Seat 6: MrDonRich ($2.64 in chips)
AAvers: posts small blind $0.01
RWN/NWR: posts big blind $0.02
Estepario_KA: sits out
*** HOLE CARDS ***
MrDonRich: folds
maraljero: raises $0.02 to $0.04
Haliankou: raises $0.04 to $0.08
AAvers: folds
RWN/NWR: folds
maraljero: calls $0.04
*** FLOP *** [Ks 4s 3d]
maraljero: checks
Haliankou: bets $0.10
maraljero: calls $0.10
*** TURN *** [Ks 4s 3d] [5d]
maraljero: checks
Haliankou: checks
*** RIVER *** [Ks 4s 3d 5d] [7s]
maraljero: checks
Haliankou: checks
*** SHOW DOWN ***
maraljero: shows [Kd Ts] (a pair of Kings)
Haliankou: mucks hand
maraljero collected $0.38 from pot
*** SUMMARY ***
Total pot $0.39 | Rake $0.01
Board [Ks 4s 3d 5d 7s]
Seat 1: maraljero showed [Kd Ts] and won ($0.38) with a pair of Kings
Seat 2: Haliankou (button) mucked
Seat 3: AAvers (small blind) folded before Flop
Seat 4: RWN/NWR (big blind) folded before Flop
Seat 6: MrDonRich folded before Flop (didn't bet)


PokerStars Hand #238174320842:  Hold'em No Limit ($0.01/$0.02 USD) - 2022/08/23 16:24:57 ET
Table 'Equinox IV' 6-max Seat #3 is the button
Seat 1: maraljero ($1.66 in chips)
Seat 2: Haliankou ($1.21 in chips)
Seat 3: AAvers ($2.25 in chips)
Seat 4: RWN/NWR ($5.25 in chips)
Seat 5: Estepario_KA ($2 in chips)
Seat 6: MrDonRich ($2.64 in chips)
RWN/NWR: posts small blind $0.01
Estepario_KA: posts big blind $0.02
*** HOLE CARDS ***
MrDonRich: folds
maraljero: folds
Haliankou: raises $0.04 to $0.06
AAvers: folds
RWN/NWR: folds
Estepario_KA: folds
Uncalled bet ($0.04) returned to Haliankou
Haliankou collected $0.05 from pot
Haliankou: doesn't show hand
*** SUMMARY ***
Total pot $0.05 | Rake $0
Seat 1: maraljero folded before Flop (didn't bet)
Seat 2: Haliankou collected ($0.05)
Seat 3: AAvers (button) folded before Flop (didn't bet)
Seat 4: RWN/NWR (small blind) folded before Flop
Seat 5: Estepario_KA (big blind) folded before Flop
Seat 6: MrDonRich folded before Flop (didn't bet)


PokerStars Hand #238174327864:  Hold'em No Limit ($0.01/$0.02 USD) - 2022/08/23 16:25:15 ET
Table 'Equinox IV' 6-max Seat #4 is the button
Seat 1: maraljero ($1.66 in chips)
Seat 2: Haliankou ($1.24 in chips)
Seat 3: AAvers ($2.25 in chips)
Seat 4: RWN/NWR ($5.24 in chips)
Seat 5: Estepario_KA ($2 in chips)
Seat 6: MrDonRich ($2.64 in chips)
Estepario_KA: posts small blind $0.01
MrDonRich: posts big blind $0.02
*** HOLE CARDS ***
maraljero: folds
Haliankou: folds
AAvers: folds
RWN/NWR: folds
Estepario_KA: raises $0.04 to $0.06
MrDonRich: folds
Uncalled bet ($0.04) returned to Estepario_KA
Estepario_KA collected $0.04 from pot
*** SUMMARY ***
Total pot $0.04 | Rake $0
Seat 1: maraljero folded before Flop (didn't bet)
Seat 2: Haliankou folded before Flop (didn't bet)
Seat 3: AAvers folded before Flop (didn't bet)
Seat 4: RWN/NWR (button) folded before Flop (didn't bet)
Seat 5: Estepario_KA (small blind) collected ($0.04)
Seat 6: MrDonRich (big blind) folded before Flop


PokerStars Hand #238174335988:  Hold'em No Limit ($0.01/$0.02 USD) - 2022/08/23 16:25:36 ET
Table 'Equinox IV' 6-max Seat #5 is the button
Seat 1: maraljero ($1.66 in chips)
Seat 2: Haliankou ($1.24 in chips)
Seat 3: AAvers ($2.25 in chips)
Seat 4: RWN/NWR ($5.24 in chips)
Seat 5: Estepario_KA ($2.02 in chips)
Seat 6: MrDonRich ($2.62 in chips)
MrDonRich: posts small blind $0.01
maraljero: posts big blind $0.02
*** HOLE CARDS ***
Haliankou: calls $0.02
AAvers: folds
RWN/NWR: folds
Estepario_KA: raises $0.04 to $0.06
MrDonRich: folds
maraljero: folds
Haliankou: calls $0.04
*** FLOP *** [7h 3s 4c]
Haliankou: bets $0.07
Estepario_KA: calls $0.07
*** TURN *** [7h 3s 4c] [Ac]
Haliankou: checks
Estepario_KA: bets $0.14
Haliankou: folds
Uncalled bet ($0.14) returned to Estepario_KA
Estepario_KA collected $0.28 from pot
*** SUMMARY ***
Total pot $0.29 | Rake $0.01
Board [7h 3s 4c Ac]
Seat 1: maraljero (big blind) folded before Flop
Seat 2: Haliankou folded on the Turn
Seat 3: AAvers folded before Flop (didn't bet)
Seat 4: RWN/NWR folded before Flop (didn't bet)
Seat 5: Estepario_KA (button) collected ($0.28)
Seat 6: MrDonRich (small blind) folded before Flop


PokerStars Hand #238174356896:  Hold'em No Limit ($0.01/$0.02 USD) - 2022/08/23 16:26:30 ET
Table 'Equinox IV' 6-max Seat #6 is the button
Seat 1: maraljero ($1.64 in chips)
Seat 2: Haliankou ($1.11 in chips)
Seat 3: AAvers ($2.25 in chips)
Seat 4: RWN/NWR ($5.24 in chips)
Seat 5: Estepario_KA ($2.17 in chips)
Seat 6: MrDonRich ($2.61 in chips)
maraljero: posts small blind $0.01
Haliankou: posts big blind $0.02
*** HOLE CARDS ***
AAvers: folds
RWN/NWR has timed out
RWN/NWR: folds
Estepario_KA: folds
MrDonRich: folds
maraljero: folds
Uncalled bet ($0.01) returned to Haliankou
Haliankou collected $0.02 from pot
Haliankou: doesn't show hand
*** SUMMARY ***
Total pot $0.02 | Rake $0
Seat 1: maraljero (small blind) folded before Flop
Seat 2: Haliankou (big blind) collected ($0.02)
Seat 3: AAvers folded before Flop (didn't bet)
Seat 4: RWN/NWR folded before Flop (didn't bet)
Seat 5: Estepario_KA folded before Flop (didn't bet)
Seat 6: MrDonRich (button) folded before Flop (didn't bet)


PokerStars Hand #238174378559:  Hold'em No Limit ($0.01/$0.02 USD) - 2022/08/23 16:27:01 ET
Table 'Equinox IV' 6-max Seat #1 is the button
Seat 1: maraljero ($1.63 in chips)
Seat 2: Haliankou ($1.12 in chips)
Seat 3: AAvers ($2.25 in chips)
Seat 4: RWN/NWR ($5.24 in chips)
Seat 5: Estepario_KA ($2.17 in chips)
Seat 6: MrDonRich ($2.61 in chips)
Haliankou: posts small blind $0.01
AAvers: posts big blind $0.02
*** HOLE CARDS ***
RWN/NWR: folds
Estepario_KA: folds
MrDonRich: folds
maraljero: folds
Haliankou: raises $0.04 to $0.06
AAvers: raises $0.12 to $0.18
Haliankou: calls $0.12
*** FLOP *** [As 9h 9s]
Haliankou: checks
AAvers: bets $0.14
Haliankou: calls $0.14
*** TURN *** [As 9h 9s] [6c]
Haliankou: bets $0.31
AAvers: calls $0.31
*** RIVER *** [As 9h 9s 6c] [3d]
Haliankou: bets $0.49 and is all-in
AAvers: calls $0.49
*** SHOW DOWN ***
Haliankou: shows [Js Ad] (two pair, Aces and Nines)
AAvers: shows [Qs Qd] (two pair, Queens and Nines)
Haliankou collected $2.16 from pot
*** SUMMARY ***
Total pot $2.24 | Rake $0.08
Board [As 9h 9s 6c 3d]
Seat 1: maraljero (button) folded before Flop (didn't bet)
Seat 2: Haliankou (small blind) showed [Js Ad] and won ($2.16) with two pair, Aces and Nines
Seat 3: AAvers (big blind) showed [Qs Qd] and lost with two pair, Queens and Nines
Seat 4: RWN/NWR folded before Flop (didn't bet)
Seat 5: Estepario_KA folded before Flop (didn't bet)
Seat 6: MrDonRich folded before Flop (didn't bet)


PokerStars Hand #238174396545:  Hold'em No Limit ($0.01/$0.02 USD) - 2022/08/23 16:27:47 ET
Table 'Equinox IV' 6-max Seat #2 is the button
Seat 1: maraljero ($1.63 in chips)
Seat 2: Haliankou ($2.16 in chips)
Seat 3: AAvers ($2 in chips)
Seat 4: RWN/NWR ($5.24 in chips)
Seat 5: Estepario_KA ($2.17 in chips)
Seat 6: MrDonRich ($2.61 in chips)
AAvers: posts small blind $0.01
RWN/NWR: posts big blind $0.02
*** HOLE CARDS ***
Estepario_KA: folds
MrDonRich: folds
maraljero: raises $0.02 to $0.04
Haliankou: calls $0.04
AAvers: folds
RWN/NWR: calls $0.02
*** FLOP *** [5d 5c 6c]
RWN/NWR: checks
maraljero: checks
Haliankou: bets $0.06
RWN/NWR: calls $0.06
maraljero: folds
*** TURN *** [5d 5c 6c] [As]
RWN/NWR: checks
Haliankou: checks
*** RIVER *** [5d 5c 6c As] [9d]
RWN/NWR: bets $0.30
Haliankou: folds
Uncalled bet ($0.30) returned to RWN/NWR
RWN/NWR collected $0.24 from pot
*** SUMMARY ***
Total pot $0.25 | Rake $0.01
Board [5d 5c 6c As 9d]
Seat 1: maraljero folded on the Flop
Seat 2: Haliankou (button) folded on the River
Seat 3: AAvers (small blind) folded before Flop
Seat 4: RWN/NWR (big blind) collected ($0.24)
Seat 5: Estepario_KA folded before Flop (didn't bet)
Seat 6: MrDonRich folded before Flop (didn't bet)


PokerStars Hand #238174412066:  Hold'em No Limit ($0.01/$0.02 USD) - 2022/08/23 16:28:27 ET
Table 'Equinox IV' 6-max Seat #3 is the button
Seat 1: maraljero ($1.59 in chips)
Seat 2: Haliankou ($2.06 in chips)
Seat 3: AAvers ($2 in chips)
Seat 4: RWN/NWR ($5.38 in chips)
Seat 5: Estepario_KA ($2.17 in chips)
Seat 6: MrDonRich ($2.61 in chips)
RWN/NWR: posts small blind $0.01
Estepario_KA: posts big blind $0.02
*** HOLE CARDS ***
MrDonRich: folds
maraljero: folds
Haliankou: raises $0.04 to $0.06
AAvers: folds
RWN/NWR: folds
Estepario_KA: folds
Uncalled bet ($0.04) returned to Haliankou
Haliankou collected $0.05 from pot
Haliankou: doesn't show hand
*** SUMMARY ***
Total pot $0.05 | Rake $0
Seat 1: maraljero folded before Flop (didn't bet)
Seat 2: Haliankou collected ($0.05)
Seat 3: AAvers (button) folded before Flop (didn't bet)
Seat 4: RWN/NWR (small blind) folded before Flop
Seat 5: Estepario_KA (big blind) folded before Flop
Seat 6: MrDonRich folded before Flop (didn't bet)


PokerStars Hand #238174418930:  Hold'em No Limit ($0.01/$0.02 USD) - 2022/08/23 16:28:44 ET
Table 'Equinox IV' 6-max Seat #4 is the button
Seat 1: maraljero ($1.59 in chips)
Seat 2: Haliankou ($2.09 in chips)
Seat 3: AAvers ($2 in chips)
Seat 4: RWN/NWR ($5.37 in chips)
Seat 5: Estepario_KA ($2.15 in chips)
Seat 6: MrDonRich ($2.61 in chips)
Estepario_KA: posts small blind $0.01
MrDonRich: posts big blind $0.02
*** HOLE CARDS ***
maraljero: raises $0.02 to $0.04
Haliankou: folds
AAvers: raises $0.08 to $0.12
RWN/NWR: folds
Estepario_KA: folds
MrDonRich: calls $0.10
maraljero: calls $0.08
*** FLOP *** [8c Kh 6c]
MrDonRich: checks
maraljero: checks
AAvers: checks
*** TURN *** [8c Kh 6c] [Qs]
MrDonRich: checks
maraljero: bets $0.10
AAvers: calls $0.10
MrDonRich: calls $0.10
*** RIVER *** [8c Kh 6c Qs] [3s]
MrDonRich: checks
maraljero: bets $0.38
AAvers: folds
MrDonRich: folds
Uncalled bet ($0.38) returned to maraljero
maraljero collected $0.65 from pot
maraljero: doesn't show hand
*** SUMMARY ***
Total pot $0.67 | Rake $0.02
Board [8c Kh 6c Qs 3s]
Seat 1: maraljero collected ($0.65)
Seat 2: Haliankou folded before Flop (didn't bet)
Seat 3: AAvers folded on the River
Seat 4: RWN/NWR (button) folded before Flop (didn't bet)
Seat 5: Estepario_KA (small blind) folded before Flop
Seat 6: MrDonRich (big blind) folded on the River


PokerStars Hand #238174441584:  Hold'em No Limit ($0.01/$0.02 USD) - 2022/08/23 16:29:42 ET
Table 'Equinox IV' 6-max Seat #5 is the button
Seat 1: maraljero ($2.02 in chips)
Seat 2: Haliankou ($2.09 in chips)
Seat 3: AAvers ($2 in chips)
Seat 4: RWN/NWR ($5.37 in chips)
Seat 5: Estepario_KA ($2.14 in chips)
Seat 6: MrDonRich ($2.39 in chips)
MrDonRich: posts small blind $0.01
maraljero: posts big blind $0.02
*** HOLE CARDS ***
Haliankou: folds
AAvers: folds
RWN/NWR: raises $0.02 to $0.04
Estepario_KA: folds
MrDonRich: raises $0.10 to $0.14
maraljero: folds
RWN/NWR: calls $0.10
*** FLOP *** [Ks 5d Ad]
MrDonRich: bets $0.19
RWN/NWR: calls $0.19
*** TURN *** [Ks 5d Ad] [Kc]
MrDonRich: checks
RWN/NWR: checks
*** RIVER *** [Ks 5d Ad Kc] [8c]
MrDonRich: bets $0.10
RWN/NWR: calls $0.10
*** SHOW DOWN ***
MrDonRich: shows [Ah Th] (two pair, Aces and Kings)
RWN/NWR: shows [Td Ac] (two pair, Aces and Kings)
MrDonRich collected $0.43 from pot
RWN/NWR collected $0.42 from pot
*** SUMMARY ***
Total pot $0.88 | Rake $0.03
Board [Ks 5d Ad Kc 8c]
Seat 1: maraljero (big blind) folded before Flop
Seat 2: Haliankou folded before Flop (didn't bet)
Seat 3: AAvers folded before Flop (didn't bet)
Seat 4: RWN/NWR showed [Td Ac] and won ($0.42) with two pair, Aces and Kings
Seat 5: Estepario_KA (button) folded before Flop (didn't bet)
Seat 6: MrDonRich (small blind) showed [Ah Th] and won ($0.43) with two pair, Aces and Kings


PokerStars Hand #238174456905:  Hold'em No Limit ($0.01/$0.02 USD) - 2022/08/23 16:30:21 ET
Table 'Equinox IV' 6-max Seat #6 is the button
Seat 1: maraljero ($2 in chips)
Seat 2: Haliankou ($2.09 in chips)
Seat 3: AAvers ($2 in chips)
Seat 4: RWN/NWR ($5.36 in chips)
Seat 5: Estepario_KA ($2.14 in chips)
Seat 6: MrDonRich ($2.39 in chips)
maraljero: posts small blind $0.01
Haliankou: posts big blind $0.02
*** HOLE CARDS ***
AAvers: folds
RWN/NWR: raises $0.04 to $0.06
Estepario_KA: folds
MrDonRich: folds
maraljero: calls $0.05
Haliankou: folds
*** FLOP *** [8h 8d Tc]
maraljero: checks
RWN/NWR: bets $0.07
maraljero: calls $0.07
*** TURN *** [8h 8d Tc] [5c]
maraljero: checks
RWN/NWR: checks
*** RIVER *** [8h 8d Tc 5c] [5s]
maraljero: checks
RWN/NWR: checks
*** SHOW DOWN ***
maraljero: shows [8s 9c] (a full house, Eights full of Fives)
RWN/NWR: mucks hand
maraljero collected $0.27 from pot
*** SUMMARY ***
Total pot $0.28 | Rake $0.01
Board [8h 8d Tc 5c 5s]
Seat 1: maraljero (small blind) showed [8s 9c] and won ($0.27) with a full house, Eights full of Fives
Seat 2: Haliankou (big blind) folded before Flop
Seat 3: AAvers folded before Flop (didn't bet)
Seat 4: RWN/NWR mucked
Seat 5: Estepario_KA folded before Flop (didn't bet)
Seat 6: MrDonRich (button) folded before Flop (didn't bet)


PokerStars Hand #238174473654:  Hold'em No Limit ($0.01/$0.02 USD) - 2022/08/23 16:31:04 ET
Table 'Equinox IV' 6-max Seat #1 is the button
Seat 1: maraljero ($2.14 in chips)
Seat 2: Haliankou ($2.07 in chips)
Seat 3: AAvers ($2 in chips)
Seat 4: RWN/NWR ($5.23 in chips)
Seat 5: Estepario_KA ($2.14 in chips)
Seat 6: MrDonRich ($2.39 in chips)
Haliankou: posts small blind $0.01
AAvers: posts big blind $0.02
*** HOLE CARDS ***
RWN/NWR: folds
Estepario_KA: folds
MrDonRich: raises $0.04 to $0.06
maraljero: folds
Haliankou: folds
AAvers: folds
Uncalled bet ($0.04) returned to MrDonRich
MrDonRich collected $0.05 from pot
MrDonRich: doesn't show hand
*** SUMMARY ***
Total pot $0.05 | Rake $0
Seat 1: maraljero (button) folded before Flop (didn't bet)
Seat 2: Haliankou (small blind) folded before Flop
Seat 3: AAvers (big blind) folded before Flop
Seat 4: RWN/NWR folded before Flop (didn't bet)
Seat 5: Estepario_KA folded before Flop (didn't bet)
Seat 6: MrDonRich collected ($0.05)


PokerStars Hand #238174480668:  Hold'em No Limit ($0.01/$0.02 USD) - 2022/08/23 16:31:22 ET
Table 'Equinox IV' 6-max Seat #2 is the button
Seat 1: maraljero ($2.14 in chips)
Seat 2: Haliankou ($2.06 in chips)
Seat 3: AAvers ($2 in chips)
Seat 4: RWN/NWR ($5.23 in chips)
Seat 5: Estepario_KA ($2.14 in chips)
Seat 6: MrDonRich ($2.42 in chips)
AAvers: posts small blind $0.01
RWN/NWR: posts big blind $0.02
*** HOLE CARDS ***
Estepario_KA: folds
MrDonRich: raises $0.04 to $0.06
maraljero: folds
Haliankou: folds
AAvers: folds
RWN/NWR: folds
Uncalled bet ($0.04) returned to MrDonRich
MrDonRich collected $0.05 from pot
MrDonRich: doesn't show hand
*** SUMMARY ***
Total pot $0.05 | Rake $0
Seat 1: maraljero folded before Flop (didn't bet)
Seat 2: Haliankou (button) folded before Flop (didn't bet)
Seat 3: AAvers (small blind) folded before Flop
Seat 4: RWN/NWR (big blind) folded before Flop
Seat 5: Estepario_KA folded before Flop (didn't bet)
Seat 6: MrDonRich collected ($0.05)


PokerStars Hand #238174487935:  Hold'em No Limit ($0.01/$0.02 USD) - 2022/08/23 16:31:40 ET
Table 'Equinox IV' 6-max Seat #3 is the button
Seat 1: maraljero ($2.14 in chips)
Seat 2: Haliankou ($2.06 in chips)
Seat 3: AAvers ($2 in chips)
Seat 4: RWN/NWR ($5.21 in chips)
Seat 5: Estepario_KA ($2.14 in chips)
Seat 6: MrDonRich ($2.45 in chips)
RWN/NWR: posts small blind $0.01
Estepario_KA: posts big blind $0.02
*** HOLE CARDS ***
MrDonRich: folds
maraljero: folds
Haliankou: folds
AAvers: raises $0.02 to $0.04
RWN/NWR: raises $0.12 to $0.16
Estepario_KA: folds
AAvers: folds
Uncalled bet ($0.12) returned to RWN/NWR
RWN/NWR collected $0.10 from pot
*** SUMMARY ***
Total pot $0.10 | Rake $0
Seat 1: maraljero folded before Flop (didn't bet)
Seat 2: Haliankou folded before Flop (didn't bet)
Seat 3: AAvers (button) folded before Flop
Seat 4: RWN/NWR (small blind) collected ($0.10)
Seat 5: Estepario_KA (big blind) folded before Flop
Seat 6: MrDonRich folded before Flop (didn't bet)


PokerStars Hand #238174505959:  Hold'em No Limit ($0.01/$0.02 USD) - 2022/08/23 16:32:06 ET
Table 'Equinox IV' 6-max Seat #4 is the button
Seat 1: maraljero ($2.14 in chips)
Seat 2: Haliankou ($2.06 in chips)
Seat 3: AAvers ($2 in chips)
Seat 4: RWN/NWR ($5.27 in chips)
Seat 5: Estepario_KA ($2.12 in chips)
Seat 6: MrDonRich ($2.45 in chips)
Estepario_KA: posts small blind $0.01
MrDonRich: posts big blind $0.02
*** HOLE CARDS ***
maraljero: folds
Haliankou: raises $0.06 to $0.08
AAvers: folds
RWN/NWR: folds
Estepario_KA: folds
MrDonRich: calls $0.06
*** FLOP *** [5s As Qd]
MrDonRich: checks
Haliankou: bets $0.10
MrDonRich: folds
Uncalled bet ($0.10) returned to Haliankou
Haliankou collected $0.16 from pot
Haliankou: doesn't show hand
*** SUMMARY ***
Total pot $0.17 | Rake $0.01
Board [5s As Qd]
Seat 1: maraljero folded before Flop (didn't bet)
Seat 2: Haliankou collected ($0.16)
Seat 3: AAvers folded before Flop (didn't bet)
Seat 4: RWN/NWR (button) folded before Flop (didn't bet)
Seat 5: Estepario_KA (small blind) folded before Flop
Seat 6: MrDonRich (big blind) folded on the Flop


PokerStars Hand #238174538094:  Hold'em No Limit ($0.01/$0.02 USD) - 2022/08/23 16:33:28 ET
Table 'Equinox IV' 6-max Seat #6 is the button
Seat 1: maraljero ($2.42 in chips)
Seat 2: Haliankou ($2.14 in chips)
Seat 3: AAvers ($2 in chips)
Seat 5: Estepario_KA ($2.11 in chips)
Seat 6: MrDonRich ($2.36 in chips)
maraljero: posts small blind $0.01
Haliankou: posts big blind $0.02
*** HOLE CARDS ***
AAvers: raises $0.04 to $0.06
Estepario_KA: folds
MrDonRich: folds
maraljero: folds
Haliankou: folds
Uncalled bet ($0.04) returned to AAvers
AAvers collected $0.05 from pot
*** SUMMARY ***
Total pot $0.05 | Rake $0
Seat 1: maraljero (small blind) folded before Flop
Seat 2: Haliankou (big blind) folded before Flop
Seat 3: AAvers collected ($0.05)
Seat 5: Estepario_KA folded before Flop (didn't bet)
Seat 6: MrDonRich (button) folded before Flop (didn't bet)


PokerStars Hand #238174518429:  Hold'em No Limit ($0.01/$0.02 USD) - 2022/08/23 16:32:38 ET
Table 'Equinox IV' 6-max Seat #5 is the button
Seat 1: maraljero ($2.14 in chips)
Seat 2: Haliankou ($2.14 in chips)
Seat 3: AAvers ($2 in chips)
Seat 4: RWN/NWR ($5.27 in chips)
Seat 5: Estepario_KA ($2.11 in chips)
Seat 6: MrDonRich ($2.37 in chips)
MrDonRich: posts small blind $0.01
maraljero: posts big blind $0.02
*** HOLE CARDS ***
Haliankou: folds
AAvers: raises $0.04 to $0.06
RWN/NWR: folds
Estepario_KA: folds
MrDonRich: folds
maraljero: calls $0.04
*** FLOP *** [9s Qs 7c]
maraljero: checks
AAvers: bets $0.09
maraljero: calls $0.09
*** TURN *** [9s Qs 7c] [Kd]
maraljero: checks
AAvers: bets $0.14
maraljero: calls $0.14
*** RIVER *** [9s Qs 7c Kd] [9h]
maraljero: checks
RWN/NWR leaves the table
AAvers: checks
*** SHOW DOWN ***
maraljero: shows [9d Ac] (three of a kind, Nines)
AAvers: mucks hand
maraljero collected $0.57 from pot
*** SUMMARY ***
Total pot $0.59 | Rake $0.02
Board [9s Qs 7c Kd 9h]
Seat 1: maraljero (big blind) showed [9d Ac] and won ($0.57) with three of a kind, Nines
Seat 2: Haliankou folded before Flop (didn't bet)
Seat 3: AAvers mucked
Seat 4: RWN/NWR folded before Flop (didn't bet)
Seat 5: Estepario_KA (button) folded before Flop (didn't bet)
Seat 6: MrDonRich (small blind) folded before Flop


PokerStars Hand #238174549323:  Hold'em No Limit ($0.01/$0.02 USD) - 2022/08/23 16:33:57 ET
Table 'Equinox IV' 6-max Seat #2 is the button
Seat 1: maraljero ($2.41 in chips)
Seat 2: Haliankou ($2.11 in chips)
Seat 3: AAvers ($2.01 in chips)
Seat 6: MrDonRich ($2.39 in chips)
AAvers: posts small blind $0.01
MrDonRich: posts big blind $0.02
*** HOLE CARDS ***
ESCOBAR0204 joins the table at seat #4
MigelBlandt joins the table at seat #5
maraljero: folds
Haliankou: folds
AAvers: folds
Uncalled bet ($0.01) returned to MrDonRich
MrDonRich collected $0.02 from pot
MrDonRich: doesn't show hand
*** SUMMARY ***
Total pot $0.02 | Rake $0
Seat 1: maraljero folded before Flop (didn't bet)
Seat 2: Haliankou (button) folded before Flop (didn't bet)
Seat 3: AAvers (small blind) folded before Flop
Seat 6: MrDonRich (big blind) collected ($0.02)


PokerStars Hand #238174545183:  Hold'em No Limit ($0.01/$0.02 USD) - 2022/08/23 16:33:46 ET
Table 'Equinox IV' 6-max Seat #1 is the button
Seat 1: maraljero ($2.41 in chips)
Seat 2: Haliankou ($2.12 in chips)
Seat 3: AAvers ($2.03 in chips)
Seat 5: Estepario_KA ($2.11 in chips)
Seat 6: MrDonRich ($2.36 in chips)
Haliankou: posts small blind $0.01
AAvers: posts big blind $0.02
*** HOLE CARDS ***
Estepario_KA: folds
Estepario_KA leaves the table
MrDonRich: raises $0.04 to $0.06
maraljero: folds
Haliankou: folds
AAvers: folds
Uncalled bet ($0.04) returned to MrDonRich
MrDonRich collected $0.05 from pot
MrDonRich: doesn't show hand
*** SUMMARY ***
Total pot $0.05 | Rake $0
Seat 1: maraljero (button) folded before Flop (didn't bet)
Seat 2: Haliankou (small blind) folded before Flop
Seat 3: AAvers (big blind) folded before Flop
Seat 5: Estepario_KA folded before Flop (didn't bet)
Seat 6: MrDonRich collected ($0.05)


PokerStars Hand #238174552354:  Hold'em No Limit ($0.01/$0.02 USD) - 2022/08/23 16:34:05 ET
Table 'Equinox IV' 6-max Seat #3 is the button
Seat 1: maraljero ($2.41 in chips)
Seat 2: Haliankou ($2.11 in chips)
Seat 3: AAvers ($2 in chips)
Seat 6: MrDonRich ($2.40 in chips)
MrDonRich: posts small blind $0.01
maraljero: posts big blind $0.02
*** HOLE CARDS ***
Haliankou: folds
AAvers: raises $0.02 to $0.04
MrDonRich: raises $0.10 to $0.14
maraljero: calls $0.12
AAvers: folds
*** FLOP *** [5c 6s 8c]
MrDonRich: bets $0.21
maraljero: calls $0.21
*** TURN *** [5c 6s 8c] [4s]
MrDonRich: bets $0.12
maraljero: calls $0.12
*** RIVER *** [5c 6s 8c 4s] [6d]
MrDonRich: bets $0.10
maraljero: raises $1.15 to $1.25
MrDonRich: folds
Uncalled bet ($1.15) returned to maraljero
maraljero collected $1.14 from pot
maraljero: doesn't show hand
*** SUMMARY ***
Total pot $1.18 | Rake $0.04
Board [5c 6s 8c 4s 6d]
Seat 1: maraljero (big blind) collected ($1.14)
Seat 2: Haliankou folded before Flop (didn't bet)
Seat 3: AAvers (button) folded before Flop
Seat 6: MrDonRich (small blind) folded on the River


PokerStars Hand #238174568948:  Hold'em No Limit ($0.01/$0.02 USD) - 2022/08/23 16:34:47 ET
Table 'Equinox IV' 6-max Seat #6 is the button
Seat 1: maraljero ($2.98 in chips)
Seat 2: Haliankou ($2.11 in chips)
Seat 3: AAvers ($2 in chips)
Seat 4: ESCOBAR0204 ($0.80 in chips)
Seat 6: MrDonRich ($1.83 in chips)
maraljero: posts small blind $0.01
Haliankou: posts big blind $0.02
ESCOBAR0204: posts big blind $0.02
MigelBlandt: sits out
*** HOLE CARDS ***
AAvers: folds
ESCOBAR0204: checks
MrDonRich: calls $0.02
maraljero: calls $0.01
Haliankou: checks
*** FLOP *** [3d 9d Js]
maraljero: checks
Haliankou: checks
ESCOBAR0204: checks
MrDonRich: checks
*** TURN *** [3d 9d Js] [Th]
maraljero: checks
Haliankou: checks
ESCOBAR0204: checks
MrDonRich: checks
*** RIVER *** [3d 9d Js Th] [Qd]
maraljero: checks
Haliankou: checks
ESCOBAR0204: bets $0.08
MrDonRich: folds
maraljero: folds
Haliankou: folds
Uncalled bet ($0.08) returned to ESCOBAR0204
ESCOBAR0204 collected $0.08 from pot
ESCOBAR0204: doesn't show hand
*** SUMMARY ***
Total pot $0.08 | Rake $0
Board [3d 9d Js Th Qd]
Seat 1: maraljero (small blind) folded on the River
Seat 2: Haliankou (big blind) folded on the River
Seat 3: AAvers folded before Flop (didn't bet)
Seat 4: ESCOBAR0204 collected ($0.08)
Seat 6: MrDonRich (button) folded on the River


PokerStars Hand #238174589849:  Hold'em No Limit ($0.01/$0.02 USD) - 2022/08/23 16:35:41 ET
Table 'Equinox IV' 6-max Seat #1 is the button
Seat 1: maraljero ($2.96 in chips)
Seat 2: Haliankou ($2.09 in chips)
Seat 3: AAvers ($2 in chips)
Seat 4: ESCOBAR0204 ($0.86 in chips)
Seat 6: MrDonRich ($1.81 in chips)
Haliankou: posts small blind $0.01
AAvers: posts big blind $0.02
MigelBlandt: sits out
*** HOLE CARDS ***
ESCOBAR0204: raises $0.02 to $0.04
MrDonRich: folds
maraljero: folds
Haliankou: calls $0.03
AAvers: folds
*** FLOP *** [Ad 2c Ts]
Haliankou: checks
ESCOBAR0204: bets $0.04
Haliankou: calls $0.04
*** TURN *** [Ad 2c Ts] [Qh]
Haliankou: checks
ESCOBAR0204: bets $0.10
Haliankou: folds
Uncalled bet ($0.10) returned to ESCOBAR0204
ESCOBAR0204 collected $0.17 from pot
ESCOBAR0204: doesn't show hand
*** SUMMARY ***
Total pot $0.18 | Rake $0.01
Board [Ad 2c Ts Qh]
Seat 1: maraljero (button) folded before Flop (didn't bet)
Seat 2: Haliankou (small blind) folded on the Turn
Seat 3: AAvers (big blind) folded before Flop
Seat 4: ESCOBAR0204 collected ($0.17)
Seat 6: MrDonRich folded before Flop (didn't bet)


PokerStars Hand #238174600864:  Hold'em No Limit ($0.01/$0.02 USD) - 2022/08/23 16:36:10 ET
Table 'Equinox IV' 6-max Seat #2 is the button
Seat 1: maraljero ($2.96 in chips)
Seat 2: Haliankou ($2.01 in chips)
Seat 3: AAvers ($2 in chips)
Seat 4: ESCOBAR0204 ($0.95 in chips)
Seat 6: MrDonRich ($1.81 in chips)
AAvers: posts small blind $0.01
ESCOBAR0204: posts big blind $0.02
MigelBlandt: sits out
*** HOLE CARDS ***
MrDonRich: folds
maraljero: raises $0.02 to $0.04
Haliankou: folds
AAvers: folds
ESCOBAR0204: folds
Uncalled bet ($0.02) returned to maraljero
maraljero collected $0.05 from pot
maraljero: doesn't show hand
*** SUMMARY ***
Total pot $0.05 | Rake $0
Seat 1: maraljero collected ($0.05)
Seat 2: Haliankou (button) folded before Flop (didn't bet)
Seat 3: AAvers (small blind) folded before Flop
Seat 4: ESCOBAR0204 (big blind) folded before Flop
Seat 6: MrDonRich folded before Flop (didn't bet)


PokerStars Hand #238174607080:  Hold'em No Limit ($0.01/$0.02 USD) - 2022/08/23 16:36:26 ET
Table 'Equinox IV' 6-max Seat #3 is the button
Seat 1: maraljero ($2.99 in chips)
Seat 2: Haliankou ($2.01 in chips)
Seat 3: AAvers ($2 in chips)
Seat 4: ESCOBAR0204 ($0.93 in chips)
Seat 5: MigelBlandt ($2 in chips)
Seat 6: MrDonRich ($1.81 in chips)
ESCOBAR0204: posts small blind $0.01
MigelBlandt: posts big blind $0.02
*** HOLE CARDS ***
MrDonRich: folds
maraljero: folds
Haliankou: folds
AAvers: folds
ESCOBAR0204: calls $0.01
MigelBlandt: raises $0.04 to $0.06
ESCOBAR0204: calls $0.04
*** FLOP *** [Qc Kd 7c]
ESCOBAR0204: checks
MigelBlandt: bets $0.07
ESCOBAR0204: calls $0.07
*** TURN *** [Qc Kd 7c] [6c]
ESCOBAR0204: checks
MigelBlandt: checks
*** RIVER *** [Qc Kd 7c 6c] [Kh]
ESCOBAR0204: checks
MigelBlandt: checks
*** SHOW DOWN ***
ESCOBAR0204: shows [2h 2c] (two pair, Kings and Deuces)
MigelBlandt: mucks hand
ESCOBAR0204 collected $0.25 from pot
*** SUMMARY ***
Total pot $0.26 | Rake $0.01
Board [Qc Kd 7c 6c Kh]
Seat 1: maraljero folded before Flop (didn't bet)
Seat 2: Haliankou folded before Flop (didn't bet)
Seat 3: AAvers (button) folded before Flop (didn't bet)
Seat 4: ESCOBAR0204 (small blind) showed [2h 2c] and won ($0.25) with two pair, Kings and Deuces
Seat 5: MigelBlandt (big blind) mucked
Seat 6: MrDonRich folded before Flop (didn't bet)


PokerStars Hand #238174619945:  Hold'em No Limit ($0.01/$0.02 USD) - 2022/08/23 16:37:00 ET
Table 'Equinox IV' 6-max Seat #4 is the button
Seat 1: maraljero ($2.99 in chips)
Seat 2: Haliankou ($2.01 in chips)
Seat 3: AAvers ($2 in chips)
Seat 4: ESCOBAR0204 ($1.05 in chips)
Seat 5: MigelBlandt ($2 in chips)
Seat 6: MrDonRich ($1.81 in chips)
MigelBlandt: posts small blind $0.01
MrDonRich: posts big blind $0.02
*** HOLE CARDS ***
maraljero: folds
Haliankou: raises $0.04 to $0.06
AAvers: raises $0.12 to $0.18
ESCOBAR0204: calls $0.18
MigelBlandt: folds
MrDonRich: folds
Haliankou: folds
*** FLOP *** [4h Js Th]
AAvers: bets $0.17
ESCOBAR0204: calls $0.17
*** TURN *** [4h Js Th] [8h]
AAvers: checks
ESCOBAR0204: checks
*** RIVER *** [4h Js Th 8h] [2c]
AAvers: checks
ESCOBAR0204: checks
*** SHOW DOWN ***
AAvers: shows [Qd Ac] (high card Ace)
ESCOBAR0204: mucks hand
AAvers collected $0.76 from pot
*** SUMMARY ***
Total pot $0.79 | Rake $0.03
Board [4h Js Th 8h 2c]
Seat 1: maraljero folded before Flop (didn't bet)
Seat 2: Haliankou folded before Flop
Seat 3: AAvers showed [Qd Ac] and won ($0.76) with high card Ace
Seat 4: ESCOBAR0204 (button) mucked
Seat 5: MigelBlandt (small blind) folded before Flop
Seat 6: MrDonRich (big blind) folded before Flop


PokerStars Hand #238174664066:  Hold'em No Limit ($0.01/$0.02 USD) - 2022/08/23 16:38:43 ET
Table 'Equinox IV' 6-max Seat #6 is the button
Seat 1: maraljero ($2.97 in chips)
Seat 2: Haliankou ($1.95 in chips)
Seat 3: AAvers ($2.21 in chips)
Seat 4: ESCOBAR0204 ($0.70 in chips)
Seat 5: MigelBlandt ($2 in chips)
Seat 6: MrDonRich ($2.21 in chips)
maraljero: posts small blind $0.01
Haliankou: posts big blind $0.02
*** HOLE CARDS ***
AAvers: folds
ESCOBAR0204: folds
MigelBlandt: folds
MrDonRich: folds
maraljero: folds
Uncalled bet ($0.01) returned to Haliankou
Haliankou collected $0.02 from pot
Haliankou: doesn't show hand
*** SUMMARY ***
Total pot $0.02 | Rake $0
Seat 1: maraljero (small blind) folded before Flop
Seat 2: Haliankou (big blind) collected ($0.02)
Seat 3: AAvers folded before Flop (didn't bet)
Seat 4: ESCOBAR0204 folded before Flop (didn't bet)
Seat 5: MigelBlandt folded before Flop (didn't bet)
Seat 6: MrDonRich (button) folded before Flop (didn't bet)


PokerStars Hand #238174647600:  Hold'em No Limit ($0.01/$0.02 USD) - 2022/08/23 16:38:00 ET
Table 'Equinox IV' 6-max Seat #5 is the button
Seat 1: maraljero ($2.99 in chips)
Seat 2: Haliankou ($1.95 in chips)
Seat 3: AAvers ($2.41 in chips)
Seat 4: ESCOBAR0204 ($0.70 in chips)
Seat 5: MigelBlandt ($2 in chips)
Seat 6: MrDonRich ($2 in chips)
MrDonRich: posts small blind $0.01
maraljero: posts big blind $0.02
*** HOLE CARDS ***
Haliankou: folds
AAvers: raises $0.04 to $0.06
ESCOBAR0204: folds
MigelBlandt: folds
MrDonRich: raises $0.14 to $0.20
maraljero: folds
AAvers: calls $0.14
*** FLOP *** [6h Ad 8c]
MrDonRich: bets $0.27
AAvers: folds
Uncalled bet ($0.27) returned to MrDonRich
MrDonRich collected $0.41 from pot
MrDonRich: doesn't show hand
*** SUMMARY ***
Total pot $0.42 | Rake $0.01
Board [6h Ad 8c]
Seat 1: maraljero (big blind) folded before Flop
Seat 2: Haliankou folded before Flop (didn't bet)
Seat 3: AAvers folded on the Flop
Seat 4: ESCOBAR0204 folded before Flop (didn't bet)
Seat 5: MigelBlandt (button) folded before Flop (didn't bet)
Seat 6: MrDonRich (small blind) collected ($0.41)


PokerStars Hand #238174668549:  Hold'em No Limit ($0.01/$0.02 USD) - 2022/08/23 16:38:54 ET
Table 'Equinox IV' 6-max Seat #1 is the button
Seat 1: maraljero ($2.96 in chips)
Seat 2: Haliankou ($1.96 in chips)
Seat 3: AAvers ($2.21 in chips)
Seat 4: ESCOBAR0204 ($0.70 in chips)
Seat 5: MigelBlandt ($2 in chips)
Seat 6: MrDonRich ($2.21 in chips)
Haliankou: posts small blind $0.01
AAvers: posts big blind $0.02
*** HOLE CARDS ***
ESCOBAR0204: folds
MigelBlandt: raises $0.03 to $0.05
MrDonRich: calls $0.05
maraljero: calls $0.05
Haliankou: folds
AAvers: calls $0.03
*** FLOP *** [9d Jd 3d]
AAvers: checks
MigelBlandt: checks
MrDonRich: checks
maraljero: bets $0.20
AAvers: folds
MigelBlandt: folds
MrDonRich has timed out
MrDonRich: folds
Uncalled bet ($0.20) returned to maraljero
maraljero collected $0.20 from pot
maraljero: doesn't show hand
*** SUMMARY ***
Total pot $0.21 | Rake $0.01
Board [9d Jd 3d]
Seat 1: maraljero (button) collected ($0.20)
Seat 2: Haliankou (small blind) folded before Flop
Seat 3: AAvers (big blind) folded on the Flop
Seat 4: ESCOBAR0204 folded before Flop (didn't bet)
Seat 5: MigelBlandt folded on the Flop
Seat 6: MrDonRich folded on the Flop


PokerStars Hand #238174710211:  Hold'em No Limit ($0.01/$0.02 USD) - 2022/08/23 16:40:43 ET
Table 'Equinox IV' 6-max Seat #2 is the button
Seat 1: maraljero ($3.11 in chips)
Seat 2: Haliankou ($1.95 in chips)
Seat 3: AAvers ($2.16 in chips)
Seat 4: ESCOBAR0204 ($0.70 in chips)
Seat 5: MigelBlandt ($2 in chips)
AAvers: posts small blind $0.01
ESCOBAR0204: posts big blind $0.02
*** HOLE CARDS ***
MigelBlandt: folds
maraljero: raises $0.02 to $0.04
Haliankou: folds
AAvers: folds
ESCOBAR0204: calls $0.02
*** FLOP *** [9s Ts Ad]
ESCOBAR0204: checks
maraljero: checks
*** TURN *** [9s Ts Ad] [As]
ESCOBAR0204: checks
maraljero: bets $0.06
ESCOBAR0204: calls $0.06
*** RIVER *** [9s Ts Ad As] [2s]
ESCOBAR0204: checks
maraljero: bets $0.14
ESCOBAR0204: calls $0.14
*** SHOW DOWN ***
maraljero: shows [Qc Qs] (a flush, Ace high)
ESCOBAR0204: mucks hand
maraljero collected $0.47 from pot
*** SUMMARY ***
Total pot $0.49 | Rake $0.02
Board [9s Ts Ad As 2s]
Seat 1: maraljero showed [Qc Qs] and won ($0.47) with a flush, Ace high
Seat 2: Haliankou (button) folded before Flop (didn't bet)
Seat 3: AAvers (small blind) folded before Flop
Seat 4: ESCOBAR0204 (big blind) mucked
Seat 5: MigelBlandt folded before Flop (didn't bet)


PokerStars Hand #238174729474:  Hold'em No Limit ($0.01/$0.02 USD) - 2022/08/23 16:41:34 ET
Table 'Equinox IV' 6-max Seat #3 is the button
Seat 1: maraljero ($3.34 in chips)
Seat 2: Haliankou ($1.95 in chips)
Seat 3: AAvers ($2.15 in chips)
Seat 4: ESCOBAR0204 ($0.46 in chips)
Seat 5: MigelBlandt ($2 in chips)
ESCOBAR0204: posts small blind $0.01
MigelBlandt: posts big blind $0.02
*** HOLE CARDS ***
maraljero: raises $0.02 to $0.04
Haliankou: folds
AAvers: folds
ESCOBAR0204: calls $0.03
MigelBlandt: calls $0.02
*** FLOP *** [5s 4c 9d]
ESCOBAR0204: checks
MigelBlandt: bets $0.07
maraljero: folds
ESCOBAR0204: folds
Uncalled bet ($0.07) returned to MigelBlandt
MigelBlandt collected $0.12 from pot
MigelBlandt: doesn't show hand
*** SUMMARY ***
Total pot $0.12 | Rake $0
Board [5s 4c 9d]
Seat 1: maraljero folded on the Flop
Seat 2: Haliankou folded before Flop (didn't bet)
Seat 3: AAvers (button) folded before Flop (didn't bet)
Seat 4: ESCOBAR0204 (small blind) folded on the Flop
Seat 5: MigelBlandt (big blind) collected ($0.12)


PokerStars Hand #238174743165:  Hold'em No Limit ($0.01/$0.02 USD) - 2022/08/23 16:42:09 ET
Table 'Equinox IV' 6-max Seat #4 is the button
Seat 1: maraljero ($3.30 in chips)
Seat 2: Haliankou ($1.95 in chips)
Seat 3: AAvers ($2.15 in chips)
Seat 4: ESCOBAR0204 ($0.42 in chips)
Seat 5: MigelBlandt ($2.08 in chips)
MigelBlandt: posts small blind $0.01
maraljero: posts big blind $0.02
*** HOLE CARDS ***
Haliankou: folds
AAvers: folds
ESCOBAR0204: calls $0.02
MigelBlandt: folds
maraljero: checks
*** FLOP *** [Jh 5s 6h]
maraljero: checks
ESCOBAR0204: checks
*** TURN *** [Jh 5s 6h] [5h]
maraljero: bets $0.02
ESCOBAR0204: calls $0.02
*** RIVER *** [Jh 5s 6h 5h] [Js]
maraljero: bets $0.02
ESCOBAR0204: raises $0.02 to $0.04
maraljero: calls $0.02
*** SHOW DOWN ***
ESCOBAR0204: shows [Ah Ac] (two pair, Aces and Jacks)
maraljero: mucks hand
ESCOBAR0204 collected $0.16 from pot
*** SUMMARY ***
Total pot $0.17 | Rake $0.01
Board [Jh 5s 6h 5h Js]
Seat 1: maraljero (big blind) mucked
Seat 2: Haliankou folded before Flop (didn't bet)
Seat 3: AAvers folded before Flop (didn't bet)
Seat 4: ESCOBAR0204 (button) showed [Ah Ac] and won ($0.16) with two pair, Aces and Jacks
Seat 5: MigelBlandt (small blind) folded before Flop


PokerStars Hand #238174758393:  Hold'em No Limit ($0.01/$0.02 USD) - 2022/08/23 16:42:50 ET
Table 'Equinox IV' 6-max Seat #5 is the button
Seat 1: maraljero ($3.22 in chips)
Seat 2: Haliankou ($1.95 in chips)
Seat 3: AAvers ($2.15 in chips)
Seat 4: ESCOBAR0204 ($0.50 in chips)
Seat 5: MigelBlandt ($2.07 in chips)
maraljero: posts small blind $0.01
Haliankou: posts big blind $0.02
*** HOLE CARDS ***
AAvers: folds
ESCOBAR0204: folds
MigelBlandt: folds
maraljero: folds
Uncalled bet ($0.01) returned to Haliankou
Haliankou collected $0.02 from pot
Haliankou: doesn't show hand
*** SUMMARY ***
Total pot $0.02 | Rake $0
Seat 1: maraljero (small blind) folded before Flop
Seat 2: Haliankou (big blind) collected ($0.02)
Seat 3: AAvers folded before Flop (didn't bet)
Seat 4: ESCOBAR0204 folded before Flop (didn't bet)
Seat 5: MigelBlandt (button) folded before Flop (didn't bet)


PokerStars Hand #238174762904:  Hold'em No Limit ($0.01/$0.02 USD) - 2022/08/23 16:43:02 ET
Table 'Equinox IV' 6-max Seat #1 is the button
Seat 1: maraljero ($3.21 in chips)
Seat 2: Haliankou ($1.96 in chips)
Seat 3: AAvers ($2.15 in chips)
Seat 4: ESCOBAR0204 ($0.50 in chips)
Seat 5: MigelBlandt ($2.07 in chips)
Haliankou: posts small blind $0.01
AAvers: posts big blind $0.02
*** HOLE CARDS ***
ESCOBAR0204: folds
MigelBlandt: folds
maraljero: raises $0.02 to $0.04
Haliankou: folds
AAvers: folds
Uncalled bet ($0.02) returned to maraljero
maraljero collected $0.05 from pot
maraljero: doesn't show hand
*** SUMMARY ***
Total pot $0.05 | Rake $0
Seat 1: maraljero (button) collected ($0.05)
Seat 2: Haliankou (small blind) folded before Flop
Seat 3: AAvers (big blind) folded before Flop
Seat 4: ESCOBAR0204 folded before Flop (didn't bet)
Seat 5: MigelBlandt folded before Flop (didn't bet)


PokerStars Hand #238174769852:  Hold'em No Limit ($0.01/$0.02 USD) - 2022/08/23 16:43:20 ET
Table 'Equinox IV' 6-max Seat #2 is the button
Seat 1: maraljero ($3.24 in chips)
Seat 2: Haliankou ($1.95 in chips)
Seat 3: AAvers ($2.13 in chips)
Seat 4: ESCOBAR0204 ($0.50 in chips)
Seat 5: MigelBlandt ($2.07 in chips)
AAvers: posts small blind $0.01
ESCOBAR0204: posts big blind $0.02
*** HOLE CARDS ***
MigelBlandt: folds
maraljero: folds
Haliankou: folds
AAvers: folds
Uncalled bet ($0.01) returned to ESCOBAR0204
ESCOBAR0204 collected $0.02 from pot
ESCOBAR0204: doesn't show hand
*** SUMMARY ***
Total pot $0.02 | Rake $0
Seat 1: maraljero folded before Flop (didn't bet)
Seat 2: Haliankou (button) folded before Flop (didn't bet)
Seat 3: AAvers (small blind) folded before Flop
Seat 4: ESCOBAR0204 (big blind) collected ($0.02)
Seat 5: MigelBlandt folded before Flop (didn't bet)


PokerStars Hand #238174774034:  Hold'em No Limit ($0.01/$0.02 USD) - 2022/08/23 16:43:31 ET
Table 'Equinox IV' 6-max Seat #3 is the button
Seat 1: maraljero ($3.24 in chips)
Seat 2: Haliankou ($1.95 in chips)
Seat 3: AAvers ($2.12 in chips)
Seat 4: ESCOBAR0204 ($0.51 in chips)
Seat 5: MigelBlandt ($2.07 in chips)
ESCOBAR0204: posts small blind $0.01
MigelBlandt: posts big blind $0.02
*** HOLE CARDS ***
maraljero: folds
Haliankou: folds
AAvers: raises $0.02 to $0.04
ESCOBAR0204: raises $0.04 to $0.08
MigelBlandt: calls $0.06
AAvers: calls $0.04
*** FLOP *** [Tc 5h Qd]
ESCOBAR0204: bets $0.08
MigelBlandt: folds
AAvers: folds
Uncalled bet ($0.08) returned to ESCOBAR0204
ESCOBAR0204 collected $0.23 from pot
ESCOBAR0204: doesn't show hand
*** SUMMARY ***
Total pot $0.24 | Rake $0.01
Board [Tc 5h Qd]
Seat 1: maraljero folded before Flop (didn't bet)
Seat 2: Haliankou folded before Flop (didn't bet)
Seat 3: AAvers (button) folded on the Flop
Seat 4: ESCOBAR0204 (small blind) collected ($0.23)
Seat 5: MigelBlandt (big blind) folded on the Flop


PokerStars Hand #238174788932:  Hold'em No Limit ($0.01/$0.02 USD) - 2022/08/23 16:44:11 ET
Table 'Equinox IV' 6-max Seat #4 is the button
Seat 1: maraljero ($3.24 in chips)
Seat 2: Haliankou ($1.95 in chips)
Seat 3: AAvers ($2.04 in chips)
Seat 4: ESCOBAR0204 ($0.66 in chips)
Seat 5: MigelBlandt ($2 in chips)
MigelBlandt: posts small blind $0.01
maraljero: posts big blind $0.02
*** HOLE CARDS ***
Haliankou: raises $0.04 to $0.06
AAvers: folds
ESCOBAR0204: folds
MigelBlandt: folds
maraljero: calls $0.04
*** FLOP *** [7d Qh Qs]
maraljero: checks
Haliankou: bets $0.04
maraljero: folds
Uncalled bet ($0.04) returned to Haliankou
Haliankou collected $0.13 from pot
Haliankou: doesn't show hand
*** SUMMARY ***
Total pot $0.13 | Rake $0
Board [7d Qh Qs]
Seat 1: maraljero (big blind) folded on the Flop
Seat 2: Haliankou collected ($0.13)
Seat 3: AAvers folded before Flop (didn't bet)
Seat 4: ESCOBAR0204 (button) folded before Flop (didn't bet)
Seat 5: MigelBlandt (small blind) folded before Flop


PokerStars Hand #238174798461:  Hold'em No Limit ($0.01/$0.02 USD) - 2022/08/23 16:44:36 ET
Table 'Equinox IV' 6-max Seat #5 is the button
Seat 1: maraljero ($3.18 in chips)
Seat 2: Haliankou ($2.02 in chips)
Seat 3: AAvers ($2.04 in chips)
Seat 4: ESCOBAR0204 ($0.66 in chips)
Seat 5: MigelBlandt ($2 in chips)
maraljero: posts small blind $0.01
Haliankou: posts big blind $0.02
*** HOLE CARDS ***
AAvers: folds
ESCOBAR0204: calls $0.02
MigelBlandt: folds
maraljero: calls $0.01
Haliankou: checks
*** FLOP *** [3h 5h 7c]
maraljero: checks
Haliankou: checks
ESCOBAR0204: checks
*** TURN *** [3h 5h 7c] [Ad]
maraljero: checks
Haliankou: checks
ESCOBAR0204: checks
*** RIVER *** [3h 5h 7c Ad] [4d]
maraljero: checks
Haliankou: checks
ESCOBAR0204: checks
*** SHOW DOWN ***
maraljero: shows [Ks Jd] (high card Ace)
Haliankou: mucks hand
ESCOBAR0204: shows [Kc Kd] (a pair of Kings)
ESCOBAR0204 collected $0.06 from pot
*** SUMMARY ***
Total pot $0.06 | Rake $0
Board [3h 5h 7c Ad 4d]
Seat 1: maraljero (small blind) showed [Ks Jd] and lost with high card Ace
Seat 2: Haliankou (big blind) mucked
Seat 3: AAvers folded before Flop (didn't bet)
Seat 4: ESCOBAR0204 showed [Kc Kd] and won ($0.06) with a pair of Kings
Seat 5: MigelBlandt (button) folded before Flop (didn't bet)


PokerStars Hand #238174815677:  Hold'em No Limit ($0.01/$0.02 USD) - 2022/08/23 16:45:21 ET
Table 'Equinox IV' 6-max Seat #1 is the button
Seat 1: maraljero ($3.16 in chips)
Seat 2: Haliankou ($2 in chips)
Seat 3: AAvers ($2.04 in chips)
Seat 4: ESCOBAR0204 ($0.70 in chips)
Seat 5: MigelBlandt ($2 in chips)
Haliankou: posts small blind $0.01
AAvers: posts big blind $0.02
MrDonRich: sits out
*** HOLE CARDS ***
ESCOBAR0204: folds
MigelBlandt: folds
maraljero: raises $0.02 to $0.04
Haliankou: folds
AAvers: folds
Uncalled bet ($0.02) returned to maraljero
maraljero collected $0.05 from pot
maraljero: doesn't show hand
*** SUMMARY ***
Total pot $0.05 | Rake $0
Seat 1: maraljero (button) collected ($0.05)
Seat 2: Haliankou (small blind) folded before Flop
Seat 3: AAvers (big blind) folded before Flop
Seat 4: ESCOBAR0204 folded before Flop (didn't bet)
Seat 5: MigelBlandt folded before Flop (didn't bet)


PokerStars Hand #238174822739:  Hold'em No Limit ($0.01/$0.02 USD) - 2022/08/23 16:45:40 ET
Table 'Equinox IV' 6-max Seat #2 is the button
Seat 1: maraljero ($3.19 in chips)
Seat 2: Haliankou ($1.99 in chips)
Seat 3: AAvers ($2.02 in chips)
Seat 4: ESCOBAR0204 ($0.70 in chips)
Seat 5: MigelBlandt ($2 in chips)
AAvers: posts small blind $0.01
ESCOBAR0204: posts big blind $0.02
MrDonRich: sits out
*** HOLE CARDS ***
MigelBlandt: folds
maraljero: folds
maraljero leaves the table
Haliankou: raises $0.04 to $0.06
AAvers: calls $0.05
ESCOBAR0204: folds
*** FLOP *** [2c 8h Ad]
AAvers: checks
Haliankou: bets $0.08
AAvers: folds
Uncalled bet ($0.08) returned to Haliankou
Haliankou collected $0.14 from pot
Haliankou: doesn't show hand
*** SUMMARY ***
Total pot $0.14 | Rake $0
Board [2c 8h Ad]
Seat 1: maraljero folded before Flop (didn't bet)
Seat 2: Haliankou (button) collected ($0.14)
Seat 3: AAvers (small blind) folded on the Flop
Seat 4: ESCOBAR0204 (big blind) folded before Flop
Seat 5: MigelBlandt folded before Flop (didn't bet)


PokerStars Hand #238174835525:  Hold'em No Limit ($0.01/$0.02 USD) - 2022/08/23 16:46:14 ET
Table 'Equinox IV' 6-max Seat #3 is the button
Seat 2: Haliankou ($2.07 in chips)
Seat 3: AAvers ($2 in chips)
Seat 4: ESCOBAR0204 ($0.68 in chips)
Seat 5: MigelBlandt ($2 in chips)
ESCOBAR0204: posts small blind $0.01
MigelBlandt: posts big blind $0.02
MrDonRich: sits out
*** HOLE CARDS ***
Haliankou: folds
chxxxs joins the table at seat #1
AAvers has timed out
AAvers: folds
ESCOBAR0204: calls $0.01
MigelBlandt: checks
*** FLOP *** [Th Js 6d]
ESCOBAR0204: checks
MigelBlandt: checks
*** TURN *** [Th Js 6d] [Jd]
ESCOBAR0204: checks
MigelBlandt: checks
*** RIVER *** [Th Js 6d Jd] [8s]
ESCOBAR0204: bets $0.20
MigelBlandt: calls $0.20
*** SHOW DOWN ***
ESCOBAR0204: shows [Kc Kh] (two pair, Kings and Jacks)
MigelBlandt: mucks hand
ESCOBAR0204 collected $0.42 from pot
*** SUMMARY ***
Total pot $0.44 | Rake $0.02
Board [Th Js 6d Jd 8s]
Seat 2: Haliankou folded before Flop (didn't bet)
Seat 3: AAvers (button) folded before Flop (didn't bet)
Seat 4: ESCOBAR0204 (small blind) showed [Kc Kh] and won ($0.42) with two pair, Kings and Jacks
Seat 5: MigelBlandt (big blind) mucked


PokerStars Hand #238174848575:  Hold'em No Limit ($0.01/$0.02 USD) - 2022/08/23 16:46:48 ET
Table 'Equinox IV' 6-max Seat #4 is the button
Seat 2: Haliankou ($2.07 in chips)
Seat 3: AAvers ($2 in chips)
Seat 4: ESCOBAR0204 ($0.88 in chips)
Seat 5: MigelBlandt ($2 in chips)
Seat 6: MrDonRich ($2.16 in chips)
MigelBlandt: posts small blind $0.01
MrDonRich: posts big blind $0.02
chxxxs: sits out
*** HOLE CARDS ***
Haliankou: raises $0.04 to $0.06
AAvers: folds
ESCOBAR0204: folds
MigelBlandt: folds
MrDonRich: folds
Uncalled bet ($0.04) returned to Haliankou
Haliankou collected $0.05 from pot
Haliankou: doesn't show hand
*** SUMMARY ***
Total pot $0.05 | Rake $0
Seat 2: Haliankou collected ($0.05)
Seat 3: AAvers folded before Flop (didn't bet)
Seat 4: ESCOBAR0204 (button) folded before Flop (didn't bet)
Seat 5: MigelBlandt (small blind) folded before Flop
Seat 6: MrDonRich (big blind) folded before Flop


PokerStars Hand #238174854521:  Hold'em No Limit ($0.01/$0.02 USD) - 2022/08/23 16:47:03 ET
Table 'Equinox IV' 6-max Seat #5 is the button
Seat 1: chxxxs ($2 in chips)
Seat 2: Haliankou ($2.10 in chips)
Seat 3: AAvers ($2 in chips)
Seat 4: ESCOBAR0204 ($0.88 in chips)
Seat 5: MigelBlandt ($2 in chips)
Seat 6: MrDonRich ($2.14 in chips)
MrDonRich: posts small blind $0.01
chxxxs: posts big blind $0.02
*** HOLE CARDS ***
Haliankou: folds
AAvers: folds
ESCOBAR0204: calls $0.02
MigelBlandt: folds
MrDonRich: calls $0.01
chxxxs: checks
*** FLOP *** [7d Js Kc]
MrDonRich: checks
chxxxs: checks
ESCOBAR0204: checks
*** TURN *** [7d Js Kc] [Qs]
MrDonRich: checks
chxxxs: checks
ESCOBAR0204: checks
*** RIVER *** [7d Js Kc Qs] [9c]
MrDonRich: checks
chxxxs: checks
ESCOBAR0204: checks
*** SHOW DOWN ***
MrDonRich: shows [8d Ah] (high card Ace)
chxxxs: shows [Th 6c] (a straight, Nine to King)
ESCOBAR0204: mucks hand
chxxxs collected $0.06 from pot
*** SUMMARY ***
Total pot $0.06 | Rake $0
Board [7d Js Kc Qs 9c]
Seat 1: chxxxs (big blind) showed [Th 6c] and won ($0.06) with a straight, Nine to King
Seat 2: Haliankou folded before Flop (didn't bet)
Seat 3: AAvers folded before Flop (didn't bet)
Seat 4: ESCOBAR0204 mucked
Seat 5: MigelBlandt (button) folded before Flop (didn't bet)
Seat 6: MrDonRich (small blind) showed [8d Ah] and lost with high card Ace


PokerStars Hand #238174870699:  Hold'em No Limit ($0.01/$0.02 USD) - 2022/08/23 16:47:46 ET
Table 'Equinox IV' 6-max Seat #6 is the button
Seat 1: chxxxs ($2.04 in chips)
Seat 2: Haliankou ($2.10 in chips)
Seat 3: AAvers ($2 in chips)
Seat 4: ESCOBAR0204 ($0.86 in chips)
Seat 5: MigelBlandt ($2 in chips)
Seat 6: MrDonRich ($2.12 in chips)
chxxxs: posts small blind $0.01
Haliankou: posts big blind $0.02
*** HOLE CARDS ***
AAvers: folds
ESCOBAR0204: calls $0.02
MigelBlandt: folds
MrDonRich: folds
chxxxs: folds
Haliankou: checks
*** FLOP *** [Ts Qd Ah]
Haliankou: bets $0.02
ESCOBAR0204: calls $0.02
*** TURN *** [Ts Qd Ah] [Th]
Haliankou: bets $0.02
ESCOBAR0204: calls $0.02
*** RIVER *** [Ts Qd Ah Th] [8c]
Haliankou: bets $0.02
ESCOBAR0204: calls $0.02
*** SHOW DOWN ***
Haliankou: shows [2d Qs] (two pair, Queens and Tens)
ESCOBAR0204: shows [Qh 6h] (two pair, Queens and Tens)
Haliankou collected $0.08 from pot
ESCOBAR0204 collected $0.08 from pot
*** SUMMARY ***
Total pot $0.17 | Rake $0.01
Board [Ts Qd Ah Th 8c]
Seat 1: chxxxs (small blind) folded before Flop
Seat 2: Haliankou (big blind) showed [2d Qs] and won ($0.08) with two pair, Queens and Tens
Seat 3: AAvers folded before Flop (didn't bet)
Seat 4: ESCOBAR0204 showed [Qh 6h] and won ($0.08) with two pair, Queens and Tens
Seat 5: MigelBlandt folded before Flop (didn't bet)
Seat 6: MrDonRich (button) folded before Flop (didn't bet)


PokerStars Hand #238174884395:  Hold'em No Limit ($0.01/$0.02 USD) - 2022/08/23 16:48:22 ET
Table 'Equinox IV' 6-max Seat #1 is the button
Seat 1: chxxxs ($2.03 in chips)
Seat 2: Haliankou ($2.10 in chips)
Seat 3: AAvers ($2 in chips)
Seat 4: ESCOBAR0204 ($0.86 in chips)
Seat 5: MigelBlandt ($2 in chips)
Seat 6: MrDonRich ($2.12 in chips)
Haliankou: posts small blind $0.01
AAvers: posts big blind $0.02
*** HOLE CARDS ***
ESCOBAR0204: calls $0.02
MigelBlandt: folds
MrDonRich: raises $0.07 to $0.09
chxxxs: folds
Haliankou: folds
AAvers: folds
ESCOBAR0204: folds
Uncalled bet ($0.07) returned to MrDonRich
MrDonRich collected $0.07 from pot
MrDonRich: doesn't show hand
*** SUMMARY ***
Total pot $0.07 | Rake $0
Seat 1: chxxxs (button) folded before Flop (didn't bet)
Seat 2: Haliankou (small blind) folded before Flop
Seat 3: AAvers (big blind) folded before Flop
Seat 4: ESCOBAR0204 folded before Flop
Seat 5: MigelBlandt folded before Flop (didn't bet)
Seat 6: MrDonRich collected ($0.07)


PokerStars Hand #238174889818:  Hold'em No Limit ($0.01/$0.02 USD) - 2022/08/23 16:48:36 ET
Table 'Equinox IV' 6-max Seat #2 is the button
Seat 1: chxxxs ($2.03 in chips)
Seat 2: Haliankou ($2.09 in chips)
Seat 3: AAvers ($2 in chips)
Seat 4: ESCOBAR0204 ($0.84 in chips)
Seat 5: MigelBlandt ($2 in chips)
Seat 6: MrDonRich ($2.17 in chips)
AAvers: posts small blind $0.01
ESCOBAR0204: posts big blind $0.02
*** HOLE CARDS ***
MigelBlandt: folds
MrDonRich: folds
chxxxs: raises $0.04 to $0.06
Haliankou: folds
AAvers: folds
ESCOBAR0204: calls $0.04
*** FLOP *** [9c 2d 2s]
ESCOBAR0204: checks
chxxxs: checks
*** TURN *** [9c 2d 2s] [Ac]
ESCOBAR0204: checks
chxxxs: checks
*** RIVER *** [9c 2d 2s Ac] [3h]
ESCOBAR0204: checks
chxxxs: bets $0.06
ESCOBAR0204: folds
Uncalled bet ($0.06) returned to chxxxs
chxxxs collected $0.13 from pot
chxxxs: doesn't show hand
*** SUMMARY ***
Total pot $0.13 | Rake $0
Board [9c 2d 2s Ac 3h]
Seat 1: chxxxs collected ($0.13)
Seat 2: Haliankou (button) folded before Flop (didn't bet)
Seat 3: AAvers (small blind) folded before Flop
Seat 4: ESCOBAR0204 (big blind) folded on the River
Seat 5: MigelBlandt folded before Flop (didn't bet)
Seat 6: MrDonRich folded before Flop (didn't bet)


PokerStars Hand #238174908204:  Hold'em No Limit ($0.01/$0.02 USD) - 2022/08/23 16:49:25 ET
Table 'Equinox IV' 6-max Seat #3 is the button
Seat 1: chxxxs ($2.10 in chips)
Seat 2: Haliankou ($2.09 in chips)
Seat 3: AAvers ($2 in chips)
Seat 4: ESCOBAR0204 ($0.78 in chips)
Seat 5: MigelBlandt ($2 in chips)
Seat 6: MrDonRich ($2.17 in chips)
ESCOBAR0204: posts small blind $0.01
MigelBlandt: posts big blind $0.02
*** HOLE CARDS ***
MrDonRich: folds
chxxxs: folds
Haliankou: folds
AAvers: folds
ESCOBAR0204: calls $0.01
MigelBlandt: checks
*** FLOP *** [3d Qd Kh]
ESCOBAR0204: checks
MigelBlandt: checks
*** TURN *** [3d Qd Kh] [7d]
ESCOBAR0204: checks
MigelBlandt: checks
*** RIVER *** [3d Qd Kh 7d] [Td]
ESCOBAR0204: checks
MigelBlandt: checks
*** SHOW DOWN ***
ESCOBAR0204: shows [6c Tc] (a pair of Tens)
MigelBlandt: shows [Js 4d] (a flush, Queen high)
MigelBlandt collected $0.04 from pot
*** SUMMARY ***
Total pot $0.04 | Rake $0
Board [3d Qd Kh 7d Td]
Seat 1: chxxxs folded before Flop (didn't bet)
Seat 2: Haliankou folded before Flop (didn't bet)
Seat 3: AAvers (button) folded before Flop (didn't bet)
Seat 4: ESCOBAR0204 (small blind) showed [6c Tc] and lost with a pair of Tens
Seat 5: MigelBlandt (big blind) showed [Js 4d] and won ($0.04) with a flush, Queen high
Seat 6: MrDonRich folded before Flop (didn't bet)


PokerStars Hand #238174922433:  Hold'em No Limit ($0.01/$0.02 USD) - 2022/08/23 16:50:03 ET
Table 'Equinox IV' 6-max Seat #4 is the button
Seat 1: chxxxs ($2.10 in chips)
Seat 2: Haliankou ($2.09 in chips)
Seat 3: AAvers ($2 in chips)
Seat 4: ESCOBAR0204 ($0.76 in chips)
Seat 6: MrDonRich ($2.17 in chips)
MrDonRich: posts small blind $0.01
chxxxs: posts big blind $0.02
*** HOLE CARDS ***
Haliankou: folds
AAvers: folds
ESCOBAR0204: folds
MrDonRich: calls $0.01
chxxxs: checks
*** FLOP *** [6s 2d Js]
MrDonRich: checks
chxxxs: checks
*** TURN *** [6s 2d Js] [9c]
MrDonRich: checks
chxxxs: checks
*** RIVER *** [6s 2d Js 9c] [Ts]
MrDonRich: bets $0.04
chxxxs: calls $0.04
*** SHOW DOWN ***
MrDonRich: shows [5c 2c] (a pair of Deuces)
chxxxs: shows [Td Kh] (a pair of Tens)
chxxxs collected $0.12 from pot
*** SUMMARY ***
Total pot $0.12 | Rake $0
Board [6s 2d Js 9c Ts]
Seat 1: chxxxs (big blind) showed [Td Kh] and won ($0.12) with a pair of Tens
Seat 2: Haliankou folded before Flop (didn't bet)
Seat 3: AAvers folded before Flop (didn't bet)
Seat 4: ESCOBAR0204 (button) folded before Flop (didn't bet)
Seat 6: MrDonRich (small blind) showed [5c 2c] and lost with a pair of Deuces


PokerStars Hand #238174939552:  Hold'em No Limit ($0.01/$0.02 USD) - 2022/08/23 16:50:48 ET
Table 'Equinox IV' 6-max Seat #6 is the button
Seat 1: chxxxs ($2.16 in chips)
Seat 2: Haliankou ($2.09 in chips)
Seat 3: AAvers ($2 in chips)
Seat 4: ESCOBAR0204 ($0.76 in chips)
Seat 6: MrDonRich ($2.11 in chips)
chxxxs: posts small blind $0.01
Haliankou: posts big blind $0.02
*** HOLE CARDS ***
AAvers: folds
ESCOBAR0204: calls $0.02
MrDonRich: calls $0.02
chxxxs: folds
Haliankou: checks
*** FLOP *** [8d 7d Th]
Haliankou: checks
ESCOBAR0204: checks
MrDonRich: checks
*** TURN *** [8d 7d Th] [2c]
Haliankou: checks
ESCOBAR0204: bets $0.08
MrDonRich: folds
Haliankou: folds
Uncalled bet ($0.08) returned to ESCOBAR0204
ESCOBAR0204 collected $0.07 from pot
ESCOBAR0204: doesn't show hand
*** SUMMARY ***
Total pot $0.07 | Rake $0
Board [8d 7d Th 2c]
Seat 1: chxxxs (small blind) folded before Flop
Seat 2: Haliankou (big blind) folded on the Turn
Seat 3: AAvers folded before Flop (didn't bet)
Seat 4: ESCOBAR0204 collected ($0.07)
Seat 6: MrDonRich (button) folded on the Turn


PokerStars Hand #238174956533:  Hold'em No Limit ($0.01/$0.02 USD) - 2022/08/23 16:51:33 ET
Table 'Equinox IV' 6-max Seat #1 is the button
Seat 1: chxxxs ($2.15 in chips)
Seat 2: Haliankou ($2.07 in chips)
Seat 3: AAvers ($2 in chips)
Seat 4: ESCOBAR0204 ($0.81 in chips)
Seat 6: MrDonRich ($2.09 in chips)
Haliankou: posts small blind $0.01
AAvers: posts big blind $0.02
*** HOLE CARDS ***
ESCOBAR0204: folds
MrDonRich: folds
chxxxs: raises $0.03 to $0.05
Haliankou: raises $0.11 to $0.16
AAvers: folds
chxxxs: folds
Uncalled bet ($0.11) returned to Haliankou
Haliankou collected $0.12 from pot
Haliankou: doesn't show hand
*** SUMMARY ***
Total pot $0.12 | Rake $0
Seat 1: chxxxs (button) folded before Flop
Seat 2: Haliankou (small blind) collected ($0.12)
Seat 3: AAvers (big blind) folded before Flop
Seat 4: ESCOBAR0204 folded before Flop (didn't bet)
Seat 6: MrDonRich folded before Flop (didn't bet)


PokerStars Hand #238174971365:  Hold'em No Limit ($0.01/$0.02 USD) - 2022/08/23 16:52:13 ET
Table 'Equinox IV' 6-max Seat #2 is the button
Seat 1: chxxxs ($2.10 in chips)
Seat 2: Haliankou ($2.14 in chips)
Seat 3: AAvers ($2 in chips)
Seat 4: ESCOBAR0204 ($0.81 in chips)
Seat 6: MrDonRich ($2.09 in chips)
AAvers: posts small blind $0.01
ESCOBAR0204: posts big blind $0.02
*** HOLE CARDS ***
MrDonRich: folds
chxxxs: folds
Haliankou: raises $0.04 to $0.06
AAvers: folds
ESCOBAR0204: raises $0.04 to $0.10
Haliankou: calls $0.04
*** FLOP *** [8h Ac 8d]
ESCOBAR0204: bets $0.06
Haliankou: calls $0.06
*** TURN *** [8h Ac 8d] [Kd]
ESCOBAR0204: bets $0.10
Haliankou: calls $0.10
*** RIVER *** [8h Ac 8d Kd] [4c]
ESCOBAR0204: checks
Haliankou: bets $0.10
ESCOBAR0204: calls $0.10
*** SHOW DOWN ***
Haliankou: shows [Kc Td] (two pair, Kings and Eights)
ESCOBAR0204: mucks hand
Haliankou collected $0.70 from pot
*** SUMMARY ***
Total pot $0.73 | Rake $0.03
Board [8h Ac 8d Kd 4c]
Seat 1: chxxxs folded before Flop (didn't bet)
Seat 2: Haliankou (button) showed [Kc Td] and won ($0.70) with two pair, Kings and Eights
Seat 3: AAvers (small blind) folded before Flop
Seat 4: ESCOBAR0204 (big blind) mucked
Seat 6: MrDonRich folded before Flop (didn't bet)


PokerStars Hand #238174984878:  Hold'em No Limit ($0.01/$0.02 USD) - 2022/08/23 16:52:49 ET
Table 'Equinox IV' 6-max Seat #3 is the button
Seat 1: chxxxs ($2.10 in chips)
Seat 2: Haliankou ($2.48 in chips)
Seat 3: AAvers ($2 in chips)
Seat 4: ESCOBAR0204 ($0.45 in chips)
Seat 6: MrDonRich ($2.09 in chips)
ESCOBAR0204: posts small blind $0.01
MrDonRich: posts big blind $0.02
*** HOLE CARDS ***
chxxxs: folds
Haliankou: raises $0.04 to $0.06
AAvers: raises $0.12 to $0.18
ESCOBAR0204: folds
MrDonRich: folds
Haliankou: folds
Uncalled bet ($0.12) returned to AAvers
AAvers collected $0.15 from pot
*** SUMMARY ***
Total pot $0.15 | Rake $0
Seat 1: chxxxs folded before Flop (didn't bet)
Seat 2: Haliankou folded before Flop
Seat 3: AAvers (button) collected ($0.15)
Seat 4: ESCOBAR0204 (small blind) folded before Flop
Seat 6: MrDonRich (big blind) folded before Flop


PokerStars Hand #238174991515:  Hold'em No Limit ($0.01/$0.02 USD) - 2022/08/23 16:53:06 ET
Table 'Equinox IV' 6-max Seat #4 is the button
Seat 1: chxxxs ($2.10 in chips)
Seat 2: Haliankou ($2.42 in chips)
Seat 3: AAvers ($2.09 in chips)
Seat 4: ESCOBAR0204 ($0.44 in chips)
Seat 6: MrDonRich ($2.07 in chips)
MrDonRich: posts small blind $0.01
chxxxs: posts big blind $0.02
*** HOLE CARDS ***
Haliankou: folds
AAvers: raises $0.03 to $0.05
ESCOBAR0204: raises $0.03 to $0.08
MrDonRich: folds
chxxxs: folds
AAvers: calls $0.03
*** FLOP *** [9c 4h Th]
AAvers: checks
ESCOBAR0204: bets $0.06
AAvers: calls $0.06
*** TURN *** [9c 4h Th] [3h]
AAvers: checks
ESCOBAR0204: bets $0.08
AAvers: folds
Uncalled bet ($0.08) returned to ESCOBAR0204
ESCOBAR0204 collected $0.30 from pot
ESCOBAR0204: doesn't show hand
*** SUMMARY ***
Total pot $0.31 | Rake $0.01
Board [9c 4h Th 3h]
Seat 1: chxxxs (big blind) folded before Flop
Seat 2: Haliankou folded before Flop (didn't bet)
Seat 3: AAvers folded on the Turn
Seat 4: ESCOBAR0204 (button) collected ($0.30)
Seat 6: MrDonRich (small blind) folded before Flop


PokerStars Hand #238175017972:  Hold'em No Limit ($0.01/$0.02 USD) - 2022/08/23 16:53:52 ET
Table 'Equinox IV' 6-max Seat #6 is the button
Seat 1: chxxxs ($2.08 in chips)
Seat 2: Haliankou ($2.42 in chips)
Seat 3: AAvers ($2 in chips)
Seat 4: ESCOBAR0204 ($0.60 in chips)
Seat 6: MrDonRich ($2.06 in chips)
chxxxs: posts small blind $0.01
Haliankou: posts big blind $0.02
*** HOLE CARDS ***
AAvers: folds
ESCOBAR0204: raises $0.04 to $0.06
MrDonRich: folds
chxxxs: folds
Haliankou: folds
Uncalled bet ($0.04) returned to ESCOBAR0204
ESCOBAR0204 collected $0.05 from pot
ESCOBAR0204: doesn't show hand
*** SUMMARY ***
Total pot $0.05 | Rake $0
Seat 1: chxxxs (small blind) folded before Flop
Seat 2: Haliankou (big blind) folded before Flop
Seat 3: AAvers folded before Flop (didn't bet)
Seat 4: ESCOBAR0204 collected ($0.05)
Seat 6: MrDonRich (button) folded before Flop (didn't bet)


PokerStars Hand #238175023495:  Hold'em No Limit ($0.01/$0.02 USD) - 2022/08/23 16:54:06 ET
Table 'Equinox IV' 6-max Seat #1 is the button
Seat 1: chxxxs ($2.07 in chips)
Seat 2: Haliankou ($2.40 in chips)
Seat 3: AAvers ($2 in chips)
Seat 4: ESCOBAR0204 ($0.63 in chips)
Seat 6: MrDonRich ($2.06 in chips)
Haliankou: posts small blind $0.01
AAvers: posts big blind $0.02
*** HOLE CARDS ***
ESCOBAR0204: raises $0.02 to $0.04
MrDonRich: folds
chxxxs: folds
Haliankou: calls $0.03
AAvers: folds
*** FLOP *** [3d 2h 9c]
Haliankou: checks
ESCOBAR0204: bets $0.10
Haliankou: folds
Uncalled bet ($0.10) returned to ESCOBAR0204
ESCOBAR0204 collected $0.10 from pot
ESCOBAR0204: doesn't show hand
*** SUMMARY ***
Total pot $0.10 | Rake $0
Board [3d 2h 9c]
Seat 1: chxxxs (button) folded before Flop (didn't bet)
Seat 2: Haliankou (small blind) folded on the Flop
Seat 3: AAvers (big blind) folded before Flop
Seat 4: ESCOBAR0204 collected ($0.10)
Seat 6: MrDonRich folded before Flop (didn't bet)


PokerStars Hand #238175032003:  Hold'em No Limit ($0.01/$0.02 USD) - 2022/08/23 16:54:30 ET
Table 'Equinox IV' 6-max Seat #2 is the button
Seat 1: chxxxs ($2.07 in chips)
Seat 2: Haliankou ($2.36 in chips)
Seat 3: AAvers ($2 in chips)
Seat 4: ESCOBAR0204 ($0.69 in chips)
Seat 6: MrDonRich ($2.06 in chips)
AAvers: posts small blind $0.01
ESCOBAR0204: posts big blind $0.02
*** HOLE CARDS ***
MrDonRich: calls $0.02
chxxxs: folds
Haliankou: folds
AAvers: folds
ESCOBAR0204: checks
*** FLOP *** [2h 3c 5s]
ESCOBAR0204: bets $0.02
MrDonRich: calls $0.02
*** TURN *** [2h 3c 5s] [3h]
ESCOBAR0204: bets $0.02
MrDonRich: calls $0.02
*** RIVER *** [2h 3c 5s 3h] [6d]
ESCOBAR0204: bets $0.24
MrDonRich: folds
Uncalled bet ($0.24) returned to ESCOBAR0204
ESCOBAR0204 collected $0.13 from pot
ESCOBAR0204: doesn't show hand
*** SUMMARY ***
Total pot $0.13 | Rake $0
Board [2h 3c 5s 3h 6d]
Seat 1: chxxxs folded before Flop (didn't bet)
Seat 2: Haliankou (button) folded before Flop (didn't bet)
Seat 3: AAvers (small blind) folded before Flop
Seat 4: ESCOBAR0204 (big blind) collected ($0.13)
Seat 6: MrDonRich folded on the River


PokerStars Hand #238175046133:  Hold'em No Limit ($0.01/$0.02 USD) - 2022/08/23 16:55:08 ET
Table 'Equinox IV' 6-max Seat #3 is the button
Seat 1: chxxxs ($2.07 in chips)
Seat 2: Haliankou ($2.36 in chips)
Seat 3: AAvers ($2 in chips)
Seat 4: ESCOBAR0204 ($0.76 in chips)
Seat 6: MrDonRich ($2 in chips)
ESCOBAR0204: posts small blind $0.01
MrDonRich: posts big blind $0.02
*** HOLE CARDS ***
chxxxs: folds
Haliankou: folds
AAvers: folds
ESCOBAR0204: raises $0.02 to $0.04
MrDonRich: folds
Uncalled bet ($0.02) returned to ESCOBAR0204
ESCOBAR0204 collected $0.04 from pot
ESCOBAR0204: doesn't show hand
*** SUMMARY ***
Total pot $0.04 | Rake $0
Seat 1: chxxxs folded before Flop (didn't bet)
Seat 2: Haliankou folded before Flop (didn't bet)
Seat 3: AAvers (button) folded before Flop (didn't bet)
Seat 4: ESCOBAR0204 (small blind) collected ($0.04)
Seat 6: MrDonRich (big blind) folded before Flop


PokerStars Hand #238175050564:  Hold'em No Limit ($0.01/$0.02 USD) - 2022/08/23 16:55:21 ET
Table 'Equinox IV' 6-max Seat #4 is the button
Seat 1: chxxxs ($2.07 in chips)
Seat 2: Haliankou ($2.36 in chips)
Seat 3: AAvers ($2 in chips)
Seat 4: ESCOBAR0204 ($0.78 in chips)
Seat 6: MrDonRich ($1.98 in chips)
MrDonRich: posts small blind $0.01
chxxxs: posts big blind $0.02
*** HOLE CARDS ***
Haliankou: folds
AAvers: folds
ESCOBAR0204: raises $0.02 to $0.04
MrDonRich: folds
chxxxs: calls $0.02
*** FLOP *** [4s 3s 4d]
chxxxs: checks
ESCOBAR0204: bets $0.06
chxxxs: folds
Uncalled bet ($0.06) returned to ESCOBAR0204
ESCOBAR0204 collected $0.09 from pot
ESCOBAR0204: doesn't show hand
*** SUMMARY ***
Total pot $0.09 | Rake $0
Board [4s 3s 4d]
Seat 1: chxxxs (big blind) folded on the Flop
Seat 2: Haliankou folded before Flop (didn't bet)
Seat 3: AAvers folded before Flop (didn't bet)
Seat 4: ESCOBAR0204 (button) collected ($0.09)
Seat 6: MrDonRich (small blind) folded before Flop


PokerStars Hand #238175064974:  Hold'em No Limit ($0.01/$0.02 USD) - 2022/08/23 16:56:12 ET
Table 'Equinox IV' 6-max Seat #6 is the button
Seat 1: chxxxs ($2.03 in chips)
Seat 2: Haliankou ($2.36 in chips)
Seat 3: AAvers ($2 in chips)
Seat 4: ESCOBAR0204 ($0.83 in chips)
Seat 6: MrDonRich ($1.97 in chips)
chxxxs: posts small blind $0.01
Haliankou: posts big blind $0.02
*** HOLE CARDS ***
AAvers: raises $0.04 to $0.06
ESCOBAR0204: calls $0.06
MrDonRich: calls $0.06
chxxxs: folds
Haliankou: folds
*** FLOP *** [6c 9d 8d]
AAvers: checks
ESCOBAR0204: bets $0.08
MrDonRich: folds
AAvers: folds
Uncalled bet ($0.08) returned to ESCOBAR0204
ESCOBAR0204 collected $0.20 from pot
ESCOBAR0204: doesn't show hand
*** SUMMARY ***
Total pot $0.21 | Rake $0.01
Board [6c 9d 8d]
Seat 1: chxxxs (small blind) folded before Flop
Seat 2: Haliankou (big blind) folded before Flop
Seat 3: AAvers folded on the Flop
Seat 4: ESCOBAR0204 collected ($0.20)
Seat 6: MrDonRich (button) folded on the Flop


PokerStars Hand #238175073346:  Hold'em No Limit ($0.01/$0.02 USD) - 2022/08/23 16:56:40 ET
Table 'Equinox IV' 6-max Seat #1 is the button
Seat 1: chxxxs ($2.02 in chips)
Seat 2: Haliankou ($2.34 in chips)
Seat 3: AAvers ($2 in chips)
Seat 4: ESCOBAR0204 ($0.97 in chips)
Seat 6: MrDonRich ($1.91 in chips)
Haliankou: posts small blind $0.01
AAvers: posts big blind $0.02
*** HOLE CARDS ***
ESCOBAR0204: calls $0.02
MrDonRich: folds
chxxxs: folds
Haliankou: folds
AAvers: checks
*** FLOP *** [5d 7s 4h]
AAvers: checks
ESCOBAR0204: checks
*** TURN *** [5d 7s 4h] [3h]
AAvers: bets $0.02
ESCOBAR0204: folds
Uncalled bet ($0.02) returned to AAvers
AAvers collected $0.05 from pot
*** SUMMARY ***
Total pot $0.05 | Rake $0
Board [5d 7s 4h 3h]
Seat 1: chxxxs (button) folded before Flop (didn't bet)
Seat 2: Haliankou (small blind) folded before Flop
Seat 3: AAvers (big blind) collected ($0.05)
Seat 4: ESCOBAR0204 folded on the Turn
Seat 6: MrDonRich folded before Flop (didn't bet)


PokerStars Hand #238175078808:  Hold'em No Limit ($0.01/$0.02 USD) - 2022/08/23 16:56:59 ET
Table 'Equinox IV' 6-max Seat #2 is the button
Seat 1: chxxxs ($2.02 in chips)
Seat 2: Haliankou ($2.33 in chips)
Seat 3: AAvers ($2.03 in chips)
Seat 4: ESCOBAR0204 ($0.95 in chips)
Seat 6: MrDonRich ($1.91 in chips)
AAvers: posts small blind $0.01
ESCOBAR0204: posts big blind $0.02
*** HOLE CARDS ***
MrDonRich: folds
chxxxs: folds
Haliankou: folds
AAvers: folds
Uncalled bet ($0.01) returned to ESCOBAR0204
ESCOBAR0204 collected $0.02 from pot
ESCOBAR0204: doesn't show hand
*** SUMMARY ***
Total pot $0.02 | Rake $0
Seat 1: chxxxs folded before Flop (didn't bet)
Seat 2: Haliankou (button) folded before Flop (didn't bet)
Seat 3: AAvers (small blind) folded before Flop
Seat 4: ESCOBAR0204 (big blind) collected ($0.02)
Seat 6: MrDonRich folded before Flop (didn't bet)


PokerStars Hand #238175083117:  Hold'em No Limit ($0.01/$0.02 USD) - 2022/08/23 16:57:14 ET
Table 'Equinox IV' 6-max Seat #3 is the button
Seat 1: chxxxs ($2.02 in chips)
Seat 2: Haliankou ($2.33 in chips)
Seat 3: AAvers ($2.02 in chips)
Seat 4: ESCOBAR0204 ($0.96 in chips)
Seat 6: MrDonRich ($1.91 in chips)
ESCOBAR0204: posts small blind $0.01
MrDonRich: posts big blind $0.02
*** HOLE CARDS ***
chxxxs: raises $0.04 to $0.06
Haliankou: folds
AAvers: folds
ESCOBAR0204: folds
MrDonRich: calls $0.04
*** FLOP *** [6s Qd Th]
MrDonRich: bets $0.09
chxxxs: calls $0.09
*** TURN *** [6s Qd Th] [Qc]
MrDonRich: bets $0.20
chxxxs: calls $0.20
*** RIVER *** [6s Qd Th Qc] [7d]
MrDonRich: bets $0.69
chxxxs: folds
Uncalled bet ($0.69) returned to MrDonRich
MrDonRich collected $0.69 from pot
MigelBlandt was removed from the table for failing to post
MigelBlandt leaves the table
MrDonRich: doesn't show hand
*** SUMMARY ***
Total pot $0.71 | Rake $0.02
Board [6s Qd Th Qc 7d]
Seat 1: chxxxs folded on the River
Seat 2: Haliankou folded before Flop (didn't bet)
Seat 3: AAvers (button) folded before Flop (didn't bet)
Seat 4: ESCOBAR0204 (small blind) folded before Flop
Seat 6: MrDonRich (big blind) collected ($0.69)


PokerStars Hand #238175101695:  Hold'em No Limit ($0.01/$0.02 USD) - 2022/08/23 16:58:19 ET
Table 'Equinox IV' 6-max Seat #4 is the button
Seat 1: chxxxs ($2 in chips)
Seat 2: Haliankou ($2.33 in chips)
Seat 3: AAvers ($2.02 in chips)
Seat 4: ESCOBAR0204 ($0.95 in chips)
Seat 6: MrDonRich ($2.25 in chips)
MrDonRich: posts small blind $0.01
chxxxs: posts big blind $0.02
*** HOLE CARDS ***
Haliankou has timed out
Haliankou: folds
AAvers: raises $0.03 to $0.05
ESCOBAR0204: calls $0.05
MrDonRich: calls $0.04
chxxxs: folds
*** FLOP *** [7d Js 4s]
MrDonRich: bets $0.11
AAvers: folds
ESCOBAR0204: calls $0.11
*** TURN *** [7d Js 4s] [6c]
MrDonRich: bets $0.32
ESCOBAR0204: folds
Uncalled bet ($0.32) returned to MrDonRich
MrDonRich collected $0.38 from pot
MrDonRich: doesn't show hand
*** SUMMARY ***
Total pot $0.39 | Rake $0.01
Board [7d Js 4s 6c]
Seat 1: chxxxs (big blind) folded before Flop
Seat 2: Haliankou folded before Flop (didn't bet)
Seat 3: AAvers folded on the Flop
Seat 4: ESCOBAR0204 (button) folded on the Turn
Seat 6: MrDonRich (small blind) collected ($0.38)


PokerStars Hand #238175116108:  Hold'em No Limit ($0.01/$0.02 USD) - 2022/08/23 16:59:09 ET
Table 'Equinox IV' 6-max Seat #6 is the button
Seat 1: chxxxs ($2 in chips)
Seat 2: Haliankou ($2.33 in chips)
Seat 3: AAvers ($2 in chips)
Seat 4: ESCOBAR0204 ($0.79 in chips)
Seat 6: MrDonRich ($2.47 in chips)
chxxxs: posts small blind $0.01
Haliankou: posts big blind $0.02
*** HOLE CARDS ***
AAvers: folds
ESCOBAR0204: folds
MrDonRich: folds
chxxxs: folds
Uncalled bet ($0.01) returned to Haliankou
Haliankou collected $0.02 from pot
Haliankou: doesn't show hand
*** SUMMARY ***
Total pot $0.02 | Rake $0
Seat 1: chxxxs (small blind) folded before Flop
Seat 2: Haliankou (big blind) collected ($0.02)
Seat 3: AAvers folded before Flop (didn't bet)
Seat 4: ESCOBAR0204 folded before Flop (didn't bet)
Seat 6: MrDonRich (button) folded before Flop (didn't bet)


PokerStars Hand #238175119605:  Hold'em No Limit ($0.01/$0.02 USD) - 2022/08/23 16:59:21 ET
Table 'Equinox IV' 6-max Seat #1 is the button
Seat 1: chxxxs ($2 in chips)
Seat 2: Haliankou ($2.34 in chips)
Seat 3: AAvers ($2 in chips)
Seat 4: ESCOBAR0204 ($0.79 in chips)
Seat 6: MrDonRich ($2.47 in chips)
Haliankou: posts small blind $0.01
AAvers: posts big blind $0.02
*** HOLE CARDS ***
ESCOBAR0204: folds
MrDonRich: folds
chxxxs: raises $0.03 to $0.05
Haliankou: folds
AAvers: raises $0.15 to $0.20
Tiones Ezequiel joins the table at seat #5
chxxxs: calls $0.15
*** FLOP *** [Qc 6s 5c]
AAvers: bets $0.27
chxxxs: folds
Uncalled bet ($0.27) returned to AAvers
AAvers collected $0.40 from pot
*** SUMMARY ***
Total pot $0.41 | Rake $0.01
Board [Qc 6s 5c]
Seat 1: chxxxs (button) folded on the Flop
Seat 2: Haliankou (small blind) folded before Flop
Seat 3: AAvers (big blind) collected ($0.40)
Seat 4: ESCOBAR0204 folded before Flop (didn't bet)
Seat 6: MrDonRich folded before Flop (didn't bet)


PokerStars Hand #238175132925:  Hold'em No Limit ($0.01/$0.02 USD) - 2022/08/23 17:00:07 ET
Table 'Equinox IV' 6-max Seat #2 is the button
Seat 1: chxxxs ($2 in chips)
Seat 2: Haliankou ($2.33 in chips)
Seat 3: AAvers ($2.20 in chips)
Seat 4: ESCOBAR0204 ($0.79 in chips)
Seat 5: Tiones Ezequiel ($0.80 in chips)
Seat 6: MrDonRich ($2.47 in chips)
AAvers: posts small blind $0.01
ESCOBAR0204: posts big blind $0.02
Tiones Ezequiel: posts big blind $0.02
*** HOLE CARDS ***
Tiones Ezequiel: checks
MrDonRich: calls $0.02
chxxxs: folds
Haliankou: calls $0.02
AAvers: raises $0.10 to $0.12
ESCOBAR0204: folds
Tiones Ezequiel: calls $0.10
MrDonRich: folds
Haliankou: calls $0.10
*** FLOP *** [6s 4h Ac]
AAvers: bets $0.20
Tiones Ezequiel: raises $0.48 to $0.68 and is all-in
Haliankou: folds
AAvers: calls $0.48
*** TURN *** [6s 4h Ac] [Jc]
*** RIVER *** [6s 4h Ac Jc] [8s]
*** SHOW DOWN ***
AAvers: shows [Ad Qd] (a pair of Aces)
Tiones Ezequiel: shows [As 6c] (two pair, Aces and Sixes)
Tiones Ezequiel cashed out the hand for $1.41 | Cash Out Fee $0.01
*** SUMMARY ***
Total pot $1.76 | Rake $0.06
Board [6s 4h Ac Jc 8s]
Seat 1: chxxxs folded before Flop (didn't bet)
Seat 2: Haliankou (button) folded on the Flop
Seat 3: AAvers (small blind) showed [Ad Qd] and lost with a pair of Aces
Seat 4: ESCOBAR0204 (big blind) folded before Flop
Seat 5: Tiones Ezequiel showed [As 6c] and won ($1.70) with two pair, Aces and Sixes (pot not awarded as player cashed out)
Seat 6: MrDonRich folded before Flop


PokerStars Hand #238175151469:  Hold'em No Limit ($0.01/$0.02 USD) - 2022/08/23 17:01:07 ET
Table 'Equinox IV' 6-max Seat #3 is the button
Seat 1: chxxxs ($2 in chips)
Seat 2: Haliankou ($2.21 in chips)
Seat 3: AAvers ($2 in chips)
Seat 4: ESCOBAR0204 ($0.77 in chips)
Seat 5: Tiones Ezequiel ($1.41 in chips)
Seat 6: MrDonRich ($2.45 in chips)
ESCOBAR0204: posts small blind $0.01
Tiones Ezequiel: posts big blind $0.02
*** HOLE CARDS ***
MrDonRich: folds
chxxxs: folds
Haliankou: folds
AAvers: folds
ESCOBAR0204: calls $0.01
Tiones Ezequiel: checks
*** FLOP *** [Jh Ts 7s]
ESCOBAR0204: checks
Tiones Ezequiel: checks
*** TURN *** [Jh Ts 7s] [4d]
ESCOBAR0204: checks
Tiones Ezequiel: bets $0.02
ESCOBAR0204: calls $0.02
*** RIVER *** [Jh Ts 7s 4d] [4c]
ESCOBAR0204: checks
Tiones Ezequiel: checks
*** SHOW DOWN ***
ESCOBAR0204: shows [8d Kd] (a pair of Fours)
Tiones Ezequiel: shows [8s Kh] (a pair of Fours)
ESCOBAR0204 collected $0.04 from pot
Tiones Ezequiel collected $0.04 from pot
*** SUMMARY ***
Total pot $0.08 | Rake $0
Board [Jh Ts 7s 4d 4c]
Seat 1: chxxxs folded before Flop (didn't bet)
Seat 2: Haliankou folded before Flop (didn't bet)
Seat 3: AAvers (button) folded before Flop (didn't bet)
Seat 4: ESCOBAR0204 (small blind) showed [8d Kd] and won ($0.04) with a pair of Fours
Seat 5: Tiones Ezequiel (big blind) showed [8s Kh] and won ($0.04) with a pair of Fours
Seat 6: MrDonRich folded before Flop (didn't bet)


PokerStars Hand #238175164417:  Hold'em No Limit ($0.01/$0.02 USD) - 2022/08/23 17:01:44 ET
Table 'Equinox IV' 6-max Seat #4 is the button
Seat 1: chxxxs ($2 in chips)
Seat 2: Haliankou ($2.21 in chips)
Seat 3: AAvers ($2 in chips)
Seat 4: ESCOBAR0204 ($0.77 in chips)
Seat 5: Tiones Ezequiel ($1.41 in chips)
Seat 6: MrDonRich ($2.45 in chips)
Tiones Ezequiel: posts small blind $0.01
MrDonRich: posts big blind $0.02
*** HOLE CARDS ***
chxxxs: folds
Haliankou: raises $0.04 to $0.06
AAvers: folds
ESCOBAR0204: folds
Tiones Ezequiel: calls $0.05
MrDonRich: folds
*** FLOP *** [3c 6c 2h]
Tiones Ezequiel: checks
Haliankou: bets $0.07
Tiones Ezequiel: folds
Uncalled bet ($0.07) returned to Haliankou
Haliankou collected $0.14 from pot
Haliankou: doesn't show hand
*** SUMMARY ***
Total pot $0.14 | Rake $0
Board [3c 6c 2h]
Seat 1: chxxxs folded before Flop (didn't bet)
Seat 2: Haliankou collected ($0.14)
Seat 3: AAvers folded before Flop (didn't bet)
Seat 4: ESCOBAR0204 (button) folded before Flop (didn't bet)
Seat 5: Tiones Ezequiel (small blind) folded on the Flop
Seat 6: MrDonRich (big blind) folded before Flop


PokerStars Hand #238175176174:  Hold'em No Limit ($0.01/$0.02 USD) - 2022/08/23 17:02:16 ET
Table 'Equinox IV' 6-max Seat #5 is the button
Seat 1: chxxxs ($2 in chips)
Seat 2: Haliankou ($2.29 in chips)
Seat 3: AAvers ($2 in chips)
Seat 4: ESCOBAR0204 ($0.77 in chips)
Seat 5: Tiones Ezequiel ($1.35 in chips)
Seat 6: MrDonRich ($2.43 in chips)
MrDonRich: posts small blind $0.01
chxxxs: posts big blind $0.02
*** HOLE CARDS ***
Haliankou: raises $0.04 to $0.06
AAvers: folds
ESCOBAR0204: calls $0.06
Tiones Ezequiel: calls $0.06
MrDonRich: calls $0.05
chxxxs: folds
*** FLOP *** [5h 2d Jd]
MrDonRich: bets $0.17
Haliankou: folds
ESCOBAR0204: calls $0.17
Tiones Ezequiel: folds
*** TURN *** [5h 2d Jd] [8s]
MrDonRich: bets $0.42
ESCOBAR0204: calls $0.42
*** RIVER *** [5h 2d Jd 8s] [Js]
MrDonRich: bets $0.93
ESCOBAR0204: calls $0.12 and is all-in
Uncalled bet ($0.81) returned to MrDonRich
*** SHOW DOWN ***
MrDonRich: shows [5d 5s] (a full house, Fives full of Jacks)
ESCOBAR0204: shows [Ad 7d] (a pair of Jacks)
MrDonRich collected $1.62 from pot
*** SUMMARY ***
Total pot $1.68 | Rake $0.06
Board [5h 2d Jd 8s Js]
Seat 1: chxxxs (big blind) folded before Flop
Seat 2: Haliankou folded on the Flop
Seat 3: AAvers folded before Flop (didn't bet)
Seat 4: ESCOBAR0204 showed [Ad 7d] and lost with a pair of Jacks
Seat 5: Tiones Ezequiel (button) folded on the Flop
Seat 6: MrDonRich (small blind) showed [5d 5s] and won ($1.62) with a full house, Fives full of Jacks


PokerStars Hand #238175196330:  Hold'em No Limit ($0.01/$0.02 USD) - 2022/08/23 17:03:11 ET
Table 'Equinox IV' 6-max Seat #6 is the button
Seat 1: chxxxs ($2 in chips)
Seat 2: Haliankou ($2.23 in chips)
Seat 3: AAvers ($2 in chips)
Seat 5: Tiones Ezequiel ($1.29 in chips)
Seat 6: MrDonRich ($3.28 in chips)
chxxxs: posts small blind $0.01
Haliankou: posts big blind $0.02
*** HOLE CARDS ***
ESCOBAR0204 leaves the table
AAvers: folds
Tiones Ezequiel: calls $0.02
MrDonRich: folds
chxxxs: folds
kiran_0695 joins the table at seat #4
Haliankou: raises $0.04 to $0.06
Tiones Ezequiel: folds
Uncalled bet ($0.04) returned to Haliankou
Haliankou collected $0.05 from pot
Haliankou: doesn't show hand
*** SUMMARY ***
Total pot $0.05 | Rake $0
Seat 1: chxxxs (small blind) folded before Flop
Seat 2: Haliankou (big blind) collected ($0.05)
Seat 3: AAvers folded before Flop (didn't bet)
Seat 5: Tiones Ezequiel folded before Flop
Seat 6: MrDonRich (button) folded before Flop (didn't bet)


PokerStars Hand #238175202435:  Hold'em No Limit ($0.01/$0.02 USD) - 2022/08/23 17:03:27 ET
Table 'Equinox IV' 6-max Seat #1 is the button
Seat 1: chxxxs ($2 in chips)
Seat 2: Haliankou ($2.26 in chips)
Seat 3: AAvers ($2 in chips)
Seat 5: Tiones Ezequiel ($1.27 in chips)
Seat 6: MrDonRich ($3.28 in chips)
Haliankou: posts small blind $0.01
AAvers: posts big blind $0.02
kiran_0695: sits out
*** HOLE CARDS ***
Tiones Ezequiel: calls $0.02
MrDonRich: folds
chxxxs: folds
Haliankou: folds
AAvers: checks
*** FLOP *** [4d Qs 9s]
AAvers: checks
Tiones Ezequiel: bets $0.02
AAvers: folds
Uncalled bet ($0.02) returned to Tiones Ezequiel
Tiones Ezequiel collected $0.05 from pot
*** SUMMARY ***
Total pot $0.05 | Rake $0
Board [4d Qs 9s]
Seat 1: chxxxs (button) folded before Flop (didn't bet)
Seat 2: Haliankou (small blind) folded before Flop
Seat 3: AAvers (big blind) folded on the Flop
Seat 5: Tiones Ezequiel collected ($0.05)
Seat 6: MrDonRich folded before Flop (didn't bet)


PokerStars Hand #238175221301:  Hold'em No Limit ($0.01/$0.02 USD) - 2022/08/23 17:04:17 ET
Table 'Equinox IV' 6-max Seat #2 is the button
Seat 1: chxxxs ($2 in chips)
Seat 2: Haliankou ($2.25 in chips)
Seat 3: AAvers ($2 in chips)
Seat 4: kiran_0695 ($1.60 in chips)
Seat 5: Tiones Ezequiel ($1.30 in chips)
Seat 6: MrDonRich ($3.28 in chips)
AAvers: posts small blind $0.01
kiran_0695: posts big blind $0.02
*** HOLE CARDS ***
Tiones Ezequiel: folds
MrDonRich: folds
chxxxs: raises $0.03 to $0.05
Haliankou: raises $0.05 to $0.10
AAvers: folds
kiran_0695: folds
chxxxs: calls $0.05
*** FLOP *** [9s 2s 3h]
chxxxs: checks
Haliankou: bets $0.12
chxxxs: calls $0.12
*** TURN *** [9s 2s 3h] [5h]
chxxxs: checks
Haliankou: checks
*** RIVER *** [9s 2s 3h 5h] [5d]
chxxxs: checks
Haliankou: checks
*** SHOW DOWN ***
chxxxs: shows [Jc Jd] (two pair, Jacks and Fives)
Haliankou: mucks hand
chxxxs collected $0.45 from pot
*** SUMMARY ***
Total pot $0.47 | Rake $0.02
Board [9s 2s 3h 5h 5d]
Seat 1: chxxxs showed [Jc Jd] and won ($0.45) with two pair, Jacks and Fives
Seat 2: Haliankou (button) mucked
Seat 3: AAvers (small blind) folded before Flop
Seat 4: kiran_0695 (big blind) folded before Flop
Seat 5: Tiones Ezequiel folded before Flop (didn't bet)
Seat 6: MrDonRich folded before Flop (didn't bet)


PokerStars Hand #238175241894:  Hold'em No Limit ($0.01/$0.02 USD) - 2022/08/23 17:05:13 ET
Table 'Equinox IV' 6-max Seat #3 is the button
Seat 1: chxxxs ($2.23 in chips)
Seat 2: Haliankou ($2.03 in chips)
Seat 3: AAvers ($2 in chips)
Seat 4: kiran_0695 ($1.58 in chips)
Seat 5: Tiones Ezequiel ($1.30 in chips)
Seat 6: MrDonRich ($3.28 in chips)
kiran_0695: posts small blind $0.01
Tiones Ezequiel: posts big blind $0.02
*** HOLE CARDS ***
MrDonRich: calls $0.02
chxxxs: folds
Haliankou: folds
AAvers: raises $0.06 to $0.08
kiran_0695: folds
Tiones Ezequiel: calls $0.06
MrDonRich: calls $0.06
*** FLOP *** [9s 8d Qh]
Tiones Ezequiel: bets $0.08
MrDonRich: folds
AAvers: calls $0.08
*** TURN *** [9s 8d Qh] [6s]
Tiones Ezequiel: bets $0.10
AAvers: calls $0.10
*** RIVER *** [9s 8d Qh 6s] [Kd]
Tiones Ezequiel: bets $0.02
AAvers: calls $0.02
*** SHOW DOWN ***
Tiones Ezequiel: shows [Qd Tc] (a pair of Queens)
AAvers: mucks hand
Tiones Ezequiel collected $0.63 from pot
*** SUMMARY ***
Total pot $0.65 | Rake $0.02
Board [9s 8d Qh 6s Kd]
Seat 1: chxxxs folded before Flop (didn't bet)
Seat 2: Haliankou folded before Flop (didn't bet)
Seat 3: AAvers (button) mucked
Seat 4: kiran_0695 (small blind) folded before Flop
Seat 5: Tiones Ezequiel (big blind) showed [Qd Tc] and won ($0.63) with a pair of Queens
Seat 6: MrDonRich folded on the Flop


PokerStars Hand #238175264825:  Hold'em No Limit ($0.01/$0.02 USD) - 2022/08/23 17:06:14 ET
Table 'Equinox IV' 6-max Seat #4 is the button
Seat 1: chxxxs ($2.23 in chips)
Seat 2: Haliankou ($2.03 in chips)
Seat 3: AAvers ($2 in chips)
Seat 4: kiran_0695 ($1.57 in chips)
Seat 5: Tiones Ezequiel ($1.65 in chips)
Seat 6: MrDonRich ($3.20 in chips)
Tiones Ezequiel: posts small blind $0.01
MrDonRich: posts big blind $0.02
*** HOLE CARDS ***
chxxxs: folds
Haliankou: folds
AAvers: folds
kiran_0695: calls $0.02
Tiones Ezequiel: calls $0.01
MrDonRich: checks
*** FLOP *** [Kc 8c 9c]
Tiones Ezequiel: checks
MrDonRich: checks
kiran_0695: checks
*** TURN *** [Kc 8c 9c] [5d]
Tiones Ezequiel: checks
MrDonRich: bets $0.04
kiran_0695: calls $0.04
Tiones Ezequiel: calls $0.04
*** RIVER *** [Kc 8c 9c 5d] [4d]
Tiones Ezequiel: checks
MrDonRich: checks
kiran_0695: checks
*** SHOW DOWN ***
Tiones Ezequiel: shows [3d Qc] (high card King)
MrDonRich: shows [Kh 3s] (a pair of Kings)
kiran_0695: mucks hand
MrDonRich collected $0.17 from pot
*** SUMMARY ***
Total pot $0.18 | Rake $0.01
Board [Kc 8c 9c 5d 4d]
Seat 1: chxxxs folded before Flop (didn't bet)
Seat 2: Haliankou folded before Flop (didn't bet)
Seat 3: AAvers folded before Flop (didn't bet)
Seat 4: kiran_0695 (button) mucked
Seat 5: Tiones Ezequiel (small blind) showed [3d Qc] and lost with high card King
Seat 6: MrDonRich (big blind) showed [Kh 3s] and won ($0.17) with a pair of Kings


PokerStars Hand #238175280825:  Hold'em No Limit ($0.01/$0.02 USD) - 2022/08/23 17:06:57 ET
Table 'Equinox IV' 6-max Seat #5 is the button
Seat 1: chxxxs ($2.23 in chips)
Seat 2: Haliankou ($2.03 in chips)
Seat 3: AAvers ($2 in chips)
Seat 4: kiran_0695 ($1.51 in chips)
Seat 5: Tiones Ezequiel ($1.59 in chips)
Seat 6: MrDonRich ($3.31 in chips)
MrDonRich: posts small blind $0.01
chxxxs: posts big blind $0.02
*** HOLE CARDS ***
Haliankou: folds
AAvers: folds
kiran_0695: calls $0.02
Tiones Ezequiel: folds
MrDonRich: folds
chxxxs: checks
*** FLOP *** [Js Ac Kc]
chxxxs: checks
kiran_0695: bets $0.05
chxxxs: folds
Uncalled bet ($0.05) returned to kiran_0695
kiran_0695 collected $0.05 from pot
*** SUMMARY ***
Total pot $0.05 | Rake $0
Board [Js Ac Kc]
Seat 1: chxxxs (big blind) folded on the Flop
Seat 2: Haliankou folded before Flop (didn't bet)
Seat 3: AAvers folded before Flop (didn't bet)
Seat 4: kiran_0695 collected ($0.05)
Seat 5: Tiones Ezequiel (button) folded before Flop (didn't bet)
Seat 6: MrDonRich (small blind) folded before Flop


PokerStars Hand #238175292466:  Hold'em No Limit ($0.01/$0.02 USD) - 2022/08/23 17:07:28 ET
Table 'Equinox IV' 6-max Seat #6 is the button
Seat 1: chxxxs ($2.21 in chips)
Seat 2: Haliankou ($2.03 in chips)
Seat 3: AAvers ($2 in chips)
Seat 4: kiran_0695 ($1.54 in chips)
Seat 5: Tiones Ezequiel ($1.59 in chips)
Seat 6: MrDonRich ($3.30 in chips)
chxxxs: posts small blind $0.01
Haliankou: posts big blind $0.02
*** HOLE CARDS ***
AAvers: raises $0.04 to $0.06
kiran_0695: folds
Tiones Ezequiel: folds
MrDonRich: folds
chxxxs: folds
Haliankou: calls $0.04
*** FLOP *** [Ks Qs 7s]
Haliankou: checks
AAvers: bets $0.05
Haliankou: folds
Uncalled bet ($0.05) returned to AAvers
AAvers collected $0.13 from pot
*** SUMMARY ***
Total pot $0.13 | Rake $0
Board [Ks Qs 7s]
Seat 1: chxxxs (small blind) folded before Flop
Seat 2: Haliankou (big blind) folded on the Flop
Seat 3: AAvers collected ($0.13)
Seat 4: kiran_0695 folded before Flop (didn't bet)
Seat 5: Tiones Ezequiel folded before Flop (didn't bet)
Seat 6: MrDonRich (button) folded before Flop (didn't bet)


PokerStars Hand #238175302345:  Hold'em No Limit ($0.01/$0.02 USD) - 2022/08/23 17:07:54 ET
Table 'Equinox IV' 6-max Seat #1 is the button
Seat 1: chxxxs ($2.20 in chips)
Seat 2: Haliankou ($1.97 in chips)
Seat 3: AAvers ($2.07 in chips)
Seat 4: kiran_0695 ($1.54 in chips)
Seat 5: Tiones Ezequiel ($1.59 in chips)
Seat 6: MrDonRich ($3.30 in chips)
Haliankou: posts small blind $0.01
AAvers: posts big blind $0.02
*** HOLE CARDS ***
kiran_0695: calls $0.02
Tiones Ezequiel: calls $0.02
MrDonRich: calls $0.02
chxxxs: folds
Haliankou: calls $0.01
AAvers: checks
*** FLOP *** [Qc Jd 7c]
Haliankou: bets $0.05
AAvers: folds
kiran_0695: folds
Tiones Ezequiel: folds
MrDonRich: folds
Uncalled bet ($0.05) returned to Haliankou
Haliankou collected $0.10 from pot
Haliankou: doesn't show hand
*** SUMMARY ***
Total pot $0.10 | Rake $0
Board [Qc Jd 7c]
Seat 1: chxxxs (button) folded before Flop (didn't bet)
Seat 2: Haliankou (small blind) collected ($0.10)
Seat 3: AAvers (big blind) folded on the Flop
Seat 4: kiran_0695 folded on the Flop
Seat 5: Tiones Ezequiel folded on the Flop
Seat 6: MrDonRich folded on the Flop


PokerStars Hand #238175322395:  Hold'em No Limit ($0.01/$0.02 USD) - 2022/08/23 17:08:48 ET
Table 'Equinox IV' 6-max Seat #2 is the button
Seat 1: chxxxs ($2.20 in chips)
Seat 2: Haliankou ($2.05 in chips)
Seat 3: AAvers ($2.05 in chips)
Seat 4: kiran_0695 ($1.52 in chips)
Seat 5: Tiones Ezequiel ($1.57 in chips)
Seat 6: MrDonRich ($3.28 in chips)
AAvers: posts small blind $0.01
kiran_0695: posts big blind $0.02
*** HOLE CARDS ***
Tiones Ezequiel: calls $0.02
MrDonRich: calls $0.02
chxxxs: folds
Haliankou: folds
AAvers: calls $0.01
Haliankou leaves the table
kiran_0695: checks
*** FLOP *** [Kd 7c 7s]
AAvers: checks
kiran_0695: bets $0.08
Tiones Ezequiel: folds
MrDonRich: folds
AAvers: folds
Uncalled bet ($0.08) returned to kiran_0695
KeyTheHuman joins the table at seat #2
kiran_0695 collected $0.08 from pot
*** SUMMARY ***
Total pot $0.08 | Rake $0
Board [Kd 7c 7s]
Seat 1: chxxxs folded before Flop (didn't bet)
Seat 2: Haliankou (button) folded before Flop (didn't bet)
Seat 3: AAvers (small blind) folded on the Flop
Seat 4: kiran_0695 (big blind) collected ($0.08)
Seat 5: Tiones Ezequiel folded on the Flop
Seat 6: MrDonRich folded on the Flop


PokerStars Hand #238175337317:  Hold'em No Limit ($0.01/$0.02 USD) - 2022/08/23 17:09:28 ET
Table 'Equinox IV' 6-max Seat #3 is the button
Seat 1: chxxxs ($2.20 in chips)
Seat 3: AAvers ($2.03 in chips)
Seat 4: kiran_0695 ($1.58 in chips)
Seat 5: Tiones Ezequiel ($1.55 in chips)
Seat 6: MrDonRich ($3.26 in chips)
kiran_0695: posts small blind $0.01
Tiones Ezequiel: posts big blind $0.02
KeyTheHuman: sits out
*** HOLE CARDS ***
KeyTheHuman leaves the table
MrDonRich: folds
chxxxs: folds
jaypostic joins the table at seat #2
AAvers: raises $0.02 to $0.04
kiran_0695: folds
Tiones Ezequiel: raises $0.02 to $0.06
AAvers: calls $0.02
*** FLOP *** [Tc 6c Kc]
Tiones Ezequiel: checks
AAvers: checks
*** TURN *** [Tc 6c Kc] [7c]
Tiones Ezequiel: checks
AAvers: bets $0.10
Tiones Ezequiel: raises $1.39 to $1.49 and is all-in
AAvers: folds
Uncalled bet ($1.39) returned to Tiones Ezequiel
Tiones Ezequiel collected $0.32 from pot
*** SUMMARY ***
Total pot $0.33 | Rake $0.01
Board [Tc 6c Kc 7c]
Seat 1: chxxxs folded before Flop (didn't bet)
Seat 3: AAvers (button) folded on the Turn
Seat 4: kiran_0695 (small blind) folded before Flop
Seat 5: Tiones Ezequiel (big blind) collected ($0.32)
Seat 6: MrDonRich folded before Flop (didn't bet)


PokerStars Hand #238175353092:  Hold'em No Limit ($0.01/$0.02 USD) - 2022/08/23 17:10:10 ET
Table 'Equinox IV' 6-max Seat #4 is the button
Seat 1: chxxxs ($2.20 in chips)
Seat 2: jaypostic ($2 in chips)
Seat 3: AAvers ($2 in chips)
Seat 4: kiran_0695 ($1.57 in chips)
Seat 5: Tiones Ezequiel ($1.71 in chips)
Seat 6: MrDonRich ($3.26 in chips)
Tiones Ezequiel: posts small blind $0.01
MrDonRich: posts big blind $0.02
jaypostic: posts big blind $0.02
*** HOLE CARDS ***
chxxxs: folds
jaypostic: raises $0.04 to $0.06
AAvers: folds
kiran_0695: folds
Tiones Ezequiel: folds
MrDonRich: folds
Uncalled bet ($0.04) returned to jaypostic
jaypostic collected $0.05 from pot
*** SUMMARY ***
Total pot $0.05 | Rake $0
Seat 1: chxxxs folded before Flop (didn't bet)
Seat 2: jaypostic collected ($0.05)
Seat 3: AAvers folded before Flop (didn't bet)
Seat 4: kiran_0695 (button) folded before Flop (didn't bet)
Seat 5: Tiones Ezequiel (small blind) folded before Flop
Seat 6: MrDonRich (big blind) folded before Flop


PokerStars Hand #238175357525:  Hold'em No Limit ($0.01/$0.02 USD) - 2022/08/23 17:10:22 ET
Table 'Equinox IV' 6-max Seat #5 is the button
Seat 1: chxxxs ($2.20 in chips)
Seat 2: jaypostic ($2.03 in chips)
Seat 3: AAvers ($2 in chips)
Seat 4: kiran_0695 ($1.57 in chips)
Seat 5: Tiones Ezequiel ($1.70 in chips)
Seat 6: MrDonRich ($3.24 in chips)
MrDonRich: posts small blind $0.01
chxxxs: posts big blind $0.02
*** HOLE CARDS ***
jaypostic: raises $0.04 to $0.06
AAvers: folds
kiran_0695: folds
Tiones Ezequiel: folds
MrDonRich: folds
chxxxs: calls $0.04
*** FLOP *** [2h 4h 5s]
chxxxs: checks
jaypostic: bets $0.06
chxxxs: raises $0.15 to $0.21
jaypostic: calls $0.15
*** TURN *** [2h 4h 5s] [Jh]
chxxxs: bets $0.30
jaypostic: folds
Uncalled bet ($0.30) returned to chxxxs
chxxxs collected $0.53 from pot
chxxxs: doesn't show hand
*** SUMMARY ***
Total pot $0.55 | Rake $0.02
Board [2h 4h 5s Jh]
Seat 1: chxxxs (big blind) collected ($0.53)
Seat 2: jaypostic folded on the Turn
Seat 3: AAvers folded before Flop (didn't bet)
Seat 4: kiran_0695 folded before Flop (didn't bet)
Seat 5: Tiones Ezequiel (button) folded before Flop (didn't bet)
Seat 6: MrDonRich (small blind) folded before Flop


PokerStars Hand #238175373040:  Hold'em No Limit ($0.01/$0.02 USD) - 2022/08/23 17:11:03 ET
Table 'Equinox IV' 6-max Seat #6 is the button
Seat 1: chxxxs ($2.46 in chips)
Seat 2: jaypostic ($1.76 in chips)
Seat 3: AAvers ($2 in chips)
Seat 4: kiran_0695 ($1.57 in chips)
Seat 5: Tiones Ezequiel ($1.70 in chips)
Seat 6: MrDonRich ($3.23 in chips)
chxxxs: posts small blind $0.01
jaypostic: posts big blind $0.02
*** HOLE CARDS ***
AAvers: raises $0.04 to $0.06
kiran_0695: folds
Tiones Ezequiel: calls $0.06
MrDonRich: calls $0.06
chxxxs: folds
jaypostic: calls $0.04
*** FLOP *** [7h Ah Qd]
jaypostic: checks
AAvers: checks
Tiones Ezequiel: checks
MrDonRich: checks
*** TURN *** [7h Ah Qd] [9d]
jaypostic: checks
AAvers: bets $0.10
Tiones Ezequiel: calls $0.10
MrDonRich: calls $0.10
jaypostic: folds
*** RIVER *** [7h Ah Qd 9d] [Th]
AAvers: bets $0.38
Tiones Ezequiel: folds
MrDonRich: folds
Uncalled bet ($0.38) returned to AAvers
AAvers collected $0.53 from pot
*** SUMMARY ***
Total pot $0.55 | Rake $0.02
Board [7h Ah Qd 9d Th]
Seat 1: chxxxs (small blind) folded before Flop
Seat 2: jaypostic (big blind) folded on the Turn
Seat 3: AAvers collected ($0.53)
Seat 4: kiran_0695 folded before Flop (didn't bet)
Seat 5: Tiones Ezequiel folded on the River
Seat 6: MrDonRich (button) folded on the River


PokerStars Hand #238175395528:  Hold'em No Limit ($0.01/$0.02 USD) - 2022/08/23 17:12:03 ET
Table 'Equinox IV' 6-max Seat #1 is the button
Seat 1: chxxxs ($2.45 in chips)
Seat 2: jaypostic ($1.70 in chips)
Seat 4: kiran_0695 ($1.57 in chips)
Seat 5: Tiones Ezequiel ($1.54 in chips)
Seat 6: MrDonRich ($3.07 in chips)
jaypostic: posts small blind $0.01
AAvers: is sitting out
kiran_0695: posts big blind $0.02
*** HOLE CARDS ***
Tiones Ezequiel: raises $0.06 to $0.08
AAvers leaves the table
MrDonRich: folds
chxxxs: folds
jaypostic: folds
kiran_0695: folds
Uncalled bet ($0.06) returned to Tiones Ezequiel
Tiones Ezequiel collected $0.05 from pot
*** SUMMARY ***
Total pot $0.05 | Rake $0
Seat 1: chxxxs (button) folded before Flop (didn't bet)
Seat 2: jaypostic (small blind) folded before Flop
Seat 4: kiran_0695 (big blind) folded before Flop
Seat 5: Tiones Ezequiel collected ($0.05)
Seat 6: MrDonRich folded before Flop (didn't bet)


PokerStars Hand #238175401360:  Hold'em No Limit ($0.01/$0.02 USD) - 2022/08/23 17:12:19 ET
Table 'Equinox IV' 6-max Seat #2 is the button
Seat 1: chxxxs ($2.45 in chips)
Seat 2: jaypostic ($1.69 in chips)
Seat 4: kiran_0695 ($1.55 in chips)
Seat 5: Tiones Ezequiel ($1.57 in chips)
Seat 6: MrDonRich ($3.07 in chips)
kiran_0695: posts small blind $0.01
Tiones Ezequiel: posts big blind $0.02
*** HOLE CARDS ***
casimiro124 joins the table at seat #3
MrDonRich: folds
chxxxs: raises $0.03 to $0.05
jaypostic: calls $0.05
kiran_0695: calls $0.04
Tiones Ezequiel: calls $0.03
*** FLOP *** [6c Jc Qh]
kiran_0695: checks
Tiones Ezequiel: checks
chxxxs: bets $0.09
jaypostic: calls $0.09
kiran_0695: folds
Tiones Ezequiel: folds
*** TURN *** [6c Jc Qh] [7h]
chxxxs: checks
jaypostic: bets $0.20
chxxxs: calls $0.20
*** RIVER *** [6c Jc Qh 7h] [5h]
chxxxs: checks
jaypostic: checks
*** SHOW DOWN ***
chxxxs: shows [Qc 8c] (a pair of Queens)
jaypostic: mucks hand
chxxxs collected $0.75 from pot
*** SUMMARY ***
Total pot $0.78 | Rake $0.03
Board [6c Jc Qh 7h 5h]
Seat 1: chxxxs showed [Qc 8c] and won ($0.75) with a pair of Queens
Seat 2: jaypostic (button) mucked
Seat 4: kiran_0695 (small blind) folded on the Flop
Seat 5: Tiones Ezequiel (big blind) folded on the Flop
Seat 6: MrDonRich folded before Flop (didn't bet)


PokerStars Hand #238175422418:  Hold'em No Limit ($0.01/$0.02 USD) - 2022/08/23 17:13:15 ET
Table 'Equinox IV' 6-max Seat #4 is the button
Seat 1: chxxxs ($2.86 in chips)
Seat 2: jaypostic ($1.35 in chips)
Seat 4: kiran_0695 ($1.50 in chips)
Seat 5: Tiones Ezequiel ($1.52 in chips)
Seat 6: MrDonRich ($3.07 in chips)
Tiones Ezequiel: posts small blind $0.01
MrDonRich: posts big blind $0.02
casimiro124: sits out
*** HOLE CARDS ***
chxxxs: folds
jaypostic: folds
kiran_0695: folds
Tiones Ezequiel: calls $0.01
MrDonRich: checks
*** FLOP *** [2s Tc Qs]
Tiones Ezequiel: checks
MrDonRich: bets $0.03
Tiones Ezequiel: folds
Uncalled bet ($0.03) returned to MrDonRich
MrDonRich collected $0.04 from pot
MrDonRich: doesn't show hand
*** SUMMARY ***
Total pot $0.04 | Rake $0
Board [2s Tc Qs]
Seat 1: chxxxs folded before Flop (didn't bet)
Seat 2: jaypostic folded before Flop (didn't bet)
Seat 4: kiran_0695 (button) folded before Flop (didn't bet)
Seat 5: Tiones Ezequiel (small blind) folded on the Flop
Seat 6: MrDonRich (big blind) collected ($0.04)


PokerStars Hand #238175429118:  Hold'em No Limit ($0.01/$0.02 USD) - 2022/08/23 17:13:33 ET
Table 'Equinox IV' 6-max Seat #5 is the button
Seat 1: chxxxs ($2.86 in chips)
Seat 2: jaypostic ($2 in chips)
Seat 4: kiran_0695 ($1.50 in chips)
Seat 5: Tiones Ezequiel ($1.50 in chips)
Seat 6: MrDonRich ($3.09 in chips)
MrDonRich: posts small blind $0.01
chxxxs: posts big blind $0.02
casimiro124: sits out
*** HOLE CARDS ***
jaypostic: folds
kiran_0695: calls $0.02
Tiones Ezequiel: calls $0.02
MrDonRich: folds
chxxxs: checks
*** FLOP *** [Qs 8s 7s]
chxxxs: checks
kiran_0695: checks
Tiones Ezequiel: bets $0.04
chxxxs: folds
kiran_0695: folds
Uncalled bet ($0.04) returned to Tiones Ezequiel
Tiones Ezequiel collected $0.07 from pot
*** SUMMARY ***
Total pot $0.07 | Rake $0
Board [Qs 8s 7s]
Seat 1: chxxxs (big blind) folded on the Flop
Seat 2: jaypostic folded before Flop (didn't bet)
Seat 4: kiran_0695 folded on the Flop
Seat 5: Tiones Ezequiel (button) collected ($0.07)
Seat 6: MrDonRich (small blind) folded before Flop


PokerStars Hand #238175437451:  Hold'em No Limit ($0.01/$0.02 USD) - 2022/08/23 17:13:55 ET
Table 'Equinox IV' 6-max Seat #6 is the button
Seat 1: chxxxs ($2.84 in chips)
Seat 2: jaypostic ($2 in chips)
Seat 4: kiran_0695 ($1.48 in chips)
Seat 5: Tiones Ezequiel ($1.55 in chips)
Seat 6: MrDonRich ($3.08 in chips)
chxxxs: posts small blind $0.01
jaypostic: posts big blind $0.02
casimiro124: sits out
*** HOLE CARDS ***
kiran_0695: calls $0.02
Tiones Ezequiel: raises $0.04 to $0.06
MrDonRich: calls $0.06
chxxxs: folds
jaypostic: folds
kiran_0695: calls $0.04
*** FLOP *** [5c 8s 2d]
kiran_0695: checks
Tiones Ezequiel: bets $0.10
MrDonRich: folds
kiran_0695: folds
Uncalled bet ($0.10) returned to Tiones Ezequiel
Tiones Ezequiel collected $0.20 from pot
*** SUMMARY ***
Total pot $0.21 | Rake $0.01
Board [5c 8s 2d]
Seat 1: chxxxs (small blind) folded before Flop
Seat 2: jaypostic (big blind) folded before Flop
Seat 4: kiran_0695 folded on the Flop
Seat 5: Tiones Ezequiel collected ($0.20)
Seat 6: MrDonRich (button) folded on the Flop


PokerStars Hand #238175448601:  Hold'em No Limit ($0.01/$0.02 USD) - 2022/08/23 17:14:26 ET
Table 'Equinox IV' 6-max Seat #1 is the button
Seat 1: chxxxs ($2.83 in chips)
Seat 2: jaypostic ($1.98 in chips)
Seat 3: casimiro124 ($2 in chips)
Seat 4: kiran_0695 ($1.42 in chips)
Seat 5: Tiones Ezequiel ($1.69 in chips)
Seat 6: MrDonRich ($3.02 in chips)
jaypostic: posts small blind $0.01
casimiro124: posts big blind $0.02
*** HOLE CARDS ***
kiran_0695: calls $0.02
Tiones Ezequiel: raises $0.04 to $0.06
MrDonRich: calls $0.06
chxxxs: folds
jaypostic: calls $0.05
casimiro124: folds
kiran_0695: calls $0.04
*** FLOP *** [6s Td 7c]
jaypostic: checks
kiran_0695: checks
Tiones Ezequiel: checks
MrDonRich: bets $0.17
jaypostic: calls $0.17
kiran_0695: folds
Tiones Ezequiel: folds
*** TURN *** [6s Td 7c] [7h]
jaypostic: checks
MrDonRich: bets $0.39
jaypostic: calls $0.39
*** RIVER *** [6s Td 7c 7h] [7s]
jaypostic: checks
MrDonRich: bets $0.89
jaypostic: calls $0.89
*** SHOW DOWN ***
MrDonRich: shows [9h Th] (a full house, Sevens full of Tens)
jaypostic: mucks hand
MrDonRich collected $3.05 from pot
*** SUMMARY ***
Total pot $3.16 | Rake $0.11
Board [6s Td 7c 7h 7s]
Seat 1: chxxxs (button) folded before Flop (didn't bet)
Seat 2: jaypostic (small blind) mucked
Seat 3: casimiro124 (big blind) folded before Flop
Seat 4: kiran_0695 folded on the Flop
Seat 5: Tiones Ezequiel folded on the Flop
Seat 6: MrDonRich showed [9h Th] and won ($3.05) with a full house, Sevens full of Tens


PokerStars Hand #238175470743:  Hold'em No Limit ($0.01/$0.02 USD) - 2022/08/23 17:15:25 ET
Table 'Equinox IV' 6-max Seat #2 is the button
Seat 1: chxxxs ($2.83 in chips)
Seat 2: jaypostic ($0.47 in chips)
Seat 3: casimiro124 ($2 in chips)
Seat 4: kiran_0695 ($1.36 in chips)
Seat 5: Tiones Ezequiel ($1.63 in chips)
Seat 6: MrDonRich ($4.56 in chips)
casimiro124: posts small blind $0.01
kiran_0695: posts big blind $0.02
*** HOLE CARDS ***
Tiones Ezequiel: raises $0.06 to $0.08
MrDonRich: folds
chxxxs: folds
jaypostic: raises $0.39 to $0.47 and is all-in
casimiro124: raises $1.53 to $2 and is all-in
kiran_0695: folds
Tiones Ezequiel: folds
Uncalled bet ($1.53) returned to casimiro124
*** FLOP *** [8d 7d 5h]
*** TURN *** [8d 7d 5h] [2h]
*** RIVER *** [8d 7d 5h 2h] [Js]
*** SHOW DOWN ***
casimiro124: shows [Ad Kc] (high card Ace)
jaypostic: shows [Jc Qc] (a pair of Jacks)
jaypostic collected $1 from pot
*** SUMMARY ***
Total pot $1.04 | Rake $0.04
Board [8d 7d 5h 2h Js]
Seat 1: chxxxs folded before Flop (didn't bet)
Seat 2: jaypostic (button) showed [Jc Qc] and won ($1) with a pair of Jacks
Seat 3: casimiro124 (small blind) showed [Ad Kc] and lost with high card Ace
Seat 4: kiran_0695 (big blind) folded before Flop
Seat 5: Tiones Ezequiel folded before Flop
Seat 6: MrDonRich folded before Flop (didn't bet)


PokerStars Hand #238175486911:  Hold'em No Limit ($0.01/$0.02 USD) - 2022/08/23 17:16:08 ET
Table 'Equinox IV' 6-max Seat #3 is the button
Seat 1: chxxxs ($2.83 in chips)
Seat 2: jaypostic ($1 in chips)
Seat 3: casimiro124 ($2 in chips)
Seat 4: kiran_0695 ($1.34 in chips)
Seat 5: Tiones Ezequiel ($1.55 in chips)
Seat 6: MrDonRich ($4.56 in chips)
kiran_0695: posts small blind $0.01
Tiones Ezequiel: posts big blind $0.02
*** HOLE CARDS ***
MrDonRich: folds
chxxxs: folds
jaypostic: raises $0.02 to $0.04
casimiro124: raises $0.14 to $0.18
kiran_0695: folds
Tiones Ezequiel: folds
jaypostic: folds
Uncalled bet ($0.14) returned to casimiro124
casimiro124 collected $0.11 from pot
casimiro124: doesn't show hand
*** SUMMARY ***
Total pot $0.11 | Rake $0
Seat 1: chxxxs folded before Flop (didn't bet)
Seat 2: jaypostic folded before Flop
Seat 3: casimiro124 (button) collected ($0.11)
Seat 4: kiran_0695 (small blind) folded before Flop
Seat 5: Tiones Ezequiel (big blind) folded before Flop
Seat 6: MrDonRich folded before Flop (didn't bet)


PokerStars Hand #238175492819:  Hold'em No Limit ($0.01/$0.02 USD) - 2022/08/23 17:16:24 ET
Table 'Equinox IV' 6-max Seat #4 is the button
Seat 1: chxxxs ($2.83 in chips)
Seat 2: jaypostic ($0.96 in chips)
Seat 3: casimiro124 ($2.07 in chips)
Seat 4: kiran_0695 ($1.33 in chips)
Seat 5: Tiones Ezequiel ($1.53 in chips)
Seat 6: MrDonRich ($4.56 in chips)
Tiones Ezequiel: posts small blind $0.01
MrDonRich: posts big blind $0.02
*** HOLE CARDS ***
chxxxs: folds
jaypostic: raises $0.04 to $0.06
casimiro124: folds
kiran_0695: calls $0.06
Tiones Ezequiel: raises $0.12 to $0.18
MrDonRich: folds
jaypostic: calls $0.12
kiran_0695: calls $0.12
*** FLOP *** [4c Ac 8c]
Tiones Ezequiel: checks
jaypostic: bets $0.27
kiran_0695: folds
Tiones Ezequiel: calls $0.27
*** TURN *** [4c Ac 8c] [9s]
Tiones Ezequiel: checks
jaypostic: bets $0.51 and is all-in
Tiones Ezequiel: calls $0.51
*** RIVER *** [4c Ac 8c 9s] [Td]
*** SHOW DOWN ***
Tiones Ezequiel: shows [Ks Kc] (a pair of Kings)
jaypostic: shows [9h Ad] (two pair, Aces and Nines)
jaypostic collected $2.05 from pot
*** SUMMARY ***
Total pot $2.12 | Rake $0.07
Board [4c Ac 8c 9s Td]
Seat 1: chxxxs folded before Flop (didn't bet)
Seat 2: jaypostic showed [9h Ad] and won ($2.05) with two pair, Aces and Nines
Seat 3: casimiro124 folded before Flop (didn't bet)
Seat 4: kiran_0695 (button) folded on the Flop
Seat 5: Tiones Ezequiel (small blind) showed [Ks Kc] and lost with a pair of Kings
Seat 6: MrDonRich (big blind) folded before Flop


PokerStars Hand #238175511164:  Hold'em No Limit ($0.01/$0.02 USD) - 2022/08/23 17:17:13 ET
Table 'Equinox IV' 6-max Seat #5 is the button
Seat 1: chxxxs ($2.83 in chips)
Seat 2: jaypostic ($2.05 in chips)
Seat 3: casimiro124 ($2.07 in chips)
Seat 4: kiran_0695 ($1.15 in chips)
Seat 5: Tiones Ezequiel ($0.57 in chips)
Seat 6: MrDonRich ($4.54 in chips)
MrDonRich: posts small blind $0.01
chxxxs: posts big blind $0.02
*** HOLE CARDS ***
jaypostic: folds
casimiro124: folds
kiran_0695: calls $0.02
Tiones Ezequiel has timed out
Tiones Ezequiel: folds
MrDonRich: calls $0.01
chxxxs: checks
*** FLOP *** [Jd Tc Kh]
MrDonRich: checks
chxxxs: checks
kiran_0695: bets $0.06
MrDonRich: folds
chxxxs: calls $0.06
*** TURN *** [Jd Tc Kh] [Ks]
chxxxs: checks
kiran_0695: bets $0.17
chxxxs: folds
Uncalled bet ($0.17) returned to kiran_0695
kiran_0695 collected $0.17 from pot
*** SUMMARY ***
Total pot $0.18 | Rake $0.01
Board [Jd Tc Kh Ks]
Seat 1: chxxxs (big blind) folded on the Turn
Seat 2: jaypostic folded before Flop (didn't bet)
Seat 3: casimiro124 folded before Flop (didn't bet)
Seat 4: kiran_0695 collected ($0.17)
Seat 5: Tiones Ezequiel (button) folded before Flop (didn't bet)
Seat 6: MrDonRich (small blind) folded on the Flop


PokerStars Hand #238175534296:  Hold'em No Limit ($0.01/$0.02 USD) - 2022/08/23 17:18:15 ET
Table 'Equinox IV' 6-max Seat #6 is the button
Seat 1: chxxxs ($2.75 in chips)
Seat 2: jaypostic ($2.05 in chips)
Seat 3: casimiro124 ($2.07 in chips)
Seat 4: kiran_0695 ($1.24 in chips)
Seat 5: Tiones Ezequiel ($0.57 in chips)
Seat 6: MrDonRich ($4.52 in chips)
chxxxs: posts small blind $0.01
jaypostic: posts big blind $0.02
*** HOLE CARDS ***
casimiro124: folds
kiran_0695: calls $0.02
Tiones Ezequiel: calls $0.02
MrDonRich: calls $0.02
chxxxs: folds
jaypostic: checks
*** FLOP *** [2d Jc Kd]
jaypostic: checks
kiran_0695: checks
Tiones Ezequiel: checks
MrDonRich: checks
*** TURN *** [2d Jc Kd] [6s]
jaypostic: bets $0.06
kiran_0695: raises $0.21 to $0.27
Tiones Ezequiel: folds
MrDonRich: folds
jaypostic: folds
Uncalled bet ($0.21) returned to kiran_0695
kiran_0695 collected $0.20 from pot
*** SUMMARY ***
Total pot $0.21 | Rake $0.01
Board [2d Jc Kd 6s]
Seat 1: chxxxs (small blind) folded before Flop
Seat 2: jaypostic (big blind) folded on the Turn
Seat 3: casimiro124 folded before Flop (didn't bet)
Seat 4: kiran_0695 collected ($0.20)
Seat 5: Tiones Ezequiel folded on the Turn
Seat 6: MrDonRich (button) folded on the Turn


PokerStars Hand #238175551955:  Hold'em No Limit ($0.01/$0.02 USD) - 2022/08/23 17:19:03 ET
Table 'Equinox IV' 6-max Seat #1 is the button
Seat 1: chxxxs ($2.74 in chips)
Seat 2: jaypostic ($1.97 in chips)
Seat 3: casimiro124 ($2.07 in chips)
Seat 4: kiran_0695 ($1.36 in chips)
Seat 5: Tiones Ezequiel ($0.55 in chips)
Seat 6: MrDonRich ($4.50 in chips)
jaypostic: posts small blind $0.01
casimiro124: posts big blind $0.02
*** HOLE CARDS ***
kiran_0695: calls $0.02
Tiones Ezequiel: calls $0.02
MrDonRich: folds
chxxxs: folds
jaypostic: calls $0.01
casimiro124: raises $0.12 to $0.14
kiran_0695: calls $0.12
Tiones Ezequiel: folds
jaypostic: folds
*** FLOP *** [9s Kd 6h]
casimiro124: bets $0.10
kiran_0695: calls $0.10
*** TURN *** [9s Kd 6h] [5s]
casimiro124: checks
kiran_0695: bets $0.50
casimiro124: folds
Uncalled bet ($0.50) returned to kiran_0695
kiran_0695 collected $0.50 from pot
*** SUMMARY ***
Total pot $0.52 | Rake $0.02
Board [9s Kd 6h 5s]
Seat 1: chxxxs (button) folded before Flop (didn't bet)
Seat 2: jaypostic (small blind) folded before Flop
Seat 3: casimiro124 (big blind) folded on the Turn
Seat 4: kiran_0695 collected ($0.50)
Seat 5: Tiones Ezequiel folded before Flop
Seat 6: MrDonRich folded before Flop (didn't bet)


PokerStars Hand #238175575662:  Hold'em No Limit ($0.01/$0.02 USD) - 2022/08/23 17:20:08 ET
Table 'Equinox IV' 6-max Seat #2 is the button
Seat 1: chxxxs ($2.74 in chips)
Seat 2: jaypostic ($1.95 in chips)
Seat 3: casimiro124 ($2 in chips)
Seat 4: kiran_0695 ($1.62 in chips)
Seat 5: Tiones Ezequiel ($0.53 in chips)
Seat 6: MrDonRich ($4.50 in chips)
casimiro124: posts small blind $0.01
kiran_0695: posts big blind $0.02
*** HOLE CARDS ***
Tiones Ezequiel: folds
MrDonRich: folds
chxxxs: folds
jaypostic: folds
casimiro124: raises $0.04 to $0.06
kiran_0695: calls $0.04
*** FLOP *** [3d Ts 7h]
casimiro124: checks
kiran_0695: bets $0.12
casimiro124: folds
Uncalled bet ($0.12) returned to kiran_0695
kiran_0695 collected $0.12 from pot
*** SUMMARY ***
Total pot $0.12 | Rake $0
Board [3d Ts 7h]
Seat 1: chxxxs folded before Flop (didn't bet)
Seat 2: jaypostic (button) folded before Flop (didn't bet)
Seat 3: casimiro124 (small blind) folded on the Flop
Seat 4: kiran_0695 (big blind) collected ($0.12)
Seat 5: Tiones Ezequiel folded before Flop (didn't bet)
Seat 6: MrDonRich folded before Flop (didn't bet)


PokerStars Hand #238175586386:  Hold'em No Limit ($0.01/$0.02 USD) - 2022/08/23 17:20:37 ET
Table 'Equinox IV' 6-max Seat #3 is the button
Seat 1: chxxxs ($2.74 in chips)
Seat 2: jaypostic ($1.95 in chips)
Seat 3: casimiro124 ($2 in chips)
Seat 4: kiran_0695 ($1.68 in chips)
Seat 5: Tiones Ezequiel ($0.53 in chips)
Seat 6: MrDonRich ($4.50 in chips)
kiran_0695: posts small blind $0.01
Tiones Ezequiel: posts big blind $0.02
*** HOLE CARDS ***
MrDonRich: folds
chxxxs: folds
jaypostic: raises $0.04 to $0.06
casimiro124: folds
kiran_0695: calls $0.05
Tiones Ezequiel: raises $0.47 to $0.53 and is all-in
jaypostic: calls $0.47
kiran_0695: folds
*** FLOP *** [Th 4h 9c]
*** TURN *** [Th 4h 9c] [8h]
*** RIVER *** [Th 4h 9c 8h] [Td]
*** SHOW DOWN ***
Tiones Ezequiel: shows [Jh 9h] (a flush, Jack high)
jaypostic: shows [Kd Qh] (a pair of Tens)
Tiones Ezequiel collected $1.08 from pot
*** SUMMARY ***
Total pot $1.12 | Rake $0.04
Board [Th 4h 9c 8h Td]
Seat 1: chxxxs folded before Flop (didn't bet)
Seat 2: jaypostic showed [Kd Qh] and lost with a pair of Tens
Seat 3: casimiro124 (button) folded before Flop (didn't bet)
Seat 4: kiran_0695 (small blind) folded before Flop
Seat 5: Tiones Ezequiel (big blind) showed [Jh 9h] and won ($1.08) with a flush, Jack high
Seat 6: MrDonRich folded before Flop (didn't bet)


PokerStars Hand #238175598342:  Hold'em No Limit ($0.01/$0.02 USD) - 2022/08/23 17:21:09 ET
Table 'Equinox IV' 6-max Seat #4 is the button
Seat 1: chxxxs ($2.74 in chips)
Seat 2: jaypostic ($1.42 in chips)
Seat 3: casimiro124 ($2 in chips)
Seat 4: kiran_0695 ($1.62 in chips)
Seat 5: Tiones Ezequiel ($1.08 in chips)
Seat 6: MrDonRich ($4.50 in chips)
Tiones Ezequiel: posts small blind $0.01
MrDonRich: posts big blind $0.02
*** HOLE CARDS ***
chxxxs: raises $0.03 to $0.05
jaypostic: folds
casimiro124: folds
kiran_0695: calls $0.05
Tiones Ezequiel: calls $0.04
MrDonRich: folds
*** FLOP *** [3d 4c 6h]
Tiones Ezequiel: checks
chxxxs: bets $0.09
kiran_0695: calls $0.09
Tiones Ezequiel: calls $0.09
*** TURN *** [3d 4c 6h] [2c]
Tiones Ezequiel: checks
chxxxs: checks
kiran_0695: bets $0.42
Tiones Ezequiel: calls $0.42
chxxxs: folds
*** RIVER *** [3d 4c 6h 2c] [7c]
Tiones Ezequiel: bets $0.22
kiran_0695: calls $0.22
*** SHOW DOWN ***
Tiones Ezequiel: shows [Ac 5c] (a flush, Ace high)
kiran_0695: mucks hand
Tiones Ezequiel collected $1.66 from pot
*** SUMMARY ***
Total pot $1.72 | Rake $0.06
Board [3d 4c 6h 2c 7c]
Seat 1: chxxxs folded on the Turn
Seat 2: jaypostic folded before Flop (didn't bet)
Seat 3: casimiro124 folded before Flop (didn't bet)
Seat 4: kiran_0695 (button) mucked
Seat 5: Tiones Ezequiel (small blind) showed [Ac 5c] and won ($1.66) with a flush, Ace high
Seat 6: MrDonRich (big blind) folded before Flop


PokerStars Hand #238175625911:  Hold'em No Limit ($0.01/$0.02 USD) - 2022/08/23 17:22:24 ET
Table 'Equinox IV' 6-max Seat #5 is the button
Seat 1: chxxxs ($2.60 in chips)
Seat 2: jaypostic ($2 in chips)
Seat 3: casimiro124 ($2 in chips)
Seat 4: kiran_0695 ($0.84 in chips)
Seat 5: Tiones Ezequiel ($1.96 in chips)
Seat 6: MrDonRich ($4.48 in chips)
MrDonRich: posts small blind $0.01
chxxxs: posts big blind $0.02
*** HOLE CARDS ***
jaypostic: folds
casimiro124: folds
kiran_0695: calls $0.02
Tiones Ezequiel: calls $0.02
MrDonRich: calls $0.01
chxxxs: checks
*** FLOP *** [6s 4h 2h]
MrDonRich: checks
chxxxs: checks
kiran_0695: checks
Tiones Ezequiel: checks
*** TURN *** [6s 4h 2h] [5h]
MrDonRich: bets $0.05
chxxxs: folds
kiran_0695: raises $0.05 to $0.10
Tiones Ezequiel: folds
MrDonRich: calls $0.05
*** RIVER *** [6s 4h 2h 5h] [3h]
MrDonRich: checks
kiran_0695: bets $0.72 and is all-in
MrDonRich: folds
Uncalled bet ($0.72) returned to kiran_0695
kiran_0695 collected $0.27 from pot
*** SUMMARY ***
Total pot $0.28 | Rake $0.01
Board [6s 4h 2h 5h 3h]
Seat 1: chxxxs (big blind) folded on the Turn
Seat 2: jaypostic folded before Flop (didn't bet)
Seat 3: casimiro124 folded before Flop (didn't bet)
Seat 4: kiran_0695 collected ($0.27)
Seat 5: Tiones Ezequiel (button) folded on the Turn
Seat 6: MrDonRich (small blind) folded on the River


PokerStars Hand #238175645036:  Hold'em No Limit ($0.01/$0.02 USD) - 2022/08/23 17:23:16 ET
Table 'Equinox IV' 6-max Seat #6 is the button
Seat 1: chxxxs ($2.58 in chips)
Seat 2: jaypostic ($2 in chips)
Seat 3: casimiro124 ($2 in chips)
Seat 4: kiran_0695 ($0.99 in chips)
Seat 5: Tiones Ezequiel ($1.94 in chips)
Seat 6: MrDonRich ($4.36 in chips)
chxxxs: posts small blind $0.01
jaypostic: posts big blind $0.02
*** HOLE CARDS ***
casimiro124: folds
kiran_0695: calls $0.02
Tiones Ezequiel: folds
MrDonRich: folds
chxxxs: folds
jaypostic: checks
*** FLOP *** [Qh Jc Ad]
jaypostic: checks
kiran_0695: checks
*** TURN *** [Qh Jc Ad] [5d]
jaypostic: bets $0.05
kiran_0695: raises $0.05 to $0.10
jaypostic: folds
Uncalled bet ($0.05) returned to kiran_0695
kiran_0695 collected $0.14 from pot
*** SUMMARY ***
Total pot $0.15 | Rake $0.01
Board [Qh Jc Ad 5d]
Seat 1: chxxxs (small blind) folded before Flop
Seat 2: jaypostic (big blind) folded on the Turn
Seat 3: casimiro124 folded before Flop (didn't bet)
Seat 4: kiran_0695 collected ($0.14)
Seat 5: Tiones Ezequiel folded before Flop (didn't bet)
Seat 6: MrDonRich (button) folded before Flop (didn't bet)


PokerStars Hand #238175654936:  Hold'em No Limit ($0.01/$0.02 USD) - 2022/08/23 17:23:43 ET
Table 'Equinox IV' 6-max Seat #1 is the button
Seat 1: chxxxs ($2.57 in chips)
Seat 2: jaypostic ($1.93 in chips)
Seat 3: casimiro124 ($2 in chips)
Seat 4: kiran_0695 ($1.06 in chips)
Seat 5: Tiones Ezequiel ($1.94 in chips)
Seat 6: MrDonRich ($4.36 in chips)
jaypostic: posts small blind $0.01
casimiro124: posts big blind $0.02
*** HOLE CARDS ***
kiran_0695: calls $0.02
Tiones Ezequiel: calls $0.02
MrDonRich: folds
chxxxs: folds
jaypostic: calls $0.01
casimiro124: checks
*** FLOP *** [6d Ks 9d]
jaypostic: checks
casimiro124: checks
kiran_0695: checks
Tiones Ezequiel: checks
*** TURN *** [6d Ks 9d] [Tc]
jaypostic: checks
casimiro124: checks
kiran_0695: bets $0.08
Tiones Ezequiel: folds
jaypostic: calls $0.08
casimiro124: calls $0.08
*** RIVER *** [6d Ks 9d Tc] [7d]
jaypostic: checks
casimiro124: checks
kiran_0695: bets $0.31
jaypostic: folds
casimiro124: raises $1.55 to $1.86
kiran_0695: calls $0.65 and is all-in
Uncalled bet ($0.90) returned to casimiro124
*** SHOW DOWN ***
casimiro124: shows [Ad 8d] (a flush, Ace high)
kiran_0695: shows [Ts Th] (three of a kind, Tens)
casimiro124 collected $2.16 from pot
*** SUMMARY ***
Total pot $2.24 | Rake $0.08
Board [6d Ks 9d Tc 7d]
Seat 1: chxxxs (button) folded before Flop (didn't bet)
Seat 2: jaypostic (small blind) folded on the River
Seat 3: casimiro124 (big blind) showed [Ad 8d] and won ($2.16) with a flush, Ace high
Seat 4: kiran_0695 showed [Ts Th] and lost with three of a kind, Tens
Seat 5: Tiones Ezequiel folded on the Turn
Seat 6: MrDonRich folded before Flop (didn't bet)


PokerStars Hand #238175682481:  Hold'em No Limit ($0.01/$0.02 USD) - 2022/08/23 17:24:58 ET
Table 'Equinox IV' 6-max Seat #2 is the button
Seat 1: chxxxs ($2.57 in chips)
Seat 2: jaypostic ($1.83 in chips)
Seat 3: casimiro124 ($3.10 in chips)
Seat 5: Tiones Ezequiel ($1.92 in chips)
Seat 6: MrDonRich ($4.36 in chips)
casimiro124: posts small blind $0.01
Tiones Ezequiel: posts big blind $0.02
*** HOLE CARDS ***
MrDonRich: folds
chxxxs: raises $0.03 to $0.05
jaypostic: folds
casimiro124: folds
Tiones Ezequiel: calls $0.03
*** FLOP *** [Td 7c 8d]
kiran_0695 leaves the table
Tiones Ezequiel: checks
chxxxs: bets $0.05
Tiones Ezequiel: folds
Uncalled bet ($0.05) returned to chxxxs
chxxxs collected $0.11 from pot
chxxxs: doesn't show hand
*** SUMMARY ***
Total pot $0.11 | Rake $0
Board [Td 7c 8d]
Seat 1: chxxxs collected ($0.11)
Seat 2: jaypostic (button) folded before Flop (didn't bet)
Seat 3: casimiro124 (small blind) folded before Flop
Seat 5: Tiones Ezequiel (big blind) folded on the Flop
Seat 6: MrDonRich folded before Flop (didn't bet)


PokerStars Hand #238175692740:  Hold'em No Limit ($0.01/$0.02 USD) - 2022/08/23 17:25:26 ET
Table 'Equinox IV' 6-max Seat #3 is the button
Seat 1: chxxxs ($2.63 in chips)
Seat 2: jaypostic ($1.83 in chips)
Seat 3: casimiro124 ($3.09 in chips)
Seat 5: Tiones Ezequiel ($1.87 in chips)
Seat 6: MrDonRich ($4.36 in chips)
Tiones Ezequiel: posts small blind $0.01
MrDonRich: posts big blind $0.02
*** HOLE CARDS ***
chxxxs: folds
jaypostic: folds
casimiro124: raises $0.03 to $0.05
Tiones Ezequiel: calls $0.04
MrDonRich: folds
*** FLOP *** [Td Qh Qd]
Tiones Ezequiel: checks
casimiro124: checks
*** TURN *** [Td Qh Qd] [Jh]
Tiones Ezequiel: bets $0.04
casimiro124: calls $0.04
*** RIVER *** [Td Qh Qd Jh] [8c]
Tiones Ezequiel: bets $0.02
casimiro124: calls $0.02
*** SHOW DOWN ***
Tiones Ezequiel: shows [Jd Ac] (two pair, Queens and Jacks)
casimiro124: mucks hand
Tiones Ezequiel collected $0.23 from pot
*** SUMMARY ***
Total pot $0.24 | Rake $0.01
Board [Td Qh Qd Jh 8c]
Seat 1: chxxxs folded before Flop (didn't bet)
Seat 2: jaypostic folded before Flop (didn't bet)
Seat 3: casimiro124 (button) mucked
Seat 5: Tiones Ezequiel (small blind) showed [Jd Ac] and won ($0.23) with two pair, Queens and Jacks
Seat 6: MrDonRich (big blind) folded before Flop


PokerStars Hand #238175705620:  Hold'em No Limit ($0.01/$0.02 USD) - 2022/08/23 17:26:02 ET
Table 'Equinox IV' 6-max Seat #5 is the button
Seat 1: chxxxs ($2.63 in chips)
Seat 2: jaypostic ($1.83 in chips)
Seat 3: casimiro124 ($2.98 in chips)
Seat 5: Tiones Ezequiel ($1.99 in chips)
Seat 6: MrDonRich ($4.34 in chips)
MrDonRich: posts small blind $0.01
chxxxs: posts big blind $0.02
*** HOLE CARDS ***
jaypostic: folds
casimiro124: raises $0.04 to $0.06
Tiones Ezequiel: calls $0.06
MrDonRich: folds
chxxxs: folds
*** FLOP *** [9s 3h Ts]
casimiro124: bets $0.07
Tiones Ezequiel: folds
Uncalled bet ($0.07) returned to casimiro124
casimiro124 collected $0.14 from pot
casimiro124: doesn't show hand
*** SUMMARY ***
Total pot $0.15 | Rake $0.01
Board [9s 3h Ts]
Seat 1: chxxxs (big blind) folded before Flop
Seat 2: jaypostic folded before Flop (didn't bet)
Seat 3: casimiro124 collected ($0.14)
Seat 5: Tiones Ezequiel (button) folded on the Flop
Seat 6: MrDonRich (small blind) folded before Flop


PokerStars Hand #238175711710:  Hold'em No Limit ($0.01/$0.02 USD) - 2022/08/23 17:26:18 ET
Table 'Equinox IV' 6-max Seat #6 is the button
Seat 1: chxxxs ($2.61 in chips)
Seat 2: jaypostic ($1.83 in chips)
Seat 3: casimiro124 ($3.06 in chips)
Seat 5: Tiones Ezequiel ($1.93 in chips)
Seat 6: MrDonRich ($4.33 in chips)
chxxxs: posts small blind $0.01
jaypostic: posts big blind $0.02
*** HOLE CARDS ***
GVcH_vt joins the table at seat #4
casimiro124: folds
Tiones Ezequiel: folds
MrDonRich: calls $0.02
chxxxs: raises $0.08 to $0.10
jaypostic: folds
MrDonRich: folds
Uncalled bet ($0.08) returned to chxxxs
chxxxs collected $0.06 from pot
chxxxs: doesn't show hand
*** SUMMARY ***
Total pot $0.06 | Rake $0
Seat 1: chxxxs (small blind) collected ($0.06)
Seat 2: jaypostic (big blind) folded before Flop
Seat 3: casimiro124 folded before Flop (didn't bet)
Seat 5: Tiones Ezequiel folded before Flop (didn't bet)
Seat 6: MrDonRich (button) folded before Flop


PokerStars Hand #238175726021:  Hold'em No Limit ($0.01/$0.02 USD) - 2022/08/23 17:26:37 ET
Table 'Equinox IV' 6-max Seat #1 is the button
Seat 1: chxxxs ($2.65 in chips)
Seat 3: casimiro124 ($3.06 in chips)
Seat 4: GVcH_vt ($2 in chips)
Seat 5: Tiones Ezequiel ($1.93 in chips)
Seat 6: MrDonRich ($4.31 in chips)
casimiro124: posts small blind $0.01
GVcH_vt: posts big blind $0.02
*** HOLE CARDS ***
Tiones Ezequiel: raises $0.02 to $0.04
MrDonRich: folds
chxxxs: folds
casimiro124: folds
GVcH_vt: calls $0.02
*** FLOP *** [Qh As Td]
GVcH_vt: checks
Tiones Ezequiel: bets $0.09
GVcH_vt: folds
Uncalled bet ($0.09) returned to Tiones Ezequiel
Tiones Ezequiel collected $0.09 from pot
*** SUMMARY ***
Total pot $0.09 | Rake $0
Board [Qh As Td]
Seat 1: chxxxs (button) folded before Flop (didn't bet)
Seat 3: casimiro124 (small blind) folded before Flop
Seat 4: GVcH_vt (big blind) folded on the Flop
Seat 5: Tiones Ezequiel collected ($0.09)
Seat 6: MrDonRich folded before Flop (didn't bet)


PokerStars Hand #238175749121:  Hold'em No Limit ($0.01/$0.02 USD) - 2022/08/23 17:27:20 ET
Table 'Equinox IV' 6-max Seat #3 is the button
Seat 1: chxxxs ($2.65 in chips)
Seat 3: casimiro124 ($3.05 in chips)
Seat 4: GVcH_vt ($2 in chips)
Seat 5: Tiones Ezequiel ($1.98 in chips)
Seat 6: MrDonRich ($4.31 in chips)
GVcH_vt: posts small blind $0.01
Tiones Ezequiel: posts big blind $0.02
*** HOLE CARDS ***
MrDonRich: calls $0.02
chxxxs: folds
casimiro124: raises $0.07 to $0.09
GVcH_vt: folds
Tiones Ezequiel: folds
MrDonRich: folds
Uncalled bet ($0.07) returned to casimiro124
casimiro124 collected $0.07 from pot
casimiro124: doesn't show hand
*** SUMMARY ***
Total pot $0.07 | Rake $0
Seat 1: chxxxs folded before Flop (didn't bet)
Seat 3: casimiro124 (button) collected ($0.07)
Seat 4: GVcH_vt (small blind) folded before Flop
Seat 5: Tiones Ezequiel (big blind) folded before Flop
Seat 6: MrDonRich folded before Flop


PokerStars Hand #238175764162:  Hold'em No Limit ($0.01/$0.02 USD) - 2022/08/23 17:28:01 ET
Table 'Equinox IV' 6-max Seat #4 is the button
Seat 1: chxxxs ($2.65 in chips)
Seat 3: casimiro124 ($3.10 in chips)
Seat 4: GVcH_vt ($1.99 in chips)
Seat 5: Tiones Ezequiel ($1.96 in chips)
Seat 6: MrDonRich ($4.29 in chips)
Tiones Ezequiel: posts small blind $0.01
MrDonRich: posts big blind $0.02
*** HOLE CARDS ***
chxxxs: folds
casimiro124: raises $0.04 to $0.06
GVcH_vt: folds
Tiones Ezequiel: calls $0.05
MrDonRich: folds
*** FLOP *** [5c 5d 6h]
Tiones Ezequiel: checks
casimiro124: checks
*** TURN *** [5c 5d 6h] [Js]
Tiones Ezequiel: bets $0.02
casimiro124: calls $0.02
*** RIVER *** [5c 5d 6h Js] [Jc]
Tiones Ezequiel: checks
casimiro124: checks
*** SHOW DOWN ***
Tiones Ezequiel: shows [7s Ac] (two pair, Jacks and Fives)
casimiro124: mucks hand
Tiones Ezequiel collected $0.17 from pot
*** SUMMARY ***
Total pot $0.18 | Rake $0.01
Board [5c 5d 6h Js Jc]
Seat 1: chxxxs folded before Flop (didn't bet)
Seat 3: casimiro124 mucked
Seat 4: GVcH_vt (button) folded before Flop (didn't bet)
Seat 5: Tiones Ezequiel (small blind) showed [7s Ac] and won ($0.17) with two pair, Jacks and Fives
Seat 6: MrDonRich (big blind) folded before Flop


PokerStars Hand #238175775644:  Hold'em No Limit ($0.01/$0.02 USD) - 2022/08/23 17:28:33 ET
Table 'Equinox IV' 6-max Seat #5 is the button
Seat 1: chxxxs ($2.65 in chips)
Seat 2: jaypostic ($1.81 in chips)
Seat 3: casimiro124 ($3.02 in chips)
Seat 4: GVcH_vt ($1.99 in chips)
Seat 5: Tiones Ezequiel ($2.05 in chips)
Seat 6: MrDonRich ($4.27 in chips)
MrDonRich: posts small blind $0.01
chxxxs: posts big blind $0.02
jaypostic: posts small blind $0.01
*** HOLE CARDS ***
jaypostic: raises $0.04 to $0.06
casimiro124: folds
GVcH_vt: folds
Tiones Ezequiel: raises $0.16 to $0.22
MrDonRich: folds
chxxxs: folds
jaypostic: calls $0.16
*** FLOP *** [8c Ad 2h]
jaypostic: checks
Tiones Ezequiel: checks
*** TURN *** [8c Ad 2h] [4c]
jaypostic: bets $0.25
Tiones Ezequiel: folds
Uncalled bet ($0.25) returned to jaypostic
jaypostic collected $0.46 from pot
*** SUMMARY ***
Total pot $0.48 | Rake $0.02
Board [8c Ad 2h 4c]
Seat 1: chxxxs (big blind) folded before Flop
Seat 2: jaypostic collected ($0.46)
Seat 3: casimiro124 folded before Flop (didn't bet)
Seat 4: GVcH_vt folded before Flop (didn't bet)
Seat 5: Tiones Ezequiel (button) folded on the Turn
Seat 6: MrDonRich (small blind) folded before Flop


PokerStars Hand #238175789700:  Hold'em No Limit ($0.01/$0.02 USD) - 2022/08/23 17:29:11 ET
Table 'Equinox IV' 6-max Seat #6 is the button
Seat 1: chxxxs ($2.63 in chips)
Seat 2: jaypostic ($2.04 in chips)
Seat 3: casimiro124 ($3.02 in chips)
Seat 4: GVcH_vt ($1.99 in chips)
Seat 5: Tiones Ezequiel ($1.83 in chips)
Seat 6: MrDonRich ($4.26 in chips)
chxxxs: posts small blind $0.01
jaypostic: posts big blind $0.02
*** HOLE CARDS ***
casimiro124: raises $0.04 to $0.06
GVcH_vt: folds
Tiones Ezequiel: folds
MrDonRich: folds
chxxxs: folds
jaypostic: calls $0.04
*** FLOP *** [8h Qd Tc]
jaypostic: checks
casimiro124: bets $0.07
jaypostic: calls $0.07
*** TURN *** [8h Qd Tc] [Td]
jaypostic: checks
casimiro124: checks
*** RIVER *** [8h Qd Tc Td] [2h]
jaypostic: checks
casimiro124: bets $0.20
jaypostic: calls $0.20
*** SHOW DOWN ***
casimiro124: shows [Jh 9h] (a straight, Eight to Queen)
jaypostic: mucks hand
casimiro124 collected $0.65 from pot
*** SUMMARY ***
Total pot $0.67 | Rake $0.02
Board [8h Qd Tc Td 2h]
Seat 1: chxxxs (small blind) folded before Flop
Seat 2: jaypostic (big blind) mucked
Seat 3: casimiro124 showed [Jh 9h] and won ($0.65) with a straight, Eight to Queen
Seat 4: GVcH_vt folded before Flop (didn't bet)
Seat 5: Tiones Ezequiel folded before Flop (didn't bet)
Seat 6: MrDonRich (button) folded before Flop (didn't bet)


PokerStars Hand #238175811129:  Hold'em No Limit ($0.01/$0.02 USD) - 2022/08/23 17:30:11 ET
Table 'Equinox IV' 6-max Seat #1 is the button
Seat 1: chxxxs ($2.62 in chips)
Seat 2: jaypostic ($1.71 in chips)
Seat 3: casimiro124 ($3.34 in chips)
Seat 4: GVcH_vt ($1.99 in chips)
Seat 5: Tiones Ezequiel ($1.83 in chips)
Seat 6: MrDonRich ($4.26 in chips)
jaypostic: posts small blind $0.01
casimiro124: posts big blind $0.02
*** HOLE CARDS ***
GVcH_vt: folds
Tiones Ezequiel: folds
MrDonRich: folds
Tiones Ezequiel leaves the table
chxxxs: folds
jaypostic: calls $0.01
casimiro124: checks
*** FLOP *** [Ad Qd 5s]
jaypostic: checks
casimiro124: checks
*** TURN *** [Ad Qd 5s] [Kc]
jaypostic: bets $0.06
SamuCao joins the table at seat #5
casimiro124: raises $0.27 to $0.33
jaypostic: calls $0.27
*** RIVER *** [Ad Qd 5s Kc] [As]
jaypostic: checks
casimiro124: checks
*** SHOW DOWN ***
jaypostic: shows [2d 5d] (two pair, Aces and Fives)
casimiro124: shows [5h Ks] (two pair, Aces and Kings)
casimiro124 collected $0.68 from pot
*** SUMMARY ***
Total pot $0.70 | Rake $0.02
Board [Ad Qd 5s Kc As]
Seat 1: chxxxs (button) folded before Flop (didn't bet)
Seat 2: jaypostic (small blind) showed [2d 5d] and lost with two pair, Aces and Fives
Seat 3: casimiro124 (big blind) showed [5h Ks] and won ($0.68) with two pair, Aces and Kings
Seat 4: GVcH_vt folded before Flop (didn't bet)
Seat 5: Tiones Ezequiel folded before Flop (didn't bet)
Seat 6: MrDonRich folded before Flop (didn't bet)


PokerStars Hand #238175838542:  Hold'em No Limit ($0.01/$0.02 USD) - 2022/08/23 17:31:26 ET
Table 'Equinox IV' 6-max Seat #2 is the button
Seat 1: chxxxs ($2.62 in chips)
Seat 2: jaypostic ($1.36 in chips)
Seat 3: casimiro124 ($3.67 in chips)
Seat 4: GVcH_vt ($1.99 in chips)
Seat 5: SamuCao ($1 in chips)
Seat 6: MrDonRich ($4.26 in chips)
casimiro124: posts small blind $0.01
GVcH_vt: posts big blind $0.02
SamuCao: posts big blind $0.02
*** HOLE CARDS ***
SamuCao: checks
MrDonRich: folds
chxxxs: raises $0.04 to $0.06
jaypostic: folds
casimiro124: folds
GVcH_vt: folds
SamuCao: calls $0.04
*** FLOP *** [5d Kc 5s]
SamuCao: checks
chxxxs: checks
*** TURN *** [5d Kc 5s] [9c]
SamuCao: bets $0.07
chxxxs: calls $0.07
*** RIVER *** [5d Kc 5s 9c] [6d]
SamuCao: bets $0.28
chxxxs: calls $0.28
*** SHOW DOWN ***
SamuCao: shows [Qc 4d] (a pair of Fives)
chxxxs: shows [Kh Jc] (two pair, Kings and Fives)
chxxxs collected $0.82 from pot
*** SUMMARY ***
Total pot $0.85 | Rake $0.03
Board [5d Kc 5s 9c 6d]
Seat 1: chxxxs showed [Kh Jc] and won ($0.82) with two pair, Kings and Fives
Seat 2: jaypostic (button) folded before Flop (didn't bet)
Seat 3: casimiro124 (small blind) folded before Flop
Seat 4: GVcH_vt (big blind) folded before Flop
Seat 5: SamuCao showed [Qc 4d] and lost with a pair of Fives
Seat 6: MrDonRich folded before Flop (didn't bet)


PokerStars Hand #238175858539:  Hold'em No Limit ($0.01/$0.02 USD) - 2022/08/23 17:32:22 ET
Table 'Equinox IV' 6-max Seat #3 is the button
Seat 1: chxxxs ($3.03 in chips)
Seat 2: jaypostic ($2 in chips)
Seat 3: casimiro124 ($3.66 in chips)
Seat 4: GVcH_vt ($2 in chips)
Seat 5: SamuCao ($0.59 in chips)
Seat 6: MrDonRich ($4.26 in chips)
GVcH_vt: posts small blind $0.01
SamuCao: posts big blind $0.02
*** HOLE CARDS ***
MrDonRich: folds
chxxxs: folds
jaypostic: raises $0.04 to $0.06
casimiro124: folds
GVcH_vt: folds
SamuCao: calls $0.04
*** FLOP *** [Jh 8d 4s]
SamuCao: checks
jaypostic: checks
*** TURN *** [Jh 8d 4s] [7s]
SamuCao: checks
jaypostic: bets $0.10
SamuCao: folds
Uncalled bet ($0.10) returned to jaypostic
jaypostic collected $0.13 from pot
*** SUMMARY ***
Total pot $0.13 | Rake $0
Board [Jh 8d 4s 7s]
Seat 1: chxxxs folded before Flop (didn't bet)
Seat 2: jaypostic collected ($0.13)
Seat 3: casimiro124 (button) folded before Flop (didn't bet)
Seat 4: GVcH_vt (small blind) folded before Flop
Seat 5: SamuCao (big blind) folded on the Turn
Seat 6: MrDonRich folded before Flop (didn't bet)


PokerStars Hand #238175876301:  Hold'em No Limit ($0.01/$0.02 USD) - 2022/08/23 17:33:11 ET
Table 'Equinox IV' 6-max Seat #4 is the button
Seat 1: chxxxs ($3.03 in chips)
Seat 2: jaypostic ($2.07 in chips)
Seat 3: casimiro124 ($3.66 in chips)
Seat 4: GVcH_vt ($1.99 in chips)
Seat 5: SamuCao ($0.53 in chips)
Seat 6: MrDonRich ($4.26 in chips)
SamuCao: posts small blind $0.01
MrDonRich: posts big blind $0.02
*** HOLE CARDS ***
chxxxs: folds
jaypostic: raises $0.04 to $0.06
casimiro124: folds
GVcH_vt: folds
SamuCao: folds
MrDonRich: calls $0.04
*** FLOP *** [8c 6c 3s]
MrDonRich: checks
jaypostic: bets $0.06
MrDonRich: folds
Uncalled bet ($0.06) returned to jaypostic
jaypostic collected $0.13 from pot
*** SUMMARY ***
Total pot $0.13 | Rake $0
Board [8c 6c 3s]
Seat 1: chxxxs folded before Flop (didn't bet)
Seat 2: jaypostic collected ($0.13)
Seat 3: casimiro124 folded before Flop (didn't bet)
Seat 4: GVcH_vt (button) folded before Flop (didn't bet)
Seat 5: SamuCao (small blind) folded before Flop
Seat 6: MrDonRich (big blind) folded on the Flop


PokerStars Hand #238175890667:  Hold'em No Limit ($0.01/$0.02 USD) - 2022/08/23 17:33:51 ET
Table 'Equinox IV' 6-max Seat #5 is the button
Seat 1: chxxxs ($3.03 in chips)
Seat 2: jaypostic ($2.14 in chips)
Seat 3: casimiro124 ($3.66 in chips)
Seat 4: GVcH_vt ($1.99 in chips)
Seat 5: SamuCao ($0.52 in chips)
Seat 6: MrDonRich ($4.20 in chips)
MrDonRich: posts small blind $0.01
chxxxs: posts big blind $0.02
*** HOLE CARDS ***
jaypostic: folds
casimiro124: raises $0.04 to $0.06
GVcH_vt: folds
SamuCao: folds
MrDonRich: folds
chxxxs: calls $0.04
*** FLOP *** [Jd 3s 4s]
chxxxs: checks
casimiro124: bets $0.07
chxxxs: calls $0.07
*** TURN *** [Jd 3s 4s] [6c]
chxxxs: checks
casimiro124: bets $0.14
chxxxs: calls $0.14
*** RIVER *** [Jd 3s 4s 6c] [5d]
chxxxs: checks
casimiro124: checks
*** SHOW DOWN ***
chxxxs: shows [Jh Kd] (a pair of Jacks)
casimiro124: shows [Kh Jc] (a pair of Jacks)
chxxxs collected $0.27 from pot
casimiro124 collected $0.26 from pot
*** SUMMARY ***
Total pot $0.55 | Rake $0.02
Board [Jd 3s 4s 6c 5d]
Seat 1: chxxxs (big blind) showed [Jh Kd] and won ($0.27) with a pair of Jacks
Seat 2: jaypostic folded before Flop (didn't bet)
Seat 3: casimiro124 showed [Kh Jc] and won ($0.26) with a pair of Jacks
Seat 4: GVcH_vt folded before Flop (didn't bet)
Seat 5: SamuCao (button) folded before Flop (didn't bet)
Seat 6: MrDonRich (small blind) folded before Flop


PokerStars Hand #238175910642:  Hold'em No Limit ($0.01/$0.02 USD) - 2022/08/23 17:34:47 ET
Table 'Equinox IV' 6-max Seat #6 is the button
Seat 1: chxxxs ($3.03 in chips)
Seat 2: jaypostic ($2.14 in chips)
Seat 3: casimiro124 ($3.65 in chips)
Seat 4: GVcH_vt ($1.99 in chips)
Seat 5: SamuCao ($0.52 in chips)
Seat 6: MrDonRich ($4.19 in chips)
chxxxs: posts small blind $0.01
jaypostic: posts big blind $0.02
*** HOLE CARDS ***
casimiro124: folds
GVcH_vt: folds
SamuCao: folds
MrDonRich: folds
chxxxs: raises $0.03 to $0.05
jaypostic: calls $0.03
*** FLOP *** [6d 2s 8h]
chxxxs: bets $0.05
jaypostic: raises $0.05 to $0.10
chxxxs: calls $0.05
*** TURN *** [6d 2s 8h] [6c]
chxxxs: checks
jaypostic: bets $0.14
chxxxs: calls $0.14
*** RIVER *** [6d 2s 8h 6c] [6s]
chxxxs: checks
jaypostic: checks
*** SHOW DOWN ***
chxxxs: shows [Qd Qc] (a full house, Sixes full of Queens)
jaypostic: mucks hand
chxxxs collected $0.56 from pot
*** SUMMARY ***
Total pot $0.58 | Rake $0.02
Board [6d 2s 8h 6c 6s]
Seat 1: chxxxs (small blind) showed [Qd Qc] and won ($0.56) with a full house, Sixes full of Queens
Seat 2: jaypostic (big blind) mucked
Seat 3: casimiro124 folded before Flop (didn't bet)
Seat 4: GVcH_vt folded before Flop (didn't bet)
Seat 5: SamuCao folded before Flop (didn't bet)
Seat 6: MrDonRich (button) folded before Flop (didn't bet)


PokerStars Hand #238175932508:  Hold'em No Limit ($0.01/$0.02 USD) - 2022/08/23 17:35:47 ET
Table 'Equinox IV' 6-max Seat #1 is the button
Seat 1: chxxxs ($3.30 in chips)
Seat 2: jaypostic ($1.85 in chips)
Seat 3: casimiro124 ($3.65 in chips)
Seat 4: GVcH_vt ($1.99 in chips)
Seat 5: SamuCao ($0.52 in chips)
Seat 6: MrDonRich ($4.19 in chips)
jaypostic: posts small blind $0.01
casimiro124: posts big blind $0.02
*** HOLE CARDS ***
GVcH_vt: folds
SamuCao: folds
MrDonRich: folds
chxxxs: folds
jaypostic: raises $0.04 to $0.06
casimiro124: raises $0.12 to $0.18
jaypostic: calls $0.12
*** FLOP *** [3h 5d 6d]
jaypostic: checks
casimiro124: checks
*** TURN *** [3h 5d 6d] [Ks]
jaypostic: bets $0.19
casimiro124: folds
Uncalled bet ($0.19) returned to jaypostic
jaypostic collected $0.35 from pot
*** SUMMARY ***
Total pot $0.36 | Rake $0.01
Board [3h 5d 6d Ks]
Seat 1: chxxxs (button) folded before Flop (didn't bet)
Seat 2: jaypostic (small blind) collected ($0.35)
Seat 3: casimiro124 (big blind) folded on the Turn
Seat 4: GVcH_vt folded before Flop (didn't bet)
Seat 5: SamuCao folded before Flop (didn't bet)
Seat 6: MrDonRich folded before Flop (didn't bet)


PokerStars Hand #238175946194:  Hold'em No Limit ($0.01/$0.02 USD) - 2022/08/23 17:36:24 ET
Table 'Equinox IV' 6-max Seat #2 is the button
Seat 1: chxxxs ($3.30 in chips)
Seat 2: jaypostic ($2.02 in chips)
Seat 3: casimiro124 ($3.47 in chips)
Seat 4: GVcH_vt ($1.99 in chips)
Seat 5: SamuCao ($0.52 in chips)
Seat 6: MrDonRich ($4.19 in chips)
casimiro124: posts small blind $0.01
GVcH_vt: posts big blind $0.02
*** HOLE CARDS ***
SamuCao: folds
MrDonRich: calls $0.02
chxxxs: folds
jaypostic: calls $0.02
casimiro124: folds
GVcH_vt: checks
*** FLOP *** [Qd Kd Kc]
GVcH_vt: checks
MrDonRich: checks
jaypostic: bets $0.07
GVcH_vt: folds
MrDonRich: calls $0.07
*** TURN *** [Qd Kd Kc] [3c]
MrDonRich: checks
jaypostic: bets $0.10
MrDonRich: calls $0.10
*** RIVER *** [Qd Kd Kc 3c] [Ac]
MrDonRich: checks
jaypostic: checks
*** SHOW DOWN ***
MrDonRich: shows [2s Ks] (three of a kind, Kings)
jaypostic: mucks hand
MrDonRich collected $0.40 from pot
*** SUMMARY ***
Total pot $0.41 | Rake $0.01
Board [Qd Kd Kc 3c Ac]
Seat 1: chxxxs folded before Flop (didn't bet)
Seat 2: jaypostic (button) mucked
Seat 3: casimiro124 (small blind) folded before Flop
Seat 4: GVcH_vt (big blind) folded on the Flop
Seat 5: SamuCao folded before Flop (didn't bet)
Seat 6: MrDonRich showed [2s Ks] and won ($0.40) with three of a kind, Kings


PokerStars Hand #238175973160:  Hold'em No Limit ($0.01/$0.02 USD) - 2022/08/23 17:37:39 ET
Table 'Equinox IV' 6-max Seat #3 is the button
Seat 1: chxxxs ($3.30 in chips)
Seat 2: jaypostic ($1.83 in chips)
Seat 3: casimiro124 ($3.46 in chips)
Seat 4: GVcH_vt ($2 in chips)
Seat 5: SamuCao ($0.52 in chips)
Seat 6: MrDonRich ($4.40 in chips)
GVcH_vt: posts small blind $0.01
SamuCao: posts big blind $0.02
*** HOLE CARDS ***
MrDonRich: folds
chxxxs: raises $0.04 to $0.06
jaypostic: calls $0.06
casimiro124: folds
GVcH_vt: folds
SamuCao: folds
*** FLOP *** [9s Ad 7c]
chxxxs: checks
jaypostic: checks
*** TURN *** [9s Ad 7c] [6s]
chxxxs: bets $0.07
jaypostic: calls $0.07
*** RIVER *** [9s Ad 7c 6s] [4s]
chxxxs: bets $0.19
jaypostic: calls $0.19
*** SHOW DOWN ***
chxxxs: shows [Ac As] (three of a kind, Aces)
jaypostic: mucks hand
chxxxs collected $0.65 from pot
*** SUMMARY ***
Total pot $0.67 | Rake $0.02
Board [9s Ad 7c 6s 4s]
Seat 1: chxxxs showed [Ac As] and won ($0.65) with three of a kind, Aces
Seat 2: jaypostic mucked
Seat 3: casimiro124 (button) folded before Flop (didn't bet)
Seat 4: GVcH_vt (small blind) folded before Flop
Seat 5: SamuCao (big blind) folded before Flop
Seat 6: MrDonRich folded before Flop (didn't bet)


PokerStars Hand #238175997674:  Hold'em No Limit ($0.01/$0.02 USD) - 2022/08/23 17:38:47 ET
Table 'Equinox IV' 6-max Seat #4 is the button
Seat 1: chxxxs ($3.63 in chips)
Seat 2: jaypostic ($1.51 in chips)
Seat 3: casimiro124 ($3.46 in chips)
Seat 4: GVcH_vt ($1.99 in chips)
Seat 5: SamuCao ($0.50 in chips)
Seat 6: MrDonRich ($4.40 in chips)
SamuCao: posts small blind $0.01
MrDonRich: posts big blind $0.02
*** HOLE CARDS ***
chxxxs: folds
jaypostic: raises $0.04 to $0.06
casimiro124: folds
GVcH_vt: folds
SamuCao: folds
MrDonRich: folds
Uncalled bet ($0.04) returned to jaypostic
jaypostic collected $0.05 from pot
*** SUMMARY ***
Total pot $0.05 | Rake $0
Seat 1: chxxxs folded before Flop (didn't bet)
Seat 2: jaypostic collected ($0.05)
Seat 3: casimiro124 folded before Flop (didn't bet)
Seat 4: GVcH_vt (button) folded before Flop (didn't bet)
Seat 5: SamuCao (small blind) folded before Flop
Seat 6: MrDonRich (big blind) folded before Flop


PokerStars Hand #238176010755:  Hold'em No Limit ($0.01/$0.02 USD) - 2022/08/23 17:39:24 ET
Table 'Equinox IV' 6-max Seat #5 is the button
Seat 1: chxxxs ($3.63 in chips)
Seat 2: jaypostic ($1.54 in chips)
Seat 3: casimiro124 ($3.46 in chips)
Seat 4: GVcH_vt ($1.99 in chips)
Seat 5: SamuCao ($0.49 in chips)
Seat 6: MrDonRich ($4.38 in chips)
MrDonRich: posts small blind $0.01
chxxxs: posts big blind $0.02
*** HOLE CARDS ***
jaypostic: folds
casimiro124: raises $0.04 to $0.06
jaypostic leaves the table
GVcH_vt: folds
SamuCao: folds
MrDonRich: folds
chxxxs: calls $0.04
*** FLOP *** [5s 5d 6c]
chxxxs: checks
casimiro124: checks
*** TURN *** [5s 5d 6c] [8h]
chxxxs: checks
@joapnolasco joins the table at seat #2
casimiro124: checks
*** RIVER *** [5s 5d 6c 8h] [Jc]
chxxxs: checks
casimiro124: checks
*** SHOW DOWN ***
chxxxs: shows [7s 2s] (a pair of Fives)
casimiro124: shows [Qd Kd] (a pair of Fives - King kicker)
casimiro124 collected $0.13 from pot
*** SUMMARY ***
Total pot $0.13 | Rake $0
Board [5s 5d 6c 8h Jc]
Seat 1: chxxxs (big blind) showed [7s 2s] and lost with a pair of Fives
Seat 2: jaypostic folded before Flop (didn't bet)
Seat 3: casimiro124 showed [Qd Kd] and won ($0.13) with a pair of Fives
Seat 4: GVcH_vt folded before Flop (didn't bet)
Seat 5: SamuCao (button) folded before Flop (didn't bet)
Seat 6: MrDonRich (small blind) folded before Flop


PokerStars Hand #238176032587:  Hold'em No Limit ($0.01/$0.02 USD) - 2022/08/23 17:40:25 ET
Table 'Equinox IV' 6-max Seat #6 is the button
Seat 1: chxxxs ($3.57 in chips)
Seat 2: @joapnolasco ($2 in chips)
Seat 3: casimiro124 ($3.53 in chips)
Seat 4: GVcH_vt ($1.99 in chips)
Seat 5: SamuCao ($0.49 in chips)
Seat 6: MrDonRich ($4.37 in chips)
chxxxs: posts small blind $0.01
@joapnolasco: posts big blind $0.02
*** HOLE CARDS ***
casimiro124: folds
GVcH_vt: folds
SamuCao: folds
MrDonRich: folds
chxxxs: folds
Uncalled bet ($0.01) returned to @joapnolasco
@joapnolasco collected $0.02 from pot
@joapnolasco: doesn't show hand
*** SUMMARY ***
Total pot $0.02 | Rake $0
Seat 1: chxxxs (small blind) folded before Flop
Seat 2: @joapnolasco (big blind) collected ($0.02)
Seat 3: casimiro124 folded before Flop (didn't bet)
Seat 4: GVcH_vt folded before Flop (didn't bet)
Seat 5: SamuCao folded before Flop (didn't bet)
Seat 6: MrDonRich (button) folded before Flop (didn't bet)


PokerStars Hand #238176038802:  Hold'em No Limit ($0.01/$0.02 USD) - 2022/08/23 17:40:42 ET
Table 'Equinox IV' 6-max Seat #1 is the button
Seat 1: chxxxs ($3.56 in chips)
Seat 2: @joapnolasco ($2.01 in chips)
Seat 4: GVcH_vt ($1.99 in chips)
Seat 5: SamuCao ($0.49 in chips)
Seat 6: MrDonRich ($4.37 in chips)
@joapnolasco: posts small blind $0.01
casimiro124: is sitting out
GVcH_vt: posts big blind $0.02
*** HOLE CARDS ***
casimiro124 leaves the table
SamuCao: folds
MrDonRich: folds
chxxxs: raises $0.03 to $0.05
@joapnolasco: calls $0.04
Ipkizz joins the table at seat #3
GVcH_vt: calls $0.03
*** FLOP *** [Jh 5s 3h]
@joapnolasco: checks
GVcH_vt: checks
chxxxs: checks
*** TURN *** [Jh 5s 3h] [6s]
@joapnolasco: checks
GVcH_vt: bets $0.10
chxxxs: folds
@joapnolasco: folds
Uncalled bet ($0.10) returned to GVcH_vt
GVcH_vt collected $0.14 from pot
*** SUMMARY ***
Total pot $0.15 | Rake $0.01
Board [Jh 5s 3h 6s]
Seat 1: chxxxs (button) folded on the Turn
Seat 2: @joapnolasco (small blind) folded on the Turn
Seat 4: GVcH_vt (big blind) collected ($0.14)
Seat 5: SamuCao folded before Flop (didn't bet)
Seat 6: MrDonRich folded before Flop (didn't bet)


PokerStars Hand #238176068553:  Hold'em No Limit ($0.01/$0.02 USD) - 2022/08/23 17:42:06 ET
Table 'Equinox IV' 6-max Seat #2 is the button
Seat 1: chxxxs ($3.51 in chips)
Seat 2: @joapnolasco ($2 in chips)
Seat 4: GVcH_vt ($2.08 in chips)
Seat 6: MrDonRich ($4.37 in chips)
GVcH_vt: posts small blind $0.01
MrDonRich: posts big blind $0.02
*** HOLE CARDS ***
chxxxs: folds
@joapnolasco: folds
GVcH_vt: folds
Uncalled bet ($0.01) returned to MrDonRich
MrDonRich collected $0.02 from pot
MrDonRich: doesn't show hand
*** SUMMARY ***
Total pot $0.02 | Rake $0
Seat 1: chxxxs folded before Flop (didn't bet)
Seat 2: @joapnolasco (button) folded before Flop (didn't bet)
Seat 4: GVcH_vt (small blind) folded before Flop
Seat 6: MrDonRich (big blind) collected ($0.02)


PokerStars Hand #238176074728:  Hold'em No Limit ($0.01/$0.02 USD) - 2022/08/23 17:42:23 ET
Table 'Equinox IV' 6-max Seat #4 is the button
Seat 1: chxxxs ($3.51 in chips)
Seat 2: @joapnolasco ($2 in chips)
Seat 4: GVcH_vt ($2.07 in chips)
Seat 6: MrDonRich ($4.38 in chips)
MrDonRich: posts small blind $0.01
chxxxs: posts big blind $0.02
Ipkizz: sits out
*** HOLE CARDS ***
@joapnolasco: folds
GVcH_vt: folds
SamuCao is disconnected
MrDonRich: calls $0.01
chxxxs: checks
*** FLOP *** [9d 8h 3c]
MrDonRich: bets $0.03
chxxxs: calls $0.03
*** TURN *** [9d 8h 3c] [7s]
MrDonRich: bets $0.07
chxxxs: calls $0.07
*** RIVER *** [9d 8h 3c 7s] [3s]
MrDonRich: checks
chxxxs: checks
*** SHOW DOWN ***
MrDonRich: shows [9h Jh] (two pair, Nines and Threes)
chxxxs: mucks hand
MrDonRich collected $0.23 from pot
*** SUMMARY ***
Total pot $0.24 | Rake $0.01
Board [9d 8h 3c 7s 3s]
Seat 1: chxxxs (big blind) mucked
Seat 2: @joapnolasco folded before Flop (didn't bet)
Seat 4: GVcH_vt (button) folded before Flop (didn't bet)
Seat 6: MrDonRich (small blind) showed [9h Jh] and won ($0.23) with two pair, Nines and Threes


PokerStars Hand #238176112293:  Hold'em No Limit ($0.01/$0.02 USD) - 2022/08/23 17:44:09 ET
Table 'Equinox IV' 6-max Seat #6 is the button
Seat 1: chxxxs ($3.39 in chips)
Seat 2: @joapnolasco ($2 in chips)
Seat 4: GVcH_vt ($2.07 in chips)
Seat 6: MrDonRich ($4.49 in chips)
chxxxs: posts small blind $0.01
@joapnolasco: posts big blind $0.02
Ipkizz: sits out
*** HOLE CARDS ***
GVcH_vt: folds
MrDonRich: folds
chxxxs: folds
Uncalled bet ($0.01) returned to @joapnolasco
@joapnolasco collected $0.02 from pot
@joapnolasco: doesn't show hand
*** SUMMARY ***
Total pot $0.02 | Rake $0
Seat 1: chxxxs (small blind) folded before Flop
Seat 2: @joapnolasco (big blind) collected ($0.02)
Seat 4: GVcH_vt folded before Flop (didn't bet)
Seat 6: MrDonRich (button) folded before Flop (didn't bet)


PokerStars Hand #238176116778:  Hold'em No Limit ($0.01/$0.02 USD) - 2022/08/23 17:44:22 ET
Table 'Equinox IV' 6-max Seat #1 is the button
Seat 1: chxxxs ($3.38 in chips)
Seat 2: @joapnolasco ($2.01 in chips)
Seat 3: Ipkizz ($2 in chips)
Seat 4: GVcH_vt ($2.07 in chips)
Seat 6: MrDonRich ($4.49 in chips)
@joapnolasco: posts small blind $0.01
Ipkizz: posts big blind $0.02
*** HOLE CARDS ***
GVcH_vt: calls $0.02
MrDonRich: calls $0.02
chxxxs: folds
@joapnolasco: folds
Ipkizz: raises $0.08 to $0.10
GVcH_vt: calls $0.08
MrDonRich: folds
*** FLOP *** [5c 8s 9h]
Ipkizz: checks
GVcH_vt: checks
*** TURN *** [5c 8s 9h] [8c]
Ipkizz: bets $0.16
GVcH_vt: folds
Uncalled bet ($0.16) returned to Ipkizz
Ipkizz collected $0.22 from pot
Ipkizz: doesn't show hand
*** SUMMARY ***
Total pot $0.23 | Rake $0.01
Board [5c 8s 9h 8c]
Seat 1: chxxxs (button) folded before Flop (didn't bet)
Seat 2: @joapnolasco (small blind) folded before Flop
Seat 3: Ipkizz (big blind) collected ($0.22)
Seat 4: GVcH_vt folded on the Turn
Seat 6: MrDonRich folded before Flop


PokerStars Hand #238176142868:  Hold'em No Limit ($0.01/$0.02 USD) - 2022/08/23 17:45:37 ET
Table 'Equinox IV' 6-max Seat #2 is the button
Seat 1: chxxxs ($3.38 in chips)
Seat 2: @joapnolasco ($2 in chips)
Seat 3: Ipkizz ($2.12 in chips)
Seat 4: GVcH_vt ($2 in chips)
Seat 6: MrDonRich ($4.47 in chips)
Ipkizz: posts small blind $0.01
GVcH_vt: posts big blind $0.02
*** HOLE CARDS ***
MrDonRich: folds
chxxxs: raises $0.03 to $0.05
@joapnolasco: folds
Ipkizz: folds
GVcH_vt: calls $0.03
*** FLOP *** [2d 9c 5c]
GVcH_vt: checks
chxxxs: bets $0.05
GVcH_vt: folds
Uncalled bet ($0.05) returned to chxxxs
chxxxs collected $0.11 from pot
chxxxs: doesn't show hand
*** SUMMARY ***
Total pot $0.11 | Rake $0
Board [2d 9c 5c]
Seat 1: chxxxs collected ($0.11)
Seat 2: @joapnolasco (button) folded before Flop (didn't bet)
Seat 3: Ipkizz (small blind) folded before Flop
Seat 4: GVcH_vt (big blind) folded on the Flop
Seat 6: MrDonRich folded before Flop (didn't bet)


PokerStars Hand #238176152960:  Hold'em No Limit ($0.01/$0.02 USD) - 2022/08/23 17:46:06 ET
Table 'Equinox IV' 6-max Seat #3 is the button
Seat 1: chxxxs ($3.44 in chips)
Seat 2: @joapnolasco ($2 in chips)
Seat 3: Ipkizz ($2.11 in chips)
Seat 4: GVcH_vt ($2 in chips)
Seat 6: MrDonRich ($4.47 in chips)
GVcH_vt: posts small blind $0.01
MrDonRich: posts big blind $0.02
*** HOLE CARDS ***
chxxxs: folds
@joapnolasco: folds
Ipkizz: raises $0.02 to $0.04
GVcH_vt: raises $0.08 to $0.12
MrDonRich: calls $0.10
Ipkizz: folds
*** FLOP *** [2c 5s Td]
GVcH_vt: bets $0.22
MrDonRich: calls $0.22
*** TURN *** [2c 5s Td] [Jd]
GVcH_vt: bets $0.18
MrDonRich: raises $0.52 to $0.70
GVcH_vt: folds
Uncalled bet ($0.52) returned to MrDonRich
MrDonRich collected $1.04 from pot
MrDonRich: doesn't show hand
*** SUMMARY ***
Total pot $1.08 | Rake $0.04
Board [2c 5s Td Jd]
Seat 1: chxxxs folded before Flop (didn't bet)
Seat 2: @joapnolasco folded before Flop (didn't bet)
Seat 3: Ipkizz (button) folded before Flop
Seat 4: GVcH_vt (small blind) folded on the Turn
Seat 6: MrDonRich (big blind) collected ($1.04)


PokerStars Hand #238176170887:  Hold'em No Limit ($0.01/$0.02 USD) - 2022/08/23 17:46:58 ET
Table 'Equinox IV' 6-max Seat #4 is the button
Seat 1: chxxxs ($3.44 in chips)
Seat 2: @joapnolasco ($2 in chips)
Seat 3: Ipkizz ($2.07 in chips)
Seat 4: GVcH_vt ($2 in chips)
Seat 6: MrDonRich ($4.99 in chips)
MrDonRich: posts small blind $0.01
chxxxs: posts big blind $0.02
*** HOLE CARDS ***
@joapnolasco: folds
Ipkizz: folds
GVcH_vt: raises $0.04 to $0.06
MrDonRich: folds
chxxxs: folds
Uncalled bet ($0.04) returned to GVcH_vt
GVcH_vt collected $0.05 from pot
*** SUMMARY ***
Total pot $0.05 | Rake $0
Seat 1: chxxxs (big blind) folded before Flop
Seat 2: @joapnolasco folded before Flop (didn't bet)
Seat 3: Ipkizz folded before Flop (didn't bet)
Seat 4: GVcH_vt (button) collected ($0.05)
Seat 6: MrDonRich (small blind) folded before Flop


PokerStars Hand #238176180963:  Hold'em No Limit ($0.01/$0.02 USD) - 2022/08/23 17:47:26 ET
Table 'Equinox IV' 6-max Seat #6 is the button
Seat 1: chxxxs ($3.42 in chips)
Seat 2: @joapnolasco ($2 in chips)
Seat 3: Ipkizz ($2.07 in chips)
Seat 4: GVcH_vt ($2.03 in chips)
Seat 6: MrDonRich ($4.98 in chips)
chxxxs: posts small blind $0.01
@joapnolasco: posts big blind $0.02
*** HOLE CARDS ***
Ipkizz: folds
GVcH_vt: folds
MrDonRich: folds
chxxxs: raises $0.03 to $0.05
@joapnolasco: calls $0.03
*** FLOP *** [9d 9c 3c]
chxxxs: checks
@joapnolasco: bets $0.08
chxxxs: raises $0.13 to $0.21
@joapnolasco: folds
Uncalled bet ($0.13) returned to chxxxs
chxxxs collected $0.25 from pot
chxxxs: doesn't show hand
*** SUMMARY ***
Total pot $0.26 | Rake $0.01
Board [9d 9c 3c]
Seat 1: chxxxs (small blind) collected ($0.25)
Seat 2: @joapnolasco (big blind) folded on the Flop
Seat 3: Ipkizz folded before Flop (didn't bet)
Seat 4: GVcH_vt folded before Flop (didn't bet)
Seat 6: MrDonRich (button) folded before Flop (didn't bet)


PokerStars Hand #238176223991:  Hold'em No Limit ($0.01/$0.02 USD) - 2022/08/23 17:49:30 ET
Table 'Equinox IV' 6-max Seat #2 is the button
Seat 1: chxxxs ($3.54 in chips)
Seat 2: @joapnolasco ($2.04 in chips)
Seat 4: GVcH_vt ($2.01 in chips)
Seat 6: MrDonRich ($4.96 in chips)
GVcH_vt: posts small blind $0.01
MrDonRich: posts big blind $0.02
*** HOLE CARDS ***
chxxxs: folds
@joapnolasco: folds
GVcH_vt: folds
Uncalled bet ($0.01) returned to MrDonRich
MrDonRich collected $0.02 from pot
MrDonRich: doesn't show hand
*** SUMMARY ***
Total pot $0.02 | Rake $0
Seat 1: chxxxs folded before Flop (didn't bet)
Seat 2: @joapnolasco (button) folded before Flop (didn't bet)
Seat 4: GVcH_vt (small blind) folded before Flop
Seat 6: MrDonRich (big blind) collected ($0.02)


PokerStars Hand #238176202003:  Hold'em No Limit ($0.01/$0.02 USD) - 2022/08/23 17:48:27 ET
Table 'Equinox IV' 6-max Seat #1 is the button
Seat 1: chxxxs ($3.54 in chips)
Seat 2: @joapnolasco ($2 in chips)
Seat 4: GVcH_vt ($2.03 in chips)
Seat 6: MrDonRich ($4.98 in chips)
@joapnolasco: posts small blind $0.01
Ipkizz: is sitting out
GVcH_vt: posts big blind $0.02
*** HOLE CARDS ***
Ipkizz leaves the table
MrDonRich: calls $0.02
chxxxs: folds
@joapnolasco: calls $0.01
GVcH_vt: checks
*** FLOP *** [Qh 7d Jc]
@joapnolasco: checks
GVcH_vt: checks
dodoMT22 joins the table at seat #3
MrDonRich: checks
*** TURN *** [Qh 7d Jc] [5s]
@joapnolasco: checks
GVcH_vt: checks
MrDonRich: checks
*** RIVER *** [Qh 7d Jc 5s] [Jh]
@joapnolasco: checks
GVcH_vt: checks
MrDonRich: checks
*** SHOW DOWN ***
@joapnolasco: shows [8c 8s] (two pair, Jacks and Eights)
GVcH_vt: mucks hand
MrDonRich: mucks hand
@joapnolasco collected $0.06 from pot
*** SUMMARY ***
Total pot $0.06 | Rake $0
Board [Qh 7d Jc 5s Jh]
Seat 1: chxxxs (button) folded before Flop (didn't bet)
Seat 2: @joapnolasco (small blind) showed [8c 8s] and won ($0.06) with two pair, Jacks and Eights
Seat 4: GVcH_vt (big blind) mucked
Seat 6: MrDonRich mucked


PokerStars Hand #238176226264:  Hold'em No Limit ($0.01/$0.02 USD) - 2022/08/23 17:49:37 ET
Table 'Equinox IV' 6-max Seat #4 is the button
Seat 1: chxxxs ($3.54 in chips)
Seat 2: @joapnolasco ($2.04 in chips)
Seat 3: dodoMT22 ($2 in chips)
Seat 4: GVcH_vt ($2 in chips)
Seat 6: MrDonRich ($4.97 in chips)
MrDonRich: posts small blind $0.01
chxxxs: posts big blind $0.02
dodoMT22: posts big blind $0.02
*** HOLE CARDS ***
@joapnolasco: folds
dodoMT22: checks
GVcH_vt: folds
MrDonRich: calls $0.01
chxxxs: checks
*** FLOP *** [2d Kh 4h]
MrDonRich: checks
chxxxs: checks
dodoMT22: checks
*** TURN *** [2d Kh 4h] [Tc]
MrDonRich: bets $0.04
chxxxs: calls $0.04
dodoMT22: calls $0.04
*** RIVER *** [2d Kh 4h Tc] [Js]
MrDonRich: checks
chxxxs: bets $0.05
dodoMT22: folds
MrDonRich: folds
Uncalled bet ($0.05) returned to chxxxs
chxxxs collected $0.17 from pot
chxxxs: doesn't show hand
*** SUMMARY ***
Total pot $0.18 | Rake $0.01
Board [2d Kh 4h Tc Js]
Seat 1: chxxxs (big blind) collected ($0.17)
Seat 2: @joapnolasco folded before Flop (didn't bet)
Seat 3: dodoMT22 folded on the River
Seat 4: GVcH_vt (button) folded before Flop (didn't bet)
Seat 6: MrDonRich (small blind) folded on the River


PokerStars Hand #238176247205:  Hold'em No Limit ($0.01/$0.02 USD) - 2022/08/23 17:50:30 ET
Table 'Equinox IV' 6-max Seat #6 is the button
Seat 1: chxxxs ($3.65 in chips)
Seat 3: dodoMT22 ($1.94 in chips)
Seat 4: GVcH_vt ($2 in chips)
Seat 6: MrDonRich ($4.91 in chips)
chxxxs: posts small blind $0.01
@joapnolasco: is sitting out
@joapnolasco leaves the table
dodoMT22: posts big blind $0.02
*** HOLE CARDS ***
GVcH_vt: folds
MrDonRich: calls $0.02
chxxxs: folds
dodoMT22: checks
*** FLOP *** [Js 2h 6s]
dodoMT22: checks
MrDonRich: checks
*** TURN *** [Js 2h 6s] [9h]
dodoMT22: checks
lov35layer joins the table at seat #2
MrDonRich: checks
*** RIVER *** [Js 2h 6s 9h] [8d]
dodoMT22: bets $0.02
MrDonRich: folds
Uncalled bet ($0.02) returned to dodoMT22
dodoMT22 collected $0.05 from pot
*** SUMMARY ***
Total pot $0.05 | Rake $0
Board [Js 2h 6s 9h 8d]
Seat 1: chxxxs (small blind) folded before Flop
Seat 3: dodoMT22 (big blind) collected ($0.05)
Seat 4: GVcH_vt folded before Flop (didn't bet)
Seat 6: MrDonRich (button) folded on the River


PokerStars Hand #238176267912:  Hold'em No Limit ($0.01/$0.02 USD) - 2022/08/23 17:51:10 ET
Table 'Equinox IV' 6-max Seat #1 is the button
Seat 1: chxxxs ($3.64 in chips)
Seat 3: dodoMT22 ($1.97 in chips)
Seat 4: GVcH_vt ($2 in chips)
Seat 6: MrDonRich ($4.89 in chips)
dodoMT22: posts small blind $0.01
GVcH_vt: posts big blind $0.02
*** HOLE CARDS ***
MrDonRich: folds
chxxxs: folds
dodoMT22: calls $0.01
GVcH_vt: checks
*** FLOP *** [Jh 2d Js]
dodoMT22: checks
GVcH_vt: checks
*** TURN *** [Jh 2d Js] [3d]
dodoMT22: checks
GVcH_vt: checks
*** RIVER *** [Jh 2d Js 3d] [7h]
dodoMT22: checks
GVcH_vt: checks
*** SHOW DOWN ***
dodoMT22: shows [5c 3h] (two pair, Jacks and Threes)
GVcH_vt: mucks hand
dodoMT22 collected $0.04 from pot
*** SUMMARY ***
Total pot $0.04 | Rake $0
Board [Jh 2d Js 3d 7h]
Seat 1: chxxxs (button) folded before Flop (didn't bet)
Seat 3: dodoMT22 (small blind) showed [5c 3h] and won ($0.04) with two pair, Jacks and Threes
Seat 4: GVcH_vt (big blind) mucked
Seat 6: MrDonRich folded before Flop (didn't bet)


PokerStars Hand #238176280985:  Hold'em No Limit ($0.01/$0.02 USD) - 2022/08/23 17:51:48 ET
Table 'Equinox IV' 6-max Seat #3 is the button
Seat 1: chxxxs ($3.64 in chips)
Seat 3: dodoMT22 ($1.99 in chips)
Seat 4: GVcH_vt ($1.98 in chips)
Seat 6: MrDonRich ($4.89 in chips)
GVcH_vt: posts small blind $0.01
MrDonRich: posts big blind $0.02
lov35layer: sits out
*** HOLE CARDS ***
chxxxs: folds
dodoMT22: calls $0.02
GVcH_vt: folds
MrDonRich: checks
*** FLOP *** [5d 4h 8h]
MrDonRich: checks
dodoMT22: checks
*** TURN *** [5d 4h 8h] [As]
MrDonRich: checks
dodoMT22: checks
*** RIVER *** [5d 4h 8h As] [5h]
MrDonRich: checks
dodoMT22: checks
*** SHOW DOWN ***
MrDonRich: shows [2c Ts] (a pair of Fives)
dodoMT22: shows [4c Jd] (two pair, Fives and Fours)
dodoMT22 collected $0.05 from pot
SamuCao was removed from the table for failing to post
SamuCao leaves the table
*** SUMMARY ***
Total pot $0.05 | Rake $0
Board [5d 4h 8h As 5h]
Seat 1: chxxxs folded before Flop (didn't bet)
Seat 3: dodoMT22 (button) showed [4c Jd] and won ($0.05) with two pair, Fives and Fours
Seat 4: GVcH_vt (small blind) folded before Flop
Seat 6: MrDonRich (big blind) showed [2c Ts] and lost with a pair of Fives


PokerStars Hand #238176296469:  Hold'em No Limit ($0.01/$0.02 USD) - 2022/08/23 17:52:33 ET
Table 'Equinox IV' 6-max Seat #4 is the button
Seat 1: chxxxs ($3.64 in chips)
Seat 3: dodoMT22 ($2.02 in chips)
Seat 4: GVcH_vt ($2 in chips)
Seat 6: MrDonRich ($4.87 in chips)
MrDonRich: posts small blind $0.01
chxxxs: posts big blind $0.02
lov35layer: sits out
*** HOLE CARDS ***
dodoMT22: calls $0.02
Oparr joins the table at seat #5
GVcH_vt: folds
MrDonRich: folds
chxxxs: checks
*** FLOP *** [6c Kh Ad]
chxxxs: checks
dodoMT22: checks
*** TURN *** [6c Kh Ad] [2h]
chxxxs: checks
dodoMT22: checks
*** RIVER *** [6c Kh Ad 2h] [Kc]
chxxxs: checks
dodoMT22: checks
*** SHOW DOWN ***
chxxxs: shows [Jd 5s] (a pair of Kings)
dodoMT22: shows [9c Jh] (a pair of Kings - Ace+Jack+Nine kicker)
dodoMT22 collected $0.05 from pot
*** SUMMARY ***
Total pot $0.05 | Rake $0
Board [6c Kh Ad 2h Kc]
Seat 1: chxxxs (big blind) showed [Jd 5s] and lost with a pair of Kings
Seat 3: dodoMT22 showed [9c Jh] and won ($0.05) with a pair of Kings
Seat 4: GVcH_vt (button) folded before Flop (didn't bet)
Seat 6: MrDonRich (small blind) folded before Flop


PokerStars Hand #238176306265:  Hold'em No Limit ($0.01/$0.02 USD) - 2022/08/23 17:53:01 ET
Table 'Equinox IV' 6-max Seat #6 is the button
Seat 1: chxxxs ($3.62 in chips)
Seat 2: lov35layer ($2 in chips)
Seat 3: dodoMT22 ($2.05 in chips)
Seat 4: GVcH_vt ($2 in chips)
Seat 6: MrDonRich ($4.86 in chips)
chxxxs: posts small blind $0.01
lov35layer: posts big blind $0.02
Oparr: sits out
*** HOLE CARDS ***
dodoMT22: calls $0.02
GVcH_vt: folds
MrDonRich: calls $0.02
chxxxs: folds
lov35layer: checks
*** FLOP *** [Kd 4h 4s]
lov35layer: checks
dodoMT22: checks
MrDonRich: checks
*** TURN *** [Kd 4h 4s] [3c]
lov35layer: checks
dodoMT22: checks
MrDonRich: checks
*** RIVER *** [Kd 4h 4s 3c] [7c]
lov35layer: checks
dodoMT22: checks
MrDonRich: checks
*** SHOW DOWN ***
lov35layer: shows [9h Tc] (a pair of Fours)
dodoMT22: shows [3s Qc] (two pair, Fours and Threes)
MrDonRich: mucks hand
dodoMT22 collected $0.07 from pot
*** SUMMARY ***
Total pot $0.07 | Rake $0
Board [Kd 4h 4s 3c 7c]
Seat 1: chxxxs (small blind) folded before Flop
Seat 2: lov35layer (big blind) showed [9h Tc] and lost with a pair of Fours
Seat 3: dodoMT22 showed [3s Qc] and won ($0.07) with two pair, Fours and Threes
Seat 4: GVcH_vt folded before Flop (didn't bet)
Seat 6: MrDonRich (button) mucked


PokerStars Hand #238176318235:  Hold'em No Limit ($0.01/$0.02 USD) - 2022/08/23 17:53:36 ET
Table 'Equinox IV' 6-max Seat #1 is the button
Seat 1: chxxxs ($3.61 in chips)
Seat 2: lov35layer ($2 in chips)
Seat 3: dodoMT22 ($2.10 in chips)
Seat 4: GVcH_vt ($2 in chips)
Seat 6: MrDonRich ($4.84 in chips)
lov35layer: posts small blind $0.01
dodoMT22: posts big blind $0.02
Oparr: sits out
*** HOLE CARDS ***
GVcH_vt: folds
MrDonRich: folds
chxxxs: folds
lov35layer: folds
Uncalled bet ($0.01) returned to dodoMT22
dodoMT22 collected $0.02 from pot
*** SUMMARY ***
Total pot $0.02 | Rake $0
Seat 1: chxxxs (button) folded before Flop (didn't bet)
Seat 2: lov35layer (small blind) folded before Flop
Seat 3: dodoMT22 (big blind) collected ($0.02)
Seat 4: GVcH_vt folded before Flop (didn't bet)
Seat 6: MrDonRich folded before Flop (didn't bet)


PokerStars Hand #238176321415:  Hold'em No Limit ($0.01/$0.02 USD) - 2022/08/23 17:53:46 ET
Table 'Equinox IV' 6-max Seat #2 is the button
Seat 1: chxxxs ($3.61 in chips)
Seat 2: lov35layer ($2 in chips)
Seat 3: dodoMT22 ($2.11 in chips)
Seat 5: Oparr ($2 in chips)
Seat 6: MrDonRich ($4.84 in chips)
dodoMT22: posts small blind $0.01
GVcH_vt: is sitting out
Oparr: posts big blind $0.02
*** HOLE CARDS ***
MrDonRich: folds
chxxxs: folds
lov35layer: folds
dodoMT22: calls $0.01
Oparr: raises $0.04 to $0.06
dodoMT22: calls $0.04
*** FLOP *** [2h 7d Tc]
dodoMT22: checks
Oparr: bets $0.08
dodoMT22: calls $0.08
*** TURN *** [2h 7d Tc] [7c]
dodoMT22: checks
GVcH_vt leaves the table
Oparr: checks
*** RIVER *** [2h 7d Tc 7c] [3h]
dodoMT22: checks
Sam_Gold720 joins the table at seat #4
Oparr: bets $0.27
dodoMT22: folds
Uncalled bet ($0.27) returned to Oparr
Oparr collected $0.27 from pot
Oparr: doesn't show hand
*** SUMMARY ***
Total pot $0.28 | Rake $0.01
Board [2h 7d Tc 7c 3h]
Seat 1: chxxxs folded before Flop (didn't bet)
Seat 2: lov35layer (button) folded before Flop (didn't bet)
Seat 3: dodoMT22 (small blind) folded on the River
Seat 5: Oparr (big blind) collected ($0.27)
Seat 6: MrDonRich folded before Flop (didn't bet)


PokerStars Hand #238176336256:  Hold'em No Limit ($0.01/$0.02 USD) - 2022/08/23 17:54:30 ET
Table 'Equinox IV' 6-max Seat #3 is the button
Seat 1: chxxxs ($3.61 in chips)
Seat 2: lov35layer ($2 in chips)
Seat 3: dodoMT22 ($1.97 in chips)
Seat 5: Oparr ($2.13 in chips)
Seat 6: MrDonRich ($4.84 in chips)
Oparr: posts small blind $0.01
MrDonRich: posts big blind $0.02
*** HOLE CARDS ***
chxxxs: folds
lov35layer: folds
dodoMT22: calls $0.02
Oparr: folds
MrDonRich: checks
*** FLOP *** [Jh 9c 3d]
MrDonRich: checks
dodoMT22: bets $0.04
MrDonRich: calls $0.04
*** TURN *** [Jh 9c 3d] [2c]
MrDonRich: checks
dodoMT22: bets $0.04
MrDonRich: raises $0.10 to $0.14
dodoMT22: calls $0.10
*** RIVER *** [Jh 9c 3d 2c] [2h]
MrDonRich: bets $0.02
dodoMT22: calls $0.02
*** SHOW DOWN ***
MrDonRich: shows [3h Jc] (two pair, Jacks and Threes)
dodoMT22: mucks hand
MrDonRich collected $0.43 from pot
*** SUMMARY ***
Total pot $0.45 | Rake $0.02
Board [Jh 9c 3d 2c 2h]
Seat 1: chxxxs folded before Flop (didn't bet)
Seat 2: lov35layer folded before Flop (didn't bet)
Seat 3: dodoMT22 (button) mucked
Seat 5: Oparr (small blind) folded before Flop
Seat 6: MrDonRich (big blind) showed [3h Jc] and won ($0.43) with two pair, Jacks and Threes


PokerStars Hand #238176353462:  Hold'em No Limit ($0.01/$0.02 USD) - 2022/08/23 17:55:23 ET
Table 'Equinox IV' 6-max Seat #5 is the button
Seat 1: chxxxs ($3.61 in chips)
Seat 2: lov35layer ($2 in chips)
Seat 3: dodoMT22 ($1.75 in chips)
Seat 5: Oparr ($2.12 in chips)
Seat 6: MrDonRich ($5.05 in chips)
MrDonRich: posts small blind $0.01
chxxxs: posts big blind $0.02
Sam_Gold720: sits out
*** HOLE CARDS ***
lov35layer: folds
dodoMT22: calls $0.02
Oparr: raises $0.02 to $0.04
MrDonRich: calls $0.03
chxxxs: calls $0.02
dodoMT22: calls $0.02
*** FLOP *** [5h 2h 6c]
MrDonRich: checks
chxxxs: checks
dodoMT22: checks
Oparr: checks
*** TURN *** [5h 2h 6c] [6d]
MrDonRich: checks
chxxxs: checks
dodoMT22: bets $0.02
Oparr: folds
MrDonRich: calls $0.02
chxxxs: folds
*** RIVER *** [5h 2h 6c 6d] [4h]
MrDonRich: checks
dodoMT22: bets $0.10
MrDonRich: calls $0.10
*** SHOW DOWN ***
dodoMT22: shows [Jh 3s] (a straight, Deuce to Six)
MrDonRich: mucks hand
dodoMT22 collected $0.39 from pot
*** SUMMARY ***
Total pot $0.40 | Rake $0.01
Board [5h 2h 6c 6d 4h]
Seat 1: chxxxs (big blind) folded on the Turn
Seat 2: lov35layer folded before Flop (didn't bet)
Seat 3: dodoMT22 showed [Jh 3s] and won ($0.39) with a straight, Deuce to Six
Seat 5: Oparr (button) folded on the Turn
Seat 6: MrDonRich (small blind) mucked


PokerStars Hand #238176381738:  Hold'em No Limit ($0.01/$0.02 USD) - 2022/08/23 17:57:07 ET
Table 'Equinox IV' 6-max Seat #6 is the button
Seat 1: chxxxs ($3.57 in chips)
Seat 2: lov35layer ($2 in chips)
Seat 3: dodoMT22 ($1.98 in chips)
Seat 5: Oparr ($2.08 in chips)
Seat 6: MrDonRich ($4.89 in chips)
chxxxs: posts small blind $0.01
lov35layer: posts big blind $0.02
Sam_Gold720: sits out
*** HOLE CARDS ***
dodoMT22: folds
Oparr: folds
MrDonRich: folds
chxxxs: folds
Uncalled bet ($0.01) returned to lov35layer
lov35layer collected $0.02 from pot
lov35layer: doesn't show hand
*** SUMMARY ***
Total pot $0.02 | Rake $0
Seat 1: chxxxs (small blind) folded before Flop
Seat 2: lov35layer (big blind) collected ($0.02)
Seat 3: dodoMT22 folded before Flop (didn't bet)
Seat 5: Oparr folded before Flop (didn't bet)
Seat 6: MrDonRich (button) folded before Flop (didn't bet)


PokerStars Hand #238176385853:  Hold'em No Limit ($0.01/$0.02 USD) - 2022/08/23 17:57:22 ET
Table 'Equinox IV' 6-max Seat #1 is the button
Seat 1: chxxxs ($3.56 in chips)
Seat 2: lov35layer ($2.01 in chips)
Seat 3: dodoMT22 ($1.98 in chips)
Seat 5: Oparr ($2.08 in chips)
Seat 6: MrDonRich ($4.89 in chips)
lov35layer: posts small blind $0.01
dodoMT22: posts big blind $0.02
Sam_Gold720: sits out
*** HOLE CARDS ***
Oparr: raises $0.02 to $0.04
MrDonRich: folds
chxxxs: folds
lov35layer: folds
dodoMT22: calls $0.02
*** FLOP *** [3d 5s As]
dodoMT22: checks
Oparr: bets $0.10
dodoMT22: folds
Uncalled bet ($0.10) returned to Oparr
Oparr collected $0.09 from pot
*** SUMMARY ***
Total pot $0.09 | Rake $0
Board [3d 5s As]
Seat 1: chxxxs (button) folded before Flop (didn't bet)
Seat 2: lov35layer (small blind) folded before Flop
Seat 3: dodoMT22 (big blind) folded on the Flop
Seat 5: Oparr collected ($0.09)
Seat 6: MrDonRich folded before Flop (didn't bet)


PokerStars Hand #238176394596:  Hold'em No Limit ($0.01/$0.02 USD) - 2022/08/23 17:57:53 ET
Table 'Equinox IV' 6-max Seat #2 is the button
Seat 1: chxxxs ($3.56 in chips)
Seat 2: lov35layer ($2 in chips)
Seat 3: dodoMT22 ($1.94 in chips)
Seat 4: Sam_Gold720 ($2 in chips)
Seat 5: Oparr ($2.13 in chips)
Seat 6: MrDonRich ($4.89 in chips)
dodoMT22: posts small blind $0.01
Sam_Gold720: posts big blind $0.02
*** HOLE CARDS ***
Oparr: folds
MrDonRich: calls $0.02
chxxxs: folds
lov35layer: raises $0.06 to $0.08
dodoMT22: folds
Sam_Gold720: folds
MrDonRich: calls $0.06
*** FLOP *** [Ac 5s Ah]
MrDonRich: checks
lov35layer: bets $0.07
MrDonRich: folds
Uncalled bet ($0.07) returned to lov35layer
lov35layer collected $0.18 from pot
lov35layer: doesn't show hand
*** SUMMARY ***
Total pot $0.19 | Rake $0.01
Board [Ac 5s Ah]
Seat 1: chxxxs folded before Flop (didn't bet)
Seat 2: lov35layer (button) collected ($0.18)
Seat 3: dodoMT22 (small blind) folded before Flop
Seat 4: Sam_Gold720 (big blind) folded before Flop
Seat 5: Oparr folded before Flop (didn't bet)
Seat 6: MrDonRich folded on the Flop


PokerStars Hand #238176406464:  Hold'em No Limit ($0.01/$0.02 USD) - 2022/08/23 17:58:36 ET
Table 'Equinox IV' 6-max Seat #3 is the button
Seat 1: chxxxs ($3.56 in chips)
Seat 2: lov35layer ($2.10 in chips)
Seat 3: dodoMT22 ($1.93 in chips)
Seat 4: Sam_Gold720 ($2 in chips)
Seat 5: Oparr ($2.13 in chips)
Seat 6: MrDonRich ($4.81 in chips)
Sam_Gold720: posts small blind $0.01
Oparr: posts big blind $0.02
*** HOLE CARDS ***
MrDonRich: folds
chxxxs: folds
lov35layer: folds
dodoMT22: calls $0.02
Sam_Gold720: raises $0.07 to $0.09
Oparr: folds
dodoMT22: calls $0.07
*** FLOP *** [6h Ts 4c]
Sam_Gold720: checks
dodoMT22: bets $0.06
Sam_Gold720: calls $0.06
*** TURN *** [6h Ts 4c] [5h]
Sam_Gold720: checks
dodoMT22: bets $0.06
Sam_Gold720: calls $0.06
*** RIVER *** [6h Ts 4c 5h] [Jd]
Sam_Gold720: checks
dodoMT22: checks
*** SHOW DOWN ***
Sam_Gold720: shows [Kh Ah] (high card Ace)
dodoMT22: shows [Th 7c] (a pair of Tens)
dodoMT22 collected $0.42 from pot
*** SUMMARY ***
Total pot $0.44 | Rake $0.02
Board [6h Ts 4c 5h Jd]
Seat 1: chxxxs folded before Flop (didn't bet)
Seat 2: lov35layer folded before Flop (didn't bet)
Seat 3: dodoMT22 (button) showed [Th 7c] and won ($0.42) with a pair of Tens
Seat 4: Sam_Gold720 (small blind) showed [Kh Ah] and lost with high card Ace
Seat 5: Oparr (big blind) folded before Flop
Seat 6: MrDonRich folded before Flop (didn't bet)


PokerStars Hand #238176417704:  Hold'em No Limit ($0.01/$0.02 USD) - 2022/08/23 17:59:17 ET
Table 'Equinox IV' 6-max Seat #4 is the button
Seat 1: chxxxs ($3.56 in chips)
Seat 2: lov35layer ($2.10 in chips)
Seat 3: dodoMT22 ($2.14 in chips)
Seat 4: Sam_Gold720 ($2 in chips)
Seat 5: Oparr ($2.11 in chips)
Oparr: posts small blind $0.01
chxxxs: posts big blind $0.02
*** HOLE CARDS ***
lov35layer: folds
dodoMT22: calls $0.02
Sam_Gold720: folds
Oparr: raises $0.03 to $0.05
chxxxs: folds
dodoMT22: calls $0.03
*** FLOP *** [8s 7h 7c]
Oparr: checks
dodoMT22: checks
*** TURN *** [8s 7h 7c] [Qh]
Oparr: bets $0.06
dodoMT22: raises $0.06 to $0.12
Oparr: calls $0.06
*** RIVER *** [8s 7h 7c Qh] [4d]
Oparr: checks
dodoMT22: checks
*** SHOW DOWN ***
Oparr: shows [6h Ks] (a pair of Sevens)
dodoMT22: shows [4c 4h] (a full house, Fours full of Sevens)
dodoMT22 collected $0.35 from pot
*** SUMMARY ***
Total pot $0.36 | Rake $0.01
Board [8s 7h 7c Qh 4d]
Seat 1: chxxxs (big blind) folded before Flop
Seat 2: lov35layer folded before Flop (didn't bet)
Seat 3: dodoMT22 showed [4c 4h] and won ($0.35) with a full house, Fours full of Sevens
Seat 4: Sam_Gold720 (button) folded before Flop (didn't bet)
Seat 5: Oparr (small blind) showed [6h Ks] and lost with a pair of Sevens


PokerStars Hand #238176431309:  Hold'em No Limit ($0.01/$0.02 USD) - 2022/08/23 18:00:06 ET
Table 'Equinox IV' 6-max Seat #5 is the button
Seat 1: chxxxs ($3.54 in chips)
Seat 2: lov35layer ($2.10 in chips)
Seat 3: dodoMT22 ($2.32 in chips)
Seat 4: Sam_Gold720 ($2 in chips)
Seat 5: Oparr ($1.94 in chips)
chxxxs: posts small blind $0.01
lov35layer: posts big blind $0.02
*** HOLE CARDS ***
dodoMT22: calls $0.02
Sam_Gold720: folds
Oparr: folds
chxxxs: calls $0.01
lov35layer: checks
*** FLOP *** [Th Ac 4s]
chxxxs: checks
lov35layer: checks
dodoMT22: checks
*** TURN *** [Th Ac 4s] [9h]
chxxxs: checks
lov35layer: checks
dodoMT22: checks
*** RIVER *** [Th Ac 4s 9h] [6d]
chxxxs: checks
lov35layer: checks
dodoMT22: checks
*** SHOW DOWN ***
chxxxs: shows [Kd 9s] (a pair of Nines)
lov35layer: mucks hand
dodoMT22: mucks hand
chxxxs collected $0.06 from pot
*** SUMMARY ***
Total pot $0.06 | Rake $0
Board [Th Ac 4s 9h 6d]
Seat 1: chxxxs (small blind) showed [Kd 9s] and won ($0.06) with a pair of Nines
Seat 2: lov35layer (big blind) mucked
Seat 3: dodoMT22 mucked
Seat 4: Sam_Gold720 folded before Flop (didn't bet)
Seat 5: Oparr (button) folded before Flop (didn't bet)


PokerStars Hand #238176449911:  Hold'em No Limit ($0.01/$0.02 USD) - 2022/08/23 18:01:09 ET
Table 'Equinox IV' 6-max Seat #1 is the button
Seat 1: chxxxs ($3.58 in chips)
Seat 2: lov35layer ($2.08 in chips)
Seat 3: dodoMT22 ($2.30 in chips)
Seat 4: Sam_Gold720 ($2 in chips)
Seat 5: Oparr ($1.94 in chips)
lov35layer: posts small blind $0.01
dodoMT22: posts big blind $0.02
*** HOLE CARDS ***
Sam_Gold720: folds
Oparr: folds
chxxxs: folds
lov35layer: folds
Uncalled bet ($0.01) returned to dodoMT22
dodoMT22 collected $0.02 from pot
dodoMT22: doesn't show hand
*** SUMMARY ***
Total pot $0.02 | Rake $0
Seat 1: chxxxs (button) folded before Flop (didn't bet)
Seat 2: lov35layer (small blind) folded before Flop
Seat 3: dodoMT22 (big blind) collected ($0.02)
Seat 4: Sam_Gold720 folded before Flop (didn't bet)
Seat 5: Oparr folded before Flop (didn't bet)


PokerStars Hand #238176452882:  Hold'em No Limit ($0.01/$0.02 USD) - 2022/08/23 18:01:18 ET
Table 'Equinox IV' 6-max Seat #2 is the button
Seat 1: chxxxs ($3.58 in chips)
Seat 2: lov35layer ($2.07 in chips)
Seat 3: dodoMT22 ($2.31 in chips)
Seat 5: Oparr ($1.94 in chips)
dodoMT22: posts small blind $0.01
Sam_Gold720: is sitting out
Oparr: posts big blind $0.02
*** HOLE CARDS ***
chxxxs: folds
lov35layer: folds
dodoMT22: calls $0.01
Oparr: checks
*** FLOP *** [4c 7c 8h]
dodoMT22: checks
Oparr: checks
*** TURN *** [4c 7c 8h] [6d]
dodoMT22: checks
Oparr: checks
*** RIVER *** [4c 7c 8h 6d] [4h]
dodoMT22: checks
Oparr: checks
*** SHOW DOWN ***
dodoMT22: shows [Th Ac] (a pair of Fours)
Oparr: mucks hand
dodoMT22 collected $0.04 from pot
*** SUMMARY ***
Total pot $0.04 | Rake $0
Board [4c 7c 8h 6d 4h]
Seat 1: chxxxs folded before Flop (didn't bet)
Seat 2: lov35layer (button) folded before Flop (didn't bet)
Seat 3: dodoMT22 (small blind) showed [Th Ac] and won ($0.04) with a pair of Fours
Seat 5: Oparr (big blind) mucked


PokerStars Hand #238176463998:  Hold'em No Limit ($0.01/$0.02 USD) - 2022/08/23 18:01:53 ET
Table 'Equinox IV' 6-max Seat #3 is the button
Seat 1: chxxxs ($3.58 in chips)
Seat 2: lov35layer ($2.07 in chips)
Seat 3: dodoMT22 ($2.33 in chips)
Seat 5: Oparr ($1.92 in chips)
Oparr: posts small blind $0.01
chxxxs: posts big blind $0.02
*** HOLE CARDS ***
lov35layer: folds
dodoMT22: folds
Oparr: folds
Uncalled bet ($0.01) returned to chxxxs
chxxxs collected $0.02 from pot
chxxxs: doesn't show hand
*** SUMMARY ***
Total pot $0.02 | Rake $0
Seat 1: chxxxs (big blind) collected ($0.02)
Seat 2: lov35layer folded before Flop (didn't bet)
Seat 3: dodoMT22 (button) folded before Flop (didn't bet)
Seat 5: Oparr (small blind) folded before Flop


PokerStars Hand #238176467637:  Hold'em No Limit ($0.01/$0.02 USD) - 2022/08/23 18:02:03 ET
Table 'Equinox IV' 6-max Seat #5 is the button
Seat 1: chxxxs ($3.59 in chips)
Seat 2: lov35layer ($2.07 in chips)
Seat 3: dodoMT22 ($2.33 in chips)
Seat 5: Oparr ($1.91 in chips)
chxxxs: posts small blind $0.01
lov35layer: posts big blind $0.02
*** HOLE CARDS ***
dodoMT22: raises $0.02 to $0.04
Oparr: raises $0.02 to $0.06
chxxxs: folds
lov35layer: folds
dodoMT22: raises $0.08 to $0.14
Oparr: calls $0.08
*** FLOP *** [Tc 5c 7c]
dodoMT22: bets $1.12
Oparr: raises $0.65 to $1.77 and is all-in
dodoMT22: calls $0.65
*** TURN *** [Tc 5c 7c] [Qh]
*** RIVER *** [Tc 5c 7c Qh] [Qd]
*** SHOW DOWN ***
dodoMT22: shows [Kh Kd] (two pair, Kings and Queens)
Oparr: shows [Th Jh] (two pair, Queens and Tens)
dodoMT22 collected $3.72 from pot
*** SUMMARY ***
Total pot $3.85 | Rake $0.13
Board [Tc 5c 7c Qh Qd]
Seat 1: chxxxs (small blind) folded before Flop
Seat 2: lov35layer (big blind) folded before Flop
Seat 3: dodoMT22 showed [Kh Kd] and won ($3.72) with two pair, Kings and Queens
Seat 5: Oparr (button) showed [Th Jh] and lost with two pair, Queens and Tens


PokerStars Hand #238176480370:  Hold'em No Limit ($0.01/$0.02 USD) - 2022/08/23 18:02:42 ET
Table 'Equinox IV' 6-max Seat #1 is the button
Seat 1: chxxxs ($3.58 in chips)
Seat 2: lov35layer ($2.05 in chips)
Seat 3: dodoMT22 ($4.14 in chips)
lov35layer: posts small blind $0.01
dodoMT22: posts big blind $0.02
*** HOLE CARDS ***
chxxxs: folds
lov35layer: folds
Uncalled bet ($0.01) returned to dodoMT22
dodoMT22 collected $0.02 from pot
dodoMT22: doesn't show hand
*** SUMMARY ***
Total pot $0.02 | Rake $0
Seat 1: chxxxs (button) folded before Flop (didn't bet)
Seat 2: lov35layer (small blind) folded before Flop
Seat 3: dodoMT22 (big blind) collected ($0.02)


PokerStars Hand #238176482237:  Hold'em No Limit ($0.01/$0.02 USD) - 2022/08/23 18:02:47 ET
Table 'Equinox IV' 6-max Seat #2 is the button
Seat 1: chxxxs ($3.58 in chips)
Seat 2: lov35layer ($2.04 in chips)
Seat 3: dodoMT22 ($4.15 in chips)
Seat 5: Oparr ($2 in chips)
dodoMT22: posts small blind $0.01
Oparr: posts big blind $0.02
*** HOLE CARDS ***
chxxxs: folds
lov35layer: folds
dodoMT22: calls $0.01
Oparr: checks
*** FLOP *** [6s Ah 2c]
dodoMT22: checks
Oparr: checks
*** TURN *** [6s Ah 2c] [8c]
dodoMT22: bets $0.02
Oparr: folds
Uncalled bet ($0.02) returned to dodoMT22
dodoMT22 collected $0.04 from pot
dodoMT22: doesn't show hand
*** SUMMARY ***
Total pot $0.04 | Rake $0
Board [6s Ah 2c 8c]
Seat 1: chxxxs folded before Flop (didn't bet)
Seat 2: lov35layer (button) folded before Flop (didn't bet)
Seat 3: dodoMT22 (small blind) collected ($0.04)
Seat 5: Oparr (big blind) folded on the Turn


PokerStars Hand #238176493975:  Hold'em No Limit ($0.01/$0.02 USD) - 2022/08/23 18:03:22 ET
Table 'Equinox IV' 6-max Seat #5 is the button
Seat 1: chxxxs ($3.60 in chips)
Seat 2: lov35layer ($2.04 in chips)
Seat 3: dodoMT22 ($4.17 in chips)
Seat 5: Oparr ($1.96 in chips)
chxxxs: posts small blind $0.01
lov35layer: posts big blind $0.02
*** HOLE CARDS ***
dodoMT22: folds
Oparr: folds
chxxxs: folds
Uncalled bet ($0.01) returned to lov35layer
lov35layer collected $0.02 from pot
lov35layer: doesn't show hand
*** SUMMARY ***
Total pot $0.02 | Rake $0
Seat 1: chxxxs (small blind) folded before Flop
Seat 2: lov35layer (big blind) collected ($0.02)
Seat 3: dodoMT22 folded before Flop (didn't bet)
Seat 5: Oparr (button) folded before Flop (didn't bet)


PokerStars Hand #238176488726:  Hold'em No Limit ($0.01/$0.02 USD) - 2022/08/23 18:03:07 ET
Table 'Equinox IV' 6-max Seat #3 is the button
Seat 1: chxxxs ($3.58 in chips)
Seat 2: lov35layer ($2.04 in chips)
Seat 3: dodoMT22 ($4.17 in chips)
Seat 5: Oparr ($1.98 in chips)
Oparr: posts small blind $0.01
chxxxs: posts big blind $0.02
*** HOLE CARDS ***
lov35layer: folds
dodoMT22: folds
Oparr: calls $0.01
chxxxs: raises $0.06 to $0.08
Oparr: folds
Uncalled bet ($0.06) returned to chxxxs
chxxxs collected $0.04 from pot
chxxxs: doesn't show hand
*** SUMMARY ***
Total pot $0.04 | Rake $0
Seat 1: chxxxs (big blind) collected ($0.04)
Seat 2: lov35layer folded before Flop (didn't bet)
Seat 3: dodoMT22 (button) folded before Flop (didn't bet)
Seat 5: Oparr (small blind) folded before Flop


PokerStars Hand #238176496969:  Hold'em No Limit ($0.01/$0.02 USD) - 2022/08/23 18:03:31 ET
Table 'Equinox IV' 6-max Seat #1 is the button
Seat 1: chxxxs ($3.59 in chips)
Seat 2: lov35layer ($2.05 in chips)
Seat 3: dodoMT22 ($4.17 in chips)
Seat 5: Oparr ($1.96 in chips)
lov35layer: posts small blind $0.01
dodoMT22: posts big blind $0.02
*** HOLE CARDS ***
Oparr: calls $0.02
chxxxs: folds
lov35layer: folds
dodoMT22: raises $0.02 to $0.04
Oparr: calls $0.02
*** FLOP *** [7h Ts Jh]
dodoMT22: bets $0.02
Oparr: raises $0.04 to $0.06
dodoMT22: raises $0.04 to $0.10
Oparr: folds
Uncalled bet ($0.04) returned to dodoMT22
dodoMT22 collected $0.20 from pot
dodoMT22: doesn't show hand
*** SUMMARY ***
Total pot $0.21 | Rake $0.01
Board [7h Ts Jh]
Seat 1: chxxxs (button) folded before Flop (didn't bet)
Seat 2: lov35layer (small blind) folded before Flop
Seat 3: dodoMT22 (big blind) collected ($0.20)
Seat 5: Oparr folded on the Flop


PokerStars Hand #238176506909:  Hold'em No Limit ($0.01/$0.02 USD) - 2022/08/23 18:04:00 ET
Table 'Equinox IV' 6-max Seat #2 is the button
Seat 1: chxxxs ($3.59 in chips)
Seat 2: lov35layer ($2.04 in chips)
Seat 3: dodoMT22 ($4.27 in chips)
Seat 5: Oparr ($1.86 in chips)
dodoMT22: posts small blind $0.01
Oparr: posts big blind $0.02
*** HOLE CARDS ***
chxxxs: folds
lov35layer: folds
dodoMT22: calls $0.01
Oparr: checks
*** FLOP *** [4d 8c 6h]
dodoMT22: bets $0.02
Oparr: calls $0.02
*** TURN *** [4d 8c 6h] [5s]
dodoMT22: bets $0.02
Oparr: raises $0.18 to $0.20
dodoMT22: folds
Uncalled bet ($0.18) returned to Oparr
Oparr collected $0.12 from pot
*** SUMMARY ***
Total pot $0.12 | Rake $0
Board [4d 8c 6h 5s]
Seat 1: chxxxs folded before Flop (didn't bet)
Seat 2: lov35layer (button) folded before Flop (didn't bet)
Seat 3: dodoMT22 (small blind) folded on the Turn
Seat 5: Oparr (big blind) collected ($0.12)


PokerStars Hand #238176516093:  Hold'em No Limit ($0.01/$0.02 USD) - 2022/08/23 18:04:28 ET
Table 'Equinox IV' 6-max Seat #3 is the button
Seat 1: chxxxs ($3.59 in chips)
Seat 2: lov35layer ($2.04 in chips)
Seat 3: dodoMT22 ($4.21 in chips)
Seat 5: Oparr ($1.92 in chips)
Oparr: posts small blind $0.01
chxxxs: posts big blind $0.02
*** HOLE CARDS ***
lov35layer: folds
dodoMT22: calls $0.02
Oparr: calls $0.01
chxxxs: checks
*** FLOP *** [Tc 4h 4c]
Oparr: checks
chxxxs: checks
dodoMT22: checks
*** TURN *** [Tc 4h 4c] [4d]
Oparr: checks
chxxxs: checks
dodoMT22: checks
*** RIVER *** [Tc 4h 4c 4d] [Jc]
Oparr: bets $0.04
chxxxs: folds
dodoMT22: folds
Uncalled bet ($0.04) returned to Oparr
Oparr collected $0.06 from pot
*** SUMMARY ***
Total pot $0.06 | Rake $0
Board [Tc 4h 4c 4d Jc]
Seat 1: chxxxs (big blind) folded on the River
Seat 2: lov35layer folded before Flop (didn't bet)
Seat 3: dodoMT22 (button) folded on the River
Seat 5: Oparr (small blind) collected ($0.06)


PokerStars Hand #238176532696:  Hold'em No Limit ($0.01/$0.02 USD) - 2022/08/23 18:05:17 ET
Table 'Equinox IV' 6-max Seat #5 is the button
Seat 1: chxxxs ($3.57 in chips)
Seat 2: lov35layer ($2.04 in chips)
Seat 3: dodoMT22 ($4.19 in chips)
Seat 5: Oparr ($1.96 in chips)
chxxxs: posts small blind $0.01
lov35layer: posts big blind $0.02
*** HOLE CARDS ***
dodoMT22: calls $0.02
Oparr: calls $0.02
chxxxs: folds
lov35layer: checks
*** FLOP *** [3d 7s 9c]
lov35layer: checks
dodoMT22: checks
Oparr: checks
*** TURN *** [3d 7s 9c] [2d]
lov35layer: checks
dodoMT22: bets $0.02
Oparr: folds
lov35layer: calls $0.02
*** RIVER *** [3d 7s 9c 2d] [Qs]
lov35layer: checks
dodoMT22: bets $0.08
lov35layer: folds
Uncalled bet ($0.08) returned to dodoMT22
dodoMT22 collected $0.11 from pot
dodoMT22: doesn't show hand
*** SUMMARY ***
Total pot $0.11 | Rake $0
Board [3d 7s 9c 2d Qs]
Seat 1: chxxxs (small blind) folded before Flop
Seat 2: lov35layer (big blind) folded on the River
Seat 3: dodoMT22 collected ($0.11)
Seat 5: Oparr (button) folded on the Turn


PokerStars Hand #238176545420:  Hold'em No Limit ($0.01/$0.02 USD) - 2022/08/23 18:05:55 ET
Table 'Equinox IV' 6-max Seat #1 is the button
Seat 1: chxxxs ($3.56 in chips)
Seat 2: lov35layer ($2 in chips)
Seat 3: dodoMT22 ($4.26 in chips)
Seat 5: Oparr ($1.94 in chips)
lov35layer: posts small blind $0.01
dodoMT22: posts big blind $0.02
MrDonRich: sits out
*** HOLE CARDS ***
Oparr: calls $0.02
chxxxs: folds
lov35layer: folds
dodoMT22: checks
*** FLOP *** [4d 3h 9h]
dodoMT22: checks
Oparr: checks
*** TURN *** [4d 3h 9h] [3d]
dodoMT22: checks
Oparr: checks
*** RIVER *** [4d 3h 9h 3d] [Qd]
dodoMT22: checks
Oparr: checks
*** SHOW DOWN ***
dodoMT22: shows [Tc 9c] (two pair, Nines and Threes)
Oparr: mucks hand
dodoMT22 collected $0.05 from pot
*** SUMMARY ***
Total pot $0.05 | Rake $0
Board [4d 3h 9h 3d Qd]
Seat 1: chxxxs (button) folded before Flop (didn't bet)
Seat 2: lov35layer (small blind) folded before Flop
Seat 3: dodoMT22 (big blind) showed [Tc 9c] and won ($0.05) with two pair, Nines and Threes
Seat 5: Oparr mucked


PokerStars Hand #238176555789:  Hold'em No Limit ($0.01/$0.02 USD) - 2022/08/23 18:06:25 ET
Table 'Equinox IV' 6-max Seat #2 is the button
Seat 1: chxxxs ($3.56 in chips)
Seat 2: lov35layer ($2 in chips)
Seat 3: dodoMT22 ($4.29 in chips)
Seat 5: Oparr ($1.92 in chips)
dodoMT22: posts small blind $0.01
Oparr: posts big blind $0.02
MrDonRich: sits out
*** HOLE CARDS ***
chxxxs: folds
lov35layer: folds
dodoMT22: calls $0.01
Oparr: raises $0.04 to $0.06
dodoMT22: calls $0.04
*** FLOP *** [Kd 9d 8s]
dodoMT22: checks
Oparr: bets $0.08
dodoMT22: calls $0.08
*** TURN *** [Kd 9d 8s] [7d]
dodoMT22: checks
Oparr: checks
*** RIVER *** [Kd 9d 8s 7d] [3d]
dodoMT22: checks
Oparr: checks
*** SHOW DOWN ***
dodoMT22: shows [8c 5d] (a flush, King high)
Oparr: mucks hand
dodoMT22 collected $0.27 from pot
Sam_Gold720 was removed from the table for failing to post
Sam_Gold720 leaves the table
*** SUMMARY ***
Total pot $0.28 | Rake $0.01
Board [Kd 9d 8s 7d 3d]
Seat 1: chxxxs folded before Flop (didn't bet)
Seat 2: lov35layer (button) folded before Flop (didn't bet)
Seat 3: dodoMT22 (small blind) showed [8c 5d] and won ($0.27) with a flush, King high
Seat 5: Oparr (big blind) mucked


PokerStars Hand #238176569750:  Hold'em No Limit ($0.01/$0.02 USD) - 2022/08/23 18:07:07 ET
Table 'Equinox IV' 6-max Seat #3 is the button
Seat 1: chxxxs ($3.56 in chips)
Seat 2: lov35layer ($2 in chips)
Seat 3: dodoMT22 ($4.42 in chips)
Seat 5: Oparr ($1.78 in chips)
Seat 6: MrDonRich ($4.81 in chips)
Oparr: posts small blind $0.01
MrDonRich: posts big blind $0.02
*** HOLE CARDS ***
chxxxs: folds
lov35layer: folds
luisinholepra joins the table at seat #4
dodoMT22: folds
Oparr: calls $0.01
dodoMT22 is disconnected
MrDonRich: checks
*** FLOP *** [6s 9c Qd]
Oparr: checks
MrDonRich: checks
*** TURN *** [6s 9c Qd] [6c]
Oparr: checks
MrDonRich: checks
*** RIVER *** [6s 9c Qd 6c] [Ts]
Oparr: checks
MrDonRich: bets $0.02
Oparr: folds
Uncalled bet ($0.02) returned to MrDonRich
MrDonRich collected $0.04 from pot
MrDonRich: doesn't show hand
*** SUMMARY ***
Total pot $0.04 | Rake $0
Board [6s 9c Qd 6c Ts]
Seat 1: chxxxs folded before Flop (didn't bet)
Seat 2: lov35layer folded before Flop (didn't bet)
Seat 3: dodoMT22 (button) folded before Flop (didn't bet)
Seat 5: Oparr (small blind) folded on the River
Seat 6: MrDonRich (big blind) collected ($0.04)


PokerStars Hand #238176582448:  Hold'em No Limit ($0.01/$0.02 USD) - 2022/08/23 18:07:45 ET
Table 'Equinox IV' 6-max Seat #5 is the button
Seat 1: chxxxs ($3.56 in chips)
Seat 2: lov35layer ($2 in chips)
Seat 3: dodoMT22 ($4.42 in chips)
Seat 4: luisinholepra ($0.82 in chips)
Seat 5: Oparr ($1.76 in chips)
Seat 6: MrDonRich ($4.83 in chips)
MrDonRich: posts small blind $0.01
chxxxs: posts big blind $0.02
luisinholepra: posts big blind $0.02
*** HOLE CARDS ***
lov35layer: folds
dodoMT22 has timed out while disconnected
dodoMT22: folds
luisinholepra: checks
Oparr: calls $0.02
MrDonRich: raises $0.08 to $0.10
chxxxs: folds
luisinholepra: calls $0.08
Oparr: folds
*** FLOP *** [Ac 7d Ts]
Oparr leaves the table
MrDonRich: bets $0.15
luisinholepra: folds
Uncalled bet ($0.15) returned to MrDonRich
MrDonRich collected $0.23 from pot
MrDonRich: doesn't show hand
*** SUMMARY ***
Total pot $0.24 | Rake $0.01
Board [Ac 7d Ts]
Seat 1: chxxxs (big blind) folded before Flop
Seat 2: lov35layer folded before Flop (didn't bet)
Seat 3: dodoMT22 folded before Flop (didn't bet)
Seat 4: luisinholepra folded on the Flop
Seat 5: Oparr (button) folded before Flop
Seat 6: MrDonRich (small blind) collected ($0.23)


PokerStars Hand #238176604755:  Hold'em No Limit ($0.01/$0.02 USD) - 2022/08/23 18:08:51 ET
Table 'Equinox IV' 6-max Seat #6 is the button
Seat 1: chxxxs ($3.54 in chips)
Seat 2: lov35layer ($2 in chips)
Seat 4: luisinholepra ($0.72 in chips)
Seat 6: MrDonRich ($4.96 in chips)
chxxxs: posts small blind $0.01
lov35layer: posts big blind $0.02
*** HOLE CARDS ***
luisinholepra: calls $0.02
MrDonRich: calls $0.02
chxxxs: folds
lov35layer: checks
*** FLOP *** [2h 6s 6h]
lov35layer: checks
luisinholepra: checks
Tallvey joins the table at seat #5
MrDonRich: checks
*** TURN *** [2h 6s 6h] [Td]
lov35layer: checks
luisinholepra: checks
MrDonRich: checks
*** RIVER *** [2h 6s 6h Td] [3d]
lov35layer: checks
luisinholepra: checks
MrDonRich: checks
*** SHOW DOWN ***
lov35layer: shows [7s Jd] (a pair of Sixes)
luisinholepra: shows [5d Qd] (a pair of Sixes - Queen kicker)
MrDonRich: mucks hand
luisinholepra collected $0.07 from pot
*** SUMMARY ***
Total pot $0.07 | Rake $0
Board [2h 6s 6h Td 3d]
Seat 1: chxxxs (small blind) folded before Flop
Seat 2: lov35layer (big blind) showed [7s Jd] and lost with a pair of Sixes
Seat 4: luisinholepra showed [5d Qd] and won ($0.07) with a pair of Sixes
Seat 6: MrDonRich (button) mucked


PokerStars Hand #238176616877:  Hold'em No Limit ($0.01/$0.02 USD) - 2022/08/23 18:09:28 ET
Table 'Equinox IV' 6-max Seat #1 is the button
Seat 1: chxxxs ($3.53 in chips)
Seat 2: lov35layer ($2 in chips)
Seat 4: luisinholepra ($0.77 in chips)
Seat 5: Tallvey ($1.60 in chips)
Seat 6: MrDonRich ($4.94 in chips)
lov35layer: posts small blind $0.01
luisinholepra: posts big blind $0.02
Tallvey: posts big blind $0.02
*** HOLE CARDS ***
Tallvey: checks
MrDonRich: calls $0.02
chxxxs: folds
lov35layer: folds
luisinholepra: checks
*** FLOP *** [Kh Td 2d]
luisinholepra: checks
Tallvey: checks
MrDonRich: bets $0.02
luisinholepra: calls $0.02
Tallvey: folds
*** TURN *** [Kh Td 2d] [Jd]
luisinholepra: checks
MrDonRich: checks
*** RIVER *** [Kh Td 2d Jd] [5s]
luisinholepra: bets $0.13
MrDonRich: folds
Uncalled bet ($0.13) returned to luisinholepra
luisinholepra collected $0.11 from pot
*** SUMMARY ***
Total pot $0.11 | Rake $0
Board [Kh Td 2d Jd 5s]
Seat 1: chxxxs (button) folded before Flop (didn't bet)
Seat 2: lov35layer (small blind) folded before Flop
Seat 4: luisinholepra (big blind) collected ($0.11)
Seat 5: Tallvey folded on the Flop (didn't bet)
Seat 6: MrDonRich folded on the River


PokerStars Hand #238176633154:  Hold'em No Limit ($0.01/$0.02 USD) - 2022/08/23 18:10:16 ET
Table 'Equinox IV' 6-max Seat #2 is the button
Seat 1: chxxxs ($3.53 in chips)
Seat 2: lov35layer ($2 in chips)
Seat 4: luisinholepra ($0.84 in chips)
Seat 5: Tallvey ($1.58 in chips)
Seat 6: MrDonRich ($4.90 in chips)
luisinholepra: posts small blind $0.01
Tallvey: posts big blind $0.02
*** HOLE CARDS ***
MrDonRich: calls $0.02
chxxxs: folds
lov35layer: folds
luisinholepra: calls $0.01
Tallvey: checks
*** FLOP *** [2h 6c 9c]
luisinholepra: checks
Tallvey: checks
MrDonRich: bets $0.04
luisinholepra: calls $0.04
Tallvey: folds
*** TURN *** [2h 6c 9c] [3c]
luisinholepra: checks
MrDonRich: checks
*** RIVER *** [2h 6c 9c 3c] [2s]
luisinholepra: checks
MrDonRich: checks
*** SHOW DOWN ***
luisinholepra: shows [Jh Kh] (a pair of Deuces)
MrDonRich: shows [9s 7s] (two pair, Nines and Deuces)
MrDonRich collected $0.14 from pot
*** SUMMARY ***
Total pot $0.14 | Rake $0
Board [2h 6c 9c 3c 2s]
Seat 1: chxxxs folded before Flop (didn't bet)
Seat 2: lov35layer (button) folded before Flop (didn't bet)
Seat 4: luisinholepra (small blind) showed [Jh Kh] and lost with a pair of Deuces
Seat 5: Tallvey (big blind) folded on the Flop
Seat 6: MrDonRich showed [9s 7s] and won ($0.14) with two pair, Nines and Deuces


PokerStars Hand #238176647513:  Hold'em No Limit ($0.01/$0.02 USD) - 2022/08/23 18:10:59 ET
Table 'Equinox IV' 6-max Seat #4 is the button
Seat 1: chxxxs ($3.53 in chips)
Seat 2: lov35layer ($2 in chips)
Seat 4: luisinholepra ($0.78 in chips)
Seat 5: Tallvey ($1.56 in chips)
Seat 6: MrDonRich ($4.98 in chips)
Tallvey: posts small blind $0.01
MrDonRich: posts big blind $0.02
*** HOLE CARDS ***
chxxxs: folds
lov35layer: folds
luisinholepra: raises $0.06 to $0.08
Tallvey: folds
MrDonRich: folds
Uncalled bet ($0.06) returned to luisinholepra
luisinholepra collected $0.05 from pot
*** SUMMARY ***
Total pot $0.05 | Rake $0
Seat 1: chxxxs folded before Flop (didn't bet)
Seat 2: lov35layer folded before Flop (didn't bet)
Seat 4: luisinholepra (button) collected ($0.05)
Seat 5: Tallvey (small blind) folded before Flop
Seat 6: MrDonRich (big blind) folded before Flop


PokerStars Hand #238176654401:  Hold'em No Limit ($0.01/$0.02 USD) - 2022/08/23 18:11:19 ET
Table 'Equinox IV' 6-max Seat #5 is the button
Seat 1: chxxxs ($3.53 in chips)
Seat 2: lov35layer ($2 in chips)
Seat 4: luisinholepra ($0.81 in chips)
Seat 5: Tallvey ($1.55 in chips)
Seat 6: MrDonRich ($4.96 in chips)
MrDonRich: posts small blind $0.01
chxxxs: posts big blind $0.02
*** HOLE CARDS ***
lov35layer: folds
luisinholepra: calls $0.02
Tallvey: folds
MrDonRich: calls $0.01
chxxxs: checks
*** FLOP *** [Jc 7c Ks]
MrDonRich: bets $0.04
chxxxs: folds
luisinholepra: calls $0.04
*** TURN *** [Jc 7c Ks] [3s]
MrDonRich: bets $0.09
luisinholepra: calls $0.09
*** RIVER *** [Jc 7c Ks 3s] [3h]
MrDonRich: bets $0.08
luisinholepra: calls $0.08
*** SHOW DOWN ***
MrDonRich: shows [Kc 9h] (two pair, Kings and Threes)
luisinholepra: mucks hand
MrDonRich collected $0.46 from pot
*** SUMMARY ***
Total pot $0.48 | Rake $0.02
Board [Jc 7c Ks 3s 3h]
Seat 1: chxxxs (big blind) folded on the Flop
Seat 2: lov35layer folded before Flop (didn't bet)
Seat 4: luisinholepra mucked
Seat 5: Tallvey (button) folded before Flop (didn't bet)
Seat 6: MrDonRich (small blind) showed [Kc 9h] and won ($0.46) with two pair, Kings and Threes


PokerStars Hand #238176665271:  Hold'em No Limit ($0.01/$0.02 USD) - 2022/08/23 18:11:52 ET
Table 'Equinox IV' 6-max Seat #6 is the button
Seat 1: chxxxs ($3.51 in chips)
Seat 2: lov35layer ($2 in chips)
Seat 4: luisinholepra ($0.58 in chips)
Seat 5: Tallvey ($1.55 in chips)
Seat 6: MrDonRich ($5.19 in chips)
chxxxs: posts small blind $0.01
lov35layer: posts big blind $0.02
*** HOLE CARDS ***
luisinholepra: calls $0.02
Tallvey: calls $0.02
MrDonRich: folds
chxxxs: folds
lov35layer: checks
*** FLOP *** [8h As Qh]
lov35layer: checks
luisinholepra: checks
Tallvey: checks
*** TURN *** [8h As Qh] [Kh]
lov35layer: checks
luisinholepra: checks
Tallvey: checks
*** RIVER *** [8h As Qh Kh] [3s]
lov35layer: checks
luisinholepra: checks
Tallvey: checks
*** SHOW DOWN ***
lov35layer: shows [4s Td] (high card Ace)
luisinholepra: shows [Th 2d] (high card Ace)
Tallvey: shows [Jc 6s] (high card Ace - King+Queen+Jack kicker)
Tallvey collected $0.07 from pot
*** SUMMARY ***
Total pot $0.07 | Rake $0
Board [8h As Qh Kh 3s]
Seat 1: chxxxs (small blind) folded before Flop
Seat 2: lov35layer (big blind) showed [4s Td] and lost with high card Ace
Seat 4: luisinholepra showed [Th 2d] and lost with high card Ace
Seat 5: Tallvey showed [Jc 6s] and won ($0.07) with high card Ace
Seat 6: MrDonRich (button) folded before Flop (didn't bet)


PokerStars Hand #238176680988:  Hold'em No Limit ($0.01/$0.02 USD) - 2022/08/23 18:12:26 ET
Table 'Equinox IV' 6-max Seat #1 is the button
Seat 1: chxxxs ($3.50 in chips)
Seat 2: lov35layer ($2 in chips)
Seat 4: luisinholepra ($0.56 in chips)
Seat 5: Tallvey ($1.60 in chips)
Seat 6: MrDonRich ($5.19 in chips)
lov35layer: posts small blind $0.01
luisinholepra: posts big blind $0.02
*** HOLE CARDS ***
Tallvey: folds
MrDonRich: calls $0.02
chxxxs: folds
lov35layer: folds
luisinholepra: checks
*** FLOP *** [Tc Kd 7d]
luisinholepra: checks
MrDonRich: bets $0.03
luisinholepra: calls $0.03
*** TURN *** [Tc Kd 7d] [Kh]
luisinholepra: checks
MrDonRich: checks
*** RIVER *** [Tc Kd 7d Kh] [Ks]
luisinholepra: checks
MrDonRich: checks
*** SHOW DOWN ***
luisinholepra: shows [Jd 4d] (three of a kind, Kings)
MrDonRich: mucks hand
luisinholepra collected $0.11 from pot
*** SUMMARY ***
Total pot $0.11 | Rake $0
Board [Tc Kd 7d Kh Ks]
Seat 1: chxxxs (button) folded before Flop (didn't bet)
Seat 2: lov35layer (small blind) folded before Flop
Seat 4: luisinholepra (big blind) showed [Jd 4d] and won ($0.11) with three of a kind, Kings
Seat 5: Tallvey folded before Flop (didn't bet)
Seat 6: MrDonRich mucked


PokerStars Hand #238176689877:  Hold'em No Limit ($0.01/$0.02 USD) - 2022/08/23 18:12:52 ET
Table 'Equinox IV' 6-max Seat #2 is the button
Seat 1: chxxxs ($3.50 in chips)
Seat 2: lov35layer ($2 in chips)
Seat 4: luisinholepra ($0.62 in chips)
Seat 5: Tallvey ($1.60 in chips)
Seat 6: MrDonRich ($5.14 in chips)
luisinholepra: posts small blind $0.01
Tallvey: posts big blind $0.02
*** HOLE CARDS ***
MrDonRich: folds
chxxxs: folds
lov35layer: folds
luisinholepra: calls $0.01
Tallvey: checks
*** FLOP *** [7h Kd Tc]
luisinholepra: checks
Tallvey: checks
*** TURN *** [7h Kd Tc] [8d]
luisinholepra: checks
Tallvey: checks
*** RIVER *** [7h Kd Tc 8d] [5h]
luisinholepra: checks
Tallvey: checks
*** SHOW DOWN ***
luisinholepra: shows [3c 5d] (a pair of Fives)
Tallvey: shows [5s 9c] (a pair of Fives - King+Ten+Nine kicker)
Tallvey collected $0.04 from pot
*** SUMMARY ***
Total pot $0.04 | Rake $0
Board [7h Kd Tc 8d 5h]
Seat 1: chxxxs folded before Flop (didn't bet)
Seat 2: lov35layer (button) folded before Flop (didn't bet)
Seat 4: luisinholepra (small blind) showed [3c 5d] and lost with a pair of Fives
Seat 5: Tallvey (big blind) showed [5s 9c] and won ($0.04) with a pair of Fives
Seat 6: MrDonRich folded before Flop (didn't bet)


PokerStars Hand #238176696892:  Hold'em No Limit ($0.01/$0.02 USD) - 2022/08/23 18:13:13 ET
Table 'Equinox IV' 6-max Seat #4 is the button
Seat 1: chxxxs ($3.50 in chips)
Seat 2: lov35layer ($2 in chips)
Seat 4: luisinholepra ($0.60 in chips)
Seat 5: Tallvey ($1.62 in chips)
Seat 6: MrDonRich ($5.14 in chips)
Tallvey: posts small blind $0.01
MrDonRich: posts big blind $0.02
*** HOLE CARDS ***
chxxxs: raises $0.03 to $0.05
lov35layer: folds
luisinholepra: calls $0.05
Tallvey: folds
MrDonRich: calls $0.03
*** FLOP *** [8s 4d 7s]
Tallvey leaves the table
MrDonRich: checks
Cardenasdias joins the table at seat #5
chxxxs: bets $0.08
luisinholepra: calls $0.08
MrDonRich: folds
*** TURN *** [8s 4d 7s] [Kd]
chxxxs: checks
luisinholepra: checks
*** RIVER *** [8s 4d 7s Kd] [Kh]
chxxxs: bets $0.21
luisinholepra: calls $0.21
*** SHOW DOWN ***
chxxxs: shows [Ks Ad] (three of a kind, Kings)
luisinholepra: shows [8c Qh] (two pair, Kings and Eights)
chxxxs collected $0.71 from pot
*** SUMMARY ***
Total pot $0.74 | Rake $0.03
Board [8s 4d 7s Kd Kh]
Seat 1: chxxxs showed [Ks Ad] and won ($0.71) with three of a kind, Kings
Seat 2: lov35layer folded before Flop (didn't bet)
Seat 4: luisinholepra (button) showed [8c Qh] and lost with two pair, Kings and Eights
Seat 5: Tallvey (small blind) folded before Flop
Seat 6: MrDonRich (big blind) folded on the Flop


PokerStars Hand #238176710505:  Hold'em No Limit ($0.01/$0.02 USD) - 2022/08/23 18:13:47 ET
Table 'Equinox IV' 6-max Seat #6 is the button
Seat 1: chxxxs ($3.87 in chips)
Seat 2: lov35layer ($2 in chips)
Seat 4: luisinholepra ($0.26 in chips)
Seat 5: Cardenasdias ($0.80 in chips)
Seat 6: MrDonRich ($5.09 in chips)
chxxxs: posts small blind $0.01
lov35layer: posts big blind $0.02
Cardenasdias: posts big blind $0.02
*** HOLE CARDS ***
luisinholepra: calls $0.02
Cardenasdias: checks
MrDonRich: folds
chxxxs: folds
lov35layer: checks
*** FLOP *** [Kh 6d 2c]
lov35layer: checks
luisinholepra: checks
Cardenasdias: checks
*** TURN *** [Kh 6d 2c] [Jc]
lov35layer: checks
luisinholepra: checks
Cardenasdias: checks
*** RIVER *** [Kh 6d 2c Jc] [5c]
lov35layer: checks
luisinholepra: checks
Cardenasdias: checks
*** SHOW DOWN ***
lov35layer: shows [As 2h] (a pair of Deuces)
luisinholepra: mucks hand
Cardenasdias: mucks hand
lov35layer collected $0.07 from pot
*** SUMMARY ***
Total pot $0.07 | Rake $0
Board [Kh 6d 2c Jc 5c]
Seat 1: chxxxs (small blind) folded before Flop
Seat 2: lov35layer (big blind) showed [As 2h] and won ($0.07) with a pair of Deuces
Seat 4: luisinholepra mucked
Seat 5: Cardenasdias mucked
Seat 6: MrDonRich (button) folded before Flop (didn't bet)


PokerStars Hand #238176720367:  Hold'em No Limit ($0.01/$0.02 USD) - 2022/08/23 18:14:17 ET
Table 'Equinox IV' 6-max Seat #1 is the button
Seat 1: chxxxs ($3.86 in chips)
Seat 2: lov35layer ($2.05 in chips)
Seat 4: luisinholepra ($0.24 in chips)
Seat 5: Cardenasdias ($0.78 in chips)
Seat 6: MrDonRich ($5.09 in chips)
lov35layer: posts small blind $0.01
luisinholepra: posts big blind $0.02
*** HOLE CARDS ***
Cardenasdias: folds
MrDonRich: folds
chxxxs: folds
lov35layer: raises $0.03 to $0.05
luisinholepra: calls $0.03
*** FLOP *** [6c 8d 5s]
lov35layer: checks
luisinholepra: checks
*** TURN *** [6c 8d 5s] [Td]
lov35layer: checks
luisinholepra: checks
*** RIVER *** [6c 8d 5s Td] [2c]
lov35layer: checks
luisinholepra: checks
*** SHOW DOWN ***
lov35layer: shows [Ks Qd] (high card King)
luisinholepra: mucks hand
lov35layer collected $0.10 from pot
*** SUMMARY ***
Total pot $0.10 | Rake $0
Board [6c 8d 5s Td 2c]
Seat 1: chxxxs (button) folded before Flop (didn't bet)
Seat 2: lov35layer (small blind) showed [Ks Qd] and won ($0.10) with high card King
Seat 4: luisinholepra (big blind) mucked
Seat 5: Cardenasdias folded before Flop (didn't bet)
Seat 6: MrDonRich folded before Flop (didn't bet)


PokerStars Hand #238176731249:  Hold'em No Limit ($0.01/$0.02 USD) - 2022/08/23 18:14:50 ET
Table 'Equinox IV' 6-max Seat #2 is the button
Seat 1: chxxxs ($3.86 in chips)
Seat 2: lov35layer ($2.10 in chips)
Seat 4: luisinholepra ($0.19 in chips)
Seat 5: Cardenasdias ($0.78 in chips)
Seat 6: MrDonRich ($5.09 in chips)
luisinholepra: posts small blind $0.01
Cardenasdias: posts big blind $0.02
*** HOLE CARDS ***
MrDonRich: folds
chxxxs: folds
lov35layer: folds
luisinholepra: raises $0.04 to $0.06
Cardenasdias: folds
Uncalled bet ($0.04) returned to luisinholepra
luisinholepra collected $0.04 from pot
*** SUMMARY ***
Total pot $0.04 | Rake $0
Seat 1: chxxxs folded before Flop (didn't bet)
Seat 2: lov35layer (button) folded before Flop (didn't bet)
Seat 4: luisinholepra (small blind) collected ($0.04)
Seat 5: Cardenasdias (big blind) folded before Flop
Seat 6: MrDonRich folded before Flop (didn't bet)


PokerStars Hand #238176751602:  Hold'em No Limit ($0.01/$0.02 USD) - 2022/08/23 18:15:52 ET
Table 'Equinox IV' 6-max Seat #5 is the button
Seat 1: chxxxs ($3.86 in chips)
Seat 2: lov35layer ($2.10 in chips)
Seat 4: luisinholepra ($0.19 in chips)
Seat 5: Cardenasdias ($0.75 in chips)
Seat 6: MrDonRich ($5.12 in chips)
MrDonRich: posts small blind $0.01
chxxxs: posts big blind $0.02
*** HOLE CARDS ***
lov35layer: folds
luisinholepra: calls $0.02
Cardenasdias: folds
MrDonRich: calls $0.01
chxxxs: checks
*** FLOP *** [Ah Qd 3s]
MrDonRich: checks
chxxxs: checks
luisinholepra: checks
*** TURN *** [Ah Qd 3s] [4h]
MrDonRich: checks
chxxxs: checks
luisinholepra: checks
*** RIVER *** [Ah Qd 3s 4h] [Td]
MrDonRich: checks
chxxxs: checks
luisinholepra: checks
*** SHOW DOWN ***
MrDonRich: shows [6h 7d] (high card Ace)
chxxxs: shows [3h 2h] (a pair of Threes)
luisinholepra: shows [7h Tc] (a pair of Tens)
luisinholepra collected $0.06 from pot
*** SUMMARY ***
Total pot $0.06 | Rake $0
Board [Ah Qd 3s 4h Td]
Seat 1: chxxxs (big blind) showed [3h 2h] and lost with a pair of Threes
Seat 2: lov35layer folded before Flop (didn't bet)
Seat 4: luisinholepra showed [7h Tc] and won ($0.06) with a pair of Tens
Seat 5: Cardenasdias (button) folded before Flop (didn't bet)
Seat 6: MrDonRich (small blind) showed [6h 7d] and lost with high card Ace


PokerStars Hand #238176764812:  Hold'em No Limit ($0.01/$0.02 USD) - 2022/08/23 18:16:33 ET
Table 'Equinox IV' 6-max Seat #6 is the button
Seat 1: chxxxs ($3.84 in chips)
Seat 2: lov35layer ($2.10 in chips)
Seat 4: luisinholepra ($0.23 in chips)
Seat 5: Cardenasdias ($0.75 in chips)
Seat 6: MrDonRich ($5.10 in chips)
chxxxs: posts small blind $0.01
lov35layer: posts big blind $0.02
*** HOLE CARDS ***
luisinholepra: calls $0.02
Cardenasdias: folds
MrDonRich: raises $0.07 to $0.09
chxxxs: raises $0.20 to $0.29
lov35layer: folds
luisinholepra: folds
MrDonRich: calls $0.20
*** FLOP *** [Js Qc 3d]
chxxxs: bets $0.33
MrDonRich: folds
Uncalled bet ($0.33) returned to chxxxs
chxxxs collected $0.60 from pot
chxxxs: doesn't show hand
*** SUMMARY ***
Total pot $0.62 | Rake $0.02
Board [Js Qc 3d]
Seat 1: chxxxs (small blind) collected ($0.60)
Seat 2: lov35layer (big blind) folded before Flop
Seat 4: luisinholepra folded before Flop
Seat 5: Cardenasdias folded before Flop (didn't bet)
Seat 6: MrDonRich (button) folded on the Flop


PokerStars Hand #238176776176:  Hold'em No Limit ($0.01/$0.02 USD) - 2022/08/23 18:17:07 ET
Table 'Equinox IV' 6-max Seat #1 is the button
Seat 1: chxxxs ($4.15 in chips)
Seat 2: lov35layer ($2.08 in chips)
Seat 4: luisinholepra ($0.21 in chips)
Seat 5: Cardenasdias ($0.75 in chips)
Seat 6: MrDonRich ($4.81 in chips)
lov35layer: posts small blind $0.01
luisinholepra: posts big blind $0.02
*** HOLE CARDS ***
Cardenasdias: calls $0.02
MrDonRich: folds
chxxxs: folds
dodoMT22 was removed from the table for failing to post
dodoMT22 leaves the table
lov35layer: raises $0.08 to $0.10
luisinholepra: folds
Cardenasdias is disconnected
Cardenasdias has timed out while disconnected
Cardenasdias: folds
Uncalled bet ($0.08) returned to lov35layer
lov35layer collected $0.06 from pot
lov35layer: doesn't show hand
*** SUMMARY ***
Total pot $0.06 | Rake $0
Seat 1: chxxxs (button) folded before Flop (didn't bet)
Seat 2: lov35layer (small blind) collected ($0.06)
Seat 4: luisinholepra (big blind) folded before Flop
Seat 5: Cardenasdias folded before Flop
Seat 6: MrDonRich folded before Flop (didn't bet)


PokerStars Hand #238176800167:  Hold'em No Limit ($0.01/$0.02 USD) - 2022/08/23 18:18:07 ET
Table 'Equinox IV' 6-max Seat #2 is the button
Seat 1: chxxxs ($4.15 in chips)
Seat 2: lov35layer ($2.12 in chips)
Seat 4: luisinholepra ($0.19 in chips)
Seat 6: MrDonRich ($4.81 in chips)
luisinholepra: posts small blind $0.01
MrDonRich: posts big blind $0.02
*** HOLE CARDS ***
chxxxs: folds
lov35layer: folds
luisinholepra: calls $0.01
MrDonRich: checks
*** FLOP *** [4h Th Ad]
luisinholepra: checks
MrDonRich: checks
*** TURN *** [4h Th Ad] [As]
luisinholepra: checks
MrDonRich: checks
*** RIVER *** [4h Th Ad As] [3s]
luisinholepra: checks
MrDonRich: checks
*** SHOW DOWN ***
luisinholepra: shows [Qs Tc] (two pair, Aces and Tens)
MrDonRich: mucks hand
luisinholepra collected $0.04 from pot
*** SUMMARY ***
Total pot $0.04 | Rake $0
Board [4h Th Ad As 3s]
Seat 1: chxxxs folded before Flop (didn't bet)
Seat 2: lov35layer (button) folded before Flop (didn't bet)
Seat 4: luisinholepra (small blind) showed [Qs Tc] and won ($0.04) with two pair, Aces and Tens
Seat 6: MrDonRich (big blind) mucked


PokerStars Hand #238176809324:  Hold'em No Limit ($0.01/$0.02 USD) - 2022/08/23 18:18:36 ET
Table 'Equinox IV' 6-max Seat #4 is the button
Seat 1: chxxxs ($4.15 in chips)
Seat 2: lov35layer ($2.12 in chips)
Seat 4: luisinholepra ($0.21 in chips)
Seat 6: MrDonRich ($4.79 in chips)
MrDonRich: posts small blind $0.01
chxxxs: posts big blind $0.02
*** HOLE CARDS ***
lov35layer: folds
luisinholepra: calls $0.02
MrDonRich: folds
chxxxs: raises $0.08 to $0.10
luisinholepra: folds
Uncalled bet ($0.08) returned to chxxxs
chxxxs collected $0.05 from pot
chxxxs: doesn't show hand
*** SUMMARY ***
Total pot $0.05 | Rake $0
Seat 1: chxxxs (big blind) collected ($0.05)
Seat 2: lov35layer folded before Flop (didn't bet)
Seat 4: luisinholepra (button) folded before Flop
Seat 6: MrDonRich (small blind) folded before Flop


PokerStars Hand #238176820712:  Hold'em No Limit ($0.01/$0.02 USD) - 2022/08/23 18:18:50 ET
Table 'Equinox IV' 6-max Seat #6 is the button
Seat 1: chxxxs ($4.18 in chips)
Seat 2: lov35layer ($2.12 in chips)
Seat 4: luisinholepra ($0.19 in chips)
Seat 5: Cardenasdias ($0.73 in chips)
Seat 6: MrDonRich ($4.78 in chips)
chxxxs: posts small blind $0.01
lov35layer: posts big blind $0.02
Cardenasdias: posts small & big blinds $0.03
*** HOLE CARDS ***
luisinholepra: calls $0.02
Cardenasdias: raises $0.04 to $0.06
MrDonRich: raises $0.22 to $0.28
chxxxs: folds
lov35layer: folds
luisinholepra: folds
Cardenasdias: calls $0.22
*** FLOP *** [As 2c Jh]
Cardenasdias: checks
MrDonRich: bets $0.44
Cardenasdias: calls $0.44 and is all-in
*** TURN *** [As 2c Jh] [8c]
*** RIVER *** [As 2c Jh 8c] [5h]
*** SHOW DOWN ***
Cardenasdias: shows [7c Ah] (a pair of Aces)
MrDonRich: shows [Kc Ks] (a pair of Kings)
Cardenasdias collected $1.45 from pot
*** SUMMARY ***
Total pot $1.50 | Rake $0.05
Board [As 2c Jh 8c 5h]
Seat 1: chxxxs (small blind) folded before Flop
Seat 2: lov35layer (big blind) folded before Flop
Seat 4: luisinholepra folded before Flop
Seat 5: Cardenasdias showed [7c Ah] and won ($1.45) with a pair of Aces
Seat 6: MrDonRich (button) showed [Kc Ks] and lost with a pair of Kings


PokerStars Hand #238176837000:  Hold'em No Limit ($0.01/$0.02 USD) - 2022/08/23 18:19:39 ET
Table 'Equinox IV' 6-max Seat #1 is the button
Seat 1: chxxxs ($4.17 in chips)
Seat 2: lov35layer ($2.10 in chips)
Seat 4: luisinholepra ($0.17 in chips)
Seat 5: Cardenasdias ($1.45 in chips)
Seat 6: MrDonRich ($4.06 in chips)
lov35layer: posts small blind $0.01
luisinholepra: posts big blind $0.02
*** HOLE CARDS ***
Cardenasdias: folds
MrDonRich: raises $0.04 to $0.06
chxxxs: raises $0.15 to $0.21
lov35layer: folds
luisinholepra: calls $0.15 and is all-in
MrDonRich: calls $0.15
*** FLOP *** [Qs Ah 9s]
MrDonRich: checks
chxxxs: bets $0.32
MrDonRich: folds
Uncalled bet ($0.32) returned to chxxxs
*** TURN *** [Qs Ah 9s] [6d]
*** RIVER *** [Qs Ah 9s 6d] [8d]
*** SHOW DOWN ***
chxxxs: shows [7h 9h] (a pair of Nines)
chxxxs collected $0.08 from side pot
luisinholepra: shows [As Jd] (a pair of Aces)
luisinholepra collected $0.50 from main pot
*** SUMMARY ***
Total pot $0.60 Main pot $0.50. Side pot $0.08. | Rake $0.02
Board [Qs Ah 9s 6d 8d]
Seat 1: chxxxs (button) showed [7h 9h] and won ($0.08) with a pair of Nines
Seat 2: lov35layer (small blind) folded before Flop
Seat 4: luisinholepra (big blind) showed [As Jd] and won ($0.50) with a pair of Aces
Seat 5: Cardenasdias folded before Flop (didn't bet)
Seat 6: MrDonRich folded on the Flop


PokerStars Hand #238176849138:  Hold'em No Limit ($0.01/$0.02 USD) - 2022/08/23 18:20:17 ET
Table 'Equinox IV' 6-max Seat #2 is the button
Seat 1: chxxxs ($4.04 in chips)
Seat 2: lov35layer ($2.09 in chips)
Seat 4: luisinholepra ($0.50 in chips)
Seat 5: Cardenasdias ($1.45 in chips)
Seat 6: MrDonRich ($3.85 in chips)
luisinholepra: posts small blind $0.01
Cardenasdias: posts big blind $0.02
*** HOLE CARDS ***
MrDonRich: calls $0.02
cadbrasil joins the table at seat #3
chxxxs: folds
lov35layer: folds
luisinholepra: calls $0.01
Cardenasdias: checks
*** FLOP *** [Ah 9h 5h]
luisinholepra: checks
Cardenasdias: checks
MrDonRich: checks
*** TURN *** [Ah 9h 5h] [Kh]
luisinholepra: checks
Cardenasdias: bets $0.02
MrDonRich: folds
luisinholepra: raises $0.06 to $0.08
Cardenasdias: calls $0.06
*** RIVER *** [Ah 9h 5h Kh] [7s]
luisinholepra: bets $0.40 and is all-in
Cardenasdias: folds
Uncalled bet ($0.40) returned to luisinholepra
luisinholepra collected $0.21 from pot
*** SUMMARY ***
Total pot $0.22 | Rake $0.01
Board [Ah 9h 5h Kh 7s]
Seat 1: chxxxs folded before Flop (didn't bet)
Seat 2: lov35layer (button) folded before Flop (didn't bet)
Seat 4: luisinholepra (small blind) collected ($0.21)
Seat 5: Cardenasdias (big blind) folded on the River
Seat 6: MrDonRich folded on the Turn


PokerStars Hand #238176861994:  Hold'em No Limit ($0.01/$0.02 USD) - 2022/08/23 18:20:57 ET
Table 'Equinox IV' 6-max Seat #4 is the button
Seat 1: chxxxs ($4.04 in chips)
Seat 2: lov35layer ($2.09 in chips)
Seat 3: cadbrasil ($0.80 in chips)
Seat 4: luisinholepra ($0.61 in chips)
Seat 5: Cardenasdias ($1.35 in chips)
Seat 6: MrDonRich ($3.83 in chips)
Cardenasdias: posts small blind $0.01
MrDonRich: posts big blind $0.02
cadbrasil: posts big blind $0.02
*** HOLE CARDS ***
chxxxs: folds
lov35layer: folds
cadbrasil: checks
luisinholepra: calls $0.02
Cardenasdias: raises $0.08 to $0.10
MrDonRich: folds
cadbrasil: folds
luisinholepra: calls $0.08
*** FLOP *** [Th Jh 8h]
Cardenasdias: bets $0.02
luisinholepra: calls $0.02
*** TURN *** [Th Jh 8h] [Ac]
Cardenasdias: bets $0.02
luisinholepra: calls $0.02
*** RIVER *** [Th Jh 8h Ac] [Kd]
Cardenasdias: bets $0.02
luisinholepra: calls $0.02
*** SHOW DOWN ***
Cardenasdias: shows [Js 9c] (a pair of Jacks)
luisinholepra: shows [6s Ks] (a pair of Kings)
luisinholepra collected $0.35 from pot
*** SUMMARY ***
Total pot $0.36 | Rake $0.01
Board [Th Jh 8h Ac Kd]
Seat 1: chxxxs folded before Flop (didn't bet)
Seat 2: lov35layer folded before Flop (didn't bet)
Seat 3: cadbrasil folded before Flop (didn't bet)
Seat 4: luisinholepra (button) showed [6s Ks] and won ($0.35) with a pair of Kings
Seat 5: Cardenasdias (small blind) showed [Js 9c] and lost with a pair of Jacks
Seat 6: MrDonRich (big blind) folded before Flop


PokerStars Hand #238176871126:  Hold'em No Limit ($0.01/$0.02 USD) - 2022/08/23 18:21:25 ET
Table 'Equinox IV' 6-max Seat #5 is the button
Seat 1: chxxxs ($4.04 in chips)
Seat 2: lov35layer ($2.09 in chips)
Seat 3: cadbrasil ($0.78 in chips)
Seat 4: luisinholepra ($0.80 in chips)
Seat 5: Cardenasdias ($1.19 in chips)
Seat 6: MrDonRich ($3.81 in chips)
MrDonRich: posts small blind $0.01
chxxxs: posts big blind $0.02
*** HOLE CARDS ***
lov35layer: raises $0.04 to $0.06
cadbrasil: calls $0.06
luisinholepra: calls $0.06
Cardenasdias: calls $0.06
MrDonRich: folds
chxxxs: folds
*** FLOP *** [4d 8h 5c]
lov35layer: checks
cadbrasil: checks
luisinholepra: checks
Cardenasdias: checks
*** TURN *** [4d 8h 5c] [2c]
lov35layer: checks
cadbrasil: checks
luisinholepra: checks
Cardenasdias: checks
*** RIVER *** [4d 8h 5c 2c] [6h]
lov35layer: checks
cadbrasil: checks
luisinholepra: bets $0.04
Cardenasdias: folds
lov35layer: folds
cadbrasil: folds
Uncalled bet ($0.04) returned to luisinholepra
luisinholepra collected $0.26 from pot
*** SUMMARY ***
Total pot $0.27 | Rake $0.01
Board [4d 8h 5c 2c 6h]
Seat 1: chxxxs (big blind) folded before Flop
Seat 2: lov35layer folded on the River
Seat 3: cadbrasil folded on the River
Seat 4: luisinholepra collected ($0.26)
Seat 5: Cardenasdias (button) folded on the River
Seat 6: MrDonRich (small blind) folded before Flop


PokerStars Hand #238176883828:  Hold'em No Limit ($0.01/$0.02 USD) - 2022/08/23 18:22:05 ET
Table 'Equinox IV' 6-max Seat #6 is the button
Seat 1: chxxxs ($4.02 in chips)
Seat 2: lov35layer ($2.03 in chips)
Seat 3: cadbrasil ($0.72 in chips)
Seat 4: luisinholepra ($1 in chips)
Seat 5: Cardenasdias ($1.13 in chips)
Seat 6: MrDonRich ($3.80 in chips)
chxxxs: posts small blind $0.01
lov35layer: posts big blind $0.02
*** HOLE CARDS ***
cadbrasil: folds
luisinholepra: calls $0.02
Cardenasdias: folds
MrDonRich: calls $0.02
chxxxs: calls $0.01
lov35layer: checks
*** FLOP *** [2c Ks 9c]
chxxxs: checks
lov35layer: checks
luisinholepra: checks
MrDonRich: checks
*** TURN *** [2c Ks 9c] [8s]
chxxxs: checks
lov35layer: checks
luisinholepra: checks
MrDonRich: bets $0.08
chxxxs: calls $0.08
lov35layer: folds
luisinholepra: calls $0.08
*** RIVER *** [2c Ks 9c 8s] [Kc]
chxxxs: checks
luisinholepra: checks
MrDonRich: checks
*** SHOW DOWN ***
chxxxs: shows [Jc Qh] (a pair of Kings)
luisinholepra: shows [7s As] (a pair of Kings - Ace kicker)
MrDonRich: shows [9d 8d] (two pair, Kings and Nines)
MrDonRich collected $0.31 from pot
*** SUMMARY ***
Total pot $0.32 | Rake $0.01
Board [2c Ks 9c 8s Kc]
Seat 1: chxxxs (small blind) showed [Jc Qh] and lost with a pair of Kings
Seat 2: lov35layer (big blind) folded on the Turn
Seat 3: cadbrasil folded before Flop (didn't bet)
Seat 4: luisinholepra showed [7s As] and lost with a pair of Kings
Seat 5: Cardenasdias folded before Flop (didn't bet)
Seat 6: MrDonRich (button) showed [9d 8d] and won ($0.31) with two pair, Kings and Nines


PokerStars Hand #238176901584:  Hold'em No Limit ($0.01/$0.02 USD) - 2022/08/23 18:23:00 ET
Table 'Equinox IV' 6-max Seat #1 is the button
Seat 1: chxxxs ($3.92 in chips)
Seat 2: lov35layer ($2.01 in chips)
Seat 3: cadbrasil ($0.72 in chips)
Seat 4: luisinholepra ($0.90 in chips)
Seat 5: Cardenasdias ($1.13 in chips)
Seat 6: MrDonRich ($4.01 in chips)
lov35layer: posts small blind $0.01
cadbrasil: posts big blind $0.02
*** HOLE CARDS ***
luisinholepra: folds
luisinholepra leaves the table
Cardenasdias: calls $0.02
MrDonRich: folds
chxxxs: folds
lov35layer: folds
cadbrasil: checks
*** FLOP *** [Jh 2c 6s]
IamKeOpS joins the table at seat #4
cadbrasil: checks
Cardenasdias: bets $0.02
cadbrasil: calls $0.02
*** TURN *** [Jh 2c 6s] [Ah]
cadbrasil: checks
Cardenasdias: checks
*** RIVER *** [Jh 2c 6s Ah] [Ad]
cadbrasil: checks
Cardenasdias: bets $0.09
cadbrasil: calls $0.09
*** SHOW DOWN ***
Cardenasdias: shows [5d 7d] (a pair of Aces)
cadbrasil: shows [6c Jd] (two pair, Aces and Jacks)
cadbrasil collected $0.26 from pot
*** SUMMARY ***
Total pot $0.27 | Rake $0.01
Board [Jh 2c 6s Ah Ad]
Seat 1: chxxxs (button) folded before Flop (didn't bet)
Seat 2: lov35layer (small blind) folded before Flop
Seat 3: cadbrasil (big blind) showed [6c Jd] and won ($0.26) with two pair, Aces and Jacks
Seat 4: luisinholepra folded before Flop (didn't bet)
Seat 5: Cardenasdias showed [5d 7d] and lost with a pair of Aces
Seat 6: MrDonRich folded before Flop (didn't bet)


PokerStars Hand #238176913121:  Hold'em No Limit ($0.01/$0.02 USD) - 2022/08/23 18:23:36 ET
Table 'Equinox IV' 6-max Seat #2 is the button
Seat 1: chxxxs ($3.92 in chips)
Seat 2: lov35layer ($2 in chips)
Seat 3: cadbrasil ($0.85 in chips)
Seat 4: IamKeOpS ($2 in chips)
Seat 5: Cardenasdias ($1 in chips)
Seat 6: MrDonRich ($4.01 in chips)
cadbrasil: posts small blind $0.01
IamKeOpS: posts big blind $0.02
*** HOLE CARDS ***
Cardenasdias: raises $0.98 to $1 and is all-in
MrDonRich: folds
chxxxs: folds
lov35layer: folds
cadbrasil: folds
IamKeOpS: folds
Uncalled bet ($0.98) returned to Cardenasdias
Cardenasdias collected $0.05 from pot
*** SUMMARY ***
Total pot $0.05 | Rake $0
Seat 1: chxxxs folded before Flop (didn't bet)
Seat 2: lov35layer (button) folded before Flop (didn't bet)
Seat 3: cadbrasil (small blind) folded before Flop
Seat 4: IamKeOpS (big blind) folded before Flop
Seat 5: Cardenasdias collected ($0.05)
Seat 6: MrDonRich folded before Flop (didn't bet)


PokerStars Hand #238176920170:  Hold'em No Limit ($0.01/$0.02 USD) - 2022/08/23 18:23:58 ET
Table 'Equinox IV' 6-max Seat #3 is the button
Seat 1: chxxxs ($3.92 in chips)
Seat 2: lov35layer ($2 in chips)
Seat 3: cadbrasil ($0.84 in chips)
Seat 4: IamKeOpS ($1.98 in chips)
Seat 5: Cardenasdias ($1.03 in chips)
Seat 6: MrDonRich ($4.01 in chips)
IamKeOpS: posts small blind $0.01
Cardenasdias: posts big blind $0.02
*** HOLE CARDS ***
MrDonRich: folds
chxxxs: raises $0.04 to $0.06
lov35layer: folds
cadbrasil: folds
IamKeOpS: folds
Cardenasdias: calls $0.04
*** FLOP *** [6d 2h Ac]
Cardenasdias: checks
chxxxs: checks
*** TURN *** [6d 2h Ac] [Kc]
Cardenasdias: checks
chxxxs: bets $0.06
Cardenasdias: raises $0.06 to $0.12
chxxxs: calls $0.06
*** RIVER *** [6d 2h Ac Kc] [6c]
Cardenasdias: bets $0.85 and is all-in
chxxxs: calls $0.85
*** SHOW DOWN ***
Cardenasdias: shows [6s Kh] (a full house, Sixes full of Kings)
chxxxs: shows [Ad Js] (two pair, Aces and Sixes)
Cardenasdias collected $2 from pot
*** SUMMARY ***
Total pot $2.07 | Rake $0.07
Board [6d 2h Ac Kc 6c]
Seat 1: chxxxs showed [Ad Js] and lost with two pair, Aces and Sixes
Seat 2: lov35layer folded before Flop (didn't bet)
Seat 3: cadbrasil (button) folded before Flop (didn't bet)
Seat 4: IamKeOpS (small blind) folded before Flop
Seat 5: Cardenasdias (big blind) showed [6s Kh] and won ($2) with a full house, Sixes full of Kings
Seat 6: MrDonRich folded before Flop (didn't bet)


PokerStars Hand #238176930114:  Hold'em No Limit ($0.01/$0.02 USD) - 2022/08/23 18:24:29 ET
Table 'Equinox IV' 6-max Seat #4 is the button
Seat 1: chxxxs ($2.89 in chips)
Seat 2: lov35layer ($2 in chips)
Seat 3: cadbrasil ($0.84 in chips)
Seat 4: IamKeOpS ($2 in chips)
Seat 5: Cardenasdias ($2 in chips)
Seat 6: MrDonRich ($4.01 in chips)
Cardenasdias: posts small blind $0.01
MrDonRich: posts big blind $0.02
*** HOLE CARDS ***
chxxxs: folds
lov35layer: folds
cadbrasil: folds
IamKeOpS: folds
Cardenasdias: raises $0.02 to $0.04
MrDonRich: folds
Uncalled bet ($0.02) returned to Cardenasdias
Cardenasdias collected $0.04 from pot
*** SUMMARY ***
Total pot $0.04 | Rake $0
Seat 1: chxxxs folded before Flop (didn't bet)
Seat 2: lov35layer folded before Flop (didn't bet)
Seat 3: cadbrasil folded before Flop (didn't bet)
Seat 4: IamKeOpS (button) folded before Flop (didn't bet)
Seat 5: Cardenasdias (small blind) collected ($0.04)
Seat 6: MrDonRich (big blind) folded before Flop


PokerStars Hand #238176933918:  Hold'em No Limit ($0.01/$0.02 USD) - 2022/08/23 18:24:40 ET
Table 'Equinox IV' 6-max Seat #5 is the button
Seat 1: chxxxs ($2.89 in chips)
Seat 2: lov35layer ($2 in chips)
Seat 3: cadbrasil ($0.84 in chips)
Seat 4: IamKeOpS ($2 in chips)
Seat 5: Cardenasdias ($2.02 in chips)
Seat 6: MrDonRich ($3.99 in chips)
MrDonRich: posts small blind $0.01
chxxxs: posts big blind $0.02
*** HOLE CARDS ***
lov35layer: folds
cadbrasil: folds
IamKeOpS: folds
Cardenasdias: raises $0.02 to $0.04
MrDonRich: calls $0.03
chxxxs: calls $0.02
*** FLOP *** [7d Td 9c]
MrDonRich: checks
chxxxs: checks
Cardenasdias: bets $0.04
MrDonRich: calls $0.04
chxxxs: folds
*** TURN *** [7d Td 9c] [Qh]
MrDonRich: checks
Cardenasdias: checks
*** RIVER *** [7d Td 9c Qh] [Ac]
MrDonRich: checks
Cardenasdias: checks
*** SHOW DOWN ***
MrDonRich: shows [Js 5s] (high card Ace)
Cardenasdias: shows [5c Ts] (a pair of Tens)
Cardenasdias collected $0.19 from pot
*** SUMMARY ***
Total pot $0.20 | Rake $0.01
Board [7d Td 9c Qh Ac]
Seat 1: chxxxs (big blind) folded on the Flop
Seat 2: lov35layer folded before Flop (didn't bet)
Seat 3: cadbrasil folded before Flop (didn't bet)
Seat 4: IamKeOpS folded before Flop (didn't bet)
Seat 5: Cardenasdias (button) showed [5c Ts] and won ($0.19) with a pair of Tens
Seat 6: MrDonRich (small blind) showed [Js 5s] and lost with high card Ace


PokerStars Hand #238176950283:  Hold'em No Limit ($0.01/$0.02 USD) - 2022/08/23 18:25:30 ET
Table 'Equinox IV' 6-max Seat #6 is the button
Seat 1: chxxxs ($2.85 in chips)
Seat 2: lov35layer ($2 in chips)
Seat 3: cadbrasil ($0.84 in chips)
Seat 4: IamKeOpS ($2 in chips)
Seat 5: Cardenasdias ($2.13 in chips)
Seat 6: MrDonRich ($3.91 in chips)
chxxxs: posts small blind $0.01
lov35layer: posts big blind $0.02
*** HOLE CARDS ***
cadbrasil: folds
IamKeOpS: folds
Cardenasdias: raises $0.02 to $0.04
MrDonRich: folds
chxxxs: raises $0.15 to $0.19
lov35layer: folds
Cardenasdias: calls $0.15
*** FLOP *** [2d 7d 8d]
chxxxs: checks
Cardenasdias: checks
*** TURN *** [2d 7d 8d] [8c]
chxxxs: checks
Cardenasdias: checks
*** RIVER *** [2d 7d 8d 8c] [7s]
chxxxs: bets $0.26
Cardenasdias: folds
Uncalled bet ($0.26) returned to chxxxs
chxxxs collected $0.39 from pot
chxxxs: doesn't show hand
*** SUMMARY ***
Total pot $0.40 | Rake $0.01
Board [2d 7d 8d 8c 7s]
Seat 1: chxxxs (small blind) collected ($0.39)
Seat 2: lov35layer (big blind) folded before Flop
Seat 3: cadbrasil folded before Flop (didn't bet)
Seat 4: IamKeOpS folded before Flop (didn't bet)
Seat 5: Cardenasdias folded on the River
Seat 6: MrDonRich (button) folded before Flop (didn't bet)


PokerStars Hand #238176961313:  Hold'em No Limit ($0.01/$0.02 USD) - 2022/08/23 18:26:05 ET
Table 'Equinox IV' 6-max Seat #1 is the button
Seat 1: chxxxs ($3.05 in chips)
Seat 2: lov35layer ($2 in chips)
Seat 3: cadbrasil ($0.84 in chips)
Seat 4: IamKeOpS ($2 in chips)
Seat 5: Cardenasdias ($1.94 in chips)
Seat 6: MrDonRich ($3.91 in chips)
lov35layer: posts small blind $0.01
cadbrasil: posts big blind $0.02
*** HOLE CARDS ***
IamKeOpS: folds
Cardenasdias: calls $0.02
MrDonRich: folds
chxxxs: calls $0.02
lov35layer: folds
cadbrasil: checks
*** FLOP *** [Th 6s 5h]
cadbrasil: checks
Cardenasdias: checks
chxxxs: checks
*** TURN *** [Th 6s 5h] [Js]
cadbrasil: checks
Cardenasdias: bets $0.02
chxxxs: folds
cadbrasil: raises $0.02 to $0.04
Cardenasdias: calls $0.02
*** RIVER *** [Th 6s 5h Js] [2h]
cadbrasil: checks
Cardenasdias: checks
*** SHOW DOWN ***
cadbrasil: shows [Td Jh] (two pair, Jacks and Tens)
Cardenasdias: mucks hand
cadbrasil collected $0.14 from pot
*** SUMMARY ***
Total pot $0.15 | Rake $0.01
Board [Th 6s 5h Js 2h]
Seat 1: chxxxs (button) folded on the Turn
Seat 2: lov35layer (small blind) folded before Flop
Seat 3: cadbrasil (big blind) showed [Td Jh] and won ($0.14) with two pair, Jacks and Tens
Seat 4: IamKeOpS folded before Flop (didn't bet)
Seat 5: Cardenasdias mucked
Seat 6: MrDonRich folded before Flop (didn't bet)


PokerStars Hand #238176983751:  Hold'em No Limit ($0.01/$0.02 USD) - 2022/08/23 18:27:15 ET
Table 'Equinox IV' 6-max Seat #2 is the button
Seat 1: chxxxs ($3.03 in chips)
Seat 2: lov35layer ($2 in chips)
Seat 3: cadbrasil ($0.92 in chips)
Seat 4: IamKeOpS ($2 in chips)
Seat 5: Cardenasdias ($1.88 in chips)
Seat 6: MrDonRich ($3.91 in chips)
cadbrasil: posts small blind $0.01
IamKeOpS: posts big blind $0.02
*** HOLE CARDS ***
Cardenasdias: folds
MrDonRich: folds
Cardenasdias leaves the table
chxxxs: raises $0.03 to $0.05
lov35layer: folds
cadbrasil: folds
IamKeOpS: folds
Uncalled bet ($0.03) returned to chxxxs
chxxxs collected $0.05 from pot
chxxxs: doesn't show hand
*** SUMMARY ***
Total pot $0.05 | Rake $0
Seat 1: chxxxs collected ($0.05)
Seat 2: lov35layer (button) folded before Flop (didn't bet)
Seat 3: cadbrasil (small blind) folded before Flop
Seat 4: IamKeOpS (big blind) folded before Flop
Seat 5: Cardenasdias folded before Flop (didn't bet)
Seat 6: MrDonRich folded before Flop (didn't bet)


PokerStars Hand #238176989191:  Hold'em No Limit ($0.01/$0.02 USD) - 2022/08/23 18:27:31 ET
Table 'Equinox IV' 6-max Seat #3 is the button
Seat 1: chxxxs ($3.06 in chips)
Seat 2: lov35layer ($2 in chips)
Seat 3: cadbrasil ($0.91 in chips)
Seat 4: IamKeOpS ($1.98 in chips)
Seat 6: MrDonRich ($3.91 in chips)
IamKeOpS: posts small blind $0.01
MrDonRich: posts big blind $0.02
*** HOLE CARDS ***
chxxxs: folds
lov35layer: folds
cadbrasil: calls $0.02
IamKeOpS: folds
xorrobinhoox joins the table at seat #5
MrDonRich: checks
*** FLOP *** [4h 2c 6s]
MrDonRich: checks
cadbrasil: checks
*** TURN *** [4h 2c 6s] [3c]
MrDonRich: checks
cadbrasil: checks
*** RIVER *** [4h 2c 6s 3c] [3s]
MrDonRich: checks
cadbrasil: checks
*** SHOW DOWN ***
MrDonRich: shows [8h Ts] (a pair of Threes)
cadbrasil: shows [Kd Js] (a pair of Threes - King kicker)
cadbrasil collected $0.05 from pot
*** SUMMARY ***
Total pot $0.05 | Rake $0
Board [4h 2c 6s 3c 3s]
Seat 1: chxxxs folded before Flop (didn't bet)
Seat 2: lov35layer folded before Flop (didn't bet)
Seat 3: cadbrasil (button) showed [Kd Js] and won ($0.05) with a pair of Threes
Seat 4: IamKeOpS (small blind) folded before Flop
Seat 6: MrDonRich (big blind) showed [8h Ts] and lost with a pair of Threes


PokerStars Hand #238177012275:  Hold'em No Limit ($0.01/$0.02 USD) - 2022/08/23 18:28:43 ET
Table 'Equinox IV' 6-max Seat #1 is the button
Seat 1: chxxxs ($3.05 in chips)
Seat 2: lov35layer ($2 in chips)
Seat 3: cadbrasil ($0.94 in chips)
Seat 5: xorrobinhoox ($2.03 in chips)
Seat 6: MrDonRich ($3.89 in chips)
lov35layer: posts small blind $0.01
cadbrasil: posts big blind $0.02
*** HOLE CARDS ***
xorrobinhoox: folds
MrDonRich: calls $0.02
chxxxs: folds
lov35layer: folds
cadbrasil: checks
*** FLOP *** [Qs 9h Js]
cadbrasil: checks
MrDonRich: bets $0.02
cadbrasil: folds
Uncalled bet ($0.02) returned to MrDonRich
MrDonRich collected $0.05 from pot
MrDonRich: doesn't show hand
*** SUMMARY ***
Total pot $0.05 | Rake $0
Board [Qs 9h Js]
Seat 1: chxxxs (button) folded before Flop (didn't bet)
Seat 2: lov35layer (small blind) folded before Flop
Seat 3: cadbrasil (big blind) folded on the Flop
Seat 5: xorrobinhoox folded before Flop (didn't bet)
Seat 6: MrDonRich collected ($0.05)


PokerStars Hand #238177020983:  Hold'em No Limit ($0.01/$0.02 USD) - 2022/08/23 18:29:11 ET
Table 'Equinox IV' 6-max Seat #2 is the button
Seat 1: chxxxs ($3.05 in chips)
Seat 2: lov35layer ($2 in chips)
Seat 3: cadbrasil ($0.92 in chips)
Seat 5: xorrobinhoox ($2.03 in chips)
Seat 6: MrDonRich ($3.92 in chips)
cadbrasil: posts small blind $0.01
xorrobinhoox: posts big blind $0.02
*** HOLE CARDS ***
MrDonRich: raises $0.04 to $0.06
chxxxs: folds
lov35layer: folds
cadbrasil: folds
xorrobinhoox: folds
Uncalled bet ($0.04) returned to MrDonRich
MrDonRich collected $0.05 from pot
MrDonRich: doesn't show hand
*** SUMMARY ***
Total pot $0.05 | Rake $0
Seat 1: chxxxs folded before Flop (didn't bet)
Seat 2: lov35layer (button) folded before Flop (didn't bet)
Seat 3: cadbrasil (small blind) folded before Flop
Seat 5: xorrobinhoox (big blind) folded before Flop
Seat 6: MrDonRich collected ($0.05)


PokerStars Hand #238177032318:  Hold'em No Limit ($0.01/$0.02 USD) - 2022/08/23 18:29:47 ET
Table 'Equinox IV' 6-max Seat #3 is the button
Seat 1: chxxxs ($3.05 in chips)
Seat 2: lov35layer ($2 in chips)
Seat 3: cadbrasil ($0.91 in chips)
Seat 5: xorrobinhoox ($2.01 in chips)
Seat 6: MrDonRich ($3.95 in chips)
xorrobinhoox: posts small blind $0.01
MrDonRich: posts big blind $0.02
*** HOLE CARDS ***
chxxxs: folds
lov35layer: raises $0.02 to $0.04
cadbrasil: folds
xorrobinhoox: folds
MrDonRich: folds
Uncalled bet ($0.02) returned to lov35layer
lov35layer collected $0.05 from pot
lov35layer: doesn't show hand
*** SUMMARY ***
Total pot $0.05 | Rake $0
Seat 1: chxxxs folded before Flop (didn't bet)
Seat 2: lov35layer collected ($0.05)
Seat 3: cadbrasil (button) folded before Flop (didn't bet)
Seat 5: xorrobinhoox (small blind) folded before Flop
Seat 6: MrDonRich (big blind) folded before Flop


PokerStars Hand #238177036653:  Hold'em No Limit ($0.01/$0.02 USD) - 2022/08/23 18:30:00 ET
Table 'Equinox IV' 6-max Seat #5 is the button
Seat 1: chxxxs ($3.05 in chips)
Seat 2: lov35layer ($2.03 in chips)
Seat 3: cadbrasil ($0.91 in chips)
Seat 5: xorrobinhoox ($2 in chips)
Seat 6: MrDonRich ($3.93 in chips)
MrDonRich: posts small blind $0.01
chxxxs: posts big blind $0.02
*** HOLE CARDS ***
lov35layer: folds
cadbrasil: calls $0.02
xorrobinhoox: folds
MrDonRich: calls $0.01
chxxxs: checks
*** FLOP *** [3h As 2d]
MrDonRich: checks
chxxxs: checks
cadbrasil: checks
*** TURN *** [3h As 2d] [3c]
MrDonRich: bets $0.02
chxxxs: calls $0.02
cadbrasil: calls $0.02
*** RIVER *** [3h As 2d 3c] [Js]
MrDonRich: bets $0.24
chxxxs: folds
cadbrasil: calls $0.24
*** SHOW DOWN ***
MrDonRich: shows [2h 3s] (a full house, Threes full of Deuces)
cadbrasil: mucks hand
MrDonRich collected $0.58 from pot
*** SUMMARY ***
Total pot $0.60 | Rake $0.02
Board [3h As 2d 3c Js]
Seat 1: chxxxs (big blind) folded on the River
Seat 2: lov35layer folded before Flop (didn't bet)
Seat 3: cadbrasil mucked
Seat 5: xorrobinhoox (button) folded before Flop (didn't bet)
Seat 6: MrDonRich (small blind) showed [2h 3s] and won ($0.58) with a full house, Threes full of Deuces


PokerStars Hand #238177056275:  Hold'em No Limit ($0.01/$0.02 USD) - 2022/08/23 18:31:01 ET
Table 'Equinox IV' 6-max Seat #6 is the button
Seat 1: chxxxs ($3.01 in chips)
Seat 2: lov35layer ($2.03 in chips)
Seat 3: cadbrasil ($0.63 in chips)
Seat 5: xorrobinhoox ($2 in chips)
Seat 6: MrDonRich ($4.23 in chips)
chxxxs: posts small blind $0.01
lov35layer: posts big blind $0.02
*** HOLE CARDS ***
cadbrasil: folds
xorrobinhoox: folds
MrDonRich: folds
chxxxs: folds
Uncalled bet ($0.01) returned to lov35layer
lov35layer collected $0.02 from pot
lov35layer: doesn't show hand
*** SUMMARY ***
Total pot $0.02 | Rake $0
Seat 1: chxxxs (small blind) folded before Flop
Seat 2: lov35layer (big blind) collected ($0.02)
Seat 3: cadbrasil folded before Flop (didn't bet)
Seat 5: xorrobinhoox folded before Flop (didn't bet)
Seat 6: MrDonRich (button) folded before Flop (didn't bet)


PokerStars Hand #238177058567:  Hold'em No Limit ($0.01/$0.02 USD) - 2022/08/23 18:31:08 ET
Table 'Equinox IV' 6-max Seat #1 is the button
Seat 1: chxxxs ($3 in chips)
Seat 2: lov35layer ($2.04 in chips)
Seat 3: cadbrasil ($0.63 in chips)
Seat 5: xorrobinhoox ($2 in chips)
Seat 6: MrDonRich ($4.23 in chips)
lov35layer: posts small blind $0.01
cadbrasil: posts big blind $0.02
*** HOLE CARDS ***
xorrobinhoox: folds
MrDonRich: raises $0.04 to $0.06
chxxxs: folds
lov35layer: folds
cadbrasil: calls $0.04
*** FLOP *** [Js Ac 6d]
cadbrasil: checks
MrDonRich: bets $0.09
cadbrasil: calls $0.09
*** TURN *** [Js Ac 6d] [Qs]
cadbrasil: checks
MrDonRich: checks
*** RIVER *** [Js Ac 6d Qs] [9d]
cadbrasil: checks
MrDonRich: checks
*** SHOW DOWN ***
cadbrasil: shows [Ad Th] (a pair of Aces)
MrDonRich: shows [Ts Ah] (a pair of Aces)
cadbrasil collected $0.15 from pot
MrDonRich collected $0.15 from pot
*** SUMMARY ***
Total pot $0.31 | Rake $0.01
Board [Js Ac 6d Qs 9d]
Seat 1: chxxxs (button) folded before Flop (didn't bet)
Seat 2: lov35layer (small blind) folded before Flop
Seat 3: cadbrasil (big blind) showed [Ad Th] and won ($0.15) with a pair of Aces
Seat 5: xorrobinhoox folded before Flop (didn't bet)
Seat 6: MrDonRich showed [Ts Ah] and won ($0.15) with a pair of Aces


PokerStars Hand #238177085384:  Hold'em No Limit ($0.01/$0.02 USD) - 2022/08/23 18:32:13 ET
Table 'Equinox IV' 6-max Seat #2 is the button
Seat 1: chxxxs ($3 in chips)
Seat 2: lov35layer ($2.03 in chips)
Seat 3: cadbrasil ($0.63 in chips)
Seat 5: xorrobinhoox ($2 in chips)
Seat 6: MrDonRich ($4.23 in chips)
cadbrasil: posts small blind $0.01
xorrobinhoox: posts big blind $0.02
*** HOLE CARDS ***
MrDonRich: folds
chxxxs: folds
lov35layer: raises $0.03 to $0.05
cadbrasil: folds
xorrobinhoox: calls $0.03
*** FLOP *** [Kc 9c Ah]
xorrobinhoox: checks
lov35layer: bets $0.05
xorrobinhoox: calls $0.05
*** TURN *** [Kc 9c Ah] [Ks]
xorrobinhoox: checks
lov35layer: checks
*** RIVER *** [Kc 9c Ah Ks] [5c]
xorrobinhoox: bets $0.10
lov35layer: raises $0.20 to $0.30
xorrobinhoox: calls $0.20
*** SHOW DOWN ***
lov35layer: shows [Ac 7c] (a flush, Ace high)
xorrobinhoox: mucks hand
lov35layer collected $0.78 from pot
*** SUMMARY ***
Total pot $0.81 | Rake $0.03
Board [Kc 9c Ah Ks 5c]
Seat 1: chxxxs folded before Flop (didn't bet)
Seat 2: lov35layer (button) showed [Ac 7c] and won ($0.78) with a flush, Ace high
Seat 3: cadbrasil (small blind) folded before Flop
Seat 5: xorrobinhoox (big blind) mucked
Seat 6: MrDonRich folded before Flop (didn't bet)


PokerStars Hand #238177108249:  Hold'em No Limit ($0.01/$0.02 USD) - 2022/08/23 18:33:25 ET
Table 'Equinox IV' 6-max Seat #3 is the button
Seat 1: chxxxs ($3 in chips)
Seat 2: lov35layer ($2.41 in chips)
Seat 3: cadbrasil ($0.62 in chips)
Seat 5: xorrobinhoox ($1.60 in chips)
Seat 6: MrDonRich ($4.23 in chips)
xorrobinhoox: posts small blind $0.01
MrDonRich: posts big blind $0.02
*** HOLE CARDS ***
chxxxs: folds
lov35layer: folds
cadbrasil: folds
xorrobinhoox: raises $0.04 to $0.06
MrDonRich: folds
Uncalled bet ($0.04) returned to xorrobinhoox
xorrobinhoox collected $0.04 from pot
xorrobinhoox: doesn't show hand
*** SUMMARY ***
Total pot $0.04 | Rake $0
Seat 1: chxxxs folded before Flop (didn't bet)
Seat 2: lov35layer folded before Flop (didn't bet)
Seat 3: cadbrasil (button) folded before Flop (didn't bet)
Seat 5: xorrobinhoox (small blind) collected ($0.04)
Seat 6: MrDonRich (big blind) folded before Flop


PokerStars Hand #238177113983:  Hold'em No Limit ($0.01/$0.02 USD) - 2022/08/23 18:33:43 ET
Table 'Equinox IV' 6-max Seat #5 is the button
Seat 1: chxxxs ($3 in chips)
Seat 2: lov35layer ($2.41 in chips)
Seat 3: cadbrasil ($0.62 in chips)
Seat 5: xorrobinhoox ($1.62 in chips)
Seat 6: MrDonRich ($4.21 in chips)
MrDonRich: posts small blind $0.01
chxxxs: posts big blind $0.02
IamKeOpS: sits out
*** HOLE CARDS ***
lov35layer: raises $0.04 to $0.06
cadbrasil: calls $0.06
xorrobinhoox: folds
MrDonRich: folds
chxxxs: folds
*** FLOP *** [2h 2c 7d]
lov35layer: checks
cadbrasil: checks
*** TURN *** [2h 2c 7d] [8d]
lov35layer: checks
cadbrasil: checks
*** RIVER *** [2h 2c 7d 8d] [4c]
lov35layer: checks
cadbrasil: checks
*** SHOW DOWN ***
lov35layer: shows [Jd Qd] (a pair of Deuces)
cadbrasil: shows [Kc 7s] (two pair, Sevens and Deuces)
cadbrasil collected $0.14 from pot
*** SUMMARY ***
Total pot $0.15 | Rake $0.01
Board [2h 2c 7d 8d 4c]
Seat 1: chxxxs (big blind) folded before Flop
Seat 2: lov35layer showed [Jd Qd] and lost with a pair of Deuces
Seat 3: cadbrasil showed [Kc 7s] and won ($0.14) with two pair, Sevens and Deuces
Seat 5: xorrobinhoox (button) folded before Flop (didn't bet)
Seat 6: MrDonRich (small blind) folded before Flop


PokerStars Hand #238177124437:  Hold'em No Limit ($0.01/$0.02 USD) - 2022/08/23 18:34:16 ET
Table 'Equinox IV' 6-max Seat #6 is the button
Seat 1: chxxxs ($2.98 in chips)
Seat 3: cadbrasil ($0.70 in chips)
Seat 5: xorrobinhoox ($1.62 in chips)
Seat 6: MrDonRich ($4.20 in chips)
chxxxs: posts small blind $0.01
lov35layer: is sitting out
cadbrasil: posts big blind $0.02
IamKeOpS: sits out
*** HOLE CARDS ***
lov35layer leaves the table
xorrobinhoox: folds
MrDonRich: folds
chxxxs: folds
Uncalled bet ($0.01) returned to cadbrasil
cadbrasil collected $0.02 from pot
*** SUMMARY ***
Total pot $0.02 | Rake $0
Seat 1: chxxxs (small blind) folded before Flop
Seat 3: cadbrasil (big blind) collected ($0.02)
Seat 5: xorrobinhoox folded before Flop (didn't bet)
Seat 6: MrDonRich (button) folded before Flop (didn't bet)


PokerStars Hand #238177128896:  Hold'em No Limit ($0.01/$0.02 USD) - 2022/08/23 18:34:30 ET
Table 'Equinox IV' 6-max Seat #1 is the button
Seat 1: chxxxs ($2.97 in chips)
Seat 3: cadbrasil ($0.71 in chips)
Seat 4: IamKeOpS ($2 in chips)
Seat 5: xorrobinhoox ($1.62 in chips)
Seat 6: MrDonRich ($4.20 in chips)
cadbrasil: posts small blind $0.01
IamKeOpS: posts big blind $0.02
*** HOLE CARDS ***
AhojasHoja joins the table at seat #2
xorrobinhoox: folds
MrDonRich: folds
chxxxs: folds
AhojasHoja leaves the table
cadbrasil: calls $0.01
IamKeOpS: checks
*** FLOP *** [6h 2s Th]
cadbrasil: checks
IamKeOpS: checks
*** TURN *** [6h 2s Th] [Qh]
cadbrasil: bets $0.02
brontobronco joins the table at seat #2
IamKeOpS: calls $0.02
*** RIVER *** [6h 2s Th Qh] [Js]
cadbrasil: checks
IamKeOpS: checks
*** SHOW DOWN ***
cadbrasil: shows [9h 4h] (a flush, Queen high)
IamKeOpS: mucks hand
cadbrasil collected $0.08 from pot
*** SUMMARY ***
Total pot $0.08 | Rake $0
Board [6h 2s Th Qh Js]
Seat 1: chxxxs (button) folded before Flop (didn't bet)
Seat 3: cadbrasil (small blind) showed [9h 4h] and won ($0.08) with a flush, Queen high
Seat 4: IamKeOpS (big blind) mucked
Seat 5: xorrobinhoox folded before Flop (didn't bet)
Seat 6: MrDonRich folded before Flop (didn't bet)


PokerStars Hand #238177148153:  Hold'em No Limit ($0.01/$0.02 USD) - 2022/08/23 18:35:30 ET
Table 'Equinox IV' 6-max Seat #3 is the button
Seat 1: chxxxs ($2.97 in chips)
Seat 3: cadbrasil ($0.75 in chips)
Seat 4: IamKeOpS ($2 in chips)
Seat 5: xorrobinhoox ($1.62 in chips)
Seat 6: MrDonRich ($4.20 in chips)
IamKeOpS: posts small blind $0.01
xorrobinhoox: posts big blind $0.02
brontobronco: sits out
*** HOLE CARDS ***
MrDonRich: folds
chxxxs: folds
cadbrasil: calls $0.02
IamKeOpS: folds
xorrobinhoox: checks
*** FLOP *** [4h 7c 5h]
xorrobinhoox: checks
cadbrasil: checks
*** TURN *** [4h 7c 5h] [Kd]
xorrobinhoox: bets $0.05
cadbrasil: calls $0.05
*** RIVER *** [4h 7c 5h Kd] [2s]
xorrobinhoox: bets $0.14
cadbrasil: folds
Uncalled bet ($0.14) returned to xorrobinhoox
xorrobinhoox collected $0.14 from pot
xorrobinhoox: doesn't show hand
*** SUMMARY ***
Total pot $0.15 | Rake $0.01
Board [4h 7c 5h Kd 2s]
Seat 1: chxxxs folded before Flop (didn't bet)
Seat 3: cadbrasil (button) folded on the River
Seat 4: IamKeOpS (small blind) folded before Flop
Seat 5: xorrobinhoox (big blind) collected ($0.14)
Seat 6: MrDonRich folded before Flop (didn't bet)


PokerStars Hand #238177170950:  Hold'em No Limit ($0.01/$0.02 USD) - 2022/08/23 18:36:12 ET
Table 'Equinox IV' 6-max Seat #4 is the button
Seat 1: chxxxs ($2.97 in chips)
Seat 3: cadbrasil ($0.68 in chips)
Seat 4: IamKeOpS ($1.99 in chips)
Seat 5: xorrobinhoox ($1.69 in chips)
Seat 6: MrDonRich ($4.20 in chips)
xorrobinhoox: posts small blind $0.01
MrDonRich: posts big blind $0.02
brontobronco: sits out
*** HOLE CARDS ***
chxxxs: folds
cadbrasil: folds
cadbrasil leaves the table
IamKeOpS: raises $0.03 to $0.05
Ilmurat01 joins the table at seat #3
xorrobinhoox: folds
MrDonRich: folds
Uncalled bet ($0.03) returned to IamKeOpS
IamKeOpS collected $0.05 from pot
IamKeOpS: doesn't show hand
*** SUMMARY ***
Total pot $0.05 | Rake $0
Seat 1: chxxxs folded before Flop (didn't bet)
Seat 3: cadbrasil folded before Flop (didn't bet)
Seat 4: IamKeOpS (button) collected ($0.05)
Seat 5: xorrobinhoox (small blind) folded before Flop
Seat 6: MrDonRich (big blind) folded before Flop


PokerStars Hand #238177180355:  Hold'em No Limit ($0.01/$0.02 USD) - 2022/08/23 18:36:42 ET
Table 'Equinox IV' 6-max Seat #5 is the button
Seat 1: chxxxs ($2.97 in chips)
Seat 4: IamKeOpS ($2.02 in chips)
Seat 5: xorrobinhoox ($1.68 in chips)
Seat 6: MrDonRich ($4.18 in chips)
MrDonRich: posts small blind $0.01
chxxxs: posts big blind $0.02
brontobronco: sits out
Ilmurat01: sits out
*** HOLE CARDS ***
IamKeOpS: folds
xorrobinhoox: raises $0.03 to $0.05
MrDonRich: calls $0.04
chxxxs: folds
*** FLOP *** [Jc 9c Ks]
MrDonRich: bets $0.08
xorrobinhoox: raises $0.14 to $0.22
MrDonRich: raises $0.14 to $0.36
xorrobinhoox: calls $0.14
*** TURN *** [Jc 9c Ks] [8s]
MrDonRich: bets $0.81
xorrobinhoox: folds
Uncalled bet ($0.81) returned to MrDonRich
MrDonRich collected $0.81 from pot
MrDonRich: doesn't show hand
*** SUMMARY ***
Total pot $0.84 | Rake $0.03
Board [Jc 9c Ks 8s]
Seat 1: chxxxs (big blind) folded before Flop
Seat 4: IamKeOpS folded before Flop (didn't bet)
Seat 5: xorrobinhoox (button) folded on the Turn
Seat 6: MrDonRich (small blind) collected ($0.81)


PokerStars Hand #238177199134:  Hold'em No Limit ($0.01/$0.02 USD) - 2022/08/23 18:37:41 ET
Table 'Equinox IV' 6-max Seat #6 is the button
Seat 1: chxxxs ($2.95 in chips)
Seat 2: brontobronco ($2 in chips)
Seat 3: Ilmurat01 ($1.33 in chips)
Seat 4: IamKeOpS ($2.02 in chips)
Seat 5: xorrobinhoox ($2 in chips)
Seat 6: MrDonRich ($4.58 in chips)
chxxxs: posts small blind $0.01
brontobronco: posts big blind $0.02
Ilmurat01: posts big blind $0.02
*** HOLE CARDS ***
Ilmurat01: checks
IamKeOpS: folds
xorrobinhoox: folds
MrDonRich: folds
chxxxs: folds
brontobronco: raises $0.04 to $0.06
Ilmurat01: calls $0.04
*** FLOP *** [Jc 8c Kc]
brontobronco: bets $0.06
Ilmurat01: calls $0.06
*** TURN *** [Jc 8c Kc] [2h]
brontobronco: bets $0.12
Ilmurat01: calls $0.12
*** RIVER *** [Jc 8c Kc 2h] [Js]
brontobronco: bets $0.23
Ilmurat01: raises $0.86 to $1.09 and is all-in
brontobronco: folds
Uncalled bet ($0.86) returned to Ilmurat01
Ilmurat01 collected $0.92 from pot
*** SUMMARY ***
Total pot $0.95 | Rake $0.03
Board [Jc 8c Kc 2h Js]
Seat 1: chxxxs (small blind) folded before Flop
Seat 2: brontobronco (big blind) folded on the River
Seat 3: Ilmurat01 collected ($0.92)
Seat 4: IamKeOpS folded before Flop (didn't bet)
Seat 5: xorrobinhoox folded before Flop (didn't bet)
Seat 6: MrDonRich (button) folded before Flop (didn't bet)


PokerStars Hand #238177217890:  Hold'em No Limit ($0.01/$0.02 USD) - 2022/08/23 18:38:40 ET
Table 'Equinox IV' 6-max Seat #1 is the button
Seat 1: chxxxs ($2.94 in chips)
Seat 2: brontobronco ($2 in chips)
Seat 3: Ilmurat01 ($1.78 in chips)
Seat 4: IamKeOpS ($2.02 in chips)
Seat 5: xorrobinhoox ($2 in chips)
Seat 6: MrDonRich ($4.58 in chips)
brontobronco: posts small blind $0.01
Ilmurat01: posts big blind $0.02
*** HOLE CARDS ***
IamKeOpS: folds
xorrobinhoox: raises $0.03 to $0.05
MrDonRich: folds
chxxxs: folds
brontobronco: folds
Ilmurat01: folds
Uncalled bet ($0.03) returned to xorrobinhoox
xorrobinhoox collected $0.05 from pot
xorrobinhoox: doesn't show hand
*** SUMMARY ***
Total pot $0.05 | Rake $0
Seat 1: chxxxs (button) folded before Flop (didn't bet)
Seat 2: brontobronco (small blind) folded before Flop
Seat 3: Ilmurat01 (big blind) folded before Flop
Seat 4: IamKeOpS folded before Flop (didn't bet)
Seat 5: xorrobinhoox collected ($0.05)
Seat 6: MrDonRich folded before Flop (didn't bet)


PokerStars Hand #238177228803:  Hold'em No Limit ($0.01/$0.02 USD) - 2022/08/23 18:39:15 ET
Table 'Equinox IV' 6-max Seat #2 is the button
Seat 1: chxxxs ($2.94 in chips)
Seat 2: brontobronco ($2 in chips)
Seat 3: Ilmurat01 ($1.76 in chips)
Seat 4: IamKeOpS ($2.02 in chips)
Seat 5: xorrobinhoox ($2.03 in chips)
Seat 6: MrDonRich ($4.58 in chips)
Ilmurat01: posts small blind $0.01
IamKeOpS: posts big blind $0.02
*** HOLE CARDS ***
xorrobinhoox: folds
MrDonRich: calls $0.02
chxxxs: folds
brontobronco: raises $0.04 to $0.06
Ilmurat01: calls $0.05
IamKeOpS: calls $0.04
MrDonRich: calls $0.04
*** FLOP *** [3s As 8s]
Ilmurat01: checks
IamKeOpS: checks
MrDonRich: checks
brontobronco: bets $0.11
Ilmurat01: folds
IamKeOpS: calls $0.11
MrDonRich: folds
*** TURN *** [3s As 8s] [Qs]
IamKeOpS: checks
brontobronco: bets $0.12
IamKeOpS: folds
Uncalled bet ($0.12) returned to brontobronco
brontobronco collected $0.44 from pot
*** SUMMARY ***
Total pot $0.46 | Rake $0.02
Board [3s As 8s Qs]
Seat 1: chxxxs folded before Flop (didn't bet)
Seat 2: brontobronco (button) collected ($0.44)
Seat 3: Ilmurat01 (small blind) folded on the Flop
Seat 4: IamKeOpS (big blind) folded on the Turn
Seat 5: xorrobinhoox folded before Flop (didn't bet)
Seat 6: MrDonRich folded on the Flop


PokerStars Hand #238177260088:  Hold'em No Limit ($0.01/$0.02 USD) - 2022/08/23 18:40:54 ET
Table 'Equinox IV' 6-max Seat #3 is the button
Seat 1: chxxxs ($2.94 in chips)
Seat 2: brontobronco ($2.27 in chips)
Seat 3: Ilmurat01 ($1.70 in chips)
Seat 4: IamKeOpS ($2 in chips)
Seat 5: xorrobinhoox ($2.03 in chips)
Seat 6: MrDonRich ($4.52 in chips)
IamKeOpS: posts small blind $0.01
xorrobinhoox: posts big blind $0.02
*** HOLE CARDS ***
MrDonRich: folds
chxxxs: raises $0.04 to $0.06
brontobronco: folds
Ilmurat01: calls $0.06
IamKeOpS: folds
xorrobinhoox: calls $0.04
*** FLOP *** [9d Ks Th]
xorrobinhoox: checks
chxxxs: bets $0.11
Ilmurat01: calls $0.11
xorrobinhoox: calls $0.11
*** TURN *** [9d Ks Th] [2d]
xorrobinhoox: checks
chxxxs: bets $0.33
Ilmurat01: folds
xorrobinhoox: folds
Uncalled bet ($0.33) returned to chxxxs
chxxxs collected $0.50 from pot
chxxxs: doesn't show hand
*** SUMMARY ***
Total pot $0.52 | Rake $0.02
Board [9d Ks Th 2d]
Seat 1: chxxxs collected ($0.50)
Seat 2: brontobronco folded before Flop (didn't bet)
Seat 3: Ilmurat01 (button) folded on the Turn
Seat 4: IamKeOpS (small blind) folded before Flop
Seat 5: xorrobinhoox (big blind) folded on the Turn
Seat 6: MrDonRich folded before Flop (didn't bet)


PokerStars Hand #238177273373:  Hold'em No Limit ($0.01/$0.02 USD) - 2022/08/23 18:41:36 ET
Table 'Equinox IV' 6-max Seat #4 is the button
Seat 1: chxxxs ($3.27 in chips)
Seat 2: brontobronco ($2.27 in chips)
Seat 3: Ilmurat01 ($1.53 in chips)
Seat 4: IamKeOpS ($1.99 in chips)
Seat 5: xorrobinhoox ($1.86 in chips)
Seat 6: MrDonRich ($4.52 in chips)
xorrobinhoox: posts small blind $0.01
MrDonRich: posts big blind $0.02
*** HOLE CARDS ***
chxxxs: folds
brontobronco: folds
Ilmurat01: folds
IamKeOpS: raises $0.03 to $0.05
xorrobinhoox: folds
MrDonRich: folds
Uncalled bet ($0.03) returned to IamKeOpS
IamKeOpS collected $0.05 from pot
IamKeOpS: doesn't show hand
*** SUMMARY ***
Total pot $0.05 | Rake $0
Seat 1: chxxxs folded before Flop (didn't bet)
Seat 2: brontobronco folded before Flop (didn't bet)
Seat 3: Ilmurat01 folded before Flop (didn't bet)
Seat 4: IamKeOpS (button) collected ($0.05)
Seat 5: xorrobinhoox (small blind) folded before Flop
Seat 6: MrDonRich (big blind) folded before Flop


PokerStars Hand #238177280342:  Hold'em No Limit ($0.01/$0.02 USD) - 2022/08/23 18:41:58 ET
Table 'Equinox IV' 6-max Seat #5 is the button
Seat 1: chxxxs ($3.27 in chips)
Seat 2: brontobronco ($2.27 in chips)
Seat 3: Ilmurat01 ($1.53 in chips)
Seat 4: IamKeOpS ($2.02 in chips)
Seat 5: xorrobinhoox ($1.85 in chips)
Seat 6: MrDonRich ($4.50 in chips)
MrDonRich: posts small blind $0.01
chxxxs: posts big blind $0.02
*** HOLE CARDS ***
brontobronco: folds
Ilmurat01: calls $0.02
IamKeOpS: folds
xorrobinhoox has timed out
xorrobinhoox: folds
MrDonRich: folds
chxxxs: checks
*** FLOP *** [3h Tc 8c]
chxxxs: checks
Ilmurat01: checks
*** TURN *** [3h Tc 8c] [Qd]
chxxxs: bets $0.03
Ilmurat01: calls $0.03
*** RIVER *** [3h Tc 8c Qd] [2d]
chxxxs: checks
Ilmurat01: checks
*** SHOW DOWN ***
chxxxs: shows [9h Kc] (high card King)
Ilmurat01: shows [Kh Jh] (high card King - Queen+Jack kicker)
Ilmurat01 collected $0.11 from pot
*** SUMMARY ***
Total pot $0.11 | Rake $0
Board [3h Tc 8c Qd 2d]
Seat 1: chxxxs (big blind) showed [9h Kc] and lost with high card King
Seat 2: brontobronco folded before Flop (didn't bet)
Seat 3: Ilmurat01 showed [Kh Jh] and won ($0.11) with high card King
Seat 4: IamKeOpS folded before Flop (didn't bet)
Seat 5: xorrobinhoox (button) folded before Flop (didn't bet)
Seat 6: MrDonRich (small blind) folded before Flop


PokerStars Hand #238177294942:  Hold'em No Limit ($0.01/$0.02 USD) - 2022/08/23 18:42:45 ET
Table 'Equinox IV' 6-max Seat #6 is the button
Seat 1: chxxxs ($3.22 in chips)
Seat 2: brontobronco ($2.27 in chips)
Seat 3: Ilmurat01 ($1.59 in chips)
Seat 4: IamKeOpS ($2.02 in chips)
Seat 5: xorrobinhoox ($1.85 in chips)
Seat 6: MrDonRich ($4.49 in chips)
chxxxs: posts small blind $0.01
brontobronco: posts big blind $0.02
*** HOLE CARDS ***
Ilmurat01: calls $0.02
IamKeOpS: folds
xorrobinhoox has timed out
xorrobinhoox: folds
MrDonRich: folds
chxxxs: folds
brontobronco: checks
*** FLOP *** [6h Kh 6s]
brontobronco: bets $0.02
Ilmurat01: raises $0.05 to $0.07
brontobronco: folds
Uncalled bet ($0.05) returned to Ilmurat01
Ilmurat01 collected $0.09 from pot
*** SUMMARY ***
Total pot $0.09 | Rake $0
Board [6h Kh 6s]
Seat 1: chxxxs (small blind) folded before Flop
Seat 2: brontobronco (big blind) folded on the Flop
Seat 3: Ilmurat01 collected ($0.09)
Seat 4: IamKeOpS folded before Flop (didn't bet)
Seat 5: xorrobinhoox folded before Flop (didn't bet)
Seat 6: MrDonRich (button) folded before Flop (didn't bet)


PokerStars Hand #238177310294:  Hold'em No Limit ($0.01/$0.02 USD) - 2022/08/23 18:43:34 ET
Table 'Equinox IV' 6-max Seat #1 is the button
Seat 1: chxxxs ($3.21 in chips)
Seat 2: brontobronco ($2.23 in chips)
Seat 3: Ilmurat01 ($1.64 in chips)
Seat 4: IamKeOpS ($2.02 in chips)
Seat 5: xorrobinhoox ($1.85 in chips)
Seat 6: MrDonRich ($4.49 in chips)
brontobronco: posts small blind $0.01
Ilmurat01: posts big blind $0.02
*** HOLE CARDS ***
IamKeOpS: folds
xorrobinhoox: raises $0.03 to $0.05
MrDonRich: folds
chxxxs: folds
brontobronco: folds
Ilmurat01: calls $0.03
*** FLOP *** [4s 5c 9s]
Ilmurat01: bets $0.02
xorrobinhoox: calls $0.02
*** TURN *** [4s 5c 9s] [Ad]
Ilmurat01: bets $0.07
xorrobinhoox: calls $0.07
*** RIVER *** [4s 5c 9s Ad] [2h]
Ilmurat01: bets $0.14
xorrobinhoox: raises $0.28 to $0.42
Ilmurat01: folds
Uncalled bet ($0.28) returned to xorrobinhoox
xorrobinhoox collected $0.55 from pot
xorrobinhoox: doesn't show hand
*** SUMMARY ***
Total pot $0.57 | Rake $0.02
Board [4s 5c 9s Ad 2h]
Seat 1: chxxxs (button) folded before Flop (didn't bet)
Seat 2: brontobronco (small blind) folded before Flop
Seat 3: Ilmurat01 (big blind) folded on the River
Seat 4: IamKeOpS folded before Flop (didn't bet)
Seat 5: xorrobinhoox collected ($0.55)
Seat 6: MrDonRich folded before Flop (didn't bet)


PokerStars Hand #238177325818:  Hold'em No Limit ($0.01/$0.02 USD) - 2022/08/23 18:44:24 ET
Table 'Equinox IV' 6-max Seat #2 is the button
Seat 1: chxxxs ($3.21 in chips)
Seat 2: brontobronco ($2.22 in chips)
Seat 3: Ilmurat01 ($1.36 in chips)
Seat 4: IamKeOpS ($2.02 in chips)
Seat 5: xorrobinhoox ($2.12 in chips)
Seat 6: MrDonRich ($4.49 in chips)
Ilmurat01: posts small blind $0.01
IamKeOpS: posts big blind $0.02
*** HOLE CARDS ***
xorrobinhoox: folds
MrDonRich: folds
chxxxs: raises $0.03 to $0.05
brontobronco: folds
Ilmurat01: calls $0.04
IamKeOpS: calls $0.03
*** FLOP *** [5c Tc 3s]
Ilmurat01: checks
IamKeOpS: checks
chxxxs: checks
*** TURN *** [5c Tc 3s] [7s]
Ilmurat01: bets $0.07
IamKeOpS: folds
chxxxs: folds
Uncalled bet ($0.07) returned to Ilmurat01
Ilmurat01 collected $0.14 from pot
*** SUMMARY ***
Total pot $0.15 | Rake $0.01
Board [5c Tc 3s 7s]
Seat 1: chxxxs folded on the Turn
Seat 2: brontobronco (button) folded before Flop (didn't bet)
Seat 3: Ilmurat01 (small blind) collected ($0.14)
Seat 4: IamKeOpS (big blind) folded on the Turn
Seat 5: xorrobinhoox folded before Flop (didn't bet)
Seat 6: MrDonRich folded before Flop (didn't bet)


PokerStars Hand #238177343169:  Hold'em No Limit ($0.01/$0.02 USD) - 2022/08/23 18:45:21 ET
Table 'Equinox IV' 6-max Seat #3 is the button
Seat 1: chxxxs ($3.16 in chips)
Seat 2: brontobronco ($2.22 in chips)
Seat 3: Ilmurat01 ($1.45 in chips)
Seat 4: IamKeOpS ($2 in chips)
Seat 5: xorrobinhoox ($2.12 in chips)
Seat 6: MrDonRich ($4.49 in chips)
IamKeOpS: posts small blind $0.01
xorrobinhoox: posts big blind $0.02
*** HOLE CARDS ***
MrDonRich: folds
chxxxs: folds
brontobronco: folds
Ilmurat01: calls $0.02
IamKeOpS: folds
xorrobinhoox: checks
*** FLOP *** [7d 9s 5h]
xorrobinhoox: checks
Ilmurat01: checks
*** TURN *** [7d 9s 5h] [8h]
xorrobinhoox: checks
Ilmurat01: checks
*** RIVER *** [7d 9s 5h 8h] [6c]
xorrobinhoox: checks
Ilmurat01: bets $0.80
xorrobinhoox: raises $0.80 to $1.60
Ilmurat01: calls $0.63 and is all-in
Uncalled bet ($0.17) returned to xorrobinhoox
*** SHOW DOWN ***
xorrobinhoox: shows [3h Tc] (a straight, Six to Ten)
Ilmurat01: shows [Ts Qd] (a straight, Six to Ten)
xorrobinhoox collected $1.41 from pot
Ilmurat01 collected $1.40 from pot
*** SUMMARY ***
Total pot $2.91 | Rake $0.10
Board [7d 9s 5h 8h 6c]
Seat 1: chxxxs folded before Flop (didn't bet)
Seat 2: brontobronco folded before Flop (didn't bet)
Seat 3: Ilmurat01 (button) showed [Ts Qd] and won ($1.40) with a straight, Six to Ten
Seat 4: IamKeOpS (small blind) folded before Flop
Seat 5: xorrobinhoox (big blind) showed [3h Tc] and won ($1.41) with a straight, Six to Ten
Seat 6: MrDonRich folded before Flop (didn't bet)


PokerStars Hand #238177361398:  Hold'em No Limit ($0.01/$0.02 USD) - 2022/08/23 18:46:20 ET
Table 'Equinox IV' 6-max Seat #4 is the button
Seat 1: chxxxs ($3.16 in chips)
Seat 2: brontobronco ($2.22 in chips)
Seat 3: Ilmurat01 ($1.40 in chips)
Seat 4: IamKeOpS ($1.99 in chips)
Seat 5: xorrobinhoox ($2.08 in chips)
Seat 6: MrDonRich ($4.49 in chips)
xorrobinhoox: posts small blind $0.01
MrDonRich: posts big blind $0.02
*** HOLE CARDS ***
chxxxs: folds
brontobronco: folds
Ilmurat01: folds
IamKeOpS: raises $0.03 to $0.05
xorrobinhoox: folds
MrDonRich: folds
Uncalled bet ($0.03) returned to IamKeOpS
IamKeOpS collected $0.05 from pot
IamKeOpS: doesn't show hand
*** SUMMARY ***
Total pot $0.05 | Rake $0
Seat 1: chxxxs folded before Flop (didn't bet)
Seat 2: brontobronco folded before Flop (didn't bet)
Seat 3: Ilmurat01 folded before Flop (didn't bet)
Seat 4: IamKeOpS (button) collected ($0.05)
Seat 5: xorrobinhoox (small blind) folded before Flop
Seat 6: MrDonRich (big blind) folded before Flop


PokerStars Hand #238177367786:  Hold'em No Limit ($0.01/$0.02 USD) - 2022/08/23 18:46:40 ET
Table 'Equinox IV' 6-max Seat #5 is the button
Seat 1: chxxxs ($3.16 in chips)
Seat 2: brontobronco ($2.22 in chips)
Seat 3: Ilmurat01 ($1.40 in chips)
Seat 4: IamKeOpS ($2.02 in chips)
Seat 5: xorrobinhoox ($2.07 in chips)
Seat 6: MrDonRich ($4.47 in chips)
MrDonRich: posts small blind $0.01
chxxxs: posts big blind $0.02
*** HOLE CARDS ***
brontobronco: folds
Ilmurat01: calls $0.02
IamKeOpS: folds
xorrobinhoox: raises $0.06 to $0.08
MrDonRich: folds
chxxxs: folds
Ilmurat01: calls $0.06
*** FLOP *** [6d 8c Ac]
Ilmurat01: checks
xorrobinhoox: bets $0.09
Ilmurat01: calls $0.09
*** TURN *** [6d 8c Ac] [3d]
Ilmurat01: checks
xorrobinhoox: bets $0.18
Ilmurat01: calls $0.18
*** RIVER *** [6d 8c Ac 3d] [2d]
Ilmurat01: checks
xorrobinhoox: checks
*** SHOW DOWN ***
Ilmurat01: shows [2h 8h] (two pair, Eights and Deuces)
xorrobinhoox: mucks hand
Ilmurat01 collected $0.70 from pot
*** SUMMARY ***
Total pot $0.73 | Rake $0.03
Board [6d 8c Ac 3d 2d]
Seat 1: chxxxs (big blind) folded before Flop
Seat 2: brontobronco folded before Flop (didn't bet)
Seat 3: Ilmurat01 showed [2h 8h] and won ($0.70) with two pair, Eights and Deuces
Seat 4: IamKeOpS folded before Flop (didn't bet)
Seat 5: xorrobinhoox (button) mucked
Seat 6: MrDonRich (small blind) folded before Flop


PokerStars Hand #238177385709:  Hold'em No Limit ($0.01/$0.02 USD) - 2022/08/23 18:47:38 ET
Table 'Equinox IV' 6-max Seat #6 is the button
Seat 1: chxxxs ($3.14 in chips)
Seat 2: brontobronco ($2.22 in chips)
Seat 3: Ilmurat01 ($1.75 in chips)
Seat 4: IamKeOpS ($2.02 in chips)
Seat 5: xorrobinhoox ($1.72 in chips)
Seat 6: MrDonRich ($4.46 in chips)
chxxxs: posts small blind $0.01
brontobronco: posts big blind $0.02
*** HOLE CARDS ***
Ilmurat01: calls $0.02
IamKeOpS: folds
xorrobinhoox: folds
MrDonRich: calls $0.02
chxxxs: folds
brontobronco: checks
*** FLOP *** [3d 7s Kd]
brontobronco: bets $0.03
Ilmurat01: folds
MrDonRich: calls $0.03
*** TURN *** [3d 7s Kd] [As]
brontobronco: bets $0.06
MrDonRich: calls $0.06
*** RIVER *** [3d 7s Kd As] [8h]
brontobronco: bets $0.10
MrDonRich: calls $0.10
*** SHOW DOWN ***
brontobronco: shows [2d 7c] (a pair of Sevens)
MrDonRich: shows [2s Ad] (a pair of Aces)
MrDonRich collected $0.43 from pot
*** SUMMARY ***
Total pot $0.45 | Rake $0.02
Board [3d 7s Kd As 8h]
Seat 1: chxxxs (small blind) folded before Flop
Seat 2: brontobronco (big blind) showed [2d 7c] and lost with a pair of Sevens
Seat 3: Ilmurat01 folded on the Flop
Seat 4: IamKeOpS folded before Flop (didn't bet)
Seat 5: xorrobinhoox folded before Flop (didn't bet)
Seat 6: MrDonRich (button) showed [2s Ad] and won ($0.43) with a pair of Aces


PokerStars Hand #238177403367:  Hold'em No Limit ($0.01/$0.02 USD) - 2022/08/23 18:48:36 ET
Table 'Equinox IV' 6-max Seat #1 is the button
Seat 1: chxxxs ($3.13 in chips)
Seat 2: brontobronco ($2.01 in chips)
Seat 3: Ilmurat01 ($1.73 in chips)
Seat 4: IamKeOpS ($2.02 in chips)
Seat 5: xorrobinhoox ($1.72 in chips)
Seat 6: MrDonRich ($4.68 in chips)
brontobronco: posts small blind $0.01
Ilmurat01: posts big blind $0.02
*** HOLE CARDS ***
IamKeOpS: folds
xorrobinhoox has timed out
xorrobinhoox: folds
MrDonRich: folds
chxxxs: raises $0.03 to $0.05
brontobronco: folds
Ilmurat01: calls $0.03
*** FLOP *** [Qs Kd 2d]
Ilmurat01: checks
chxxxs: checks
*** TURN *** [Qs Kd 2d] [Ts]
Ilmurat01: bets $0.02
chxxxs: calls $0.02
*** RIVER *** [Qs Kd 2d Ts] [6d]
Ilmurat01: bets $0.07
chxxxs: folds
Uncalled bet ($0.07) returned to Ilmurat01
Ilmurat01 collected $0.14 from pot
*** SUMMARY ***
Total pot $0.15 | Rake $0.01
Board [Qs Kd 2d Ts 6d]
Seat 1: chxxxs (button) folded on the River
Seat 2: brontobronco (small blind) folded before Flop
Seat 3: Ilmurat01 (big blind) collected ($0.14)
Seat 4: IamKeOpS folded before Flop (didn't bet)
Seat 5: xorrobinhoox folded before Flop (didn't bet)
Seat 6: MrDonRich folded before Flop (didn't bet)


PokerStars Hand #238177419934:  Hold'em No Limit ($0.01/$0.02 USD) - 2022/08/23 18:49:30 ET
Table 'Equinox IV' 6-max Seat #2 is the button
Seat 1: chxxxs ($3.06 in chips)
Seat 2: brontobronco ($2 in chips)
Seat 3: Ilmurat01 ($1.80 in chips)
Seat 4: IamKeOpS ($2.02 in chips)
Seat 5: xorrobinhoox ($1.72 in chips)
Seat 6: MrDonRich ($4.68 in chips)
Ilmurat01: posts small blind $0.01
IamKeOpS: posts big blind $0.02
*** HOLE CARDS ***
xorrobinhoox: folds
MrDonRich: folds
chxxxs: folds
brontobronco: folds
Ilmurat01: calls $0.01
IamKeOpS: raises $0.06 to $0.08
Ilmurat01: folds
Uncalled bet ($0.06) returned to IamKeOpS
IamKeOpS collected $0.04 from pot
IamKeOpS: doesn't show hand
*** SUMMARY ***
Total pot $0.04 | Rake $0
Seat 1: chxxxs folded before Flop (didn't bet)
Seat 2: brontobronco (button) folded before Flop (didn't bet)
Seat 3: Ilmurat01 (small blind) folded before Flop
Seat 4: IamKeOpS (big blind) collected ($0.04)
Seat 5: xorrobinhoox folded before Flop (didn't bet)
Seat 6: MrDonRich folded before Flop (didn't bet)


PokerStars Hand #238177425990:  Hold'em No Limit ($0.01/$0.02 USD) - 2022/08/23 18:49:50 ET
Table 'Equinox IV' 6-max Seat #3 is the button
Seat 1: chxxxs ($3.06 in chips)
Seat 2: brontobronco ($2 in chips)
Seat 3: Ilmurat01 ($1.78 in chips)
Seat 4: IamKeOpS ($2.04 in chips)
Seat 5: xorrobinhoox ($1.72 in chips)
Seat 6: MrDonRich ($4.68 in chips)
IamKeOpS: posts small blind $0.01
xorrobinhoox: posts big blind $0.02
*** HOLE CARDS ***
MrDonRich: calls $0.02
chxxxs: folds
brontobronco: folds
Ilmurat01: calls $0.02
IamKeOpS: folds
xorrobinhoox: checks
*** FLOP *** [6d Td 4c]
xorrobinhoox: checks
MrDonRich: checks
Ilmurat01: bets $0.02
xorrobinhoox: folds
MrDonRich: calls $0.02
*** TURN *** [6d Td 4c] [7d]
MrDonRich: checks
Ilmurat01: bets $0.05
MrDonRich: folds
Uncalled bet ($0.05) returned to Ilmurat01
Ilmurat01 collected $0.11 from pot
*** SUMMARY ***
Total pot $0.11 | Rake $0
Board [6d Td 4c 7d]
Seat 1: chxxxs folded before Flop (didn't bet)
Seat 2: brontobronco folded before Flop (didn't bet)
Seat 3: Ilmurat01 (button) collected ($0.11)
Seat 4: IamKeOpS (small blind) folded before Flop
Seat 5: xorrobinhoox (big blind) folded on the Flop
Seat 6: MrDonRich folded on the Turn


PokerStars Hand #238177438389:  Hold'em No Limit ($0.01/$0.02 USD) - 2022/08/23 18:50:30 ET
Table 'Equinox IV' 6-max Seat #4 is the button
Seat 1: chxxxs ($3.06 in chips)
Seat 2: brontobronco ($2 in chips)
Seat 3: Ilmurat01 ($1.85 in chips)
Seat 4: IamKeOpS ($2.03 in chips)
Seat 5: xorrobinhoox ($1.70 in chips)
Seat 6: MrDonRich ($4.64 in chips)
xorrobinhoox: posts small blind $0.01
MrDonRich: posts big blind $0.02
*** HOLE CARDS ***
chxxxs: folds
brontobronco: raises $0.04 to $0.06
Ilmurat01: folds
IamKeOpS: folds
xorrobinhoox: calls $0.05
MrDonRich: folds
*** FLOP *** [9d Ac Ks]
xorrobinhoox: checks
brontobronco: bets $0.07
xorrobinhoox: calls $0.07
*** TURN *** [9d Ac Ks] [4d]
xorrobinhoox: checks
brontobronco: checks
*** RIVER *** [9d Ac Ks 4d] [9s]
xorrobinhoox: bets $0.13
brontobronco: folds
Uncalled bet ($0.13) returned to xorrobinhoox
xorrobinhoox collected $0.27 from pot
xorrobinhoox: doesn't show hand
*** SUMMARY ***
Total pot $0.28 | Rake $0.01
Board [9d Ac Ks 4d 9s]
Seat 1: chxxxs folded before Flop (didn't bet)
Seat 2: brontobronco folded on the River
Seat 3: Ilmurat01 folded before Flop (didn't bet)
Seat 4: IamKeOpS (button) folded before Flop (didn't bet)
Seat 5: xorrobinhoox (small blind) collected ($0.27)
Seat 6: MrDonRich (big blind) folded before Flop


PokerStars Hand #238177450677:  Hold'em No Limit ($0.01/$0.02 USD) - 2022/08/23 18:51:10 ET
Table 'Equinox IV' 6-max Seat #5 is the button
Seat 1: chxxxs ($3.06 in chips)
Seat 2: brontobronco ($2 in chips)
Seat 3: Ilmurat01 ($1.85 in chips)
Seat 4: IamKeOpS ($2.03 in chips)
Seat 5: xorrobinhoox ($1.84 in chips)
Seat 6: MrDonRich ($4.62 in chips)
MrDonRich: posts small blind $0.01
chxxxs: posts big blind $0.02
*** HOLE CARDS ***
brontobronco: raises $0.04 to $0.06
Ilmurat01: calls $0.06
IamKeOpS: folds
xorrobinhoox: folds
MrDonRich: calls $0.05
chxxxs: calls $0.04
*** FLOP *** [4c Td 8c]
MrDonRich: bets $0.15
chxxxs: folds
brontobronco: calls $0.15
Ilmurat01: folds
*** TURN *** [4c Td 8c] [5d]
MrDonRich: bets $0.52
brontobronco: folds
Uncalled bet ($0.52) returned to MrDonRich
MrDonRich collected $0.52 from pot
MrDonRich: doesn't show hand
*** SUMMARY ***
Total pot $0.54 | Rake $0.02
Board [4c Td 8c 5d]
Seat 1: chxxxs (big blind) folded on the Flop
Seat 2: brontobronco folded on the Turn
Seat 3: Ilmurat01 folded on the Flop
Seat 4: IamKeOpS folded before Flop (didn't bet)
Seat 5: xorrobinhoox (button) folded before Flop (didn't bet)
Seat 6: MrDonRich (small blind) collected ($0.52)


PokerStars Hand #238177459708:  Hold'em No Limit ($0.01/$0.02 USD) - 2022/08/23 18:51:40 ET
Table 'Equinox IV' 6-max Seat #6 is the button
Seat 1: chxxxs ($3 in chips)
Seat 2: brontobronco ($2 in chips)
Seat 3: Ilmurat01 ($1.79 in chips)
Seat 4: IamKeOpS ($2.03 in chips)
Seat 5: xorrobinhoox ($1.84 in chips)
Seat 6: MrDonRich ($4.93 in chips)
chxxxs: posts small blind $0.01
brontobronco: posts big blind $0.02
*** HOLE CARDS ***
Ilmurat01: calls $0.02
IamKeOpS: folds
xorrobinhoox: folds
MrDonRich: folds
chxxxs: raises $0.06 to $0.08
brontobronco: folds
Ilmurat01: folds
Uncalled bet ($0.06) returned to chxxxs
chxxxs collected $0.06 from pot
chxxxs: doesn't show hand
*** SUMMARY ***
Total pot $0.06 | Rake $0
Seat 1: chxxxs (small blind) collected ($0.06)
Seat 2: brontobronco (big blind) folded before Flop
Seat 3: Ilmurat01 folded before Flop
Seat 4: IamKeOpS folded before Flop (didn't bet)
Seat 5: xorrobinhoox folded before Flop (didn't bet)
Seat 6: MrDonRich (button) folded before Flop (didn't bet)


PokerStars Hand #238177466921:  Hold'em No Limit ($0.01/$0.02 USD) - 2022/08/23 18:52:04 ET
Table 'Equinox IV' 6-max Seat #1 is the button
Seat 1: chxxxs ($3.04 in chips)
Seat 2: brontobronco ($2 in chips)
Seat 3: Ilmurat01 ($1.77 in chips)
Seat 4: IamKeOpS ($2.03 in chips)
Seat 5: xorrobinhoox ($1.84 in chips)
Seat 6: MrDonRich ($4.93 in chips)
brontobronco: posts small blind $0.01
Ilmurat01: posts big blind $0.02
*** HOLE CARDS ***
IamKeOpS: folds
xorrobinhoox: folds
MrDonRich: calls $0.02
chxxxs: raises $0.10 to $0.12
brontobronco: folds
Ilmurat01: calls $0.10
MrDonRich: folds
*** FLOP *** [7c Ks As]
Ilmurat01: checks
chxxxs: bets $0.17
Ilmurat01: calls $0.17
*** TURN *** [7c Ks As] [9c]
Ilmurat01: checks
chxxxs: bets $0.39
Ilmurat01: calls $0.39
*** RIVER *** [7c Ks As 9c] [Qd]
Ilmurat01: checks
chxxxs: checks
*** SHOW DOWN ***
Ilmurat01: shows [4s Ac] (a pair of Aces)
chxxxs: shows [8d Ad] (a pair of Aces)
Ilmurat01 collected $0.67 from pot
chxxxs collected $0.67 from pot
*** SUMMARY ***
Total pot $1.39 | Rake $0.05
Board [7c Ks As 9c Qd]
Seat 1: chxxxs (button) showed [8d Ad] and won ($0.67) with a pair of Aces
Seat 2: brontobronco (small blind) folded before Flop
Seat 3: Ilmurat01 (big blind) showed [4s Ac] and won ($0.67) with a pair of Aces
Seat 4: IamKeOpS folded before Flop (didn't bet)
Seat 5: xorrobinhoox folded before Flop (didn't bet)
Seat 6: MrDonRich folded before Flop


PokerStars Hand #238177485849:  Hold'em No Limit ($0.01/$0.02 USD) - 2022/08/23 18:53:07 ET
Table 'Equinox IV' 6-max Seat #2 is the button
Seat 1: chxxxs ($3.03 in chips)
Seat 2: brontobronco ($2 in chips)
Seat 3: Ilmurat01 ($1.76 in chips)
Seat 4: IamKeOpS ($2.03 in chips)
Seat 5: xorrobinhoox ($1.84 in chips)
Seat 6: MrDonRich ($4.91 in chips)
Ilmurat01: posts small blind $0.01
IamKeOpS: posts big blind $0.02
*** HOLE CARDS ***
xorrobinhoox has timed out
xorrobinhoox: folds
MrDonRich: calls $0.02
chxxxs: folds
brontobronco: calls $0.02
Ilmurat01: calls $0.01
IamKeOpS: checks
*** FLOP *** [Ts Qc Jd]
Ilmurat01: checks
IamKeOpS: checks
MrDonRich: checks
brontobronco: checks
*** TURN *** [Ts Qc Jd] [Ah]
Ilmurat01: checks
IamKeOpS: checks
MrDonRich: checks
brontobronco: checks
*** RIVER *** [Ts Qc Jd Ah] [7d]
Ilmurat01: checks
IamKeOpS: checks
MrDonRich: checks
brontobronco: checks
*** SHOW DOWN ***
Ilmurat01: shows [Td 8s] (a pair of Tens)
IamKeOpS: shows [9h Tc] (a pair of Tens)
MrDonRich: shows [As 9s] (a pair of Aces)
brontobronco: mucks hand
MrDonRich collected $0.08 from pot
*** SUMMARY ***
Total pot $0.08 | Rake $0
Board [Ts Qc Jd Ah 7d]
Seat 1: chxxxs folded before Flop (didn't bet)
Seat 2: brontobronco (button) mucked
Seat 3: Ilmurat01 (small blind) showed [Td 8s] and lost with a pair of Tens
Seat 4: IamKeOpS (big blind) showed [9h Tc] and lost with a pair of Tens
Seat 5: xorrobinhoox folded before Flop (didn't bet)
Seat 6: MrDonRich showed [As 9s] and won ($0.08) with a pair of Aces


PokerStars Hand #238177503764:  Hold'em No Limit ($0.01/$0.02 USD) - 2022/08/23 18:54:07 ET
Table 'Equinox IV' 6-max Seat #3 is the button
Seat 1: chxxxs ($3.03 in chips)
Seat 2: brontobronco ($2 in chips)
Seat 3: Ilmurat01 ($1.74 in chips)
Seat 4: IamKeOpS ($2.01 in chips)
Seat 5: xorrobinhoox ($1.84 in chips)
Seat 6: MrDonRich ($4.97 in chips)
IamKeOpS: posts small blind $0.01
xorrobinhoox: posts big blind $0.02
*** HOLE CARDS ***
MrDonRich: folds
chxxxs: folds
brontobronco: raises $0.04 to $0.06
Ilmurat01: calls $0.06
IamKeOpS: folds
xorrobinhoox: folds
*** FLOP *** [5d 3h 9h]
brontobronco: bets $0.07
Ilmurat01: calls $0.07
*** TURN *** [5d 3h 9h] [Th]
brontobronco: bets $0.14
Ilmurat01: folds
Uncalled bet ($0.14) returned to brontobronco
brontobronco collected $0.28 from pot
*** SUMMARY ***
Total pot $0.29 | Rake $0.01
Board [5d 3h 9h Th]
Seat 1: chxxxs folded before Flop (didn't bet)
Seat 2: brontobronco collected ($0.28)
Seat 3: Ilmurat01 (button) folded on the Turn
Seat 4: IamKeOpS (small blind) folded before Flop
Seat 5: xorrobinhoox (big blind) folded before Flop
Seat 6: MrDonRich folded before Flop (didn't bet)


PokerStars Hand #238177514583:  Hold'em No Limit ($0.01/$0.02 USD) - 2022/08/23 18:54:43 ET
Table 'Equinox IV' 6-max Seat #4 is the button
Seat 1: chxxxs ($3.03 in chips)
Seat 2: brontobronco ($2.15 in chips)
Seat 3: Ilmurat01 ($1.61 in chips)
Seat 4: IamKeOpS ($2 in chips)
Seat 5: xorrobinhoox ($1.82 in chips)
Seat 6: MrDonRich ($4.97 in chips)
xorrobinhoox: posts small blind $0.01
MrDonRich: posts big blind $0.02
*** HOLE CARDS ***
chxxxs: folds
brontobronco: raises $0.04 to $0.06
Ilmurat01: calls $0.06
IamKeOpS: folds
xorrobinhoox: folds
MrDonRich: folds
*** FLOP *** [Qc Ad 7s]
brontobronco: bets $0.07
Ilmurat01: calls $0.07
*** TURN *** [Qc Ad 7s] [4c]
brontobronco: checks
Ilmurat01: checks
*** RIVER *** [Qc Ad 7s 4c] [2s]
brontobronco: checks
Ilmurat01: checks
*** SHOW DOWN ***
brontobronco: shows [Kc 7h] (a pair of Sevens)
Ilmurat01: mucks hand
brontobronco collected $0.28 from pot
*** SUMMARY ***
Total pot $0.29 | Rake $0.01
Board [Qc Ad 7s 4c 2s]
Seat 1: chxxxs folded before Flop (didn't bet)
Seat 2: brontobronco showed [Kc 7h] and won ($0.28) with a pair of Sevens
Seat 3: Ilmurat01 mucked
Seat 4: IamKeOpS (button) folded before Flop (didn't bet)
Seat 5: xorrobinhoox (small blind) folded before Flop
Seat 6: MrDonRich (big blind) folded before Flop


PokerStars Hand #238177530782:  Hold'em No Limit ($0.01/$0.02 USD) - 2022/08/23 18:55:43 ET
Table 'Equinox IV' 6-max Seat #5 is the button
Seat 1: chxxxs ($3.03 in chips)
Seat 2: brontobronco ($2.30 in chips)
Seat 3: Ilmurat01 ($1.48 in chips)
Seat 4: IamKeOpS ($2 in chips)
Seat 5: xorrobinhoox ($1.81 in chips)
Seat 6: MrDonRich ($4.95 in chips)
MrDonRich: posts small blind $0.01
chxxxs: posts big blind $0.02
*** HOLE CARDS ***
brontobronco: folds
Ilmurat01: calls $0.02
IamKeOpS: folds
xorrobinhoox: raises $0.06 to $0.08
MrDonRich: calls $0.07
chxxxs: folds
Ilmurat01: calls $0.06
*** FLOP *** [5d 2s 7d]
MrDonRich: checks
Ilmurat01: checks
xorrobinhoox: bets $0.12
MrDonRich: folds
Ilmurat01: calls $0.12
*** TURN *** [5d 2s 7d] [Qd]
Ilmurat01: checks
xorrobinhoox: bets $0.24
Ilmurat01: calls $0.24
*** RIVER *** [5d 2s 7d Qd] [6h]
Ilmurat01: checks
xorrobinhoox: checks
*** SHOW DOWN ***
Ilmurat01: shows [Kc Ad] (high card Ace)
xorrobinhoox: shows [6c 6d] (three of a kind, Sixes)
xorrobinhoox collected $0.95 from pot
*** SUMMARY ***
Total pot $0.98 | Rake $0.03
Board [5d 2s 7d Qd 6h]
Seat 1: chxxxs (big blind) folded before Flop
Seat 2: brontobronco folded before Flop (didn't bet)
Seat 3: Ilmurat01 showed [Kc Ad] and lost with high card Ace
Seat 4: IamKeOpS folded before Flop (didn't bet)
Seat 5: xorrobinhoox (button) showed [6c 6d] and won ($0.95) with three of a kind, Sixes
Seat 6: MrDonRich (small blind) folded on the Flop


PokerStars Hand #238177547103:  Hold'em No Limit ($0.01/$0.02 USD) - 2022/08/23 18:56:50 ET
Table 'Equinox IV' 6-max Seat #6 is the button
Seat 1: chxxxs ($3.01 in chips)
Seat 2: brontobronco ($2.30 in chips)
Seat 3: Ilmurat01 ($1.04 in chips)
Seat 4: IamKeOpS ($2 in chips)
Seat 5: xorrobinhoox ($2.32 in chips)
Seat 6: MrDonRich ($4.87 in chips)
chxxxs: posts small blind $0.01
brontobronco: posts big blind $0.02
*** HOLE CARDS ***
Ilmurat01: calls $0.02
IamKeOpS: folds
xorrobinhoox: calls $0.02
MrDonRich: folds
chxxxs: folds
brontobronco: checks
*** FLOP *** [Ts Kc 5h]
brontobronco: checks
Ilmurat01: checks
xorrobinhoox: bets $0.03
brontobronco: folds
Ilmurat01: folds
Uncalled bet ($0.03) returned to xorrobinhoox
xorrobinhoox collected $0.07 from pot
xorrobinhoox: doesn't show hand
*** SUMMARY ***
Total pot $0.07 | Rake $0
Board [Ts Kc 5h]
Seat 1: chxxxs (small blind) folded before Flop
Seat 2: brontobronco (big blind) folded on the Flop
Seat 3: Ilmurat01 folded on the Flop
Seat 4: IamKeOpS folded before Flop (didn't bet)
Seat 5: xorrobinhoox collected ($0.07)
Seat 6: MrDonRich (button) folded before Flop (didn't bet)


PokerStars Hand #238177555991:  Hold'em No Limit ($0.01/$0.02 USD) - 2022/08/23 18:57:27 ET
Table 'Equinox IV' 6-max Seat #1 is the button
Seat 1: chxxxs ($3 in chips)
Seat 2: brontobronco ($2.28 in chips)
Seat 3: Ilmurat01 ($1.02 in chips)
Seat 4: IamKeOpS ($2 in chips)
Seat 5: xorrobinhoox ($2.37 in chips)
Seat 6: MrDonRich ($4.87 in chips)
brontobronco: posts small blind $0.01
Ilmurat01: posts big blind $0.02
*** HOLE CARDS ***
IamKeOpS: folds
xorrobinhoox: folds
MrDonRich: calls $0.02
chxxxs: folds
brontobronco: folds
Ilmurat01: checks
*** FLOP *** [Qc Kd Kc]
Ilmurat01: checks
MrDonRich: checks
*** TURN *** [Qc Kd Kc] [Jd]
Ilmurat01: checks
MrDonRich: checks
*** RIVER *** [Qc Kd Kc Jd] [Kh]
Ilmurat01: checks
MrDonRich: checks
*** SHOW DOWN ***
Ilmurat01: shows [7s 8c] (three of a kind, Kings)
MrDonRich: shows [Ad 3c] (three of a kind, Kings - Ace kicker)
MrDonRich collected $0.05 from pot
*** SUMMARY ***
Total pot $0.05 | Rake $0
Board [Qc Kd Kc Jd Kh]
Seat 1: chxxxs (button) folded before Flop (didn't bet)
Seat 2: brontobronco (small blind) folded before Flop
Seat 3: Ilmurat01 (big blind) showed [7s 8c] and lost with three of a kind, Kings
Seat 4: IamKeOpS folded before Flop (didn't bet)
Seat 5: xorrobinhoox folded before Flop (didn't bet)
Seat 6: MrDonRich showed [Ad 3c] and won ($0.05) with three of a kind, Kings


PokerStars Hand #238177570716:  Hold'em No Limit ($0.01/$0.02 USD) - 2022/08/23 18:58:06 ET
Table 'Equinox IV' 6-max Seat #2 is the button
Seat 1: chxxxs ($3 in chips)
Seat 2: brontobronco ($2.27 in chips)
Seat 3: Ilmurat01 ($1 in chips)
Seat 4: IamKeOpS ($2 in chips)
Seat 5: xorrobinhoox ($2.37 in chips)
Seat 6: MrDonRich ($4.90 in chips)
Ilmurat01: posts small blind $0.01
IamKeOpS: posts big blind $0.02
*** HOLE CARDS ***
xorrobinhoox: folds
MrDonRich: folds
chxxxs: folds
brontobronco: folds
Ilmurat01: calls $0.01
IamKeOpS: checks
*** FLOP *** [7s Qs 5c]
Ilmurat01: checks
IamKeOpS: checks
*** TURN *** [7s Qs 5c] [Th]
Ilmurat01: bets $0.02
IamKeOpS: calls $0.02
*** RIVER *** [7s Qs 5c Th] [Jc]
Ilmurat01: bets $0.08
IamKeOpS: folds
Uncalled bet ($0.08) returned to Ilmurat01
Ilmurat01 collected $0.08 from pot
*** SUMMARY ***
Total pot $0.08 | Rake $0
Board [7s Qs 5c Th Jc]
Seat 1: chxxxs folded before Flop (didn't bet)
Seat 2: brontobronco (button) folded before Flop (didn't bet)
Seat 3: Ilmurat01 (small blind) collected ($0.08)
Seat 4: IamKeOpS (big blind) folded on the River
Seat 5: xorrobinhoox folded before Flop (didn't bet)
Seat 6: MrDonRich folded before Flop (didn't bet)


PokerStars Hand #238177577876:  Hold'em No Limit ($0.01/$0.02 USD) - 2022/08/23 18:58:35 ET
Table 'Equinox IV' 6-max Seat #3 is the button
Seat 1: chxxxs ($3 in chips)
Seat 2: brontobronco ($2.27 in chips)
Seat 3: Ilmurat01 ($1.04 in chips)
Seat 4: IamKeOpS ($2 in chips)
Seat 5: xorrobinhoox ($2.37 in chips)
Seat 6: MrDonRich ($4.90 in chips)
IamKeOpS: posts small blind $0.01
xorrobinhoox: posts big blind $0.02
*** HOLE CARDS ***
MrDonRich: folds
chxxxs: folds
brontobronco: raises $0.04 to $0.06
Ilmurat01: calls $0.06
IamKeOpS: folds
xorrobinhoox: raises $0.14 to $0.20
brontobronco: folds
Ilmurat01: calls $0.14
*** FLOP *** [Qd 6s Th]
xorrobinhoox: bets $0.22
Ilmurat01: folds
Uncalled bet ($0.22) returned to xorrobinhoox
xorrobinhoox collected $0.45 from pot
xorrobinhoox: doesn't show hand
*** SUMMARY ***
Total pot $0.47 | Rake $0.02
Board [Qd 6s Th]
Seat 1: chxxxs folded before Flop (didn't bet)
Seat 2: brontobronco folded before Flop
Seat 3: Ilmurat01 (button) folded on the Flop
Seat 4: IamKeOpS (small blind) folded before Flop
Seat 5: xorrobinhoox (big blind) collected ($0.45)
Seat 6: MrDonRich folded before Flop (didn't bet)


PokerStars Hand #238177595855:  Hold'em No Limit ($0.01/$0.02 USD) - 2022/08/23 18:59:15 ET
Table 'Equinox IV' 6-max Seat #4 is the button
Seat 1: chxxxs ($3 in chips)
Seat 2: brontobronco ($2.21 in chips)
Seat 3: Ilmurat01 ($0.84 in chips)
Seat 4: IamKeOpS ($1.99 in chips)
Seat 5: xorrobinhoox ($2.62 in chips)
Seat 6: MrDonRich ($4.90 in chips)
xorrobinhoox: posts small blind $0.01
MrDonRich: posts big blind $0.02
*** HOLE CARDS ***
chxxxs: folds
brontobronco: folds
Ilmurat01: calls $0.02
IamKeOpS: folds
xorrobinhoox: calls $0.01
MrDonRich: checks
*** FLOP *** [Td Jh 5h]
xorrobinhoox: checks
MrDonRich: checks
Ilmurat01: bets $0.03
xorrobinhoox: raises $0.05 to $0.08
MrDonRich: folds
Ilmurat01: calls $0.05
*** TURN *** [Td Jh 5h] [2d]
xorrobinhoox: checks
Ilmurat01: checks
*** RIVER *** [Td Jh 5h 2d] [6s]
xorrobinhoox: bets $0.21
Ilmurat01: folds
Uncalled bet ($0.21) returned to xorrobinhoox
xorrobinhoox collected $0.21 from pot
xorrobinhoox: doesn't show hand
*** SUMMARY ***
Total pot $0.22 | Rake $0.01
Board [Td Jh 5h 2d 6s]
Seat 1: chxxxs folded before Flop (didn't bet)
Seat 2: brontobronco folded before Flop (didn't bet)
Seat 3: Ilmurat01 folded on the River
Seat 4: IamKeOpS (button) folded before Flop (didn't bet)
Seat 5: xorrobinhoox (small blind) collected ($0.21)
Seat 6: MrDonRich (big blind) folded on the Flop


PokerStars Hand #238177607492:  Hold'em No Limit ($0.01/$0.02 USD) - 2022/08/23 19:00:03 ET
Table 'Equinox IV' 6-max Seat #5 is the button
Seat 1: chxxxs ($3 in chips)
Seat 2: brontobronco ($2.21 in chips)
Seat 3: Ilmurat01 ($0.74 in chips)
Seat 4: IamKeOpS ($1.99 in chips)
Seat 5: xorrobinhoox ($2.73 in chips)
Seat 6: MrDonRich ($4.88 in chips)
MrDonRich: posts small blind $0.01
chxxxs: posts big blind $0.02
*** HOLE CARDS ***
brontobronco: raises $0.04 to $0.06
Ilmurat01: calls $0.06
IamKeOpS: folds
xorrobinhoox: folds
MrDonRich: folds
chxxxs: folds
*** FLOP *** [As 4c 3s]
brontobronco: bets $0.07
Ilmurat01: calls $0.07
*** TURN *** [As 4c 3s] [8d]
brontobronco: checks
Ilmurat01: checks
*** RIVER *** [As 4c 3s 8d] [Tc]
brontobronco: bets $0.14
Ilmurat01: raises $0.14 to $0.28
brontobronco: folds
Uncalled bet ($0.14) returned to Ilmurat01
Ilmurat01 collected $0.55 from pot
*** SUMMARY ***
Total pot $0.57 | Rake $0.02
Board [As 4c 3s 8d Tc]
Seat 1: chxxxs (big blind) folded before Flop
Seat 2: brontobronco folded on the River
Seat 3: Ilmurat01 collected ($0.55)
Seat 4: IamKeOpS folded before Flop (didn't bet)
Seat 5: xorrobinhoox (button) folded before Flop (didn't bet)
Seat 6: MrDonRich (small blind) folded before Flop


PokerStars Hand #238177626398:  Hold'em No Limit ($0.01/$0.02 USD) - 2022/08/23 19:00:43 ET
Table 'Equinox IV' 6-max Seat #6 is the button
Seat 1: chxxxs ($2.98 in chips)
Seat 2: brontobronco ($2 in chips)
Seat 3: Ilmurat01 ($1.02 in chips)
Seat 4: IamKeOpS ($1.99 in chips)
Seat 5: xorrobinhoox ($2.73 in chips)
Seat 6: MrDonRich ($4.87 in chips)
chxxxs: posts small blind $0.01
brontobronco: posts big blind $0.02
*** HOLE CARDS ***
Ilmurat01: calls $0.02
IamKeOpS: raises $0.06 to $0.08
xorrobinhoox: folds
MrDonRich: folds
chxxxs: folds
brontobronco: folds
Ilmurat01: calls $0.06
*** FLOP *** [3c Jc Kc]
Ilmurat01: bets $0.18
IamKeOpS: calls $0.18
*** TURN *** [3c Jc Kc] [6d]
Ilmurat01: bets $0.26
IamKeOpS: raises $0.46 to $0.72
Ilmurat01: raises $0.04 to $0.76 and is all-in
IamKeOpS: calls $0.04
*** RIVER *** [3c Jc Kc 6d] [8d]
*** SHOW DOWN ***
Ilmurat01: shows [4d Jh] (a pair of Jacks)
IamKeOpS: shows [Ac 5c] (a flush, Ace high)
IamKeOpS collected $2 from pot
*** SUMMARY ***
Total pot $2.07 | Rake $0.07
Board [3c Jc Kc 6d 8d]
Seat 1: chxxxs (small blind) folded before Flop
Seat 2: brontobronco (big blind) folded before Flop
Seat 3: Ilmurat01 showed [4d Jh] and lost with a pair of Jacks
Seat 4: IamKeOpS showed [Ac 5c] and won ($2) with a flush, Ace high
Seat 5: xorrobinhoox folded before Flop (didn't bet)
Seat 6: MrDonRich (button) folded before Flop (didn't bet)


PokerStars Hand #238177647122:  Hold'em No Limit ($0.01/$0.02 USD) - 2022/08/23 19:01:56 ET
Table 'Equinox IV' 6-max Seat #1 is the button
Seat 1: chxxxs ($2.97 in chips)
Seat 2: brontobronco ($2 in chips)
Seat 4: IamKeOpS ($2.97 in chips)
Seat 5: xorrobinhoox ($2.73 in chips)
Seat 6: MrDonRich ($4.87 in chips)
brontobronco: posts small blind $0.01
IamKeOpS: posts big blind $0.02
*** HOLE CARDS ***
xorrobinhoox: folds
MrDonRich: calls $0.02
Ilmurat01 leaves the table
chxxxs: folds
brontobronco: calls $0.01
IamKeOpS: checks
*** FLOP *** [3h 4c 5s]
brontobronco: bets $0.03
IamKeOpS: calls $0.03
MrDonRich: calls $0.03
*** TURN *** [3h 4c 5s] [3s]
brontobronco: bets $0.07
IamKeOpS: calls $0.07
homero4021 joins the table at seat #3
MrDonRich: calls $0.07
*** RIVER *** [3h 4c 5s 3s] [3c]
brontobronco: bets $0.17
IamKeOpS: folds
MrDonRich: calls $0.17
*** SHOW DOWN ***
brontobronco: shows [Qc 5d] (a full house, Threes full of Fives)
MrDonRich: mucks hand
brontobronco collected $0.68 from pot
*** SUMMARY ***
Total pot $0.70 | Rake $0.02
Board [3h 4c 5s 3s 3c]
Seat 1: chxxxs (button) folded before Flop (didn't bet)
Seat 2: brontobronco (small blind) showed [Qc 5d] and won ($0.68) with a full house, Threes full of Fives
Seat 4: IamKeOpS (big blind) folded on the River
Seat 5: xorrobinhoox folded before Flop (didn't bet)
Seat 6: MrDonRich mucked


PokerStars Hand #238177666830:  Hold'em No Limit ($0.01/$0.02 USD) - 2022/08/23 19:03:03 ET
Table 'Equinox IV' 6-max Seat #2 is the button
Seat 1: chxxxs ($2.97 in chips)
Seat 2: brontobronco ($2.39 in chips)
Seat 4: IamKeOpS ($2.85 in chips)
Seat 5: xorrobinhoox ($2.73 in chips)
Seat 6: MrDonRich ($4.58 in chips)
IamKeOpS: posts small blind $0.01
xorrobinhoox: posts big blind $0.02
*** HOLE CARDS ***
MrDonRich: calls $0.02
chxxxs: folds
brontobronco: folds
IamKeOpS: folds
xorrobinhoox: checks
*** FLOP *** [6d 2d Jh]
xorrobinhoox: checks
MrDonRich: checks
*** TURN *** [6d 2d Jh] [Td]
xorrobinhoox: checks
MrDonRich: checks
*** RIVER *** [6d 2d Jh Td] [8h]
xorrobinhoox: checks
MrDonRich: checks
*** SHOW DOWN ***
xorrobinhoox: shows [Th 7c] (a pair of Tens)
MrDonRich: mucks hand
xorrobinhoox collected $0.05 from pot
*** SUMMARY ***
Total pot $0.05 | Rake $0
Board [6d 2d Jh Td 8h]
Seat 1: chxxxs folded before Flop (didn't bet)
Seat 2: brontobronco (button) folded before Flop (didn't bet)
Seat 4: IamKeOpS (small blind) folded before Flop
Seat 5: xorrobinhoox (big blind) showed [Th 7c] and won ($0.05) with a pair of Tens
Seat 6: MrDonRich mucked


PokerStars Hand #238177681545:  Hold'em No Limit ($0.01/$0.02 USD) - 2022/08/23 19:03:54 ET
Table 'Equinox IV' 6-max Seat #4 is the button
Seat 1: chxxxs ($2.97 in chips)
Seat 2: brontobronco ($2.39 in chips)
Seat 3: homero4021 ($2 in chips)
Seat 4: IamKeOpS ($2.84 in chips)
Seat 5: xorrobinhoox ($2.76 in chips)
Seat 6: MrDonRich ($4.56 in chips)
xorrobinhoox: posts small blind $0.01
MrDonRich: posts big blind $0.02
homero4021: posts big blind $0.02
*** HOLE CARDS ***
chxxxs: folds
brontobronco: raises $0.04 to $0.06
homero4021: calls $0.04
IamKeOpS: folds
xorrobinhoox: folds
MrDonRich: folds
*** FLOP *** [6h Jc 9d]
brontobronco: bets $0.07
homero4021: folds
Uncalled bet ($0.07) returned to brontobronco
brontobronco collected $0.14 from pot
*** SUMMARY ***
Total pot $0.15 | Rake $0.01
Board [6h Jc 9d]
Seat 1: chxxxs folded before Flop (didn't bet)
Seat 2: brontobronco collected ($0.14)
Seat 3: homero4021 folded on the Flop
Seat 4: IamKeOpS (button) folded before Flop (didn't bet)
Seat 5: xorrobinhoox (small blind) folded before Flop
Seat 6: MrDonRich (big blind) folded before Flop


PokerStars Hand #238177692428:  Hold'em No Limit ($0.01/$0.02 USD) - 2022/08/23 19:04:32 ET
Table 'Equinox IV' 6-max Seat #5 is the button
Seat 1: chxxxs ($2.97 in chips)
Seat 2: brontobronco ($2.47 in chips)
Seat 3: homero4021 ($1.94 in chips)
Seat 4: IamKeOpS ($2.84 in chips)
Seat 5: xorrobinhoox ($2.75 in chips)
Seat 6: MrDonRich ($4.54 in chips)
MrDonRich: posts small blind $0.01
chxxxs: posts big blind $0.02
*** HOLE CARDS ***
brontobronco: folds
homero4021: raises $0.02 to $0.04
IamKeOpS: folds
xorrobinhoox: folds
MrDonRich: folds
chxxxs: folds
Uncalled bet ($0.02) returned to homero4021
homero4021 collected $0.05 from pot
*** SUMMARY ***
Total pot $0.05 | Rake $0
Seat 1: chxxxs (big blind) folded before Flop
Seat 2: brontobronco folded before Flop (didn't bet)
Seat 3: homero4021 collected ($0.05)
Seat 4: IamKeOpS folded before Flop (didn't bet)
Seat 5: xorrobinhoox (button) folded before Flop (didn't bet)
Seat 6: MrDonRich (small blind) folded before Flop


PokerStars Hand #238177698748:  Hold'em No Limit ($0.01/$0.02 USD) - 2022/08/23 19:04:54 ET
Table 'Equinox IV' 6-max Seat #6 is the button
Seat 1: chxxxs ($2.95 in chips)
Seat 2: brontobronco ($2.47 in chips)
Seat 3: homero4021 ($1.97 in chips)
Seat 4: IamKeOpS ($2.84 in chips)
Seat 5: xorrobinhoox ($2.75 in chips)
Seat 6: MrDonRich ($4.53 in chips)
chxxxs: posts small blind $0.01
brontobronco: posts big blind $0.02
*** HOLE CARDS ***
homero4021: folds
IamKeOpS: folds
xorrobinhoox: folds
MrDonRich: raises $0.04 to $0.06
chxxxs: raises $0.14 to $0.20
brontobronco: folds
MrDonRich: folds
Uncalled bet ($0.14) returned to chxxxs
chxxxs collected $0.14 from pot
chxxxs: doesn't show hand
*** SUMMARY ***
Total pot $0.14 | Rake $0
Seat 1: chxxxs (small blind) collected ($0.14)
Seat 2: brontobronco (big blind) folded before Flop
Seat 3: homero4021 folded before Flop (didn't bet)
Seat 4: IamKeOpS folded before Flop (didn't bet)
Seat 5: xorrobinhoox folded before Flop (didn't bet)
Seat 6: MrDonRich (button) folded before Flop


PokerStars Hand #238177704032:  Hold'em No Limit ($0.01/$0.02 USD) - 2022/08/23 19:05:12 ET
Table 'Equinox IV' 6-max Seat #1 is the button
Seat 1: chxxxs ($3.03 in chips)
Seat 2: brontobronco ($2.45 in chips)
Seat 3: homero4021 ($1.97 in chips)
Seat 4: IamKeOpS ($2.84 in chips)
Seat 5: xorrobinhoox ($2.75 in chips)
Seat 6: MrDonRich ($4.47 in chips)
brontobronco: posts small blind $0.01
homero4021: posts big blind $0.02
*** HOLE CARDS ***
IamKeOpS: folds
xorrobinhoox: folds
MrDonRich: calls $0.02
chxxxs: folds
brontobronco: calls $0.01
homero4021: checks
*** FLOP *** [2c 4c 6d]
brontobronco: bets $0.03
homero4021: calls $0.03
MrDonRich: calls $0.03
*** TURN *** [2c 4c 6d] [5s]
brontobronco: checks
homero4021: bets $0.14
MrDonRich: calls $0.14
brontobronco: folds
*** RIVER *** [2c 4c 6d 5s] [4s]
homero4021: checks
MrDonRich: checks
*** SHOW DOWN ***
homero4021: shows [6h Qs] (two pair, Sixes and Fours)
MrDonRich: mucks hand
homero4021 collected $0.41 from pot
*** SUMMARY ***
Total pot $0.43 | Rake $0.02
Board [2c 4c 6d 5s 4s]
Seat 1: chxxxs (button) folded before Flop (didn't bet)
Seat 2: brontobronco (small blind) folded on the Turn
Seat 3: homero4021 (big blind) showed [6h Qs] and won ($0.41) with two pair, Sixes and Fours
Seat 4: IamKeOpS folded before Flop (didn't bet)
Seat 5: xorrobinhoox folded before Flop (didn't bet)
Seat 6: MrDonRich mucked


PokerStars Hand #238177720279:  Hold'em No Limit ($0.01/$0.02 USD) - 2022/08/23 19:06:08 ET
Table 'Equinox IV' 6-max Seat #2 is the button
Seat 1: chxxxs ($3.03 in chips)
Seat 2: brontobronco ($2.40 in chips)
Seat 3: homero4021 ($2.19 in chips)
Seat 4: IamKeOpS ($2.84 in chips)
Seat 5: xorrobinhoox ($2.75 in chips)
Seat 6: MrDonRich ($4.28 in chips)
homero4021: posts small blind $0.01
IamKeOpS: posts big blind $0.02
*** HOLE CARDS ***
xorrobinhoox has timed out
xorrobinhoox: folds
MrDonRich: calls $0.02
chxxxs: folds
brontobronco: calls $0.02
homero4021: calls $0.01
IamKeOpS: checks
*** FLOP *** [Ad 3d 2h]
homero4021: checks
IamKeOpS: checks
MrDonRich: checks
brontobronco: checks
*** TURN *** [Ad 3d 2h] [9c]
homero4021: checks
IamKeOpS: checks
MrDonRich: bets $0.02
brontobronco: folds
homero4021: calls $0.02
IamKeOpS: folds
*** RIVER *** [Ad 3d 2h 9c] [Ts]
homero4021: checks
MrDonRich: checks
*** SHOW DOWN ***
homero4021: shows [6h 2s] (a pair of Deuces)
MrDonRich: shows [Js 9s] (a pair of Nines)
MrDonRich collected $0.12 from pot
*** SUMMARY ***
Total pot $0.12 | Rake $0
Board [Ad 3d 2h 9c Ts]
Seat 1: chxxxs folded before Flop (didn't bet)
Seat 2: brontobronco (button) folded on the Turn
Seat 3: homero4021 (small blind) showed [6h 2s] and lost with a pair of Deuces
Seat 4: IamKeOpS (big blind) folded on the Turn
Seat 5: xorrobinhoox folded before Flop (didn't bet)
Seat 6: MrDonRich showed [Js 9s] and won ($0.12) with a pair of Nines


PokerStars Hand #238177738121:  Hold'em No Limit ($0.01/$0.02 USD) - 2022/08/23 19:07:09 ET
Table 'Equinox IV' 6-max Seat #3 is the button
Seat 1: chxxxs ($3.03 in chips)
Seat 2: brontobronco ($2.38 in chips)
Seat 3: homero4021 ($2.15 in chips)
Seat 4: IamKeOpS ($2.82 in chips)
Seat 5: xorrobinhoox ($2.75 in chips)
IamKeOpS: posts small blind $0.01
xorrobinhoox: posts big blind $0.02
*** HOLE CARDS ***
chxxxs: raises $0.04 to $0.06
brontobronco: folds
homero4021: folds
IamKeOpS: folds
xorrobinhoox: raises $0.06 to $0.12
chxxxs: calls $0.06
*** FLOP *** [8s 8c Jc]
xorrobinhoox: bets $0.06
chxxxs: folds
Uncalled bet ($0.06) returned to xorrobinhoox
xorrobinhoox collected $0.24 from pot
xorrobinhoox: doesn't show hand
*** SUMMARY ***
Total pot $0.25 | Rake $0.01
Board [8s 8c Jc]
Seat 1: chxxxs folded on the Flop
Seat 2: brontobronco folded before Flop (didn't bet)
Seat 3: homero4021 (button) folded before Flop (didn't bet)
Seat 4: IamKeOpS (small blind) folded before Flop
Seat 5: xorrobinhoox (big blind) collected ($0.24)


PokerStars Hand #238177758597:  Hold'em No Limit ($0.01/$0.02 USD) - 2022/08/23 19:08:20 ET
Table 'Equinox IV' 6-max Seat #4 is the button
Seat 1: chxxxs ($2.91 in chips)
Seat 2: brontobronco ($2.38 in chips)
Seat 3: homero4021 ($2.15 in chips)
Seat 4: IamKeOpS ($2.81 in chips)
Seat 5: xorrobinhoox ($2.87 in chips)
xorrobinhoox: posts small blind $0.01
chxxxs: posts big blind $0.02
*** HOLE CARDS ***
brontobronco: folds
homero4021: calls $0.02
IamKeOpS: raises $0.06 to $0.08
xorrobinhoox: folds
chxxxs: folds
homero4021: calls $0.06
*** FLOP *** [7h Qs Kc]
homero4021: checks
IamKeOpS: bets $0.09
homero4021: calls $0.09
*** TURN *** [7h Qs Kc] [6c]
homero4021: checks
IamKeOpS: checks
*** RIVER *** [7h Qs Kc 6c] [4h]
homero4021: checks
IamKeOpS: bets $0.12
homero4021: folds
Uncalled bet ($0.12) returned to IamKeOpS
IamKeOpS collected $0.36 from pot
*** SUMMARY ***
Total pot $0.37 | Rake $0.01
Board [7h Qs Kc 6c 4h]
Seat 1: chxxxs (big blind) folded before Flop
Seat 2: brontobronco folded before Flop (didn't bet)
Seat 3: homero4021 folded on the River
Seat 4: IamKeOpS (button) collected ($0.36)
Seat 5: xorrobinhoox (small blind) folded before Flop


PokerStars Hand #238177787060:  Hold'em No Limit ($0.01/$0.02 USD) - 2022/08/23 19:09:59 ET
Table 'Equinox IV' 6-max Seat #5 is the button
Seat 1: chxxxs ($2.89 in chips)
Seat 2: brontobronco ($2.38 in chips)
Seat 3: homero4021 ($1.98 in chips)
Seat 4: IamKeOpS ($3 in chips)
Seat 5: xorrobinhoox ($2.86 in chips)
chxxxs: posts small blind $0.01
brontobronco: posts big blind $0.02
*** HOLE CARDS ***
homero4021: raises $0.02 to $0.04
IamKeOpS: folds
xorrobinhoox: calls $0.04
chxxxs: folds
brontobronco: raises $0.02 to $0.06
homero4021: calls $0.02
xorrobinhoox: calls $0.02
*** FLOP *** [4c Ad Jh]
brontobronco: bets $0.09
homero4021: calls $0.09
xorrobinhoox: folds
*** TURN *** [4c Ad Jh] [7c]
brontobronco: bets $0.18
homero4021: folds
Uncalled bet ($0.18) returned to brontobronco
brontobronco collected $0.36 from pot
*** SUMMARY ***
Total pot $0.37 | Rake $0.01
Board [4c Ad Jh 7c]
Seat 1: chxxxs (small blind) folded before Flop
Seat 2: brontobronco (big blind) collected ($0.36)
Seat 3: homero4021 folded on the Turn
Seat 4: IamKeOpS folded before Flop (didn't bet)
Seat 5: xorrobinhoox (button) folded on the Flop


PokerStars Hand #238177809709:  Hold'em No Limit ($0.01/$0.02 USD) - 2022/08/23 19:11:18 ET
Table 'Equinox IV' 6-max Seat #1 is the button
Seat 1: chxxxs ($2.88 in chips)
Seat 2: brontobronco ($2.59 in chips)
Seat 3: homero4021 ($1.83 in chips)
Seat 4: IamKeOpS ($3 in chips)
Seat 5: xorrobinhoox ($2.80 in chips)
brontobronco: posts small blind $0.01
homero4021: posts big blind $0.02
*** HOLE CARDS ***
IamKeOpS: folds
xorrobinhoox: folds
chxxxs: folds
brontobronco: raises $0.04 to $0.06
homero4021: calls $0.04
*** FLOP *** [9h Ah Jh]
brontobronco: bets $0.06
homero4021: calls $0.06
*** TURN *** [9h Ah Jh] [As]
brontobronco: bets $0.11
homero4021: calls $0.11
*** RIVER *** [9h Ah Jh As] [5c]
brontobronco: bets $0.14
homero4021: calls $0.14
*** SHOW DOWN ***
brontobronco: shows [2c Ac] (three of a kind, Aces)
homero4021: mucks hand
brontobronco collected $0.71 from pot
*** SUMMARY ***
Total pot $0.74 | Rake $0.03
Board [9h Ah Jh As 5c]
Seat 1: chxxxs (button) folded before Flop (didn't bet)
Seat 2: brontobronco (small blind) showed [2c Ac] and won ($0.71) with three of a kind, Aces
Seat 3: homero4021 (big blind) mucked
Seat 4: IamKeOpS folded before Flop (didn't bet)
Seat 5: xorrobinhoox folded before Flop (didn't bet)


PokerStars Hand #238177824492:  Hold'em No Limit ($0.01/$0.02 USD) - 2022/08/23 19:12:11 ET
Table 'Equinox IV' 6-max Seat #2 is the button
Seat 1: chxxxs ($2.88 in chips)
Seat 2: brontobronco ($2.93 in chips)
Seat 3: homero4021 ($1.46 in chips)
Seat 4: IamKeOpS ($3 in chips)
Seat 5: xorrobinhoox ($2.80 in chips)
homero4021: posts small blind $0.01
IamKeOpS: posts big blind $0.02
*** HOLE CARDS ***
xorrobinhoox: folds
chxxxs: folds
brontobronco: raises $0.04 to $0.06
homero4021: calls $0.05
IamKeOpS: folds
*** FLOP *** [Ks Tc Kc]
homero4021: checks
brontobronco: bets $0.07
homero4021: folds
Uncalled bet ($0.07) returned to brontobronco
brontobronco collected $0.14 from pot
*** SUMMARY ***
Total pot $0.14 | Rake $0
Board [Ks Tc Kc]
Seat 1: chxxxs folded before Flop (didn't bet)
Seat 2: brontobronco (button) collected ($0.14)
Seat 3: homero4021 (small blind) folded on the Flop
Seat 4: IamKeOpS (big blind) folded before Flop
Seat 5: xorrobinhoox folded before Flop (didn't bet)


PokerStars Hand #238177833493:  Hold'em No Limit ($0.01/$0.02 USD) - 2022/08/23 19:12:43 ET
Table 'Equinox IV' 6-max Seat #3 is the button
Seat 1: chxxxs ($2.88 in chips)
Seat 2: brontobronco ($3.01 in chips)
Seat 3: homero4021 ($1.40 in chips)
Seat 4: IamKeOpS ($2.98 in chips)
Seat 5: xorrobinhoox ($2.80 in chips)
IamKeOpS: posts small blind $0.01
xorrobinhoox: posts big blind $0.02
*** HOLE CARDS ***
chxxxs: raises $0.04 to $0.06
brontobronco: folds
homero4021: folds
IamKeOpS: folds
xorrobinhoox: folds
Uncalled bet ($0.04) returned to chxxxs
chxxxs collected $0.05 from pot
chxxxs: doesn't show hand
*** SUMMARY ***
Total pot $0.05 | Rake $0
Seat 1: chxxxs collected ($0.05)
Seat 2: brontobronco folded before Flop (didn't bet)
Seat 3: homero4021 (button) folded before Flop (didn't bet)
Seat 4: IamKeOpS (small blind) folded before Flop
Seat 5: xorrobinhoox (big blind) folded before Flop


PokerStars Hand #238177839859:  Hold'em No Limit ($0.01/$0.02 USD) - 2022/08/23 19:13:06 ET
Table 'Equinox IV' 6-max Seat #4 is the button
Seat 1: chxxxs ($2.91 in chips)
Seat 2: brontobronco ($3.01 in chips)
Seat 3: homero4021 ($1.40 in chips)
Seat 4: IamKeOpS ($2.97 in chips)
Seat 5: xorrobinhoox ($2.78 in chips)
xorrobinhoox: posts small blind $0.01
chxxxs: posts big blind $0.02
*** HOLE CARDS ***
brontobronco: folds
homero4021: calls $0.02
IamKeOpS: folds
xorrobinhoox: folds
chxxxs: checks
*** FLOP *** [Td Jd 9s]
chxxxs: checks
homero4021: checks
*** TURN *** [Td Jd 9s] [Ah]
chxxxs: checks
homero4021: checks
*** RIVER *** [Td Jd 9s Ah] [8h]
chxxxs: checks
homero4021: bets $0.05
chxxxs: folds
Uncalled bet ($0.05) returned to homero4021
homero4021 collected $0.05 from pot
*** SUMMARY ***
Total pot $0.05 | Rake $0
Board [Td Jd 9s Ah 8h]
Seat 1: chxxxs (big blind) folded on the River
Seat 2: brontobronco folded before Flop (didn't bet)
Seat 3: homero4021 collected ($0.05)
Seat 4: IamKeOpS (button) folded before Flop (didn't bet)
Seat 5: xorrobinhoox (small blind) folded before Flop


PokerStars Hand #238177854388:  Hold'em No Limit ($0.01/$0.02 USD) - 2022/08/23 19:13:58 ET
Table 'Equinox IV' 6-max Seat #5 is the button
Seat 1: chxxxs ($2.89 in chips)
Seat 3: homero4021 ($1.43 in chips)
Seat 4: IamKeOpS ($2.97 in chips)
Seat 5: xorrobinhoox ($2.77 in chips)
chxxxs: posts small blind $0.01
brontobronco: is sitting out
homero4021: posts big blind $0.02
*** HOLE CARDS ***
IamKeOpS: folds
xorrobinhoox: folds
chxxxs: raises $0.03 to $0.05
homero4021: folds
Uncalled bet ($0.03) returned to chxxxs
chxxxs collected $0.04 from pot
chxxxs: doesn't show hand
*** SUMMARY ***
Total pot $0.04 | Rake $0
Seat 1: chxxxs (small blind) collected ($0.04)
Seat 3: homero4021 (big blind) folded before Flop
Seat 4: IamKeOpS folded before Flop (didn't bet)
Seat 5: xorrobinhoox (button) folded before Flop (didn't bet)


PokerStars Hand #238177859760:  Hold'em No Limit ($0.01/$0.02 USD) - 2022/08/23 19:14:17 ET
Table 'Equinox IV' 6-max Seat #1 is the button
Seat 1: chxxxs ($2.91 in chips)
Seat 3: homero4021 ($1.41 in chips)
Seat 4: IamKeOpS ($2.97 in chips)
Seat 5: xorrobinhoox ($2.77 in chips)
homero4021: posts small blind $0.01
IamKeOpS: posts big blind $0.02
*** HOLE CARDS ***
xorrobinhoox: folds
chxxxs: folds
homero4021: calls $0.01
IamKeOpS: checks
*** FLOP *** [As 4s Kd]
homero4021: bets $0.02
IamKeOpS: folds
Uncalled bet ($0.02) returned to homero4021
homero4021 collected $0.04 from pot
*** SUMMARY ***
Total pot $0.04 | Rake $0
Board [As 4s Kd]
Seat 1: chxxxs (button) folded before Flop (didn't bet)
Seat 3: homero4021 (small blind) collected ($0.04)
Seat 4: IamKeOpS (big blind) folded on the Flop
Seat 5: xorrobinhoox folded before Flop (didn't bet)


PokerStars Hand #238177867377:  Hold'em No Limit ($0.01/$0.02 USD) - 2022/08/23 19:14:45 ET
Table 'Equinox IV' 6-max Seat #3 is the button
Seat 1: chxxxs ($2.91 in chips)
Seat 3: homero4021 ($1.43 in chips)
Seat 4: IamKeOpS ($2.95 in chips)
Seat 5: xorrobinhoox ($2.77 in chips)
IamKeOpS: posts small blind $0.01
xorrobinhoox: posts big blind $0.02
MrDonRich: sits out
*** HOLE CARDS ***
chxxxs: folds
homero4021: calls $0.02
IamKeOpS: folds
xorrobinhoox: checks
*** FLOP *** [Qs Kd Jc]
xorrobinhoox: checks
homero4021: bets $1.41 and is all-in
xorrobinhoox: folds
Uncalled bet ($1.41) returned to homero4021
homero4021 collected $0.05 from pot
*** SUMMARY ***
Total pot $0.05 | Rake $0
Board [Qs Kd Jc]
Seat 1: chxxxs folded before Flop (didn't bet)
Seat 3: homero4021 (button) collected ($0.05)
Seat 4: IamKeOpS (small blind) folded before Flop
Seat 5: xorrobinhoox (big blind) folded on the Flop


PokerStars Hand #238177873216:  Hold'em No Limit ($0.01/$0.02 USD) - 2022/08/23 19:15:05 ET
Table 'Equinox IV' 6-max Seat #4 is the button
Seat 1: chxxxs ($2.91 in chips)
Seat 3: homero4021 ($1.46 in chips)
Seat 4: IamKeOpS ($2.94 in chips)
Seat 5: xorrobinhoox ($2.75 in chips)
Seat 6: MrDonRich ($4.36 in chips)
xorrobinhoox: posts small blind $0.01
MrDonRich: posts big blind $0.02
*** HOLE CARDS ***
chxxxs: folds
homero4021: calls $0.02
IamKeOpS: raises $0.06 to $0.08
xorrobinhoox: folds
MrDonRich: folds
homero4021: calls $0.06
*** FLOP *** [3c 4c 4d]
homero4021: checks
IamKeOpS: bets $0.09
homero4021: folds
Uncalled bet ($0.09) returned to IamKeOpS
IamKeOpS collected $0.18 from pot
IamKeOpS: doesn't show hand
*** SUMMARY ***
Total pot $0.19 | Rake $0.01
Board [3c 4c 4d]
Seat 1: chxxxs folded before Flop (didn't bet)
Seat 3: homero4021 folded on the Flop
Seat 4: IamKeOpS (button) collected ($0.18)
Seat 5: xorrobinhoox (small blind) folded before Flop
Seat 6: MrDonRich (big blind) folded before Flop


PokerStars Hand #238177893220:  Hold'em No Limit ($0.01/$0.02 USD) - 2022/08/23 19:16:16 ET
Table 'Equinox IV' 6-max Seat #5 is the button
Seat 1: chxxxs ($2.91 in chips)
Seat 3: homero4021 ($1.38 in chips)
Seat 4: IamKeOpS ($3.04 in chips)
Seat 5: xorrobinhoox ($2.74 in chips)
Seat 6: MrDonRich ($4.34 in chips)
MrDonRich: posts small blind $0.01
chxxxs: posts big blind $0.02
brontobronco: sits out
*** HOLE CARDS ***
homero4021: folds
IamKeOpS: folds
xorrobinhoox: folds
MrDonRich: calls $0.01
chxxxs: checks
*** FLOP *** [8c Jc Js]
MrDonRich: checks
chxxxs: checks
*** TURN *** [8c Jc Js] [5c]
MrDonRich: bets $0.02
chxxxs: calls $0.02
*** RIVER *** [8c Jc Js 5c] [Qc]
MrDonRich: bets $0.08
chxxxs: folds
Uncalled bet ($0.08) returned to MrDonRich
MrDonRich collected $0.08 from pot
MrDonRich: doesn't show hand
*** SUMMARY ***
Total pot $0.08 | Rake $0
Board [8c Jc Js 5c Qc]
Seat 1: chxxxs (big blind) folded on the River
Seat 3: homero4021 folded before Flop (didn't bet)
Seat 4: IamKeOpS folded before Flop (didn't bet)
Seat 5: xorrobinhoox (button) folded before Flop (didn't bet)
Seat 6: MrDonRich (small blind) collected ($0.08)


PokerStars Hand #238177901710:  Hold'em No Limit ($0.01/$0.02 USD) - 2022/08/23 19:16:46 ET
Table 'Equinox IV' 6-max Seat #6 is the button
Seat 1: chxxxs ($2.87 in chips)
Seat 2: brontobronco ($3.01 in chips)
Seat 3: homero4021 ($1.38 in chips)
Seat 4: IamKeOpS ($3.04 in chips)
Seat 5: xorrobinhoox ($2.74 in chips)
Seat 6: MrDonRich ($4.38 in chips)
chxxxs: posts small blind $0.01
brontobronco: posts big blind $0.02
*** HOLE CARDS ***
homero4021: calls $0.02
IamKeOpS: folds
xorrobinhoox: raises $0.06 to $0.08
MrDonRich: folds
chxxxs: folds
brontobronco: folds
homero4021: calls $0.06
*** FLOP *** [4s 4c 2d]
homero4021: checks
xorrobinhoox: checks
*** TURN *** [4s 4c 2d] [Kc]
homero4021: checks
xorrobinhoox: bets $0.18
homero4021: folds
Uncalled bet ($0.18) returned to xorrobinhoox
xorrobinhoox collected $0.18 from pot
xorrobinhoox: doesn't show hand
*** SUMMARY ***
Total pot $0.19 | Rake $0.01
Board [4s 4c 2d Kc]
Seat 1: chxxxs (small blind) folded before Flop
Seat 2: brontobronco (big blind) folded before Flop
Seat 3: homero4021 folded on the Turn
Seat 4: IamKeOpS folded before Flop (didn't bet)
Seat 5: xorrobinhoox collected ($0.18)
Seat 6: MrDonRich (button) folded before Flop (didn't bet)


PokerStars Hand #238177913313:  Hold'em No Limit ($0.01/$0.02 USD) - 2022/08/23 19:17:27 ET
Table 'Equinox IV' 6-max Seat #1 is the button
Seat 1: chxxxs ($2.86 in chips)
Seat 2: brontobronco ($2.99 in chips)
Seat 3: homero4021 ($1.30 in chips)
Seat 4: IamKeOpS ($3.04 in chips)
Seat 5: xorrobinhoox ($2.84 in chips)
Seat 6: MrDonRich ($4.38 in chips)
brontobronco: posts small blind $0.01
homero4021: posts big blind $0.02
*** HOLE CARDS ***
IamKeOpS: folds
xorrobinhoox: folds
MrDonRich: folds
chxxxs: raises $0.03 to $0.05
brontobronco: raises $0.09 to $0.14
homero4021: folds
chxxxs: calls $0.09
*** FLOP *** [Ad 6d Qh]
brontobronco: bets $0.14
chxxxs: calls $0.14
*** TURN *** [Ad 6d Qh] [Th]
brontobronco: bets $0.18
chxxxs: folds
Uncalled bet ($0.18) returned to brontobronco
brontobronco collected $0.56 from pot
*** SUMMARY ***
Total pot $0.58 | Rake $0.02
Board [Ad 6d Qh Th]
Seat 1: chxxxs (button) folded on the Turn
Seat 2: brontobronco (small blind) collected ($0.56)
Seat 3: homero4021 (big blind) folded before Flop
Seat 4: IamKeOpS folded before Flop (didn't bet)
Seat 5: xorrobinhoox folded before Flop (didn't bet)
Seat 6: MrDonRich folded before Flop (didn't bet)


PokerStars Hand #238177925589:  Hold'em No Limit ($0.01/$0.02 USD) - 2022/08/23 19:18:10 ET
Table 'Equinox IV' 6-max Seat #2 is the button
Seat 1: chxxxs ($2.58 in chips)
Seat 2: brontobronco ($3.27 in chips)
Seat 3: homero4021 ($1.28 in chips)
Seat 4: IamKeOpS ($3.04 in chips)
Seat 5: xorrobinhoox ($2.84 in chips)
Seat 6: MrDonRich ($4.38 in chips)
homero4021: posts small blind $0.01
IamKeOpS: posts big blind $0.02
*** HOLE CARDS ***
xorrobinhoox: raises $0.03 to $0.05
MrDonRich: folds
chxxxs: folds
brontobronco: calls $0.05
homero4021: calls $0.04
IamKeOpS: folds
*** FLOP *** [Ad 4h 9c]
homero4021: checks
xorrobinhoox: checks
brontobronco: bets $0.12
homero4021: folds
xorrobinhoox: calls $0.12
*** TURN *** [Ad 4h 9c] [Js]
xorrobinhoox: checks
brontobronco: checks
*** RIVER *** [Ad 4h 9c Js] [Ks]
xorrobinhoox: checks
brontobronco: checks
*** SHOW DOWN ***
xorrobinhoox: shows [Qd Qs] (a pair of Queens)
brontobronco: shows [As 2h] (a pair of Aces)
brontobronco collected $0.40 from pot
*** SUMMARY ***
Total pot $0.41 | Rake $0.01
Board [Ad 4h 9c Js Ks]
Seat 1: chxxxs folded before Flop (didn't bet)
Seat 2: brontobronco (button) showed [As 2h] and won ($0.40) with a pair of Aces
Seat 3: homero4021 (small blind) folded on the Flop
Seat 4: IamKeOpS (big blind) folded before Flop
Seat 5: xorrobinhoox showed [Qd Qs] and lost with a pair of Queens
Seat 6: MrDonRich folded before Flop (didn't bet)


PokerStars Hand #238177975289:  Hold'em No Limit ($0.01/$0.02 USD) - 2022/08/23 19:20:48 ET
Table 'Equinox IV' 6-max Seat #6 is the button
Seat 1: chxxxs ($2.29 in chips)
Seat 2: brontobronco ($3.50 in chips)
Seat 3: homero4021 ($1.23 in chips)
Seat 4: IamKeOpS ($3.01 in chips)
Seat 5: xorrobinhoox ($2.99 in chips)
Seat 6: MrDonRich ($4.34 in chips)
chxxxs: posts small blind $0.01
brontobronco: posts big blind $0.02
*** HOLE CARDS ***
homero4021: folds
IamKeOpS: folds
xorrobinhoox: folds
MrDonRich: raises $0.04 to $0.06
chxxxs: folds
brontobronco: folds
Uncalled bet ($0.04) returned to MrDonRich
MrDonRich collected $0.05 from pot
MrDonRich: doesn't show hand
*** SUMMARY ***
Total pot $0.05 | Rake $0
Seat 1: chxxxs (small blind) folded before Flop
Seat 2: brontobronco (big blind) folded before Flop
Seat 3: homero4021 folded before Flop (didn't bet)
Seat 4: IamKeOpS folded before Flop (didn't bet)
Seat 5: xorrobinhoox folded before Flop (didn't bet)
Seat 6: MrDonRich (button) collected ($0.05)


PokerStars Hand #238177962408:  Hold'em No Limit ($0.01/$0.02 USD) - 2022/08/23 19:20:24 ET
Table 'Equinox IV' 6-max Seat #5 is the button
Seat 1: chxxxs ($2.27 in chips)
Seat 2: brontobronco ($3.50 in chips)
Seat 3: homero4021 ($1.23 in chips)
Seat 4: IamKeOpS ($3.01 in chips)
Seat 5: xorrobinhoox ($2.99 in chips)
Seat 6: MrDonRich ($4.36 in chips)
MrDonRich: posts small blind $0.01
chxxxs: posts big blind $0.02
*** HOLE CARDS ***
brontobronco: folds
homero4021: folds
IamKeOpS: folds
xorrobinhoox: folds
MrDonRich: calls $0.01
chxxxs: checks
*** FLOP *** [Qh Kh Jh]
MrDonRich: checks
chxxxs: bets $0.02
MrDonRich: folds
Uncalled bet ($0.02) returned to chxxxs
chxxxs collected $0.04 from pot
chxxxs: doesn't show hand
*** SUMMARY ***
Total pot $0.04 | Rake $0
Board [Qh Kh Jh]
Seat 1: chxxxs (big blind) collected ($0.04)
Seat 2: brontobronco folded before Flop (didn't bet)
Seat 3: homero4021 folded before Flop (didn't bet)
Seat 4: IamKeOpS folded before Flop (didn't bet)
Seat 5: xorrobinhoox (button) folded before Flop (didn't bet)
Seat 6: MrDonRich (small blind) folded on the Flop


PokerStars Hand #238177950658:  Hold'em No Limit ($0.01/$0.02 USD) - 2022/08/23 19:19:39 ET
Table 'Equinox IV' 6-max Seat #4 is the button
Seat 1: chxxxs ($2.27 in chips)
Seat 2: brontobronco ($3.50 in chips)
Seat 3: homero4021 ($1.23 in chips)
Seat 4: IamKeOpS ($3.01 in chips)
Seat 5: xorrobinhoox ($2.97 in chips)
Seat 6: MrDonRich ($4.38 in chips)
xorrobinhoox: posts small blind $0.01
MrDonRich: posts big blind $0.02
*** HOLE CARDS ***
chxxxs: folds
brontobronco: folds
homero4021: folds
IamKeOpS: folds
xorrobinhoox: calls $0.01
MrDonRich: checks
*** FLOP *** [7h 8h Qs]
xorrobinhoox: checks
MrDonRich: checks
*** TURN *** [7h 8h Qs] [7s]
xorrobinhoox: checks
MrDonRich: checks
*** RIVER *** [7h 8h Qs 7s] [9d]
xorrobinhoox: checks
MrDonRich: checks
*** SHOW DOWN ***
xorrobinhoox: shows [8d Jc] (two pair, Eights and Sevens)
MrDonRich: mucks hand
xorrobinhoox collected $0.04 from pot
*** SUMMARY ***
Total pot $0.04 | Rake $0
Board [7h 8h Qs 7s 9d]
Seat 1: chxxxs folded before Flop (didn't bet)
Seat 2: brontobronco folded before Flop (didn't bet)
Seat 3: homero4021 folded before Flop (didn't bet)
Seat 4: IamKeOpS (button) folded before Flop (didn't bet)
Seat 5: xorrobinhoox (small blind) showed [8d Jc] and won ($0.04) with two pair, Eights and Sevens
Seat 6: MrDonRich (big blind) mucked


PokerStars Hand #238177938396:  Hold'em No Limit ($0.01/$0.02 USD) - 2022/08/23 19:18:55 ET
Table 'Equinox IV' 6-max Seat #3 is the button
Seat 1: chxxxs ($2.58 in chips)
Seat 2: brontobronco ($3.50 in chips)
Seat 3: homero4021 ($1.23 in chips)
Seat 4: IamKeOpS ($3.02 in chips)
Seat 5: xorrobinhoox ($2.67 in chips)
Seat 6: MrDonRich ($4.38 in chips)
IamKeOpS: posts small blind $0.01
xorrobinhoox: posts big blind $0.02
*** HOLE CARDS ***
MrDonRich: folds
chxxxs: raises $0.04 to $0.06
brontobronco: folds
homero4021: folds
IamKeOpS: folds
xorrobinhoox: calls $0.04
*** FLOP *** [9d 7h 3s]
xorrobinhoox: checks
chxxxs: bets $0.08
xorrobinhoox: calls $0.08
*** TURN *** [9d 7h 3s] [8s]
xorrobinhoox: checks
chxxxs: bets $0.17
xorrobinhoox: calls $0.17
*** RIVER *** [9d 7h 3s 8s] [2s]
xorrobinhoox: checks
chxxxs: checks
*** SHOW DOWN ***
xorrobinhoox: shows [Th Jd] (a straight, Seven to Jack)
chxxxs: mucks hand
xorrobinhoox collected $0.61 from pot
*** SUMMARY ***
Total pot $0.63 | Rake $0.02
Board [9d 7h 3s 8s 2s]
Seat 1: chxxxs mucked
Seat 2: brontobronco folded before Flop (didn't bet)
Seat 3: homero4021 (button) folded before Flop (didn't bet)
Seat 4: IamKeOpS (small blind) folded before Flop
Seat 5: xorrobinhoox (big blind) showed [Th Jd] and won ($0.61) with a straight, Seven to Jack
Seat 6: MrDonRich folded before Flop (didn't bet)


PokerStars Hand #238177981628:  Hold'em No Limit ($0.01/$0.02 USD) - 2022/08/23 19:21:10 ET
Table 'Equinox IV' 6-max Seat #1 is the button
Seat 1: chxxxs ($2.28 in chips)
Seat 2: brontobronco ($3.48 in chips)
Seat 3: homero4021 ($1.23 in chips)
Seat 4: IamKeOpS ($3.01 in chips)
Seat 5: xorrobinhoox ($2.99 in chips)
Seat 6: MrDonRich ($4.37 in chips)
brontobronco: posts small blind $0.01
homero4021: posts big blind $0.02
*** HOLE CARDS ***
IamKeOpS: folds
xorrobinhoox: folds
MrDonRich: calls $0.02
chxxxs: folds
brontobronco: calls $0.01
homero4021: checks
*** FLOP *** [6c 6h Js]
brontobronco: bets $0.03
homero4021: raises $0.03 to $0.06
MrDonRich: calls $0.06
brontobronco: folds
*** TURN *** [6c 6h Js] [2d]
homero4021: bets $0.20
MrDonRich: calls $0.20
*** RIVER *** [6c 6h Js 2d] [7d]
homero4021: bets $0.95 and is all-in
MrDonRich: folds
Uncalled bet ($0.95) returned to homero4021
homero4021 collected $0.59 from pot
*** SUMMARY ***
Total pot $0.61 | Rake $0.02
Board [6c 6h Js 2d 7d]
Seat 1: chxxxs (button) folded before Flop (didn't bet)
Seat 2: brontobronco (small blind) folded on the Flop
Seat 3: homero4021 (big blind) collected ($0.59)
Seat 4: IamKeOpS folded before Flop (didn't bet)
Seat 5: xorrobinhoox folded before Flop (didn't bet)
Seat 6: MrDonRich folded on the River


PokerStars Hand #238178006917:  Hold'em No Limit ($0.01/$0.02 USD) - 2022/08/23 19:22:09 ET
Table 'Equinox IV' 6-max Seat #2 is the button
Seat 1: chxxxs ($2.28 in chips)
Seat 2: brontobronco ($3.43 in chips)
Seat 3: homero4021 ($1.54 in chips)
Seat 4: IamKeOpS ($3.01 in chips)
Seat 5: xorrobinhoox ($2.99 in chips)
Seat 6: MrDonRich ($4.09 in chips)
homero4021: posts small blind $0.01
IamKeOpS: posts big blind $0.02
*** HOLE CARDS ***
xorrobinhoox: folds
MrDonRich: folds
chxxxs: folds
brontobronco: raises $0.04 to $0.06
homero4021: calls $0.05
IamKeOpS: folds
*** FLOP *** [2s 3h 6s]
homero4021: checks
brontobronco: bets $0.07
homero4021: folds
Uncalled bet ($0.07) returned to brontobronco
brontobronco collected $0.14 from pot
*** SUMMARY ***
Total pot $0.14 | Rake $0
Board [2s 3h 6s]
Seat 1: chxxxs folded before Flop (didn't bet)
Seat 2: brontobronco (button) collected ($0.14)
Seat 3: homero4021 (small blind) folded on the Flop
Seat 4: IamKeOpS (big blind) folded before Flop
Seat 5: xorrobinhoox folded before Flop (didn't bet)
Seat 6: MrDonRich folded before Flop (didn't bet)


PokerStars Hand #238178014055:  Hold'em No Limit ($0.01/$0.02 USD) - 2022/08/23 19:22:34 ET
Table 'Equinox IV' 6-max Seat #3 is the button
Seat 1: chxxxs ($2.28 in chips)
Seat 2: brontobronco ($3.51 in chips)
Seat 3: homero4021 ($1.48 in chips)
Seat 4: IamKeOpS ($2.99 in chips)
Seat 5: xorrobinhoox ($2.99 in chips)
Seat 6: MrDonRich ($4.09 in chips)
IamKeOpS: posts small blind $0.01
xorrobinhoox: posts big blind $0.02
*** HOLE CARDS ***
MrDonRich: folds
chxxxs: folds
brontobronco: folds
homero4021: folds
homero4021 leaves the table
IamKeOpS: raises $0.04 to $0.06
xorrobinhoox: folds
Uncalled bet ($0.04) returned to IamKeOpS
IamKeOpS collected $0.04 from pot
IamKeOpS: doesn't show hand
*** SUMMARY ***
Total pot $0.04 | Rake $0
Seat 1: chxxxs folded before Flop (didn't bet)
Seat 2: brontobronco folded before Flop (didn't bet)
Seat 3: homero4021 (button) folded before Flop (didn't bet)
Seat 4: IamKeOpS (small blind) collected ($0.04)
Seat 5: xorrobinhoox (big blind) folded before Flop
Seat 6: MrDonRich folded before Flop (didn't bet)


PokerStars Hand #238178020198:  Hold'em No Limit ($0.01/$0.02 USD) - 2022/08/23 19:22:56 ET
Table 'Equinox IV' 6-max Seat #4 is the button
Seat 1: chxxxs ($2.28 in chips)
Seat 2: brontobronco ($3.51 in chips)
Seat 4: IamKeOpS ($3.01 in chips)
Seat 5: xorrobinhoox ($2.97 in chips)
Seat 6: MrDonRich ($4.09 in chips)
xorrobinhoox: posts small blind $0.01
MrDonRich: posts big blind $0.02
*** HOLE CARDS ***
chxxxs: folds
brontobronco: folds
IamKeOpS: folds
xorrobinhoox: raises $0.06 to $0.08
MrDonRich: calls $0.06
*** FLOP *** [Ah 7c Jd]
xorrobinhoox: bets $0.07
MrDonRich: calls $0.07
*** TURN *** [Ah 7c Jd] [Kd]
xorrobinhoox: bets $0.14
MrDonRich: folds
Uncalled bet ($0.14) returned to xorrobinhoox
xorrobinhoox collected $0.29 from pot
xorrobinhoox: doesn't show hand
*** SUMMARY ***
Total pot $0.30 | Rake $0.01
Board [Ah 7c Jd Kd]
Seat 1: chxxxs folded before Flop (didn't bet)
Seat 2: brontobronco folded before Flop (didn't bet)
Seat 4: IamKeOpS (button) folded before Flop (didn't bet)
Seat 5: xorrobinhoox (small blind) collected ($0.29)
Seat 6: MrDonRich (big blind) folded on the Turn


PokerStars Hand #238178029342:  Hold'em No Limit ($0.01/$0.02 USD) - 2022/08/23 19:23:29 ET
Table 'Equinox IV' 6-max Seat #5 is the button
Seat 1: chxxxs ($2.28 in chips)
Seat 2: brontobronco ($3.51 in chips)
Seat 4: IamKeOpS ($3.01 in chips)
Seat 5: xorrobinhoox ($3.11 in chips)
Seat 6: MrDonRich ($3.94 in chips)
MrDonRich: posts small blind $0.01
chxxxs: posts big blind $0.02
*** HOLE CARDS ***
lameth80 joins the table at seat #3
brontobronco: folds
IamKeOpS: folds
xorrobinhoox: folds
MrDonRich: folds
Uncalled bet ($0.01) returned to chxxxs
chxxxs collected $0.02 from pot
chxxxs: doesn't show hand
*** SUMMARY ***
Total pot $0.02 | Rake $0
Seat 1: chxxxs (big blind) collected ($0.02)
Seat 2: brontobronco folded before Flop (didn't bet)
Seat 4: IamKeOpS folded before Flop (didn't bet)
Seat 5: xorrobinhoox (button) folded before Flop (didn't bet)
Seat 6: MrDonRich (small blind) folded before Flop


PokerStars Hand #238178031402:  Hold'em No Limit ($0.01/$0.02 USD) - 2022/08/23 19:23:36 ET
Table 'Equinox IV' 6-max Seat #6 is the button
Seat 1: chxxxs ($2.29 in chips)
Seat 2: brontobronco ($3.51 in chips)
Seat 4: IamKeOpS ($3.01 in chips)
Seat 5: xorrobinhoox ($3.11 in chips)
Seat 6: MrDonRich ($3.93 in chips)
chxxxs: posts small blind $0.01
brontobronco: posts big blind $0.02
lameth80: sits out
*** HOLE CARDS ***
IamKeOpS: raises $0.04 to $0.06
xorrobinhoox: calls $0.06
MrDonRich: folds
chxxxs: folds
brontobronco: folds
*** FLOP *** [2h Tc 9c]
IamKeOpS: bets $0.07
xorrobinhoox: calls $0.07
*** TURN *** [2h Tc 9c] [7c]
IamKeOpS: checks
xorrobinhoox: bets $0.14
IamKeOpS: calls $0.14
*** RIVER *** [2h Tc 9c 7c] [8d]
IamKeOpS: checks
xorrobinhoox: checks
*** SHOW DOWN ***
IamKeOpS: shows [Th 9h] (two pair, Tens and Nines)
xorrobinhoox: mucks hand
IamKeOpS collected $0.55 from pot
*** SUMMARY ***
Total pot $0.57 | Rake $0.02
Board [2h Tc 9c 7c 8d]
Seat 1: chxxxs (small blind) folded before Flop
Seat 2: brontobronco (big blind) folded before Flop
Seat 4: IamKeOpS showed [Th 9h] and won ($0.55) with two pair, Tens and Nines
Seat 5: xorrobinhoox mucked
Seat 6: MrDonRich (button) folded before Flop (didn't bet)


PokerStars Hand #238178045511:  Hold'em No Limit ($0.01/$0.02 USD) - 2022/08/23 19:24:28 ET
Table 'Equinox IV' 6-max Seat #1 is the button
Seat 1: chxxxs ($2.28 in chips)
Seat 2: brontobronco ($3.49 in chips)
Seat 3: lameth80 ($1.60 in chips)
Seat 4: IamKeOpS ($3.29 in chips)
Seat 5: xorrobinhoox ($2.84 in chips)
Seat 6: MrDonRich ($3.93 in chips)
brontobronco: posts small blind $0.01
lameth80: posts big blind $0.02
*** HOLE CARDS ***
IamKeOpS: folds
xorrobinhoox: folds
MrDonRich: folds
chxxxs: folds
brontobronco: raises $0.04 to $0.06
lameth80: folds
Uncalled bet ($0.04) returned to brontobronco
brontobronco collected $0.04 from pot
*** SUMMARY ***
Total pot $0.04 | Rake $0
Seat 1: chxxxs (button) folded before Flop (didn't bet)
Seat 2: brontobronco (small blind) collected ($0.04)
Seat 3: lameth80 (big blind) folded before Flop
Seat 4: IamKeOpS folded before Flop (didn't bet)
Seat 5: xorrobinhoox folded before Flop (didn't bet)
Seat 6: MrDonRich folded before Flop (didn't bet)


PokerStars Hand #238178049625:  Hold'em No Limit ($0.01/$0.02 USD) - 2022/08/23 19:24:43 ET
Table 'Equinox IV' 6-max Seat #2 is the button
Seat 1: chxxxs ($2.28 in chips)
Seat 2: brontobronco ($3.51 in chips)
Seat 3: lameth80 ($1.58 in chips)
Seat 4: IamKeOpS ($3.29 in chips)
Seat 5: xorrobinhoox ($2.84 in chips)
Seat 6: MrDonRich ($3.93 in chips)
lameth80: posts small blind $0.01
IamKeOpS: posts big blind $0.02
*** HOLE CARDS ***
xorrobinhoox: folds
MrDonRich: raises $0.04 to $0.06
chxxxs: folds
brontobronco: folds
lameth80: calls $0.05
IamKeOpS: folds
*** FLOP *** [Jd 7d Js]
lameth80: checks
MrDonRich: checks
*** TURN *** [Jd 7d Js] [Ad]
lameth80: checks
MrDonRich: checks
*** RIVER *** [Jd 7d Js Ad] [9s]
lameth80: bets $0.07
MrDonRich: folds
Uncalled bet ($0.07) returned to lameth80
lameth80 collected $0.14 from pot
*** SUMMARY ***
Total pot $0.14 | Rake $0
Board [Jd 7d Js Ad 9s]
Seat 1: chxxxs folded before Flop (didn't bet)
Seat 2: brontobronco (button) folded before Flop (didn't bet)
Seat 3: lameth80 (small blind) collected ($0.14)
Seat 4: IamKeOpS (big blind) folded before Flop
Seat 5: xorrobinhoox folded before Flop (didn't bet)
Seat 6: MrDonRich folded on the River


PokerStars Hand #238178062390:  Hold'em No Limit ($0.01/$0.02 USD) - 2022/08/23 19:25:29 ET
Table 'Equinox IV' 6-max Seat #3 is the button
Seat 1: chxxxs ($2.28 in chips)
Seat 2: brontobronco ($3.51 in chips)
Seat 3: lameth80 ($1.66 in chips)
Seat 4: IamKeOpS ($3.27 in chips)
Seat 5: xorrobinhoox ($2.84 in chips)
Seat 6: MrDonRich ($3.87 in chips)
IamKeOpS: posts small blind $0.01
xorrobinhoox: posts big blind $0.02
*** HOLE CARDS ***
MrDonRich: raises $0.04 to $0.06
chxxxs: folds
brontobronco: calls $0.06
lameth80: folds
IamKeOpS: folds
xorrobinhoox: folds
*** FLOP *** [7d 8h Qc]
MrDonRich: checks
brontobronco: bets $0.07
MrDonRich has timed out
MrDonRich: folds
Uncalled bet ($0.07) returned to brontobronco
brontobronco collected $0.14 from pot
*** SUMMARY ***
Total pot $0.15 | Rake $0.01
Board [7d 8h Qc]
Seat 1: chxxxs folded before Flop (didn't bet)
Seat 2: brontobronco collected ($0.14)
Seat 3: lameth80 (button) folded before Flop (didn't bet)
Seat 4: IamKeOpS (small blind) folded before Flop
Seat 5: xorrobinhoox (big blind) folded before Flop
Seat 6: MrDonRich folded on the Flop


PokerStars Hand #238178093218:  Hold'em No Limit ($0.01/$0.02 USD) - 2022/08/23 19:27:23 ET
Table 'Equinox IV' 6-max Seat #4 is the button
Seat 1: chxxxs ($2.28 in chips)
Seat 2: brontobronco ($3.59 in chips)
Seat 3: lameth80 ($1.66 in chips)
Seat 4: IamKeOpS ($3.26 in chips)
Seat 5: xorrobinhoox ($2.82 in chips)
xorrobinhoox: posts small blind $0.01
chxxxs: posts big blind $0.02
*** HOLE CARDS ***
brontobronco: raises $0.04 to $0.06
lameth80: folds
IamKeOpS: folds
xorrobinhoox: calls $0.05
chxxxs: calls $0.04
*** FLOP *** [As 6h 4d]
xorrobinhoox: checks
chxxxs: checks
brontobronco: bets $0.08
xorrobinhoox: calls $0.08
chxxxs: folds
*** TURN *** [As 6h 4d] [8d]
xorrobinhoox: bets $0.16
brontobronco: calls $0.16
*** RIVER *** [As 6h 4d 8d] [Kh]
xorrobinhoox: bets $0.32
brontobronco: calls $0.32
*** SHOW DOWN ***
xorrobinhoox: shows [Jh Ac] (a pair of Aces)
brontobronco: shows [Ad Qc] (a pair of Aces - King+Queen kicker)
brontobronco collected $1.25 from pot
*** SUMMARY ***
Total pot $1.30 | Rake $0.05
Board [As 6h 4d 8d Kh]
Seat 1: chxxxs (big blind) folded on the Flop
Seat 2: brontobronco showed [Ad Qc] and won ($1.25) with a pair of Aces
Seat 3: lameth80 folded before Flop (didn't bet)
Seat 4: IamKeOpS (button) folded before Flop (didn't bet)
Seat 5: xorrobinhoox (small blind) showed [Jh Ac] and lost with a pair of Aces


PokerStars Hand #238178106534:  Hold'em No Limit ($0.01/$0.02 USD) - 2022/08/23 19:28:12 ET
Table 'Equinox IV' 6-max Seat #5 is the button
Seat 1: chxxxs ($2.22 in chips)
Seat 2: brontobronco ($4.22 in chips)
Seat 3: lameth80 ($1.66 in chips)
Seat 4: IamKeOpS ($3.26 in chips)
Seat 5: xorrobinhoox ($2.20 in chips)
chxxxs: posts small blind $0.01
brontobronco: posts big blind $0.02
*** HOLE CARDS ***
lameth80: calls $0.02
IamKeOpS: raises $0.06 to $0.08
xorrobinhoox: folds
chxxxs: folds
brontobronco: folds
lameth80: calls $0.06
*** FLOP *** [4d 2s 8c]
lameth80: checks
IamKeOpS: checks
*** TURN *** [4d 2s 8c] [Jh]
lameth80: bets $0.09
IamKeOpS: calls $0.09
*** RIVER *** [4d 2s 8c Jh] [2d]
lameth80: bets $0.36
IamKeOpS: calls $0.36
*** SHOW DOWN ***
lameth80: shows [Jd Qd] (two pair, Jacks and Deuces)
IamKeOpS: shows [Js Ah] (two pair, Jacks and Deuces - Ace kicker)
IamKeOpS collected $1.05 from pot
*** SUMMARY ***
Total pot $1.09 | Rake $0.04
Board [4d 2s 8c Jh 2d]
Seat 1: chxxxs (small blind) folded before Flop
Seat 2: brontobronco (big blind) folded before Flop
Seat 3: lameth80 showed [Jd Qd] and lost with two pair, Jacks and Deuces
Seat 4: IamKeOpS showed [Js Ah] and won ($1.05) with two pair, Jacks and Deuces
Seat 5: xorrobinhoox (button) folded before Flop (didn't bet)


PokerStars Hand #238178121869:  Hold'em No Limit ($0.01/$0.02 USD) - 2022/08/23 19:29:08 ET
Table 'Equinox IV' 6-max Seat #1 is the button
Seat 1: chxxxs ($2.21 in chips)
Seat 2: brontobronco ($4.20 in chips)
Seat 3: lameth80 ($1.13 in chips)
Seat 4: IamKeOpS ($3.78 in chips)
Seat 5: xorrobinhoox ($2.20 in chips)
brontobronco: posts small blind $0.01
lameth80: posts big blind $0.02
MrDonRich: sits out
*** HOLE CARDS ***
IamKeOpS: folds
xorrobinhoox: folds
chxxxs: folds
brontobronco: raises $0.04 to $0.06
lameth80: calls $0.04
*** FLOP *** [As 5c 6d]
brontobronco: bets $0.06
lameth80: calls $0.06
*** TURN *** [As 5c 6d] [8c]
brontobronco: checks
lameth80: bets $0.11
brontobronco: folds
Uncalled bet ($0.11) returned to lameth80
lameth80 collected $0.23 from pot
*** SUMMARY ***
Total pot $0.24 | Rake $0.01
Board [As 5c 6d 8c]
Seat 1: chxxxs (button) folded before Flop (didn't bet)
Seat 2: brontobronco (small blind) folded on the Turn
Seat 3: lameth80 (big blind) collected ($0.23)
Seat 4: IamKeOpS folded before Flop (didn't bet)
Seat 5: xorrobinhoox folded before Flop (didn't bet)


PokerStars Hand #238178132025:  Hold'em No Limit ($0.01/$0.02 USD) - 2022/08/23 19:29:46 ET
Table 'Equinox IV' 6-max Seat #2 is the button
Seat 1: chxxxs ($2.21 in chips)
Seat 2: brontobronco ($4.08 in chips)
Seat 3: lameth80 ($1.24 in chips)
Seat 5: xorrobinhoox ($2.20 in chips)
lameth80: posts small blind $0.01
IamKeOpS: is sitting out
xorrobinhoox: posts big blind $0.02
IamKeOpS leaves the table
MrDonRich: sits out
*** HOLE CARDS ***
chxxxs: folds
brontobronco: folds
lameth80: calls $0.01
xorrobinhoox: checks
*** FLOP *** [Ad 8d Ah]
lameth80: bets $0.04
xorrobinhoox: calls $0.04
*** TURN *** [Ad 8d Ah] [9s]
Jkogeraski3108 joins the table at seat #4
lameth80: bets $0.12
xorrobinhoox: calls $0.12
*** RIVER *** [Ad 8d Ah 9s] [6h]
lameth80: bets $0.35
xorrobinhoox: folds
Uncalled bet ($0.35) returned to lameth80
lameth80 collected $0.35 from pot
*** SUMMARY ***
Total pot $0.36 | Rake $0.01
Board [Ad 8d Ah 9s 6h]
Seat 1: chxxxs folded before Flop (didn't bet)
Seat 2: brontobronco (button) folded before Flop (didn't bet)
Seat 3: lameth80 (small blind) collected ($0.35)
Seat 5: xorrobinhoox (big blind) folded on the River


PokerStars Hand #238178148452:  Hold'em No Limit ($0.01/$0.02 USD) - 2022/08/23 19:30:47 ET
Table 'Equinox IV' 6-max Seat #3 is the button
Seat 1: chxxxs ($2.21 in chips)
Seat 2: brontobronco ($4.08 in chips)
Seat 3: lameth80 ($1.41 in chips)
Seat 5: xorrobinhoox ($2.02 in chips)
Seat 6: MrDonRich ($3.81 in chips)
xorrobinhoox: posts small blind $0.01
MrDonRich: posts big blind $0.02
*** HOLE CARDS ***
chxxxs: folds
brontobronco: folds
lameth80: calls $0.02
xorrobinhoox: calls $0.01
MrDonRich: checks
*** FLOP *** [Ad 3d 8c]
xorrobinhoox: checks
MrDonRich: checks
lameth80: checks
*** TURN *** [Ad 3d 8c] [6h]
xorrobinhoox: checks
MrDonRich: checks
lameth80: checks
*** RIVER *** [Ad 3d 8c 6h] [Jd]
xorrobinhoox: checks
MrDonRich: checks
lameth80: checks
*** SHOW DOWN ***
xorrobinhoox: shows [2h Th] (high card Ace)
MrDonRich: shows [Td Jc] (a pair of Jacks)
lameth80: shows [Jh Qs] (a pair of Jacks - Ace+Queen kicker)
lameth80 collected $0.06 from pot
*** SUMMARY ***
Total pot $0.06 | Rake $0
Board [Ad 3d 8c 6h Jd]
Seat 1: chxxxs folded before Flop (didn't bet)
Seat 2: brontobronco folded before Flop (didn't bet)
Seat 3: lameth80 (button) showed [Jh Qs] and won ($0.06) with a pair of Jacks
Seat 5: xorrobinhoox (small blind) showed [2h Th] and lost with high card Ace
Seat 6: MrDonRich (big blind) showed [Td Jc] and lost with a pair of Jacks


PokerStars Hand #238178158822:  Hold'em No Limit ($0.01/$0.02 USD) - 2022/08/23 19:31:25 ET
Table 'Equinox IV' 6-max Seat #5 is the button
Seat 1: chxxxs ($2.21 in chips)
Seat 2: brontobronco ($4.08 in chips)
Seat 3: lameth80 ($1.45 in chips)
Seat 4: Jkogeraski3108 ($0.83 in chips)
Seat 5: xorrobinhoox ($2 in chips)
Seat 6: MrDonRich ($3.79 in chips)
MrDonRich: posts small blind $0.01
chxxxs: posts big blind $0.02
Jkogeraski3108: posts big blind $0.02
*** HOLE CARDS ***
brontobronco: folds
lameth80: folds
Jkogeraski3108: checks
xorrobinhoox: calls $0.02
lameth80 leaves the table
MrDonRich: calls $0.01
chxxxs: raises $0.12 to $0.14
Jkogeraski3108: folds
xorrobinhoox: calls $0.12
MrDonRich: folds
*** FLOP *** [4s As Kc]
chxxxs: bets $0.18
xorrobinhoox: calls $0.18
*** TURN *** [4s As Kc] [Qh]
chxxxs: checks
xorrobinhoox: checks
*** RIVER *** [4s As Kc Qh] [Td]
chxxxs: checks
xorrobinhoox: bets $0.66
lWGETl joins the table at seat #3
chxxxs: calls $0.66
*** SHOW DOWN ***
xorrobinhoox: shows [Js Kh] (a straight, Ten to Ace)
chxxxs: mucks hand
xorrobinhoox collected $1.93 from pot
*** SUMMARY ***
Total pot $2 | Rake $0.07
Board [4s As Kc Qh Td]
Seat 1: chxxxs (big blind) mucked
Seat 2: brontobronco folded before Flop (didn't bet)
Seat 3: lameth80 folded before Flop (didn't bet)
Seat 4: Jkogeraski3108 folded before Flop (didn't bet)
Seat 5: xorrobinhoox (button) showed [Js Kh] and won ($1.93) with a straight, Ten to Ace
Seat 6: MrDonRich (small blind) folded before Flop


PokerStars Hand #238178179298:  Hold'em No Limit ($0.01/$0.02 USD) - 2022/08/23 19:32:41 ET
Table 'Equinox IV' 6-max Seat #6 is the button
Seat 1: chxxxs ($2 in chips)
Seat 2: brontobronco ($4.08 in chips)
Seat 4: Jkogeraski3108 ($0.81 in chips)
Seat 5: xorrobinhoox ($2.95 in chips)
Seat 6: MrDonRich ($3.77 in chips)
chxxxs: posts small blind $0.01
brontobronco: posts big blind $0.02
lWGETl: sits out
*** HOLE CARDS ***
Jkogeraski3108: calls $0.02
xorrobinhoox: raises $0.02 to $0.04
MrDonRich: folds
chxxxs: calls $0.03
brontobronco: folds
Jkogeraski3108: calls $0.02
*** FLOP *** [Ts Jd Jc]
chxxxs: checks
Jkogeraski3108: checks
xorrobinhoox: checks
*** TURN *** [Ts Jd Jc] [Ac]
chxxxs: checks
Jkogeraski3108: checks
xorrobinhoox: checks
*** RIVER *** [Ts Jd Jc Ac] [6c]
chxxxs: checks
Jkogeraski3108: checks
xorrobinhoox: checks
*** SHOW DOWN ***
chxxxs: shows [6d Kd] (two pair, Jacks and Sixes)
Jkogeraski3108: shows [Kh Th] (two pair, Jacks and Tens)
xorrobinhoox: mucks hand
Jkogeraski3108 collected $0.14 from pot
*** SUMMARY ***
Total pot $0.14 | Rake $0
Board [Ts Jd Jc Ac 6c]
Seat 1: chxxxs (small blind) showed [6d Kd] and lost with two pair, Jacks and Sixes
Seat 2: brontobronco (big blind) folded before Flop
Seat 4: Jkogeraski3108 showed [Kh Th] and won ($0.14) with two pair, Jacks and Tens
Seat 5: xorrobinhoox mucked
Seat 6: MrDonRich (button) folded before Flop (didn't bet)


PokerStars Hand #238178190607:  Hold'em No Limit ($0.01/$0.02 USD) - 2022/08/23 19:33:23 ET
Table 'Equinox IV' 6-max Seat #1 is the button
Seat 1: chxxxs ($2 in chips)
Seat 2: brontobronco ($4.06 in chips)
Seat 3: lWGETl ($2 in chips)
Seat 4: Jkogeraski3108 ($0.91 in chips)
Seat 5: xorrobinhoox ($2.91 in chips)
Seat 6: MrDonRich ($3.77 in chips)
brontobronco: posts small blind $0.01
lWGETl: posts big blind $0.02
*** HOLE CARDS ***
Jkogeraski3108: folds
xorrobinhoox: folds
MrDonRich: folds
chxxxs: raises $0.03 to $0.05
brontobronco: calls $0.04
lWGETl: folds
*** FLOP *** [2h 4c Kc]
brontobronco: bets $0.06
chxxxs: calls $0.06
*** TURN *** [2h 4c Kc] [3h]
brontobronco: checks
chxxxs: bets $0.15
brontobronco: calls $0.15
*** RIVER *** [2h 4c Kc 3h] [6d]
brontobronco: bets $0.10
chxxxs: folds
Uncalled bet ($0.10) returned to brontobronco
brontobronco collected $0.52 from pot
*** SUMMARY ***
Total pot $0.54 | Rake $0.02
Board [2h 4c Kc 3h 6d]
Seat 1: chxxxs (button) folded on the River
Seat 2: brontobronco (small blind) collected ($0.52)
Seat 3: lWGETl (big blind) folded before Flop
Seat 4: Jkogeraski3108 folded before Flop (didn't bet)
Seat 5: xorrobinhoox folded before Flop (didn't bet)
Seat 6: MrDonRich folded before Flop (didn't bet)


PokerStars Hand #238178207652:  Hold'em No Limit ($0.01/$0.02 USD) - 2022/08/23 19:34:28 ET
Table 'Equinox IV' 6-max Seat #2 is the button
Seat 1: chxxxs ($2 in chips)
Seat 2: brontobronco ($4.32 in chips)
Seat 3: lWGETl ($1.98 in chips)
Seat 4: Jkogeraski3108 ($0.91 in chips)
Seat 5: xorrobinhoox ($2.91 in chips)
Seat 6: MrDonRich ($3.77 in chips)
lWGETl: posts small blind $0.01
Jkogeraski3108: posts big blind $0.02
*** HOLE CARDS ***
xorrobinhoox: folds
MrDonRich: folds
chxxxs: folds
brontobronco: folds
lWGETl: folds
Uncalled bet ($0.01) returned to Jkogeraski3108
Jkogeraski3108 collected $0.02 from pot
*** SUMMARY ***
Total pot $0.02 | Rake $0
Seat 1: chxxxs folded before Flop (didn't bet)
Seat 2: brontobronco (button) folded before Flop (didn't bet)
Seat 3: lWGETl (small blind) folded before Flop
Seat 4: Jkogeraski3108 (big blind) collected ($0.02)
Seat 5: xorrobinhoox folded before Flop (didn't bet)
Seat 6: MrDonRich folded before Flop (didn't bet)


PokerStars Hand #238178212380:  Hold'em No Limit ($0.01/$0.02 USD) - 2022/08/23 19:34:46 ET
Table 'Equinox IV' 6-max Seat #3 is the button
Seat 1: chxxxs ($2 in chips)
Seat 2: brontobronco ($4.32 in chips)
Seat 3: lWGETl ($1.97 in chips)
Seat 4: Jkogeraski3108 ($0.92 in chips)
Seat 5: xorrobinhoox ($2.91 in chips)
Seat 6: MrDonRich ($3.77 in chips)
Jkogeraski3108: posts small blind $0.01
xorrobinhoox: posts big blind $0.02
*** HOLE CARDS ***
MrDonRich: folds
chxxxs: folds
brontobronco: folds
lWGETl: folds
Jkogeraski3108: calls $0.01
xorrobinhoox: checks
*** FLOP *** [2s 9c Qh]
Jkogeraski3108: checks
xorrobinhoox: checks
*** TURN *** [2s 9c Qh] [6s]
Jkogeraski3108: checks
xorrobinhoox: bets $0.02
Jkogeraski3108: calls $0.02
*** RIVER *** [2s 9c Qh 6s] [As]
Jkogeraski3108: checks
xorrobinhoox: checks
*** SHOW DOWN ***
Jkogeraski3108: shows [8h 8s] (a pair of Eights)
xorrobinhoox: mucks hand
Jkogeraski3108 collected $0.08 from pot
*** SUMMARY ***
Total pot $0.08 | Rake $0
Board [2s 9c Qh 6s As]
Seat 1: chxxxs folded before Flop (didn't bet)
Seat 2: brontobronco folded before Flop (didn't bet)
Seat 3: lWGETl (button) folded before Flop (didn't bet)
Seat 4: Jkogeraski3108 (small blind) showed [8h 8s] and won ($0.08) with a pair of Eights
Seat 5: xorrobinhoox (big blind) mucked
Seat 6: MrDonRich folded before Flop (didn't bet)


PokerStars Hand #238178220604:  Hold'em No Limit ($0.01/$0.02 USD) - 2022/08/23 19:35:17 ET
Table 'Equinox IV' 6-max Seat #4 is the button
Seat 1: chxxxs ($2 in chips)
Seat 2: brontobronco ($4.32 in chips)
Seat 3: lWGETl ($2 in chips)
Seat 4: Jkogeraski3108 ($0.96 in chips)
Seat 5: xorrobinhoox ($2.87 in chips)
Seat 6: MrDonRich ($3.77 in chips)
xorrobinhoox: posts small blind $0.01
MrDonRich: posts big blind $0.02
*** HOLE CARDS ***
chxxxs: folds
brontobronco: folds
lWGETl: folds
Jkogeraski3108: folds
xorrobinhoox: raises $0.03 to $0.05
MrDonRich: folds
Uncalled bet ($0.03) returned to xorrobinhoox
xorrobinhoox collected $0.04 from pot
xorrobinhoox: doesn't show hand
*** SUMMARY ***
Total pot $0.04 | Rake $0
Seat 1: chxxxs folded before Flop (didn't bet)
Seat 2: brontobronco folded before Flop (didn't bet)
Seat 3: lWGETl folded before Flop (didn't bet)
Seat 4: Jkogeraski3108 (button) folded before Flop (didn't bet)
Seat 5: xorrobinhoox (small blind) collected ($0.04)
Seat 6: MrDonRich (big blind) folded before Flop


PokerStars Hand #238178229105:  Hold'em No Limit ($0.01/$0.02 USD) - 2022/08/23 19:35:50 ET
Table 'Equinox IV' 6-max Seat #5 is the button
Seat 1: chxxxs ($2 in chips)
Seat 2: brontobronco ($4.32 in chips)
Seat 3: lWGETl ($2 in chips)
Seat 4: Jkogeraski3108 ($0.96 in chips)
Seat 5: xorrobinhoox ($2.89 in chips)
Seat 6: MrDonRich ($3.75 in chips)
MrDonRich: posts small blind $0.01
chxxxs: posts big blind $0.02
*** HOLE CARDS ***
brontobronco: folds
lWGETl: folds
Jkogeraski3108: calls $0.02
xorrobinhoox: calls $0.02
MrDonRich: calls $0.01
chxxxs: checks
*** FLOP *** [Ts 7s Kc]
MrDonRich: checks
chxxxs: checks
Jkogeraski3108: checks
xorrobinhoox: bets $0.04
MrDonRich: folds
chxxxs: calls $0.04
Jkogeraski3108: folds
*** TURN *** [Ts 7s Kc] [4s]
chxxxs: checks
xorrobinhoox: bets $0.07
chxxxs: calls $0.07
*** RIVER *** [Ts 7s Kc 4s] [Qh]
chxxxs: checks
xorrobinhoox: bets $0.29
chxxxs: calls $0.29
*** SHOW DOWN ***
xorrobinhoox: shows [9s Ks] (a flush, King high)
chxxxs: mucks hand
xorrobinhoox collected $0.85 from pot
*** SUMMARY ***
Total pot $0.88 | Rake $0.03
Board [Ts 7s Kc 4s Qh]
Seat 1: chxxxs (big blind) mucked
Seat 2: brontobronco folded before Flop (didn't bet)
Seat 3: lWGETl folded before Flop (didn't bet)
Seat 4: Jkogeraski3108 folded on the Flop
Seat 5: xorrobinhoox (button) showed [9s Ks] and won ($0.85) with a flush, King high
Seat 6: MrDonRich (small blind) folded on the Flop


PokerStars Hand #238178243563:  Hold'em No Limit ($0.01/$0.02 USD) - 2022/08/23 19:36:45 ET
Table 'Equinox IV' 6-max Seat #6 is the button
Seat 1: chxxxs ($2 in chips)
Seat 2: brontobronco ($4.32 in chips)
Seat 3: lWGETl ($2 in chips)
Seat 4: Jkogeraski3108 ($0.94 in chips)
Seat 5: xorrobinhoox ($3.32 in chips)
Seat 6: MrDonRich ($3.73 in chips)
chxxxs: posts small blind $0.01
brontobronco: posts big blind $0.02
*** HOLE CARDS ***
lWGETl: folds
Jkogeraski3108: folds
xorrobinhoox: folds
MrDonRich: folds
chxxxs: folds
Uncalled bet ($0.01) returned to brontobronco
brontobronco collected $0.02 from pot
*** SUMMARY ***
Total pot $0.02 | Rake $0
Seat 1: chxxxs (small blind) folded before Flop
Seat 2: brontobronco (big blind) collected ($0.02)
Seat 3: lWGETl folded before Flop (didn't bet)
Seat 4: Jkogeraski3108 folded before Flop (didn't bet)
Seat 5: xorrobinhoox folded before Flop (didn't bet)
Seat 6: MrDonRich (button) folded before Flop (didn't bet)


PokerStars Hand #238178246220:  Hold'em No Limit ($0.01/$0.02 USD) - 2022/08/23 19:36:55 ET
Table 'Equinox IV' 6-max Seat #1 is the button
Seat 1: chxxxs ($2 in chips)
Seat 2: brontobronco ($4.33 in chips)
Seat 3: lWGETl ($2 in chips)
Seat 4: Jkogeraski3108 ($0.94 in chips)
Seat 5: xorrobinhoox ($3.32 in chips)
Seat 6: MrDonRich ($3.73 in chips)
brontobronco: posts small blind $0.01
lWGETl: posts big blind $0.02
*** HOLE CARDS ***
Jkogeraski3108: folds
xorrobinhoox: folds
MrDonRich: folds
chxxxs: folds
brontobronco: raises $0.04 to $0.06
lWGETl: folds
Uncalled bet ($0.04) returned to brontobronco
brontobronco collected $0.04 from pot
*** SUMMARY ***
Total pot $0.04 | Rake $0
Seat 1: chxxxs (button) folded before Flop (didn't bet)
Seat 2: brontobronco (small blind) collected ($0.04)
Seat 3: lWGETl (big blind) folded before Flop
Seat 4: Jkogeraski3108 folded before Flop (didn't bet)
Seat 5: xorrobinhoox folded before Flop (didn't bet)
Seat 6: MrDonRich folded before Flop (didn't bet)


PokerStars Hand #238178249881:  Hold'em No Limit ($0.01/$0.02 USD) - 2022/08/23 19:37:09 ET
Table 'Equinox IV' 6-max Seat #2 is the button
Seat 1: chxxxs ($2 in chips)
Seat 2: brontobronco ($4.35 in chips)
Seat 3: lWGETl ($1.98 in chips)
Seat 4: Jkogeraski3108 ($0.94 in chips)
Seat 5: xorrobinhoox ($3.32 in chips)
Seat 6: MrDonRich ($3.73 in chips)
lWGETl: posts small blind $0.01
Jkogeraski3108: posts big blind $0.02
*** HOLE CARDS ***
xorrobinhoox: folds
MrDonRich: calls $0.02
chxxxs: raises $0.10 to $0.12
brontobronco: folds
lWGETl: folds
Jkogeraski3108: folds
MrDonRich: folds
Uncalled bet ($0.10) returned to chxxxs
chxxxs collected $0.07 from pot
chxxxs: doesn't show hand
*** SUMMARY ***
Total pot $0.07 | Rake $0
Seat 1: chxxxs collected ($0.07)
Seat 2: brontobronco (button) folded before Flop (didn't bet)
Seat 3: lWGETl (small blind) folded before Flop
Seat 4: Jkogeraski3108 (big blind) folded before Flop
Seat 5: xorrobinhoox folded before Flop (didn't bet)
Seat 6: MrDonRich folded before Flop


PokerStars Hand #238178256938:  Hold'em No Limit ($0.01/$0.02 USD) - 2022/08/23 19:37:36 ET
Table 'Equinox IV' 6-max Seat #3 is the button
Seat 1: chxxxs ($2.05 in chips)
Seat 2: brontobronco ($4.35 in chips)
Seat 3: lWGETl ($1.97 in chips)
Seat 4: Jkogeraski3108 ($0.92 in chips)
Seat 5: xorrobinhoox ($3.32 in chips)
Seat 6: MrDonRich ($3.71 in chips)
Jkogeraski3108: posts small blind $0.01
xorrobinhoox: posts big blind $0.02
*** HOLE CARDS ***
MrDonRich: folds
chxxxs: folds
brontobronco: raises $0.04 to $0.06
lWGETl: folds
Jkogeraski3108: folds
xorrobinhoox: calls $0.04
*** FLOP *** [Tc 6d 5c]
xorrobinhoox: checks
brontobronco: bets $0.06
xorrobinhoox: folds
Uncalled bet ($0.06) returned to brontobronco
brontobronco collected $0.13 from pot
*** SUMMARY ***
Total pot $0.13 | Rake $0
Board [Tc 6d 5c]
Seat 1: chxxxs folded before Flop (didn't bet)
Seat 2: brontobronco collected ($0.13)
Seat 3: lWGETl (button) folded before Flop (didn't bet)
Seat 4: Jkogeraski3108 (small blind) folded before Flop
Seat 5: xorrobinhoox (big blind) folded on the Flop
Seat 6: MrDonRich folded before Flop (didn't bet)


PokerStars Hand #238178262313:  Hold'em No Limit ($0.01/$0.02 USD) - 2022/08/23 19:37:56 ET
Table 'Equinox IV' 6-max Seat #4 is the button
Seat 1: chxxxs ($2.05 in chips)
Seat 2: brontobronco ($4.42 in chips)
Seat 3: lWGETl ($1.97 in chips)
Seat 4: Jkogeraski3108 ($0.91 in chips)
Seat 5: xorrobinhoox ($3.26 in chips)
Seat 6: MrDonRich ($3.71 in chips)
xorrobinhoox: posts small blind $0.01
MrDonRich: posts big blind $0.02
*** HOLE CARDS ***
chxxxs: folds
brontobronco: folds
lWGETl: raises $0.04 to $0.06
Jkogeraski3108: folds
xorrobinhoox: folds
MrDonRich: folds
Uncalled bet ($0.04) returned to lWGETl
lWGETl collected $0.05 from pot
lWGETl: doesn't show hand
*** SUMMARY ***
Total pot $0.05 | Rake $0
Seat 1: chxxxs folded before Flop (didn't bet)
Seat 2: brontobronco folded before Flop (didn't bet)
Seat 3: lWGETl collected ($0.05)
Seat 4: Jkogeraski3108 (button) folded before Flop (didn't bet)
Seat 5: xorrobinhoox (small blind) folded before Flop
Seat 6: MrDonRich (big blind) folded before Flop


PokerStars Hand #238178267602:  Hold'em No Limit ($0.01/$0.02 USD) - 2022/08/23 19:38:16 ET
Table 'Equinox IV' 6-max Seat #5 is the button
Seat 1: chxxxs ($2.05 in chips)
Seat 2: brontobronco ($4.42 in chips)
Seat 3: lWGETl ($2 in chips)
Seat 4: Jkogeraski3108 ($0.91 in chips)
Seat 5: xorrobinhoox ($3.25 in chips)
Seat 6: MrDonRich ($3.69 in chips)
MrDonRich: posts small blind $0.01
chxxxs: posts big blind $0.02
*** HOLE CARDS ***
brontobronco: folds
lWGETl: folds
Jkogeraski3108: folds
xorrobinhoox: folds
MrDonRich: calls $0.01
chxxxs: checks
*** FLOP *** [6d 8s 3d]
MrDonRich: bets $0.02
chxxxs: folds
Uncalled bet ($0.02) returned to MrDonRich
MrDonRich collected $0.04 from pot
MrDonRich: doesn't show hand
*** SUMMARY ***
Total pot $0.04 | Rake $0
Board [6d 8s 3d]
Seat 1: chxxxs (big blind) folded on the Flop
Seat 2: brontobronco folded before Flop (didn't bet)
Seat 3: lWGETl folded before Flop (didn't bet)
Seat 4: Jkogeraski3108 folded before Flop (didn't bet)
Seat 5: xorrobinhoox (button) folded before Flop (didn't bet)
Seat 6: MrDonRich (small blind) collected ($0.04)


PokerStars Hand #238178272981:  Hold'em No Limit ($0.01/$0.02 USD) - 2022/08/23 19:38:37 ET
Table 'Equinox IV' 6-max Seat #6 is the button
Seat 1: chxxxs ($2.03 in chips)
Seat 2: brontobronco ($4.42 in chips)
Seat 3: lWGETl ($2 in chips)
Seat 4: Jkogeraski3108 ($0.91 in chips)
Seat 5: xorrobinhoox ($3.25 in chips)
Seat 6: MrDonRich ($3.71 in chips)
chxxxs: posts small blind $0.01
brontobronco: posts big blind $0.02
*** HOLE CARDS ***
lWGETl: folds
lWGETl leaves the table
Jkogeraski3108: folds
xorrobinhoox: calls $0.02
MrDonRich: calls $0.02
chxxxs: folds
brontobronco: checks
*** FLOP *** [4d Tc 8s]
brontobronco: checks
xorrobinhoox: checks
MrDonRich: checks
*** TURN *** [4d Tc 8s] [Th]
mmdapix joins the table at seat #3
brontobronco: checks
xorrobinhoox: checks
MrDonRich: checks
*** RIVER *** [4d Tc 8s Th] [9c]
brontobronco: bets $0.03
xorrobinhoox: calls $0.03
MrDonRich: folds
*** SHOW DOWN ***
brontobronco: shows [6s Kh] (a pair of Tens)
xorrobinhoox: shows [9h 8h] (two pair, Tens and Nines)
xorrobinhoox collected $0.13 from pot
*** SUMMARY ***
Total pot $0.13 | Rake $0
Board [4d Tc 8s Th 9c]
Seat 1: chxxxs (small blind) folded before Flop
Seat 2: brontobronco (big blind) showed [6s Kh] and lost with a pair of Tens
Seat 3: lWGETl folded before Flop (didn't bet)
Seat 4: Jkogeraski3108 folded before Flop (didn't bet)
Seat 5: xorrobinhoox showed [9h 8h] and won ($0.13) with two pair, Tens and Nines
Seat 6: MrDonRich (button) folded on the River


PokerStars Hand #238178286644:  Hold'em No Limit ($0.01/$0.02 USD) - 2022/08/23 19:39:29 ET
Table 'Equinox IV' 6-max Seat #1 is the button
Seat 1: chxxxs ($2.02 in chips)
Seat 2: brontobronco ($4.37 in chips)
Seat 3: mmdapix ($1.50 in chips)
Seat 4: Jkogeraski3108 ($0.91 in chips)
Seat 5: xorrobinhoox ($3.33 in chips)
Seat 6: MrDonRich ($3.69 in chips)
brontobronco: posts small blind $0.01
mmdapix: posts big blind $0.02
*** HOLE CARDS ***
Jkogeraski3108: folds
xorrobinhoox has timed out
xorrobinhoox: folds
MrDonRich: raises $0.04 to $0.06
chxxxs: folds
brontobronco: folds
mmdapix: calls $0.04
*** FLOP *** [6d Qs 8s]
mmdapix: checks
MrDonRich: checks
*** TURN *** [6d Qs 8s] [Ac]
mmdapix: checks
MrDonRich: checks
*** RIVER *** [6d Qs 8s Ac] [4c]
mmdapix: checks
MrDonRich: checks
*** SHOW DOWN ***
mmdapix: shows [5h Ks] (high card Ace)
MrDonRich: shows [Jc Js] (a pair of Jacks)
MrDonRich collected $0.13 from pot
*** SUMMARY ***
Total pot $0.13 | Rake $0
Board [6d Qs 8s Ac 4c]
Seat 1: chxxxs (button) folded before Flop (didn't bet)
Seat 2: brontobronco (small blind) folded before Flop
Seat 3: mmdapix (big blind) showed [5h Ks] and lost with high card Ace
Seat 4: Jkogeraski3108 folded before Flop (didn't bet)
Seat 5: xorrobinhoox folded before Flop (didn't bet)
Seat 6: MrDonRich showed [Jc Js] and won ($0.13) with a pair of Jacks


PokerStars Hand #238178296023:  Hold'em No Limit ($0.01/$0.02 USD) - 2022/08/23 19:40:05 ET
Table 'Equinox IV' 6-max Seat #2 is the button
Seat 1: chxxxs ($2.02 in chips)
Seat 2: brontobronco ($4.36 in chips)
Seat 3: mmdapix ($1.44 in chips)
Seat 4: Jkogeraski3108 ($0.91 in chips)
Seat 5: xorrobinhoox ($3.33 in chips)
Seat 6: MrDonRich ($3.76 in chips)
mmdapix: posts small blind $0.01
Jkogeraski3108: posts big blind $0.02
*** HOLE CARDS ***
xorrobinhoox has timed out
xorrobinhoox: folds
MrDonRich: folds
chxxxs: folds
brontobronco: raises $0.04 to $0.06
mmdapix: calls $0.05
Jkogeraski3108: folds
*** FLOP *** [Kh 8s 2c]
mmdapix: checks
brontobronco: bets $0.07
mmdapix: folds
Uncalled bet ($0.07) returned to brontobronco
brontobronco collected $0.14 from pot
*** SUMMARY ***
Total pot $0.14 | Rake $0
Board [Kh 8s 2c]
Seat 1: chxxxs folded before Flop (didn't bet)
Seat 2: brontobronco (button) collected ($0.14)
Seat 3: mmdapix (small blind) folded on the Flop
Seat 4: Jkogeraski3108 (big blind) folded before Flop
Seat 5: xorrobinhoox folded before Flop (didn't bet)
Seat 6: MrDonRich folded before Flop (didn't bet)


PokerStars Hand #238178303313:  Hold'em No Limit ($0.01/$0.02 USD) - 2022/08/23 19:40:33 ET
Table 'Equinox IV' 6-max Seat #3 is the button
Seat 1: chxxxs ($2.02 in chips)
Seat 2: brontobronco ($4.44 in chips)
Seat 3: mmdapix ($1.38 in chips)
Seat 4: Jkogeraski3108 ($0.89 in chips)
Seat 5: xorrobinhoox ($3.33 in chips)
Seat 6: MrDonRich ($3.76 in chips)
Jkogeraski3108: posts small blind $0.01
xorrobinhoox: posts big blind $0.02
*** HOLE CARDS ***
MrDonRich: folds
chxxxs: raises $0.04 to $0.06
brontobronco: calls $0.06
mmdapix: calls $0.06
Jkogeraski3108: folds
xorrobinhoox: folds
*** FLOP *** [Td 6h 9c]
chxxxs: checks
brontobronco: bets $0.10
mmdapix: raises $0.10 to $0.20
chxxxs: calls $0.20
brontobronco: folds
*** TURN *** [Td 6h 9c] [8s]
chxxxs: checks
mmdapix: bets $0.34
chxxxs: raises $0.69 to $1.03
mmdapix: folds
Uncalled bet ($0.69) returned to chxxxs
chxxxs collected $1.34 from pot
chxxxs: doesn't show hand
*** SUMMARY ***
Total pot $1.39 | Rake $0.05
Board [Td 6h 9c 8s]
Seat 1: chxxxs collected ($1.34)
Seat 2: brontobronco folded on the Flop
Seat 3: mmdapix (button) folded on the Turn
Seat 4: Jkogeraski3108 (small blind) folded before Flop
Seat 5: xorrobinhoox (big blind) folded before Flop
Seat 6: MrDonRich folded before Flop (didn't bet)


PokerStars Hand #238178317868:  Hold'em No Limit ($0.01/$0.02 USD) - 2022/08/23 19:41:29 ET
Table 'Equinox IV' 6-max Seat #4 is the button
Seat 1: chxxxs ($2.76 in chips)
Seat 2: brontobronco ($4.28 in chips)
Seat 3: mmdapix ($0.78 in chips)
Seat 4: Jkogeraski3108 ($0.88 in chips)
Seat 5: xorrobinhoox ($3.31 in chips)
Seat 6: MrDonRich ($3.76 in chips)
xorrobinhoox: posts small blind $0.01
MrDonRich: posts big blind $0.02
*** HOLE CARDS ***
chxxxs: folds
brontobronco: raises $0.04 to $0.06
mmdapix: calls $0.06
Jkogeraski3108: folds
xorrobinhoox: folds
MrDonRich: calls $0.04
*** FLOP *** [Ac 2h 9h]
MrDonRich: bets $0.12
brontobronco: folds
mmdapix: folds
Uncalled bet ($0.12) returned to MrDonRich
MrDonRich collected $0.18 from pot
MrDonRich: doesn't show hand
*** SUMMARY ***
Total pot $0.19 | Rake $0.01
Board [Ac 2h 9h]
Seat 1: chxxxs folded before Flop (didn't bet)
Seat 2: brontobronco folded on the Flop
Seat 3: mmdapix folded on the Flop
Seat 4: Jkogeraski3108 (button) folded before Flop (didn't bet)
Seat 5: xorrobinhoox (small blind) folded before Flop
Seat 6: MrDonRich (big blind) collected ($0.18)


PokerStars Hand #238178327608:  Hold'em No Limit ($0.01/$0.02 USD) - 2022/08/23 19:42:01 ET
Table 'Equinox IV' 6-max Seat #5 is the button
Seat 1: chxxxs ($2.76 in chips)
Seat 2: brontobronco ($4.22 in chips)
Seat 3: mmdapix ($0.72 in chips)
Seat 4: Jkogeraski3108 ($0.88 in chips)
Seat 5: xorrobinhoox ($3.30 in chips)
Seat 6: MrDonRich ($3.88 in chips)
MrDonRich: posts small blind $0.01
chxxxs: posts big blind $0.02
*** HOLE CARDS ***
brontobronco: raises $0.04 to $0.06
mmdapix: calls $0.06
Jkogeraski3108: folds
xorrobinhoox: folds
MrDonRich: folds
chxxxs: calls $0.04
*** FLOP *** [Qd Ks Kd]
chxxxs: checks
brontobronco: bets $0.09
mmdapix: calls $0.09
chxxxs: folds
*** TURN *** [Qd Ks Kd] [7h]
brontobronco: bets $0.18
mmdapix: calls $0.18
*** RIVER *** [Qd Ks Kd 7h] [7s]
brontobronco: bets $0.39
mmdapix: folds
Uncalled bet ($0.39) returned to brontobronco
brontobronco collected $0.70 from pot
*** SUMMARY ***
Total pot $0.73 | Rake $0.03
Board [Qd Ks Kd 7h 7s]
Seat 1: chxxxs (big blind) folded on the Flop
Seat 2: brontobronco collected ($0.70)
Seat 3: mmdapix folded on the River
Seat 4: Jkogeraski3108 folded before Flop (didn't bet)
Seat 5: xorrobinhoox (button) folded before Flop (didn't bet)
Seat 6: MrDonRich (small blind) folded before Flop


PokerStars Hand #238178339348:  Hold'em No Limit ($0.01/$0.02 USD) - 2022/08/23 19:42:46 ET
Table 'Equinox IV' 6-max Seat #6 is the button
Seat 1: chxxxs ($2.70 in chips)
Seat 2: brontobronco ($4.59 in chips)
Seat 3: mmdapix ($0.39 in chips)
Seat 4: Jkogeraski3108 ($0.88 in chips)
Seat 5: xorrobinhoox ($3.30 in chips)
Seat 6: MrDonRich ($3.87 in chips)
chxxxs: posts small blind $0.01
brontobronco: posts big blind $0.02
*** HOLE CARDS ***
mmdapix: raises $0.04 to $0.06
Jkogeraski3108: folds
xorrobinhoox: raises $0.06 to $0.12
MrDonRich: folds
chxxxs: folds
brontobronco: folds
mmdapix: calls $0.06
*** FLOP *** [9c 5s Ts]
mmdapix: checks
xorrobinhoox: checks
*** TURN *** [9c 5s Ts] [Kd]
mmdapix: bets $0.27 and is all-in
xorrobinhoox: calls $0.27
*** RIVER *** [9c 5s Ts Kd] [5h]
*** SHOW DOWN ***
mmdapix: shows [Ks 6s] (two pair, Kings and Fives)
xorrobinhoox: shows [Kc Qd] (two pair, Kings and Fives - Queen kicker)
xorrobinhoox collected $0.78 from pot
*** SUMMARY ***
Total pot $0.81 | Rake $0.03
Board [9c 5s Ts Kd 5h]
Seat 1: chxxxs (small blind) folded before Flop
Seat 2: brontobronco (big blind) folded before Flop
Seat 3: mmdapix showed [Ks 6s] and lost with two pair, Kings and Fives
Seat 4: Jkogeraski3108 folded before Flop (didn't bet)
Seat 5: xorrobinhoox showed [Kc Qd] and won ($0.78) with two pair, Kings and Fives
Seat 6: MrDonRich (button) folded before Flop (didn't bet)


PokerStars Hand #238178348562:  Hold'em No Limit ($0.01/$0.02 USD) - 2022/08/23 19:43:22 ET
Table 'Equinox IV' 6-max Seat #1 is the button
Seat 1: chxxxs ($2.69 in chips)
Seat 2: brontobronco ($4.57 in chips)
Seat 4: Jkogeraski3108 ($0.88 in chips)
Seat 5: xorrobinhoox ($3.69 in chips)
Seat 6: MrDonRich ($3.87 in chips)
brontobronco: posts small blind $0.01
Jkogeraski3108: posts big blind $0.02
*** HOLE CARDS ***
xorrobinhoox: folds
MrDonRich: calls $0.02
chxxxs: folds
brontobronco: calls $0.01
Jkogeraski3108: checks
*** FLOP *** [5h Jh 2d]
brontobronco: checks
Jkogeraski3108: checks
MrDonRich: bets $0.02
brontobronco: calls $0.02
Jkogeraski3108: folds
*** TURN *** [5h Jh 2d] [Jd]
brontobronco: bets $0.05
Jkogeraski3108 leaves the table
MrDonRich: raises $0.20 to $0.25
brontobronco: folds
Uncalled bet ($0.20) returned to MrDonRich
MrDonRich collected $0.19 from pot
MrDonRich: doesn't show hand
*** SUMMARY ***
Total pot $0.20 | Rake $0.01
Board [5h Jh 2d Jd]
Seat 1: chxxxs (button) folded before Flop (didn't bet)
Seat 2: brontobronco (small blind) folded on the Turn
Seat 4: Jkogeraski3108 (big blind) folded on the Flop
Seat 5: xorrobinhoox folded before Flop (didn't bet)
Seat 6: MrDonRich collected ($0.19)


PokerStars Hand #238178363928:  Hold'em No Limit ($0.01/$0.02 USD) - 2022/08/23 19:44:08 ET
Table 'Equinox IV' 6-max Seat #2 is the button
Seat 1: chxxxs ($2.69 in chips)
Seat 2: brontobronco ($4.48 in chips)
Seat 5: xorrobinhoox ($3.69 in chips)
Seat 6: MrDonRich ($3.97 in chips)
xorrobinhoox: posts small blind $0.01
MrDonRich: posts big blind $0.02
*** HOLE CARDS ***
chxxxs: folds
brontobronco: raises $0.04 to $0.06
xorrobinhoox: folds
Jkogeraski3108 joins the table at seat #4
MrDonRich: calls $0.04
*** FLOP *** [9c 3c Kh]
MrDonRich: checks
brontobronco: bets $0.06
MrDonRich: folds
Uncalled bet ($0.06) returned to brontobronco
brontobronco collected $0.13 from pot
*** SUMMARY ***
Total pot $0.13 | Rake $0
Board [9c 3c Kh]
Seat 1: chxxxs folded before Flop (didn't bet)
Seat 2: brontobronco (button) collected ($0.13)
Seat 5: xorrobinhoox (small blind) folded before Flop
Seat 6: MrDonRich (big blind) folded on the Flop


PokerStars Hand #238178369846:  Hold'em No Limit ($0.01/$0.02 USD) - 2022/08/23 19:44:32 ET
Table 'Equinox IV' 6-max Seat #5 is the button
Seat 1: chxxxs ($2.69 in chips)
Seat 2: brontobronco ($4.55 in chips)
Seat 3: mmdapix ($1.50 in chips)
Seat 4: Jkogeraski3108 ($0.86 in chips)
Seat 5: xorrobinhoox ($3.68 in chips)
Seat 6: MrDonRich ($3.91 in chips)
MrDonRich: posts small blind $0.01
chxxxs: posts big blind $0.02
mmdapix: posts small & big blinds $0.03
Jkogeraski3108: posts big blind $0.02
*** HOLE CARDS ***
brontobronco: folds
mmdapix: checks
Jkogeraski3108: checks
xorrobinhoox: calls $0.02
MrDonRich: calls $0.01
chxxxs: checks
*** FLOP *** [2d Qh 6h]
MrDonRich: checks
chxxxs: checks
mmdapix: checks
Jkogeraski3108: bets $0.02
xorrobinhoox: raises $0.08 to $0.10
MrDonRich: folds
chxxxs: folds
mmdapix: folds
Jkogeraski3108: calls $0.08
*** TURN *** [2d Qh 6h] [8s]
Jkogeraski3108: checks
xorrobinhoox: bets $0.10
Jkogeraski3108: calls $0.10
*** RIVER *** [2d Qh 6h 8s] [5h]
Jkogeraski3108: checks
xorrobinhoox: bets $0.49
Jkogeraski3108: calls $0.49
*** SHOW DOWN ***
xorrobinhoox: shows [6s 6d] (three of a kind, Sixes)
Jkogeraski3108: shows [3h Th] (a flush, Queen high)
Jkogeraski3108 collected $1.44 from pot
*** SUMMARY ***
Total pot $1.49 | Rake $0.05
Board [2d Qh 6h 8s 5h]
Seat 1: chxxxs (big blind) folded on the Flop
Seat 2: brontobronco folded before Flop (didn't bet)
Seat 3: mmdapix folded on the Flop (didn't bet)
Seat 4: Jkogeraski3108 showed [3h Th] and won ($1.44) with a flush, Queen high
Seat 5: xorrobinhoox (button) showed [6s 6d] and lost with three of a kind, Sixes
Seat 6: MrDonRich (small blind) folded on the Flop


PokerStars Hand #238178389035:  Hold'em No Limit ($0.01/$0.02 USD) - 2022/08/23 19:45:39 ET
Table 'Equinox IV' 6-max Seat #6 is the button
Seat 1: chxxxs ($2.67 in chips)
Seat 2: brontobronco ($4.55 in chips)
Seat 3: mmdapix ($1.47 in chips)
Seat 4: Jkogeraski3108 ($1.59 in chips)
Seat 5: xorrobinhoox ($2.97 in chips)
Seat 6: MrDonRich ($3.89 in chips)
chxxxs: posts small blind $0.01
brontobronco: posts big blind $0.02
*** HOLE CARDS ***
mmdapix: folds
Jkogeraski3108: folds
xorrobinhoox: folds
MrDonRich: folds
chxxxs: folds
Uncalled bet ($0.01) returned to brontobronco
brontobronco collected $0.02 from pot
*** SUMMARY ***
Total pot $0.02 | Rake $0
Seat 1: chxxxs (small blind) folded before Flop
Seat 2: brontobronco (big blind) collected ($0.02)
Seat 3: mmdapix folded before Flop (didn't bet)
Seat 4: Jkogeraski3108 folded before Flop (didn't bet)
Seat 5: xorrobinhoox folded before Flop (didn't bet)
Seat 6: MrDonRich (button) folded before Flop (didn't bet)


PokerStars Hand #238178393473:  Hold'em No Limit ($0.01/$0.02 USD) - 2022/08/23 19:45:57 ET
Table 'Equinox IV' 6-max Seat #1 is the button
Seat 1: chxxxs ($2.66 in chips)
Seat 2: brontobronco ($4.56 in chips)
Seat 3: mmdapix ($1.47 in chips)
Seat 4: Jkogeraski3108 ($1.59 in chips)
Seat 5: xorrobinhoox ($2.97 in chips)
Seat 6: MrDonRich ($3.89 in chips)
brontobronco: posts small blind $0.01
mmdapix: posts big blind $0.02
*** HOLE CARDS ***
Jkogeraski3108: calls $0.02
xorrobinhoox: folds
MrDonRich: folds
chxxxs: folds
brontobronco: calls $0.01
mmdapix: raises $0.04 to $0.06
Jkogeraski3108: calls $0.04
brontobronco: calls $0.04
*** FLOP *** [2c 9h 7c]
brontobronco: checks
mmdapix: bets $0.08
Jkogeraski3108: calls $0.08
brontobronco: folds
*** TURN *** [2c 9h 7c] [4h]
mmdapix: checks
Jkogeraski3108: checks
*** RIVER *** [2c 9h 7c 4h] [Td]
mmdapix: checks
Jkogeraski3108: bets $0.16
mmdapix: calls $0.16
*** SHOW DOWN ***
Jkogeraski3108: shows [Tc Th] (three of a kind, Tens)
mmdapix: mucks hand
Jkogeraski3108 collected $0.64 from pot
*** SUMMARY ***
Total pot $0.66 | Rake $0.02
Board [2c 9h 7c 4h Td]
Seat 1: chxxxs (button) folded before Flop (didn't bet)
Seat 2: brontobronco (small blind) folded on the Flop
Seat 3: mmdapix (big blind) mucked
Seat 4: Jkogeraski3108 showed [Tc Th] and won ($0.64) with three of a kind, Tens
Seat 5: xorrobinhoox folded before Flop (didn't bet)
Seat 6: MrDonRich folded before Flop (didn't bet)


PokerStars Hand #238178405539:  Hold'em No Limit ($0.01/$0.02 USD) - 2022/08/23 19:46:45 ET
Table 'Equinox IV' 6-max Seat #2 is the button
Seat 1: chxxxs ($2.66 in chips)
Seat 2: brontobronco ($4.50 in chips)
Seat 3: mmdapix ($1.17 in chips)
Seat 4: Jkogeraski3108 ($1.93 in chips)
Seat 5: xorrobinhoox ($2.97 in chips)
Seat 6: MrDonRich ($3.89 in chips)
mmdapix: posts small blind $0.01
Jkogeraski3108: posts big blind $0.02
*** HOLE CARDS ***
xorrobinhoox: folds
MrDonRich has timed out
MrDonRich: folds
chxxxs: raises $0.03 to $0.05
brontobronco: folds
mmdapix: raises $0.05 to $0.10
Jkogeraski3108: folds
chxxxs: calls $0.05
*** FLOP *** [8h 6c 7d]
mmdapix: checks
chxxxs: checks
*** TURN *** [8h 6c 7d] [3d]
mmdapix: checks
chxxxs: checks
*** RIVER *** [8h 6c 7d 3d] [6h]
MrDonRich leaves the table
mmdapix: checks
chxxxs: checks
*** SHOW DOWN ***
mmdapix: shows [Ah Jc] (a pair of Sixes)
chxxxs: mucks hand
mmdapix collected $0.21 from pot
SalveCamal joins the table at seat #6
*** SUMMARY ***
Total pot $0.22 | Rake $0.01
Board [8h 6c 7d 3d 6h]
Seat 1: chxxxs mucked
Seat 2: brontobronco (button) folded before Flop (didn't bet)
Seat 3: mmdapix (small blind) showed [Ah Jc] and won ($0.21) with a pair of Sixes
Seat 4: Jkogeraski3108 (big blind) folded before Flop
Seat 5: xorrobinhoox folded before Flop (didn't bet)
Seat 6: MrDonRich folded before Flop (didn't bet)


PokerStars Hand #238178418271:  Hold'em No Limit ($0.01/$0.02 USD) - 2022/08/23 19:47:35 ET
Table 'Equinox IV' 6-max Seat #3 is the button
Seat 1: chxxxs ($2.56 in chips)
Seat 2: brontobronco ($4.50 in chips)
Seat 3: mmdapix ($1.28 in chips)
Seat 4: Jkogeraski3108 ($1.91 in chips)
Seat 5: xorrobinhoox ($2.97 in chips)
Jkogeraski3108: posts small blind $0.01
xorrobinhoox: posts big blind $0.02
SalveCamal: sits out
*** HOLE CARDS ***
chxxxs: folds
brontobronco: folds
mmdapix: raises $0.04 to $0.06
Jkogeraski3108: folds
xorrobinhoox: folds
Uncalled bet ($0.04) returned to mmdapix
mmdapix collected $0.05 from pot
mmdapix: doesn't show hand
*** SUMMARY ***
Total pot $0.05 | Rake $0
Seat 1: chxxxs folded before Flop (didn't bet)
Seat 2: brontobronco folded before Flop (didn't bet)
Seat 3: mmdapix (button) collected ($0.05)
Seat 4: Jkogeraski3108 (small blind) folded before Flop
Seat 5: xorrobinhoox (big blind) folded before Flop


PokerStars Hand #238178423756:  Hold'em No Limit ($0.01/$0.02 USD) - 2022/08/23 19:47:56 ET
Table 'Equinox IV' 6-max Seat #4 is the button
Seat 1: chxxxs ($2.56 in chips)
Seat 2: brontobronco ($4.50 in chips)
Seat 3: mmdapix ($1.31 in chips)
Seat 4: Jkogeraski3108 ($1.90 in chips)
Seat 5: xorrobinhoox ($2.95 in chips)
Seat 6: SalveCamal ($0.80 in chips)
xorrobinhoox: posts small blind $0.01
SalveCamal: posts big blind $0.02
*** HOLE CARDS ***
chxxxs: folds
brontobronco: raises $0.04 to $0.06
mmdapix: calls $0.06
Jkogeraski3108: folds
xorrobinhoox: calls $0.05
SalveCamal: folds
*** FLOP *** [9d Qh 4h]
xorrobinhoox: bets $0.09
brontobronco: calls $0.09
mmdapix: calls $0.09
*** TURN *** [9d Qh 4h] [4d]
xorrobinhoox: bets $0.22
brontobronco: calls $0.22
mmdapix: folds
*** RIVER *** [9d Qh 4h 4d] [Ad]
xorrobinhoox: checks
brontobronco: checks
*** SHOW DOWN ***
xorrobinhoox: shows [Qs Tc] (two pair, Queens and Fours)
brontobronco: shows [Qd Kc] (two pair, Queens and Fours)
xorrobinhoox collected $0.44 from pot
brontobronco collected $0.44 from pot
*** SUMMARY ***
Total pot $0.91 | Rake $0.03
Board [9d Qh 4h 4d Ad]
Seat 1: chxxxs folded before Flop (didn't bet)
Seat 2: brontobronco showed [Qd Kc] and won ($0.44) with two pair, Queens and Fours
Seat 3: mmdapix folded on the Turn
Seat 4: Jkogeraski3108 (button) folded before Flop (didn't bet)
Seat 5: xorrobinhoox (small blind) showed [Qs Tc] and won ($0.44) with two pair, Queens and Fours
Seat 6: SalveCamal (big blind) folded before Flop


PokerStars Hand #238178438105:  Hold'em No Limit ($0.01/$0.02 USD) - 2022/08/23 19:48:53 ET
Table 'Equinox IV' 6-max Seat #5 is the button
Seat 1: chxxxs ($2.56 in chips)
Seat 2: brontobronco ($4.57 in chips)
Seat 3: mmdapix ($1.16 in chips)
Seat 4: Jkogeraski3108 ($1.90 in chips)
Seat 5: xorrobinhoox ($3.02 in chips)
Seat 6: SalveCamal ($0.78 in chips)
SalveCamal: posts small blind $0.01
chxxxs: posts big blind $0.02
*** HOLE CARDS ***
brontobronco: folds
mmdapix: raises $0.05 to $0.07
Jkogeraski3108: calls $0.07
xorrobinhoox: calls $0.07
SalveCamal: calls $0.06
chxxxs: folds
*** FLOP *** [Kh 9d 5c]
SalveCamal: checks
mmdapix: checks
Jkogeraski3108: checks
xorrobinhoox: bets $0.14
SalveCamal: calls $0.14
mmdapix: folds
Jkogeraski3108: folds
*** TURN *** [Kh 9d 5c] [Jh]
SalveCamal: checks
xorrobinhoox: checks
*** RIVER *** [Kh 9d 5c Jh] [5s]
SalveCamal: bets $0.24
xorrobinhoox: calls $0.24
*** SHOW DOWN ***
SalveCamal: shows [Kc Td] (two pair, Kings and Fives)
xorrobinhoox: shows [Ts Ks] (two pair, Kings and Fives)
SalveCamal collected $0.51 from pot
xorrobinhoox collected $0.51 from pot
mmdapix leaves the table
*** SUMMARY ***
Total pot $1.06 | Rake $0.04
Board [Kh 9d 5c Jh 5s]
Seat 1: chxxxs (big blind) folded before Flop
Seat 2: brontobronco folded before Flop (didn't bet)
Seat 3: mmdapix folded on the Flop
Seat 4: Jkogeraski3108 folded on the Flop
Seat 5: xorrobinhoox (button) showed [Ts Ks] and won ($0.51) with two pair, Kings and Fives
Seat 6: SalveCamal (small blind) showed [Kc Td] and won ($0.51) with two pair, Kings and Fives


PokerStars Hand #238178461968:  Hold'em No Limit ($0.01/$0.02 USD) - 2022/08/23 19:50:02 ET
Table 'Equinox IV' 6-max Seat #6 is the button
Seat 1: chxxxs ($2.54 in chips)
Seat 2: brontobronco ($4.57 in chips)
Seat 4: Jkogeraski3108 ($1.83 in chips)
Seat 5: xorrobinhoox ($3.08 in chips)
Seat 6: SalveCamal ($0.84 in chips)
chxxxs: posts small blind $0.01
brontobronco: posts big blind $0.02
*** HOLE CARDS ***
Jkogeraski3108: calls $0.02
xorrobinhoox: calls $0.02
SalveCamal: calls $0.02
chxxxs: folds
brontobronco: checks
*** FLOP *** [Td 2d 4c]
Ramirres joins the table at seat #3
brontobronco: checks
Jkogeraski3108: bets $0.02
xorrobinhoox: calls $0.02
SalveCamal: calls $0.02
brontobronco: calls $0.02
*** TURN *** [Td 2d 4c] [2c]
brontobronco: checks
Jkogeraski3108: bets $0.02
xorrobinhoox: calls $0.02
SalveCamal: folds
brontobronco: calls $0.02
*** RIVER *** [Td 2d 4c 2c] [Ad]
brontobronco: bets $0.11
Jkogeraski3108: calls $0.11
xorrobinhoox: folds
*** SHOW DOWN ***
brontobronco: shows [8c Jc] (a pair of Deuces)
Jkogeraski3108: shows [Tc 5c] (two pair, Tens and Deuces)
Jkogeraski3108 collected $0.43 from pot
*** SUMMARY ***
Total pot $0.45 | Rake $0.02
Board [Td 2d 4c 2c Ad]
Seat 1: chxxxs (small blind) folded before Flop
Seat 2: brontobronco (big blind) showed [8c Jc] and lost with a pair of Deuces
Seat 4: Jkogeraski3108 showed [Tc 5c] and won ($0.43) with two pair, Tens and Deuces
Seat 5: xorrobinhoox folded on the River
Seat 6: SalveCamal (button) folded on the Turn


PokerStars Hand #238178484774:  Hold'em No Limit ($0.01/$0.02 USD) - 2022/08/23 19:51:33 ET
Table 'Equinox IV' 6-max Seat #1 is the button
Seat 1: chxxxs ($2.53 in chips)
Seat 2: brontobronco ($4.40 in chips)
Seat 3: Ramirres ($2 in chips)
Seat 4: Jkogeraski3108 ($2.09 in chips)
Seat 5: xorrobinhoox ($3.02 in chips)
Seat 6: SalveCamal ($0.80 in chips)
brontobronco: posts small blind $0.01
Ramirres: posts big blind $0.02
*** HOLE CARDS ***
Jkogeraski3108: folds
xorrobinhoox: raises $0.03 to $0.05
SalveCamal: calls $0.05
chxxxs: folds
brontobronco: folds
Ramirres: folds
*** FLOP *** [Ts Kc Qc]
xorrobinhoox: bets $0.06
SalveCamal: calls $0.06
*** TURN *** [Ts Kc Qc] [Td]
xorrobinhoox: bets $0.12
SalveCamal: calls $0.12
*** RIVER *** [Ts Kc Qc Td] [Js]
xorrobinhoox: bets $0.47
SalveCamal: raises $0.10 to $0.57 and is all-in
xorrobinhoox: calls $0.10
*** SHOW DOWN ***
SalveCamal: shows [7h Ac] (a straight, Ten to Ace)
xorrobinhoox: shows [Th Kh] (a full house, Tens full of Kings)
xorrobinhoox collected $1.57 from pot
*** SUMMARY ***
Total pot $1.63 | Rake $0.06
Board [Ts Kc Qc Td Js]
Seat 1: chxxxs (button) folded before Flop (didn't bet)
Seat 2: brontobronco (small blind) folded before Flop
Seat 3: Ramirres (big blind) folded before Flop
Seat 4: Jkogeraski3108 folded before Flop (didn't bet)
Seat 5: xorrobinhoox showed [Th Kh] and won ($1.57) with a full house, Tens full of Kings
Seat 6: SalveCamal showed [7h Ac] and lost with a straight, Ten to Ace


PokerStars Hand #238178499343:  Hold'em No Limit ($0.01/$0.02 USD) - 2022/08/23 19:52:32 ET
Table 'Equinox IV' 6-max Seat #2 is the button
Seat 1: chxxxs ($2.53 in chips)
Seat 2: brontobronco ($4.39 in chips)
Seat 3: Ramirres ($2 in chips)
Seat 4: Jkogeraski3108 ($2.09 in chips)
Seat 5: xorrobinhoox ($3.79 in chips)
Ramirres: posts small blind $0.01
Jkogeraski3108: posts big blind $0.02
*** HOLE CARDS ***
xorrobinhoox: folds
chxxxs: folds
brontobronco: raises $0.04 to $0.06
SalveCamal leaves the table
xorrobinhoox leaves the table
Ramirres: folds
Jkogeraski3108: calls $0.04
*** FLOP *** [3h 2d 6d]
Jkogeraski3108: checks
brontobronco: checks
*** TURN *** [3h 2d 6d] [Kc]
Jkogeraski3108: checks
brontobronco: checks
*** RIVER *** [3h 2d 6d Kc] [3s]
Jkogeraski3108: checks
brontobronco: checks
*** SHOW DOWN ***
Jkogeraski3108: shows [8s 5s] (a pair of Threes)
brontobronco: shows [8h 9h] (a pair of Threes - King+Nine kicker)
brontobronco collected $0.13 from pot
*** SUMMARY ***
Total pot $0.13 | Rake $0
Board [3h 2d 6d Kc 3s]
Seat 1: chxxxs folded before Flop (didn't bet)
Seat 2: brontobronco (button) showed [8h 9h] and won ($0.13) with a pair of Threes
Seat 3: Ramirres (small blind) folded before Flop
Seat 4: Jkogeraski3108 (big blind) showed [8s 5s] and lost with a pair of Threes
Seat 5: xorrobinhoox folded before Flop (didn't bet)


PokerStars Hand #238178509331:  Hold'em No Limit ($0.01/$0.02 USD) - 2022/08/23 19:53:12 ET
Table 'Equinox IV' 6-max Seat #3 is the button
Seat 1: chxxxs ($2.53 in chips)
Seat 2: brontobronco ($4.46 in chips)
Seat 3: Ramirres ($2 in chips)
Seat 4: Jkogeraski3108 ($2.03 in chips)
Jkogeraski3108: posts small blind $0.01
chxxxs: posts big blind $0.02
*** HOLE CARDS ***
brontobronco: folds
Ramirres: folds
Jkogeraski3108: calls $0.01
chxxxs: raises $0.06 to $0.08
Jkogeraski3108: calls $0.06
*** FLOP *** [Tc 5d 7c]
Jkogeraski3108: checks
chxxxs: bets $0.10
Jkogeraski3108: folds
Uncalled bet ($0.10) returned to chxxxs
chxxxs collected $0.15 from pot
chxxxs: doesn't show hand
*** SUMMARY ***
Total pot $0.16 | Rake $0.01
Board [Tc 5d 7c]
Seat 1: chxxxs (big blind) collected ($0.15)
Seat 2: brontobronco folded before Flop (didn't bet)
Seat 3: Ramirres (button) folded before Flop (didn't bet)
Seat 4: Jkogeraski3108 (small blind) folded on the Flop


PokerStars Hand #238178517294:  Hold'em No Limit ($0.01/$0.02 USD) - 2022/08/23 19:53:45 ET
Table 'Equinox IV' 6-max Seat #4 is the button
Seat 1: chxxxs ($2.60 in chips)
Seat 2: brontobronco ($4.46 in chips)
Seat 3: Ramirres ($2 in chips)
Seat 4: Jkogeraski3108 ($1.95 in chips)
chxxxs: posts small blind $0.01
brontobronco: posts big blind $0.02
*** HOLE CARDS ***
Ramirres: folds
Jkogeraski3108: folds
chxxxs: folds
Uncalled bet ($0.01) returned to brontobronco
brontobronco collected $0.02 from pot
*** SUMMARY ***
Total pot $0.02 | Rake $0
Seat 1: chxxxs (small blind) folded before Flop
Seat 2: brontobronco (big blind) collected ($0.02)
Seat 3: Ramirres folded before Flop (didn't bet)
Seat 4: Jkogeraski3108 (button) folded before Flop (didn't bet)


PokerStars Hand #238178520494:  Hold'em No Limit ($0.01/$0.02 USD) - 2022/08/23 19:53:58 ET
Table 'Equinox IV' 6-max Seat #1 is the button
Seat 1: chxxxs ($2.59 in chips)
Seat 2: brontobronco ($4.47 in chips)
Seat 3: Ramirres ($2 in chips)
Seat 4: Jkogeraski3108 ($1.95 in chips)
brontobronco: posts small blind $0.01
Ramirres: posts big blind $0.02
*** HOLE CARDS ***
Jkogeraski3108: folds
chxxxs: folds
brontobronco: raises $0.04 to $0.06
Ramirres: calls $0.04
*** FLOP *** [Qh Qs 5d]
brontobronco: bets $0.06
Ramirres: folds
Uncalled bet ($0.06) returned to brontobronco
brontobronco collected $0.12 from pot
*** SUMMARY ***
Total pot $0.12 | Rake $0
Board [Qh Qs 5d]
Seat 1: chxxxs (button) folded before Flop (didn't bet)
Seat 2: brontobronco (small blind) collected ($0.12)
Seat 3: Ramirres (big blind) folded on the Flop
Seat 4: Jkogeraski3108 folded before Flop (didn't bet)


PokerStars Hand #238178532076:  Hold'em No Limit ($0.01/$0.02 USD) - 2022/08/23 19:54:45 ET
Table 'Equinox IV' 6-max Seat #2 is the button
Seat 1: chxxxs ($2.59 in chips)
Seat 2: brontobronco ($4.53 in chips)
Seat 3: Ramirres ($2 in chips)
Seat 4: Jkogeraski3108 ($1.95 in chips)
Ramirres: posts small blind $0.01
Jkogeraski3108: posts big blind $0.02
*** HOLE CARDS ***
chxxxs: folds
brontobronco: folds
Ramirres: raises $0.03 to $0.05
Jkogeraski3108: calls $0.03
*** FLOP *** [5h 9h 4h]
Ramirres: bets $0.07
Jkogeraski3108: calls $0.07
*** TURN *** [5h 9h 4h] [8h]
Ramirres: bets $0.14
Jkogeraski3108: folds
Uncalled bet ($0.14) returned to Ramirres
Ramirres collected $0.23 from pot
*** SUMMARY ***
Total pot $0.24 | Rake $0.01
Board [5h 9h 4h 8h]
Seat 1: chxxxs folded before Flop (didn't bet)
Seat 2: brontobronco (button) folded before Flop (didn't bet)
Seat 3: Ramirres (small blind) collected ($0.23)
Seat 4: Jkogeraski3108 (big blind) folded on the Turn


PokerStars Hand #238178540374:  Hold'em No Limit ($0.01/$0.02 USD) - 2022/08/23 19:55:19 ET
Table 'Equinox IV' 6-max Seat #3 is the button
Seat 1: chxxxs ($2.59 in chips)
Seat 2: brontobronco ($4.53 in chips)
Seat 3: Ramirres ($2.11 in chips)
Seat 4: Jkogeraski3108 ($1.83 in chips)
Jkogeraski3108: posts small blind $0.01
chxxxs: posts big blind $0.02
*** HOLE CARDS ***
brontobronco: folds
Rômulo_rj2016 joins the table at seat #6
Ramirres: folds
Jkogeraski3108: calls $0.01
chxxxs: checks
*** FLOP *** [Kc 3s Jd]
lizAng1 joins the table at seat #5
Jkogeraski3108: checks
chxxxs: checks
*** TURN *** [Kc 3s Jd] [Kh]
Jkogeraski3108: bets $0.22
chxxxs: folds
Uncalled bet ($0.22) returned to Jkogeraski3108
Jkogeraski3108 collected $0.04 from pot
*** SUMMARY ***
Total pot $0.04 | Rake $0
Board [Kc 3s Jd Kh]
Seat 1: chxxxs (big blind) folded on the Turn
Seat 2: brontobronco folded before Flop (didn't bet)
Seat 3: Ramirres (button) folded before Flop (didn't bet)
Seat 4: Jkogeraski3108 (small blind) collected ($0.04)


PokerStars Hand #238178551104:  Hold'em No Limit ($0.01/$0.02 USD) - 2022/08/23 19:56:11 ET
Table 'Equinox IV' 6-max Seat #4 is the button
Seat 1: chxxxs ($2.57 in chips)
Seat 2: brontobronco ($4.53 in chips)
Seat 3: Ramirres ($2.11 in chips)
Seat 4: Jkogeraski3108 ($1.85 in chips)
chxxxs: posts small blind $0.01
brontobronco: posts big blind $0.02
*** HOLE CARDS ***
Ramirres: raises $0.03 to $0.05
Jkogeraski3108: folds
chxxxs: folds
brontobronco: folds
Uncalled bet ($0.03) returned to Ramirres
Ramirres collected $0.05 from pot
*** SUMMARY ***
Total pot $0.05 | Rake $0
Seat 1: chxxxs (small blind) folded before Flop
Seat 2: brontobronco (big blind) folded before Flop
Seat 3: Ramirres collected ($0.05)
Seat 4: Jkogeraski3108 (button) folded before Flop (didn't bet)


PokerStars Hand #238178553623:  Hold'em No Limit ($0.01/$0.02 USD) - 2022/08/23 19:56:23 ET
Table 'Equinox IV' 6-max Seat #1 is the button
Seat 1: chxxxs ($2.56 in chips)
Seat 2: brontobronco ($4.51 in chips)
Seat 3: Ramirres ($2.14 in chips)
Seat 4: Jkogeraski3108 ($1.85 in chips)
Seat 6: Rômulo_rj2016 ($2 in chips)
brontobronco: posts small blind $0.01
Ramirres: posts big blind $0.02
lizAng1: sits out
Rômulo_rj2016: posts big blind $0.02
*** HOLE CARDS ***
Jkogeraski3108: calls $0.02
Rômulo_rj2016: raises $0.04 to $0.06
chxxxs: folds
brontobronco: folds
Ramirres: folds
Jkogeraski3108: calls $0.04
*** FLOP *** [Kh 7s 3s]
Jkogeraski3108: checks
Rômulo_rj2016: bets $0.07
Jkogeraski3108: folds
Uncalled bet ($0.07) returned to Rômulo_rj2016
Rômulo_rj2016 collected $0.14 from pot
*** SUMMARY ***
Total pot $0.15 | Rake $0.01
Board [Kh 7s 3s]
Seat 1: chxxxs (button) folded before Flop (didn't bet)
Seat 2: brontobronco (small blind) folded before Flop
Seat 3: Ramirres (big blind) folded before Flop
Seat 4: Jkogeraski3108 folded on the Flop
Seat 6: Rômulo_rj2016 collected ($0.14)


PokerStars Hand #238178560895:  Hold'em No Limit ($0.01/$0.02 USD) - 2022/08/23 19:56:58 ET
Table 'Equinox IV' 6-max Seat #2 is the button
Seat 1: chxxxs ($2.56 in chips)
Seat 2: brontobronco ($4.50 in chips)
Seat 3: Ramirres ($2.12 in chips)
Seat 4: Jkogeraski3108 ($1.79 in chips)
Seat 6: Rômulo_rj2016 ($2.08 in chips)
Ramirres: posts small blind $0.01
Jkogeraski3108: posts big blind $0.02
lizAng1: sits out
*** HOLE CARDS ***
Rômulo_rj2016: folds
chxxxs: folds
brontobronco: folds
Ramirres: folds
Uncalled bet ($0.01) returned to Jkogeraski3108
Jkogeraski3108 collected $0.02 from pot
*** SUMMARY ***
Total pot $0.02 | Rake $0
Seat 1: chxxxs folded before Flop (didn't bet)
Seat 2: brontobronco (button) folded before Flop (didn't bet)
Seat 3: Ramirres (small blind) folded before Flop
Seat 4: Jkogeraski3108 (big blind) collected ($0.02)
Seat 6: Rômulo_rj2016 folded before Flop (didn't bet)


PokerStars Hand #238178565758:  Hold'em No Limit ($0.01/$0.02 USD) - 2022/08/23 19:57:22 ET
Table 'Equinox IV' 6-max Seat #3 is the button
Seat 1: chxxxs ($2.56 in chips)
Seat 2: brontobronco ($4.50 in chips)
Seat 3: Ramirres ($2.11 in chips)
Seat 4: Jkogeraski3108 ($1.80 in chips)
Seat 5: lizAng1 ($2 in chips)
Seat 6: Rômulo_rj2016 ($2.08 in chips)
Jkogeraski3108: posts small blind $0.01
lizAng1: posts big blind $0.02
*** HOLE CARDS ***
Rômulo_rj2016: folds
chxxxs: folds
brontobronco: folds
Ramirres: raises $0.03 to $0.05
Jkogeraski3108: folds
lizAng1: calls $0.03
*** FLOP *** [2s 2d Ah]
lizAng1: checks
Ramirres: bets $0.07
lizAng1: folds
Uncalled bet ($0.07) returned to Ramirres
Ramirres collected $0.11 from pot
*** SUMMARY ***
Total pot $0.11 | Rake $0
Board [2s 2d Ah]
Seat 1: chxxxs folded before Flop (didn't bet)
Seat 2: brontobronco folded before Flop (didn't bet)
Seat 3: Ramirres (button) collected ($0.11)
Seat 4: Jkogeraski3108 (small blind) folded before Flop
Seat 5: lizAng1 (big blind) folded on the Flop
Seat 6: Rômulo_rj2016 folded before Flop (didn't bet)


PokerStars Hand #238178577060:  Hold'em No Limit ($0.01/$0.02 USD) - 2022/08/23 19:58:06 ET
Table 'Equinox IV' 6-max Seat #4 is the button
Seat 1: chxxxs ($2.56 in chips)
Seat 2: brontobronco ($4.50 in chips)
Seat 3: Ramirres ($2.17 in chips)
Seat 4: Jkogeraski3108 ($1.79 in chips)
Seat 5: lizAng1 ($2 in chips)
Seat 6: Rômulo_rj2016 ($2.08 in chips)
lizAng1: posts small blind $0.01
Rômulo_rj2016: posts big blind $0.02
*** HOLE CARDS ***
chxxxs: folds
brontobronco: raises $0.04 to $0.06
Ramirres: folds
Jkogeraski3108: folds
lizAng1: folds
Rômulo_rj2016: folds
Uncalled bet ($0.04) returned to brontobronco
brontobronco collected $0.05 from pot
*** SUMMARY ***
Total pot $0.05 | Rake $0
Seat 1: chxxxs folded before Flop (didn't bet)
Seat 2: brontobronco collected ($0.05)
Seat 3: Ramirres folded before Flop (didn't bet)
Seat 4: Jkogeraski3108 (button) folded before Flop (didn't bet)
Seat 5: lizAng1 (small blind) folded before Flop
Seat 6: Rômulo_rj2016 (big blind) folded before Flop


